Date,State,New_Cases,Deaths,Recovered,Total_Tests,Vaccine_Dose_1,Vaccine_Dose_2,Positivity_Rate(%),Active_Cases,Population_Millions,Cumulative_Cases,Cumulative_Deaths,Cumulative_Recovered,Vaccination_Coverage_Dose1(%),Vaccination_Coverage_Dose2(%),Tests_per_Million,Case_Fatality_Rate(%),Recovery_Rate(%)
2020-01-01,Andhra Pradesh,88,0,87,1583,637,615,5.56,1,53.9,88,0,87,1.18,1.14,0.029369202226345082,0.0,98.86
2020-01-02,Andhra Pradesh,949,12,946,12223,1594,751,7.76,0,53.9,1037,12,1033,2.96,1.39,0.22677179962894248,1.16,99.61
2020-01-03,Andhra Pradesh,77,0,75,1147,4426,2697,6.71,2,53.9,1114,12,1108,8.21,5.0,0.021280148423005567,1.08,99.46
2020-01-04,Andhra Pradesh,1315,11,1313,16676,3435,65,7.89,0,53.9,2429,23,2421,6.37,0.12,0.3093877551020408,0.95,99.67
2020-01-05,Andhra Pradesh,1436,8,1432,18005,1464,727,7.98,0,53.9,3865,31,3853,2.72,1.35,0.33404452690166975,0.8,99.69
2020-01-06,Andhra Pradesh,1017,8,1008,12673,2348,1052,8.02,1,53.9,4882,39,4861,4.36,1.95,0.23512059369202226,0.8,99.57
2020-01-07,Andhra Pradesh,553,7,548,7216,586,137,7.66,0,53.9,5435,46,5409,1.09,0.25,0.13387755102040816,0.85,99.52
2020-01-08,Andhra Pradesh,621,3,613,8361,2352,21,7.43,5,53.9,6056,49,6022,4.36,0.04,0.15512059369202227,0.81,99.44
2020-01-09,Andhra Pradesh,1080,7,1080,13151,2821,2646,8.21,0,53.9,7136,56,7102,5.23,4.91,0.24398886827458255,0.78,99.52
2020-01-10,Andhra Pradesh,155,1,146,1718,783,395,9.02,8,53.9,7291,57,7248,1.45,0.73,0.03187384044526902,0.78,99.41
2020-01-11,Andhra Pradesh,1344,6,1344,16985,892,658,7.91,0,53.9,8635,63,8592,1.65,1.22,0.3151205936920223,0.73,99.5
2020-01-12,Andhra Pradesh,1343,19,1335,16541,4456,34,8.12,0,53.9,9978,82,9927,8.27,0.06,0.30688311688311687,0.82,99.49
2020-01-13,Andhra Pradesh,1283,14,1282,15953,1389,127,8.04,0,53.9,11261,96,11209,2.58,0.24,0.295974025974026,0.85,99.54
2020-01-14,Andhra Pradesh,1106,14,1100,13771,3763,3122,8.03,0,53.9,12367,110,12309,6.98,5.79,0.2554916512059369,0.89,99.53
2020-01-15,Andhra Pradesh,773,7,767,9752,4032,1999,7.93,0,53.9,13140,117,13076,7.48,3.71,0.18092764378478665,0.89,99.51
2020-01-16,Andhra Pradesh,851,7,844,10599,2053,1768,8.03,0,53.9,13991,124,13920,3.81,3.28,0.19664192949907236,0.89,99.49
2020-01-17,Andhra Pradesh,1347,18,1344,16719,4430,3195,8.06,0,53.9,15338,142,15264,8.22,5.93,0.3101855287569573,0.93,99.52
2020-01-18,Andhra Pradesh,1552,13,1549,19544,2165,278,7.94,0,53.9,16890,155,16813,4.02,0.52,0.3625974025974026,0.92,99.54
2020-01-19,Andhra Pradesh,1443,10,1436,18034,4744,1999,8.0,0,53.9,18333,165,18249,8.8,3.71,0.334582560296846,0.9,99.54
2020-01-20,Andhra Pradesh,955,3,952,11634,2391,1182,8.21,0,53.9,19288,168,19201,4.44,2.19,0.21584415584415584,0.87,99.55
2020-01-21,Andhra Pradesh,568,7,561,7084,4407,1097,8.02,0,53.9,19856,175,19762,8.18,2.04,0.13142857142857142,0.88,99.53
2020-01-22,Andhra Pradesh,43,0,42,872,1778,336,4.93,1,53.9,19899,175,19804,3.3,0.62,0.016178107606679034,0.88,99.52
2020-01-23,Andhra Pradesh,53,0,53,769,1129,426,6.89,0,53.9,19952,175,19857,2.09,0.79,0.014267161410018553,0.88,99.52
2020-01-24,Andhra Pradesh,989,14,980,12152,2988,2823,8.14,0,53.9,20941,189,20837,5.54,5.24,0.22545454545454546,0.9,99.5
2020-01-25,Andhra Pradesh,608,3,600,7549,3501,1314,8.05,5,53.9,21549,192,21437,6.5,2.44,0.1400556586270872,0.89,99.48
2020-01-26,Andhra Pradesh,410,2,407,4469,283,133,9.17,1,53.9,21959,194,21844,0.53,0.25,0.08291280148423005,0.88,99.48
2020-01-27,Andhra Pradesh,79,0,78,1123,3836,585,7.03,1,53.9,22038,194,21922,7.12,1.09,0.020834879406307977,0.88,99.47
2020-01-28,Andhra Pradesh,314,4,306,4023,3438,3393,7.81,4,53.9,22352,198,22228,6.38,6.29,0.07463821892393321,0.89,99.45
2020-01-29,Andhra Pradesh,1132,10,1125,14205,1169,535,7.97,0,53.9,23484,208,23353,2.17,0.99,0.26354359925788495,0.89,99.44
2020-01-30,Andhra Pradesh,343,1,342,4406,4303,2143,7.78,0,53.9,23827,209,23695,7.98,3.98,0.08174397031539889,0.88,99.45
2020-01-31,Andhra Pradesh,623,5,620,7796,1111,197,7.99,0,53.9,24450,214,24315,2.06,0.37,0.14463821892393322,0.88,99.45
2020-02-01,Andhra Pradesh,292,3,292,3564,2792,2786,8.19,0,53.9,24742,217,24607,5.18,5.17,0.06612244897959184,0.88,99.45
2020-02-02,Andhra Pradesh,1519,17,1515,18930,2044,658,8.02,0,53.9,26261,234,26122,3.79,1.22,0.3512059369202226,0.89,99.47
2020-02-03,Andhra Pradesh,1546,5,1542,19375,2195,174,7.98,0,53.9,27807,239,27664,4.07,0.32,0.35946196660482377,0.86,99.49
2020-02-04,Andhra Pradesh,851,12,842,9961,1462,660,8.54,0,53.9,28658,251,28506,2.71,1.22,0.1848051948051948,0.88,99.47
2020-02-05,Andhra Pradesh,253,0,252,2425,4736,3547,10.43,1,53.9,28911,251,28758,8.79,6.58,0.044990723562152134,0.87,99.47
2020-02-06,Andhra Pradesh,423,1,423,5189,940,38,8.15,0,53.9,29334,252,29181,1.74,0.07,0.0962708719851577,0.86,99.48
2020-02-07,Andhra Pradesh,1495,11,1488,18047,2390,1639,8.28,0,53.9,30829,263,30669,4.43,3.04,0.3348237476808905,0.85,99.48
2020-02-08,Andhra Pradesh,55,0,52,627,4936,1026,8.77,3,53.9,30884,263,30721,9.16,1.9,0.01163265306122449,0.85,99.47
2020-02-09,Andhra Pradesh,950,7,950,12435,4548,3444,7.64,0,53.9,31834,270,31671,8.44,6.39,0.23070500927643786,0.85,99.49
2020-02-10,Andhra Pradesh,641,6,634,8055,2410,946,7.96,1,53.9,32475,276,32305,4.47,1.76,0.149443413729128,0.85,99.48
2020-02-11,Andhra Pradesh,378,5,377,4762,4049,2759,7.94,0,53.9,32853,281,32682,7.51,5.12,0.08834879406307977,0.86,99.48
2020-02-12,Andhra Pradesh,1317,7,1312,16543,2330,1239,7.96,0,53.9,34170,288,33994,4.32,2.3,0.30692022263450836,0.84,99.48
2020-02-13,Andhra Pradesh,375,1,370,4804,2430,2051,7.81,4,53.9,34545,289,34364,4.51,3.81,0.08912801484230055,0.84,99.48
2020-02-14,Andhra Pradesh,546,5,541,6615,2368,730,8.25,0,53.9,35091,294,34905,4.39,1.35,0.12272727272727273,0.84,99.47
2020-02-15,Andhra Pradesh,803,6,795,9874,2359,130,8.13,2,53.9,35894,300,35700,4.38,0.24,0.18319109461966604,0.84,99.46
2020-02-16,Andhra Pradesh,1366,5,1357,16990,2980,1113,8.04,4,53.9,37260,305,37057,5.53,2.06,0.31521335807050094,0.82,99.46
2020-02-17,Andhra Pradesh,822,10,822,10471,193,127,7.85,0,53.9,38082,315,37879,0.36,0.24,0.19426716141001854,0.83,99.47
2020-02-18,Andhra Pradesh,1207,15,1205,14908,3368,261,8.1,0,53.9,39289,330,39084,6.25,0.48,0.2765862708719852,0.84,99.48
2020-02-19,Andhra Pradesh,204,1,202,2618,2544,2130,7.79,1,53.9,39493,331,39286,4.72,3.95,0.04857142857142857,0.84,99.48
2020-02-20,Andhra Pradesh,1629,11,1622,19921,43,1,8.18,0,53.9,41122,342,40908,0.08,0.0,0.36959183673469387,0.83,99.48
2020-02-21,Andhra Pradesh,394,4,389,4888,2801,1612,8.06,1,53.9,41516,346,41297,5.2,2.99,0.09068645640074212,0.83,99.47
2020-02-22,Andhra Pradesh,1351,6,1345,17050,3416,1822,7.92,0,53.9,42867,352,42642,6.34,3.38,0.3163265306122449,0.82,99.48
2020-02-23,Andhra Pradesh,268,1,261,3648,2389,1984,7.35,6,53.9,43135,353,42903,4.43,3.68,0.06768089053803339,0.82,99.46
2020-02-24,Andhra Pradesh,398,2,393,5447,3313,1969,7.31,3,53.9,43533,355,43296,6.15,3.65,0.10105751391465677,0.82,99.46
2020-02-25,Andhra Pradesh,1596,9,1594,19907,3659,2200,8.02,0,53.9,45129,364,44890,6.79,4.08,0.36933209647495363,0.81,99.47
2020-02-26,Andhra Pradesh,1142,12,1138,14448,2198,1562,7.9,0,53.9,46271,376,46028,4.08,2.9,0.26805194805194804,0.81,99.47
2020-02-27,Andhra Pradesh,439,2,438,5288,3042,1549,8.3,0,53.9,46710,378,46466,5.64,2.87,0.09810760667903524,0.81,99.48
2020-02-28,Andhra Pradesh,1041,4,1033,13584,3180,3075,7.66,4,53.9,47751,382,47499,5.9,5.71,0.2520222634508349,0.8,99.47
2020-02-29,Andhra Pradesh,763,8,761,9616,3068,2101,7.93,0,53.9,48514,390,48260,5.69,3.9,0.17840445269016697,0.8,99.48
2020-03-01,Andhra Pradesh,1517,11,1517,18835,4298,2690,8.05,0,53.9,50031,401,49777,7.97,4.99,0.349443413729128,0.8,99.49
2020-03-02,Andhra Pradesh,1415,11,1408,17427,830,759,8.12,0,53.9,51446,412,51185,1.54,1.41,0.3233209647495362,0.8,99.49
2020-03-03,Andhra Pradesh,1575,15,1567,19656,1405,612,8.01,0,53.9,53021,427,52752,2.61,1.14,0.36467532467532465,0.81,99.49
2020-03-04,Andhra Pradesh,632,9,632,7726,3698,2154,8.18,0,53.9,53653,436,53384,6.86,4.0,0.14333951762523192,0.81,99.5
2020-03-05,Andhra Pradesh,1572,16,1563,19810,1708,799,7.94,0,53.9,55225,452,54947,3.17,1.48,0.36753246753246754,0.82,99.5
2020-03-06,Andhra Pradesh,1461,5,1456,18076,3748,3498,8.08,0,53.9,56686,457,56403,6.95,6.49,0.3353617810760668,0.81,99.5
2020-03-07,Andhra Pradesh,1566,4,1558,19233,4141,573,8.14,4,53.9,58252,461,57961,7.68,1.06,0.3568274582560297,0.79,99.5
2020-03-08,Andhra Pradesh,425,3,421,5142,2883,1549,8.27,1,53.9,58677,464,58382,5.35,2.87,0.09539888682745826,0.79,99.5
2020-03-09,Andhra Pradesh,1239,4,1234,15358,4793,2227,8.07,1,53.9,59916,468,59616,8.89,4.13,0.28493506493506493,0.78,99.5
2020-03-10,Andhra Pradesh,599,7,590,7661,4351,3232,7.82,2,53.9,60515,475,60206,8.07,6.0,0.14213358070500928,0.78,99.49
2020-03-11,Andhra Pradesh,300,4,297,3800,2227,500,7.89,0,53.9,60815,479,60503,4.13,0.93,0.07050092764378478,0.79,99.49
2020-03-12,Andhra Pradesh,1395,18,1390,17206,4930,3622,8.11,0,53.9,62210,497,61893,9.15,6.72,0.31922077922077924,0.8,99.49
2020-03-13,Andhra Pradesh,129,1,129,1474,2002,255,8.75,0,53.9,62339,498,62022,3.71,0.47,0.027346938775510202,0.8,99.49
2020-03-14,Andhra Pradesh,155,1,152,2121,4510,294,7.31,2,53.9,62494,499,62174,8.37,0.55,0.03935064935064935,0.8,99.49
2020-03-15,Andhra Pradesh,1107,5,1099,13977,1465,340,7.92,3,53.9,63601,504,63273,2.72,0.63,0.2593135435992579,0.79,99.48
2020-03-16,Andhra Pradesh,1187,10,1185,15059,1943,1183,7.88,0,53.9,64788,514,64458,3.6,2.19,0.27938775510204084,0.79,99.49
2020-03-17,Andhra Pradesh,409,1,401,5240,3499,1161,7.81,7,53.9,65197,515,64859,6.49,2.15,0.09721706864564007,0.79,99.48
2020-03-18,Andhra Pradesh,1404,8,1396,17285,360,82,8.12,0,53.9,66601,523,66255,0.67,0.15,0.3206864564007421,0.79,99.48
2020-03-19,Andhra Pradesh,1520,8,1511,18825,162,142,8.07,1,53.9,68121,531,67766,0.3,0.26,0.3492578849721707,0.78,99.48
2020-03-20,Andhra Pradesh,1204,7,1201,14809,3841,2456,8.13,0,53.9,69325,538,68967,7.13,4.56,0.2747495361781076,0.78,99.48
2020-03-21,Andhra Pradesh,992,8,992,12385,3168,2486,8.01,0,53.9,70317,546,69959,5.88,4.61,0.2297773654916512,0.78,99.49
2020-03-22,Andhra Pradesh,99,0,98,773,2943,2812,12.81,1,53.9,70416,546,70057,5.46,5.22,0.014341372912801484,0.78,99.49
2020-03-23,Andhra Pradesh,410,5,405,5133,3242,3187,7.99,0,53.9,70826,551,70462,6.01,5.91,0.09523191094619667,0.78,99.49
2020-03-24,Andhra Pradesh,200,2,194,2639,3436,1631,7.58,4,53.9,71026,553,70656,6.37,3.03,0.04896103896103896,0.78,99.48
2020-03-25,Andhra Pradesh,1044,13,1037,13013,3376,1332,8.02,0,53.9,72070,566,71693,6.26,2.47,0.24142857142857144,0.79,99.48
2020-03-26,Andhra Pradesh,1438,14,1434,17901,471,6,8.03,0,53.9,73508,580,73127,0.87,0.01,0.33211502782931357,0.79,99.48
2020-03-27,Andhra Pradesh,1129,5,1123,14331,3661,1533,7.88,1,53.9,74637,585,74250,6.79,2.84,0.2658812615955473,0.78,99.48
2020-03-28,Andhra Pradesh,1446,19,1442,18273,3735,2121,7.91,0,53.9,76083,604,75692,6.93,3.94,0.33901669758812614,0.79,99.49
2020-03-29,Andhra Pradesh,59,0,53,786,1137,16,7.51,6,53.9,76142,604,75745,2.11,0.03,0.014582560296846011,0.79,99.48
2020-03-30,Andhra Pradesh,1336,11,1331,16866,1959,340,7.92,0,53.9,77478,615,77076,3.63,0.63,0.31291280148423006,0.79,99.48
2020-03-31,Andhra Pradesh,800,4,792,10151,2907,865,7.88,4,53.9,78278,619,77868,5.39,1.6,0.18833024118738403,0.79,99.48
2020-04-01,Andhra Pradesh,1034,9,1033,12943,4522,2467,7.99,0,53.9,79312,628,78901,8.39,4.58,0.24012987012987014,0.79,99.48
2020-04-02,Andhra Pradesh,700,6,699,8477,4112,2007,8.26,0,53.9,80012,634,79600,7.63,3.72,0.1572727272727273,0.79,99.49
2020-04-03,Andhra Pradesh,1109,6,1100,14553,2461,735,7.62,3,53.9,81121,640,80700,4.57,1.36,0.27,0.79,99.48
2020-04-04,Andhra Pradesh,278,4,277,3283,2486,874,8.47,0,53.9,81399,644,80977,4.61,1.62,0.060909090909090906,0.79,99.48
2020-04-05,Andhra Pradesh,748,4,740,9496,3679,2538,7.88,4,53.9,82147,648,81717,6.83,4.71,0.17617810760667904,0.79,99.48
2020-04-06,Andhra Pradesh,677,3,677,8705,1953,28,7.78,0,53.9,82824,651,82394,3.62,0.05,0.16150278293135437,0.79,99.48
2020-04-07,Andhra Pradesh,226,1,222,2514,301,277,8.99,3,53.9,83050,652,82616,0.56,0.51,0.04664192949907236,0.79,99.48
2020-04-08,Andhra Pradesh,1504,20,1495,18720,722,365,8.03,0,53.9,84554,672,84111,1.34,0.68,0.3473098330241187,0.79,99.48
2020-04-09,Andhra Pradesh,397,2,390,4796,1104,1078,8.28,5,53.9,84951,674,84501,2.05,2.0,0.08897959183673469,0.79,99.47
2020-04-10,Andhra Pradesh,660,7,659,8111,2177,861,8.14,0,53.9,85611,681,85160,4.04,1.6,0.15048237476808907,0.8,99.47
2020-04-11,Andhra Pradesh,1239,13,1233,15554,1798,1688,7.97,0,53.9,86850,694,86393,3.34,3.13,0.2885714285714286,0.8,99.47
2020-04-12,Andhra Pradesh,1351,18,1347,16851,2622,2372,8.02,0,53.9,88201,712,87740,4.86,4.4,0.3126345083487941,0.81,99.48
2020-04-13,Andhra Pradesh,882,4,876,11106,1104,1071,7.94,2,53.9,89083,716,88616,2.05,1.99,0.2060482374768089,0.8,99.48
2020-04-14,Andhra Pradesh,856,5,856,10321,3565,1770,8.29,0,53.9,89939,721,89472,6.61,3.28,0.19148423005565862,0.8,99.48
2020-04-15,Andhra Pradesh,314,3,310,4129,3356,152,7.6,1,53.9,90253,724,89782,6.23,0.28,0.07660482374768089,0.8,99.48
2020-04-16,Andhra Pradesh,1315,17,1306,16382,951,357,8.03,0,53.9,91568,741,91088,1.76,0.66,0.3039332096474954,0.81,99.48
2020-04-17,Andhra Pradesh,1332,4,1324,16589,824,529,8.03,4,53.9,92900,745,92412,1.53,0.98,0.30777365491651204,0.8,99.47
2020-04-18,Andhra Pradesh,1389,14,1389,17051,3508,3023,8.15,0,53.9,94289,759,93801,6.51,5.61,0.3163450834879406,0.8,99.48
2020-04-19,Andhra Pradesh,803,4,802,10361,3465,1583,7.75,0,53.9,95092,763,94603,6.43,2.94,0.19222634508348793,0.8,99.49
2020-04-20,Andhra Pradesh,1165,15,1160,14492,649,163,8.04,0,53.9,96257,778,95763,1.2,0.3,0.2688682745825603,0.81,99.49
2020-04-21,Andhra Pradesh,965,9,959,11988,4161,974,8.05,0,53.9,97222,787,96722,7.72,1.81,0.22241187384044528,0.81,99.49
2020-04-22,Andhra Pradesh,554,3,548,6464,3487,660,8.57,3,53.9,97776,790,97270,6.47,1.22,0.11992578849721706,0.81,99.48
2020-04-23,Andhra Pradesh,261,1,261,2831,1419,341,9.22,0,53.9,98037,791,97531,2.63,0.63,0.05252319109461966,0.81,99.48
2020-04-24,Andhra Pradesh,722,7,718,9018,3535,1892,8.01,0,53.9,98759,798,98249,6.56,3.51,0.16730983302411873,0.81,99.48
2020-04-25,Andhra Pradesh,589,1,587,7417,1906,709,7.94,1,53.9,99348,799,98836,3.54,1.32,0.13760667903525045,0.8,99.48
2020-04-26,Andhra Pradesh,245,1,244,2727,934,55,8.98,0,53.9,99593,800,99080,1.73,0.1,0.05059369202226345,0.8,99.48
2020-04-27,Andhra Pradesh,1452,17,1451,18215,4482,460,7.97,0,53.9,101045,817,100531,8.32,0.85,0.33794063079777364,0.81,99.49
2020-04-28,Andhra Pradesh,896,7,895,10621,4776,3662,8.44,0,53.9,101941,824,101426,8.86,6.79,0.1970500927643785,0.81,99.49
2020-04-29,Andhra Pradesh,384,1,376,4464,2919,676,8.6,7,53.9,102325,825,101802,5.42,1.25,0.08282003710575139,0.81,99.49
2020-04-30,Andhra Pradesh,999,8,995,12658,1093,5,7.89,0,53.9,103324,833,102797,2.03,0.01,0.23484230055658628,0.81,99.49
2020-05-01,Andhra Pradesh,1136,15,1132,14380,4666,4295,7.9,0,53.9,104460,848,103929,8.66,7.97,0.26679035250463823,0.81,99.49
2020-05-02,Andhra Pradesh,655,6,653,8209,1341,243,7.98,0,53.9,105115,854,104582,2.49,0.45,0.15230055658627087,0.81,99.49
2020-05-03,Andhra Pradesh,236,1,228,2804,2475,875,8.42,7,53.9,105351,855,104810,4.59,1.62,0.05202226345083488,0.81,99.49
2020-05-04,Andhra Pradesh,902,10,899,11581,3577,2981,7.79,0,53.9,106253,865,105709,6.64,5.53,0.214860853432282,0.81,99.49
2020-05-05,Andhra Pradesh,1191,11,1191,14824,4078,3332,8.03,0,53.9,107444,876,106900,7.57,6.18,0.2750278293135436,0.82,99.49
2020-05-06,Andhra Pradesh,1499,19,1497,18348,1596,1530,8.17,0,53.9,108943,895,108397,2.96,2.84,0.3404081632653061,0.82,99.5
2020-05-07,Andhra Pradesh,1016,8,1015,12739,4542,3675,7.98,0,53.9,109959,903,109412,8.43,6.82,0.23634508348794064,0.82,99.5
2020-05-08,Andhra Pradesh,1379,13,1378,17207,4068,3090,8.01,0,53.9,111338,916,110790,7.55,5.73,0.3192393320964749,0.82,99.51
2020-05-09,Andhra Pradesh,991,10,991,12598,392,329,7.87,0,53.9,112329,926,111781,0.73,0.61,0.2337291280148423,0.82,99.51
2020-05-10,Andhra Pradesh,1486,18,1486,18755,4500,49,7.92,0,53.9,113815,944,113267,8.35,0.09,0.3479591836734694,0.83,99.52
2020-05-11,Andhra Pradesh,1185,14,1181,14781,1855,929,8.02,0,53.9,115000,958,114448,3.44,1.72,0.27423005565862707,0.83,99.52
2020-05-12,Andhra Pradesh,808,12,801,10382,2303,1730,7.78,0,53.9,115808,970,115249,4.27,3.21,0.19261595547309834,0.84,99.52
2020-05-13,Andhra Pradesh,988,8,982,12169,508,225,8.12,0,53.9,116796,978,116231,0.94,0.42,0.2257699443413729,0.84,99.52
2020-05-14,Andhra Pradesh,1403,7,1396,17893,2321,1698,7.84,0,53.9,118199,985,117627,4.31,3.15,0.3319666048237477,0.83,99.52
2020-05-15,Andhra Pradesh,144,0,136,2293,1270,517,6.28,8,53.9,118343,985,117763,2.36,0.96,0.0425417439703154,0.83,99.51
2020-05-16,Andhra Pradesh,1443,9,1436,18474,2026,843,7.81,0,53.9,119786,994,119199,3.76,1.56,0.34274582560296846,0.83,99.51
2020-05-17,Andhra Pradesh,231,3,231,2937,3584,1878,7.87,0,53.9,120017,997,119430,6.65,3.48,0.05448979591836735,0.83,99.51
2020-05-18,Andhra Pradesh,431,3,423,5077,2628,53,8.49,5,53.9,120448,1000,119853,4.88,0.1,0.09419294990723562,0.83,99.51
2020-05-19,Andhra Pradesh,1246,9,1240,15191,1806,869,8.2,0,53.9,121694,1009,121093,3.35,1.61,0.28183673469387754,0.83,99.51
2020-05-20,Andhra Pradesh,483,2,483,6075,4443,229,7.95,0,53.9,122177,1011,121576,8.24,0.42,0.11270871985157699,0.83,99.51
2020-05-21,Andhra Pradesh,985,3,981,12115,4687,4539,8.13,1,53.9,123162,1014,122557,8.7,8.42,0.22476808905380333,0.82,99.51
2020-05-22,Andhra Pradesh,1450,8,1446,18007,4491,2156,8.05,0,53.9,124612,1022,124003,8.33,4.0,0.33408163265306123,0.82,99.51
2020-05-23,Andhra Pradesh,1456,12,1455,17975,18,6,8.1,0,53.9,126068,1034,125458,0.03,0.01,0.3334879406307978,0.82,99.52
2020-05-24,Andhra Pradesh,1292,7,1288,15519,784,157,8.33,0,53.9,127360,1041,126746,1.45,0.29,0.2879220779220779,0.82,99.52
2020-05-25,Andhra Pradesh,1271,9,1269,15654,195,174,8.12,0,53.9,128631,1050,128015,0.36,0.32,0.29042671614100185,0.82,99.52
2020-05-26,Andhra Pradesh,273,3,271,3401,3058,1292,8.03,0,53.9,128904,1053,128286,5.67,2.4,0.06309833024118738,0.82,99.52
2020-05-27,Andhra Pradesh,1135,13,1134,13935,3488,3424,8.14,0,53.9,130039,1066,129420,6.47,6.35,0.25853432282003713,0.82,99.52
2020-05-28,Andhra Pradesh,390,5,390,4965,3727,2269,7.85,0,53.9,130429,1071,129810,6.91,4.21,0.09211502782931355,0.82,99.53
2020-05-29,Andhra Pradesh,832,3,831,9863,3297,967,8.44,0,53.9,131261,1074,130641,6.12,1.79,0.18298701298701298,0.82,99.53
2020-05-30,Andhra Pradesh,1276,17,1272,15565,697,627,8.2,0,53.9,132537,1091,131913,1.29,1.16,0.28877551020408165,0.82,99.53
2020-05-31,Andhra Pradesh,874,6,866,10992,718,228,7.95,2,53.9,133411,1097,132779,1.33,0.42,0.20393320964749537,0.82,99.53
2020-06-01,Andhra Pradesh,1492,5,1491,18304,2579,1602,8.15,0,53.9,134903,1102,134270,4.78,2.97,0.3395918367346939,0.82,99.53
2020-06-02,Andhra Pradesh,1218,12,1213,15370,1599,554,7.92,0,53.9,136121,1114,135483,2.97,1.03,0.28515769944341374,0.82,99.53
2020-06-03,Andhra Pradesh,1044,6,1042,13190,4242,2114,7.92,0,53.9,137165,1120,136525,7.87,3.92,0.24471243042671614,0.82,99.53
2020-06-04,Andhra Pradesh,195,2,187,2458,3938,1053,7.93,6,53.9,137360,1122,136712,7.31,1.95,0.04560296846011132,0.82,99.53
2020-06-05,Andhra Pradesh,193,1,191,2140,1025,629,9.02,1,53.9,137553,1123,136903,1.9,1.17,0.03970315398886828,0.82,99.53
2020-06-06,Andhra Pradesh,736,9,732,8826,1172,279,8.34,0,53.9,138289,1132,137635,2.17,0.52,0.16374768089053804,0.82,99.53
2020-06-07,Andhra Pradesh,120,0,113,1362,1508,364,8.81,7,53.9,138409,1132,137748,2.8,0.68,0.025269016697588124,0.82,99.52
2020-06-08,Andhra Pradesh,1087,15,1082,13403,4024,1845,8.11,0,53.9,139496,1147,138830,7.47,3.42,0.24866419294990724,0.82,99.52
2020-06-09,Andhra Pradesh,399,4,398,5207,1368,955,7.66,0,53.9,139895,1151,139228,2.54,1.77,0.0966048237476809,0.82,99.52
2020-06-10,Andhra Pradesh,897,5,891,11182,4192,2294,8.02,1,53.9,140792,1156,140119,7.78,4.26,0.2074582560296846,0.82,99.52
2020-06-11,Andhra Pradesh,1089,5,1080,13447,487,67,8.1,4,53.9,141881,1161,141199,0.9,0.12,0.24948051948051947,0.82,99.52
2020-06-12,Andhra Pradesh,376,5,371,4582,3072,2480,8.21,0,53.9,142257,1166,141570,5.7,4.6,0.08500927643784786,0.82,99.52
2020-06-13,Andhra Pradesh,1560,20,1551,19384,2513,108,8.05,0,53.9,143817,1186,143121,4.66,0.2,0.35962894248608535,0.82,99.52
2020-06-14,Andhra Pradesh,386,4,378,5153,27,23,7.49,4,53.9,144203,1190,143499,0.05,0.04,0.09560296846011132,0.83,99.51
2020-06-15,Andhra Pradesh,570,6,568,6882,3896,3713,8.28,0,53.9,144773,1196,144067,7.23,6.89,0.1276808905380334,0.83,99.51
2020-06-16,Andhra Pradesh,122,1,118,1335,3175,536,9.14,3,53.9,144895,1197,144185,5.89,0.99,0.02476808905380334,0.83,99.51
2020-06-17,Andhra Pradesh,1415,20,1411,17017,1545,631,8.32,0,53.9,146310,1217,145596,2.87,1.17,0.3157142857142857,0.83,99.51
2020-06-18,Andhra Pradesh,645,5,638,8305,687,620,7.77,2,53.9,146955,1222,146234,1.27,1.15,0.1540816326530612,0.83,99.51
2020-06-19,Andhra Pradesh,558,7,554,6694,3116,2351,8.34,0,53.9,147513,1229,146788,5.78,4.36,0.12419294990723562,0.83,99.51
2020-06-20,Andhra Pradesh,579,4,572,7330,4180,2151,7.9,3,53.9,148092,1233,147360,7.76,3.99,0.1359925788497217,0.83,99.51
2020-06-21,Andhra Pradesh,241,1,240,2957,838,26,8.15,0,53.9,148333,1234,147600,1.55,0.05,0.054860853432282,0.83,99.51
2020-06-22,Andhra Pradesh,130,1,130,1412,4212,1369,9.21,0,53.9,148463,1235,147730,7.81,2.54,0.02619666048237477,0.83,99.51
2020-06-23,Andhra Pradesh,126,1,120,1835,2842,417,6.87,5,53.9,148589,1236,147850,5.27,0.77,0.03404452690166976,0.83,99.5
2020-06-24,Andhra Pradesh,82,0,82,836,3400,1210,9.81,0,53.9,148671,1236,147932,6.31,2.24,0.015510204081632653,0.83,99.5
2020-06-25,Andhra Pradesh,941,6,933,11314,4003,2482,8.32,2,53.9,149612,1242,148865,7.43,4.6,0.20990723562152133,0.83,99.5
2020-06-26,Andhra Pradesh,1318,14,1317,16054,2203,1397,8.21,0,53.9,150930,1256,150182,4.09,2.59,0.297847866419295,0.83,99.5
2020-06-27,Andhra Pradesh,860,10,852,10419,2196,916,8.25,0,53.9,151790,1266,151034,4.07,1.7,0.19330241187384045,0.83,99.5
2020-06-28,Andhra Pradesh,183,2,180,2190,387,164,8.36,1,53.9,151973,1268,151214,0.72,0.3,0.040630797773654914,0.83,99.5
2020-06-29,Andhra Pradesh,911,9,903,11540,1096,530,7.89,0,53.9,152884,1277,152117,2.03,0.98,0.21410018552875695,0.84,99.5
2020-06-30,Andhra Pradesh,1118,3,1117,13955,2020,1870,8.01,0,53.9,154002,1280,153234,3.75,3.47,0.2589053803339518,0.83,99.5
2020-07-01,Andhra Pradesh,166,0,160,2078,695,294,7.99,6,53.9,154168,1280,153394,1.29,0.55,0.03855287569573284,0.83,99.5
2020-07-02,Andhra Pradesh,1577,8,1576,19838,1796,637,7.95,0,53.9,155745,1288,154970,3.33,1.18,0.3680519480519481,0.83,99.5
2020-07-03,Andhra Pradesh,475,6,471,5964,2609,1256,7.96,0,53.9,156220,1294,155441,4.84,2.33,0.11064935064935065,0.83,99.5
2020-07-04,Andhra Pradesh,59,0,54,595,4912,4506,9.92,5,53.9,156279,1294,155495,9.11,8.36,0.01103896103896104,0.83,99.5
2020-07-05,Andhra Pradesh,994,2,986,12422,1500,1392,8.0,6,53.9,157273,1296,156481,2.78,2.58,0.2304638218923933,0.82,99.5
2020-07-06,Andhra Pradesh,1155,15,1155,14673,433,125,7.87,0,53.9,158428,1311,157636,0.8,0.23,0.2722263450834879,0.83,99.5
2020-07-07,Andhra Pradesh,180,1,177,2169,2303,794,8.3,2,53.9,158608,1312,157813,4.27,1.47,0.04024118738404453,0.83,99.5
2020-07-08,Andhra Pradesh,1320,11,1314,16537,900,145,7.98,0,53.9,159928,1323,159127,1.67,0.27,0.30680890538033395,0.83,99.5
2020-07-09,Andhra Pradesh,737,8,733,8904,854,537,8.28,0,53.9,160665,1331,159860,1.58,1.0,0.1651948051948052,0.83,99.5
2020-07-10,Andhra Pradesh,295,1,289,3909,515,157,7.55,5,53.9,160960,1332,160149,0.96,0.29,0.07252319109461966,0.83,99.5
2020-07-11,Andhra Pradesh,223,2,217,3173,3616,2884,7.03,4,53.9,161183,1334,160366,6.71,5.35,0.0588682745825603,0.83,99.49
2020-07-12,Andhra Pradesh,1498,9,1496,18523,3781,3060,8.09,0,53.9,162681,1343,161862,7.01,5.68,0.34365491651205937,0.83,99.5
2020-07-13,Andhra Pradesh,314,2,313,3746,3045,2479,8.38,0,53.9,162995,1345,162175,5.65,4.6,0.06949907235621522,0.83,99.5
2020-07-14,Andhra Pradesh,1045,5,1038,12857,4991,2956,8.13,2,53.9,164040,1350,163213,9.26,5.48,0.23853432282003711,0.82,99.5
2020-07-15,Andhra Pradesh,1202,17,1198,15115,2885,448,7.95,0,53.9,165242,1367,164411,5.35,0.83,0.28042671614100184,0.83,99.5
2020-07-16,Andhra Pradesh,1442,15,1440,17754,4139,3268,8.12,0,53.9,166684,1382,165851,7.68,6.06,0.3293877551020408,0.83,99.5
2020-07-17,Andhra Pradesh,916,3,910,11511,29,28,7.96,3,53.9,167600,1385,166761,0.05,0.05,0.2135621521335807,0.83,99.5
2020-07-18,Andhra Pradesh,1097,9,1094,13334,4537,1764,8.23,0,53.9,168697,1394,167855,8.42,3.27,0.24738404452690166,0.83,99.5
2020-07-19,Andhra Pradesh,805,3,804,9887,3201,3026,8.14,0,53.9,169502,1397,168659,5.94,5.61,0.18343228200371056,0.82,99.5
2020-07-20,Andhra Pradesh,1357,19,1352,16405,1567,381,8.27,0,53.9,170859,1416,170011,2.91,0.71,0.30435992578849724,0.83,99.5
2020-07-21,Andhra Pradesh,90,1,89,1290,796,34,6.98,0,53.9,170949,1417,170100,1.48,0.06,0.023933209647495363,0.83,99.5
2020-07-22,Andhra Pradesh,44,0,41,509,3837,2226,8.64,3,53.9,170993,1417,170141,7.12,4.13,0.009443413729128014,0.83,99.5
2020-07-23,Andhra Pradesh,128,1,126,1497,358,120,8.55,1,53.9,171121,1418,170267,0.66,0.22,0.02777365491651206,0.83,99.5
2020-07-24,Andhra Pradesh,1050,8,1042,13350,4600,4063,7.87,0,53.9,172171,1426,171309,8.53,7.54,0.24768089053803338,0.83,99.5
2020-07-25,Andhra Pradesh,1236,15,1234,15606,348,180,7.92,0,53.9,173407,1441,172543,0.65,0.33,0.2895361781076067,0.83,99.5
2020-07-26,Andhra Pradesh,1535,19,1528,19111,3488,2356,8.03,0,53.9,174942,1460,174071,6.47,4.37,0.3545640074211503,0.83,99.5
2020-07-27,Andhra Pradesh,1243,15,1237,15639,2032,906,7.95,0,53.9,176185,1475,175308,3.77,1.68,0.29014842300556587,0.84,99.5
2020-07-28,Andhra Pradesh,754,6,749,9423,2745,2203,8.0,0,53.9,176939,1481,176057,5.09,4.09,0.17482374768089054,0.84,99.5
2020-07-29,Andhra Pradesh,1471,19,1462,18591,852,392,7.91,0,53.9,178410,1500,177519,1.58,0.73,0.3449165120593692,0.84,99.5
2020-07-30,Andhra Pradesh,1223,5,1220,15277,819,638,8.01,0,53.9,179633,1505,178739,1.52,1.18,0.28343228200371057,0.84,99.5
2020-07-31,Andhra Pradesh,392,3,385,5165,305,197,7.59,4,53.9,180025,1508,179124,0.57,0.37,0.09582560296846011,0.84,99.5
2020-08-01,Andhra Pradesh,1138,9,1133,14250,3674,3575,7.99,0,53.9,181163,1517,180257,6.82,6.63,0.26437847866419295,0.84,99.5
2020-08-02,Andhra Pradesh,539,4,539,7033,22,20,7.66,0,53.9,181702,1521,180796,0.04,0.04,0.13048237476808905,0.84,99.5
2020-08-03,Andhra Pradesh,667,2,665,8430,390,360,7.91,0,53.9,182369,1523,181461,0.72,0.67,0.15640074211502783,0.84,99.5
2020-08-04,Andhra Pradesh,19,0,10,506,3119,481,3.75,9,53.9,182388,1523,181471,5.79,0.89,0.009387755102040816,0.84,99.5
2020-08-05,Andhra Pradesh,1421,10,1420,17311,3566,2574,8.21,0,53.9,183809,1533,182891,6.62,4.78,0.32116883116883116,0.83,99.5
2020-08-06,Andhra Pradesh,181,0,175,2398,3951,1148,7.55,6,53.9,183990,1533,183066,7.33,2.13,0.044489795918367346,0.83,99.5
2020-08-07,Andhra Pradesh,590,7,589,6951,3809,424,8.49,0,53.9,184580,1540,183655,7.07,0.79,0.12896103896103897,0.83,99.5
2020-08-08,Andhra Pradesh,1318,16,1316,16493,1129,1000,7.99,0,53.9,185898,1556,184971,2.09,1.86,0.3059925788497217,0.84,99.5
2020-08-09,Andhra Pradesh,320,4,319,3738,1301,706,8.56,0,53.9,186218,1560,185290,2.41,1.31,0.06935064935064936,0.84,99.5
2020-08-10,Andhra Pradesh,753,2,753,9297,4191,427,8.1,0,53.9,186971,1562,186043,7.78,0.79,0.1724860853432282,0.84,99.5
2020-08-11,Andhra Pradesh,386,2,386,4849,230,202,7.96,0,53.9,187357,1564,186429,0.43,0.37,0.08996289424860854,0.83,99.5
2020-08-12,Andhra Pradesh,702,4,699,8676,3374,263,8.09,0,53.9,188059,1568,187128,6.26,0.49,0.16096474953617812,0.83,99.5
2020-08-13,Andhra Pradesh,1371,4,1369,17099,659,638,8.02,0,53.9,189430,1572,188497,1.22,1.18,0.31723562152133583,0.83,99.51
2020-08-14,Andhra Pradesh,110,1,101,1110,355,15,9.91,8,53.9,189540,1573,188598,0.66,0.03,0.020593692022263452,0.83,99.5
2020-08-15,Andhra Pradesh,436,3,434,5105,3796,2744,8.54,0,53.9,189976,1576,189032,7.04,5.09,0.09471243042671613,0.83,99.5
2020-08-16,Andhra Pradesh,50,0,42,717,2364,1895,6.97,8,53.9,190026,1576,189074,4.39,3.52,0.013302411873840445,0.83,99.5
2020-08-17,Andhra Pradesh,716,2,707,8585,4047,3241,8.34,7,53.9,190742,1578,189781,7.51,6.01,0.1592764378478664,0.83,99.5
2020-08-18,Andhra Pradesh,107,0,99,1251,2815,2170,8.55,8,53.9,190849,1578,189880,5.22,4.03,0.023209647495361783,0.83,99.49
2020-08-19,Andhra Pradesh,1583,20,1581,19736,1760,1695,8.02,0,53.9,192432,1598,191461,3.27,3.14,0.3661595547309833,0.83,99.5
2020-08-20,Andhra Pradesh,562,3,553,7273,3882,2254,7.73,6,53.9,192994,1601,192014,7.2,4.18,0.13493506493506494,0.83,99.49
2020-08-21,Andhra Pradesh,274,2,268,3093,2275,2090,8.86,4,53.9,193268,1603,192282,4.22,3.88,0.05738404452690167,0.83,99.49
2020-08-22,Andhra Pradesh,126,0,124,1612,3624,2809,7.82,2,53.9,193394,1603,192406,6.72,5.21,0.029907235621521335,0.83,99.49
2020-08-23,Andhra Pradesh,186,2,183,2536,4050,1608,7.33,1,53.9,193580,1605,192589,7.51,2.98,0.04705009276437848,0.83,99.49
2020-08-24,Andhra Pradesh,679,7,674,8797,2466,711,7.72,0,53.9,194259,1612,193263,4.58,1.32,0.1632096474953618,0.83,99.49
2020-08-25,Andhra Pradesh,795,3,788,9942,1841,653,8.0,4,53.9,195054,1615,194051,3.42,1.21,0.18445269016697588,0.83,99.49
2020-08-26,Andhra Pradesh,264,2,256,3375,3735,2034,7.82,6,53.9,195318,1617,194307,6.93,3.77,0.06261595547309833,0.83,99.48
2020-08-27,Andhra Pradesh,1394,12,1393,17572,310,214,7.93,0,53.9,196712,1629,195700,0.58,0.4,0.32601113172541746,0.83,99.49
2020-08-28,Andhra Pradesh,1087,13,1084,13623,1102,804,7.98,0,53.9,197799,1642,196784,2.04,1.49,0.25274582560296843,0.83,99.49
2020-08-29,Andhra Pradesh,1203,5,1201,15243,3965,3923,7.89,0,53.9,199002,1647,197985,7.36,7.28,0.28280148423005563,0.83,99.49
2020-08-30,Andhra Pradesh,588,8,584,7380,1084,547,7.97,0,53.9,199590,1655,198569,2.01,1.01,0.13692022263450834,0.83,99.49
2020-08-31,Andhra Pradesh,1309,15,1307,16322,813,325,8.02,0,53.9,200899,1670,199876,1.51,0.6,0.3028200371057514,0.83,99.49
2020-09-01,Andhra Pradesh,388,3,388,4733,2355,450,8.2,0,53.9,201287,1673,200264,4.37,0.83,0.08781076066790353,0.83,99.49
2020-09-02,Andhra Pradesh,860,11,855,10471,3146,1848,8.21,0,53.9,202147,1684,201119,5.84,3.43,0.19426716141001854,0.83,99.49
2020-09-03,Andhra Pradesh,454,1,449,5925,583,167,7.66,4,53.9,202601,1685,201568,1.08,0.31,0.10992578849721707,0.83,99.49
2020-09-04,Andhra Pradesh,378,3,373,4909,2090,1831,7.7,2,53.9,202979,1688,201941,3.88,3.4,0.0910760667903525,0.83,99.49
2020-09-05,Andhra Pradesh,1194,13,1185,14981,2525,148,7.97,0,53.9,204173,1701,203126,4.68,0.27,0.27794063079777365,0.83,99.49
2020-09-06,Andhra Pradesh,709,8,704,8736,343,83,8.12,0,53.9,204882,1709,203830,0.64,0.15,0.16207792207792207,0.83,99.49
2020-09-07,Andhra Pradesh,1215,4,1206,15406,2391,1982,7.89,5,53.9,206097,1713,205036,4.44,3.68,0.2858256029684601,0.83,99.49
2020-09-08,Andhra Pradesh,1062,10,1062,13276,483,100,8.0,0,53.9,207159,1723,206098,0.9,0.19,0.24630797773654917,0.83,99.49
2020-09-09,Andhra Pradesh,902,8,897,11000,2458,1474,8.2,0,53.9,208061,1731,206995,4.56,2.73,0.20408163265306123,0.83,99.49
2020-09-10,Andhra Pradesh,1493,20,1491,18658,2077,671,8.0,0,53.9,209554,1751,208486,3.85,1.24,0.3461595547309833,0.84,99.49
2020-09-11,Andhra Pradesh,180,0,172,2132,655,599,8.44,8,53.9,209734,1751,208658,1.22,1.11,0.039554730983302415,0.83,99.49
2020-09-12,Andhra Pradesh,787,9,786,9729,2256,465,8.09,0,53.9,210521,1760,209444,4.19,0.86,0.18050092764378478,0.84,99.49
2020-09-13,Andhra Pradesh,1482,6,1474,18937,3062,31,7.83,2,53.9,212003,1766,210918,5.68,0.06,0.35133580705009276,0.83,99.49
2020-09-14,Andhra Pradesh,240,1,240,2572,3765,2147,9.33,0,53.9,212243,1767,211158,6.99,3.98,0.04771799628942486,0.83,99.49
2020-09-15,Andhra Pradesh,216,1,207,2582,4129,1758,8.37,8,53.9,212459,1768,211365,7.66,3.26,0.04790352504638219,0.83,99.49
2020-09-16,Andhra Pradesh,448,6,448,5506,2983,1863,8.14,0,53.9,212907,1774,211813,5.53,3.46,0.102152133580705,0.83,99.49
2020-09-17,Andhra Pradesh,1378,13,1377,17186,1616,1194,8.02,0,53.9,214285,1787,213190,3.0,2.22,0.31884972170686454,0.83,99.49
2020-09-18,Andhra Pradesh,1101,6,1098,13490,1565,905,8.16,0,53.9,215386,1793,214288,2.9,1.68,0.250278293135436,0.83,99.49
2020-09-19,Andhra Pradesh,1419,12,1417,17830,1951,1374,7.96,0,53.9,216805,1805,215705,3.62,2.55,0.3307977736549165,0.83,99.49
2020-09-20,Andhra Pradesh,1205,5,1198,15211,4808,3401,7.92,2,53.9,218010,1810,216903,8.92,6.31,0.2822077922077922,0.83,99.49
2020-09-21,Andhra Pradesh,532,5,523,6491,4719,878,8.2,4,53.9,218542,1815,217426,8.76,1.63,0.12042671614100185,0.83,99.49
2020-09-22,Andhra Pradesh,581,4,573,7487,3468,1222,7.76,4,53.9,219123,1819,217999,6.43,2.27,0.13890538033395175,0.83,99.49
2020-09-23,Andhra Pradesh,552,3,549,6772,1246,534,8.15,0,53.9,219675,1822,218548,2.31,0.99,0.12564007421150278,0.83,99.49
2020-09-24,Andhra Pradesh,1560,17,1554,19371,1502,202,8.05,0,53.9,221235,1839,220102,2.79,0.37,0.3593877551020408,0.83,99.49
2020-09-25,Andhra Pradesh,1554,17,1546,19280,1705,307,8.06,0,53.9,222789,1856,221648,3.16,0.57,0.3576994434137291,0.83,99.49
2020-09-26,Andhra Pradesh,795,5,794,10121,283,173,7.85,0,53.9,223584,1861,222442,0.53,0.32,0.18777365491651207,0.83,99.49
2020-09-27,Andhra Pradesh,977,13,976,12131,3981,3639,8.05,0,53.9,224561,1874,223418,7.39,6.75,0.22506493506493505,0.83,99.49
2020-09-28,Andhra Pradesh,770,2,767,9814,4887,118,7.85,1,53.9,225331,1876,224185,9.07,0.22,0.1820779220779221,0.83,99.49
2020-09-29,Andhra Pradesh,1404,15,1402,17242,4451,345,8.14,0,53.9,226735,1891,225587,8.26,0.64,0.3198886827458256,0.83,99.49
2020-09-30,Andhra Pradesh,303,3,295,3835,550,93,7.9,5,53.9,227038,1894,225882,1.02,0.17,0.07115027829313543,0.83,99.49
2020-10-01,Andhra Pradesh,411,5,406,5319,599,293,7.73,0,53.9,227449,1899,226288,1.11,0.54,0.09868274582560296,0.83,99.49
2020-10-02,Andhra Pradesh,1305,5,1301,16333,3046,614,7.99,0,53.9,228754,1904,227589,5.65,1.14,0.30302411873840446,0.83,99.49
2020-10-03,Andhra Pradesh,431,4,431,5706,4227,2974,7.55,0,53.9,229185,1908,228020,7.84,5.52,0.10586270871985158,0.83,99.49
2020-10-04,Andhra Pradesh,439,3,439,5913,756,438,7.42,0,53.9,229624,1911,228459,1.4,0.81,0.10970315398886828,0.83,99.49
2020-10-05,Andhra Pradesh,310,4,309,4104,286,278,7.55,0,53.9,229934,1915,228768,0.53,0.52,0.07614100185528756,0.83,99.49
2020-10-06,Andhra Pradesh,1012,8,1012,12663,2578,2064,7.99,0,53.9,230946,1923,229780,4.78,3.83,0.23493506493506494,0.83,99.5
2020-10-07,Andhra Pradesh,328,3,319,4137,4953,335,7.93,6,53.9,231274,1926,230099,9.19,0.62,0.07675324675324675,0.83,99.49
2020-10-08,Andhra Pradesh,882,8,880,11173,821,771,7.89,0,53.9,232156,1934,230979,1.52,1.43,0.20729128014842302,0.83,99.49
2020-10-09,Andhra Pradesh,1563,12,1560,19296,3922,910,8.1,0,53.9,233719,1946,232539,7.28,1.69,0.35799628942486084,0.83,99.5
2020-10-10,Andhra Pradesh,571,7,567,7721,307,105,7.4,0,53.9,234290,1953,233106,0.57,0.19,0.14324675324675323,0.83,99.49
2020-10-11,Andhra Pradesh,625,5,622,7915,1006,68,7.9,0,53.9,234915,1958,233728,1.87,0.13,0.1468460111317254,0.83,99.49
2020-10-12,Andhra Pradesh,72,0,70,1223,4181,843,5.89,2,53.9,234987,1958,233798,7.76,1.56,0.022690166975881262,0.83,99.49
2020-10-13,Andhra Pradesh,1109,7,1108,14308,3281,3190,7.75,0,53.9,236096,1965,234906,6.09,5.92,0.26545454545454544,0.83,99.5
2020-10-14,Andhra Pradesh,638,1,638,8267,2807,172,7.72,0,53.9,236734,1966,235544,5.21,0.32,0.1533766233766234,0.83,99.5
2020-10-15,Andhra Pradesh,695,8,687,8768,278,124,7.93,0,53.9,237429,1974,236231,0.52,0.23,0.16267161410018552,0.83,99.5
2020-10-16,Andhra Pradesh,760,3,757,9770,3950,2766,7.78,0,53.9,238189,1977,236988,7.33,5.13,0.18126159554730983,0.83,99.5
2020-10-17,Andhra Pradesh,329,1,324,3630,4037,3016,9.06,4,53.9,238518,1978,237312,7.49,5.6,0.0673469387755102,0.83,99.49
2020-10-18,Andhra Pradesh,1168,16,1161,14790,2938,2352,7.9,0,53.9,239686,1994,238473,5.45,4.36,0.2743970315398887,0.83,99.49
2020-10-19,Andhra Pradesh,1471,12,1464,18719,3440,463,7.86,0,53.9,241157,2006,239937,6.38,0.86,0.34729128014842303,0.83,99.49
2020-10-20,Andhra Pradesh,1414,19,1413,17476,722,166,8.09,0,53.9,242571,2025,241350,1.34,0.31,0.3242300556586271,0.83,99.5
2020-10-21,Andhra Pradesh,827,4,825,10042,4027,3217,8.24,0,53.9,243398,2029,242175,7.47,5.97,0.18630797773654917,0.83,99.5
2020-10-22,Andhra Pradesh,458,2,454,5980,2039,1325,7.66,2,53.9,243856,2031,242629,3.78,2.46,0.11094619666048237,0.83,99.5
2020-10-23,Andhra Pradesh,1089,7,1085,13823,4785,3294,7.88,0,53.9,244945,2038,243714,8.88,6.11,0.256456400742115,0.83,99.5
2020-10-24,Andhra Pradesh,103,0,101,1572,1851,1269,6.55,2,53.9,245048,2038,243815,3.43,2.35,0.029165120593692022,0.83,99.5
2020-10-25,Andhra Pradesh,1300,11,1297,17054,1246,1241,7.62,0,53.9,246348,2049,245112,2.31,2.3,0.31640074211502783,0.83,99.5
2020-10-26,Andhra Pradesh,92,1,88,1214,4252,2749,7.58,3,53.9,246440,2050,245200,7.89,5.1,0.022523191094619668,0.83,99.5
2020-10-27,Andhra Pradesh,634,5,634,8216,4386,1946,7.72,0,53.9,247074,2055,245834,8.14,3.61,0.15243042671614102,0.83,99.5
2020-10-28,Andhra Pradesh,873,12,865,10523,731,428,8.3,0,53.9,247947,2067,246699,1.36,0.79,0.19523191094619666,0.83,99.5
2020-10-29,Andhra Pradesh,1125,10,1120,13636,293,112,8.25,0,53.9,249072,2077,247819,0.54,0.21,0.252987012987013,0.83,99.5
2020-10-30,Andhra Pradesh,1148,6,1142,14392,2856,2427,7.98,0,53.9,250220,2083,248961,5.3,4.5,0.26701298701298704,0.83,99.5
2020-10-31,Andhra Pradesh,612,2,612,7616,3086,9,8.04,0,53.9,250832,2085,249573,5.73,0.02,0.1412987012987013,0.83,99.5
2020-11-01,Andhra Pradesh,456,5,450,5598,3130,3064,8.15,1,53.9,251288,2090,250023,5.81,5.68,0.10385899814471243,0.83,99.5
2020-11-02,Andhra Pradesh,1119,9,1111,13755,4266,3272,8.14,0,53.9,252407,2099,251134,7.91,6.07,0.2551948051948052,0.83,99.5
2020-11-03,Andhra Pradesh,378,5,377,4477,4326,1507,8.44,0,53.9,252785,2104,251511,8.03,2.8,0.08306122448979592,0.83,99.5
2020-11-04,Andhra Pradesh,1402,7,1396,17892,3621,3068,7.84,0,53.9,254187,2111,252907,6.72,5.69,0.33194805194805194,0.83,99.5
2020-11-05,Andhra Pradesh,1160,6,1152,14319,1984,1317,8.1,2,53.9,255347,2117,254059,3.68,2.44,0.2656586270871985,0.83,99.5
2020-11-06,Andhra Pradesh,905,8,902,11724,907,611,7.72,0,53.9,256252,2125,254961,1.68,1.13,0.2175139146567718,0.83,99.5
2020-11-07,Andhra Pradesh,1525,16,1516,19259,1550,1369,7.92,0,53.9,257777,2141,256477,2.88,2.54,0.35730983302411873,0.83,99.5
2020-11-08,Andhra Pradesh,1587,5,1586,19921,3914,1458,7.97,0,53.9,259364,2146,258063,7.26,2.71,0.36959183673469387,0.83,99.5
2020-11-09,Andhra Pradesh,278,0,270,3609,4193,112,7.7,8,53.9,259642,2146,258333,7.78,0.21,0.06695732838589981,0.83,99.5
2020-11-10,Andhra Pradesh,1342,10,1336,16768,1112,831,8.0,0,53.9,260984,2156,259669,2.06,1.54,0.31109461966604823,0.83,99.5
2020-11-11,Andhra Pradesh,651,3,646,7775,1408,1090,8.37,2,53.9,261635,2159,260315,2.61,2.02,0.1442486085343228,0.83,99.5
2020-11-12,Andhra Pradesh,840,5,838,9916,2472,705,8.47,0,53.9,262475,2164,261153,4.59,1.31,0.18397031539888684,0.82,99.5
2020-11-13,Andhra Pradesh,1256,17,1248,15477,265,140,8.12,0,53.9,263731,2181,262401,0.49,0.26,0.28714285714285714,0.83,99.5
2020-11-14,Andhra Pradesh,1158,11,1151,14962,4223,1793,7.74,0,53.9,264889,2192,263552,7.83,3.33,0.27758812615955475,0.83,99.5
2020-11-15,Andhra Pradesh,223,0,218,2806,454,140,7.95,5,53.9,265112,2192,263770,0.84,0.26,0.05205936920222635,0.83,99.49
2020-11-16,Andhra Pradesh,568,6,567,7078,912,352,8.02,0,53.9,265680,2198,264337,1.69,0.65,0.13131725417439702,0.83,99.49
2020-11-17,Andhra Pradesh,607,2,604,7488,2412,1758,8.11,1,53.9,266287,2200,264941,4.47,3.26,0.1389239332096475,0.83,99.49
2020-11-18,Andhra Pradesh,834,5,832,10716,4765,3218,7.78,0,53.9,267121,2205,265773,8.84,5.97,0.1988126159554731,0.83,99.5
2020-11-19,Andhra Pradesh,1345,16,1344,16806,3983,2221,8.0,0,53.9,268466,2221,267117,7.39,4.12,0.3117996289424861,0.83,99.5
2020-11-20,Andhra Pradesh,1404,4,1403,17479,4631,4142,8.03,0,53.9,269870,2225,268520,8.59,7.68,0.3242857142857143,0.82,99.5
2020-11-21,Andhra Pradesh,1332,13,1329,16699,3863,1944,7.98,0,53.9,271202,2238,269849,7.17,3.61,0.3098144712430427,0.83,99.5
2020-11-22,Andhra Pradesh,1386,15,1384,17767,4642,1546,7.8,0,53.9,272588,2253,271233,8.61,2.87,0.3296289424860853,0.83,99.5
2020-11-23,Andhra Pradesh,1027,12,1027,12922,1449,599,7.95,0,53.9,273615,2265,272260,2.69,1.11,0.23974025974025975,0.83,99.5
2020-11-24,Andhra Pradesh,938,13,935,11749,27,6,7.98,0,53.9,274553,2278,273195,0.05,0.01,0.2179777365491651,0.83,99.51
2020-11-25,Andhra Pradesh,782,6,776,10163,4831,1976,7.69,0,53.9,275335,2284,273971,8.96,3.67,0.18855287569573284,0.83,99.5
2020-11-26,Andhra Pradesh,274,4,271,3209,4816,1705,8.54,0,53.9,275609,2288,274242,8.94,3.16,0.059536178107606676,0.83,99.5
2020-11-27,Andhra Pradesh,716,4,707,9036,2962,2482,7.92,5,53.9,276325,2292,274949,5.5,4.6,0.16764378478664194,0.83,99.5
2020-11-28,Andhra Pradesh,559,6,551,7364,4606,4408,7.59,2,53.9,276884,2298,275500,8.55,8.18,0.13662337662337662,0.83,99.5
2020-11-29,Andhra Pradesh,1198,14,1190,15095,4158,750,7.94,0,53.9,278082,2312,276690,7.71,1.39,0.2800556586270872,0.83,99.5
2020-11-30,Andhra Pradesh,528,6,525,6206,2284,824,8.51,0,53.9,278610,2318,277215,4.24,1.53,0.115139146567718,0.83,99.5
2020-12-01,Andhra Pradesh,511,4,503,6209,2407,1336,8.23,4,53.9,279121,2322,277718,4.47,2.48,0.1151948051948052,0.83,99.5
2020-12-02,Andhra Pradesh,1310,17,1302,16262,3008,2056,8.06,0,53.9,280431,2339,279020,5.58,3.81,0.3017068645640074,0.83,99.5
2020-12-03,Andhra Pradesh,1467,11,1465,18444,4276,2629,7.95,0,53.9,281898,2350,280485,7.93,4.88,0.3421892393320965,0.83,99.5
2020-12-04,Andhra Pradesh,1461,17,1456,18538,900,239,7.88,0,53.9,283359,2367,281941,1.67,0.44,0.34393320964749535,0.84,99.5
2020-12-05,Andhra Pradesh,181,2,179,2813,2521,1125,6.43,0,53.9,283540,2369,282120,4.68,2.09,0.052189239332096474,0.84,99.5
2020-12-06,Andhra Pradesh,883,3,882,11327,2996,240,7.8,0,53.9,284423,2372,283002,5.56,0.45,0.21014842300556585,0.83,99.5
2020-12-07,Andhra Pradesh,452,4,448,5552,3956,479,8.14,0,53.9,284875,2376,283450,7.34,0.89,0.10300556586270872,0.83,99.5
2020-12-08,Andhra Pradesh,1107,15,1107,13905,4746,2973,7.96,0,53.9,285982,2391,284557,8.81,5.52,0.2579777365491651,0.84,99.5
2020-12-09,Andhra Pradesh,510,4,509,6361,4110,3439,8.02,0,53.9,286492,2395,285066,7.63,6.38,0.11801484230055659,0.84,99.5
2020-12-10,Andhra Pradesh,1380,11,1375,17221,2621,97,8.01,0,53.9,287872,2406,286441,4.86,0.18,0.3194990723562152,0.84,99.5
2020-12-11,Andhra Pradesh,289,1,283,3699,3345,2811,7.81,5,53.9,288161,2407,286724,6.21,5.22,0.06862708719851578,0.84,99.5
2020-12-12,Andhra Pradesh,286,2,282,3347,3468,1540,8.54,2,53.9,288447,2409,287006,6.43,2.86,0.06209647495361781,0.84,99.5
2020-12-13,Andhra Pradesh,934,5,925,11590,1625,1397,8.06,4,53.9,289381,2414,287931,3.01,2.59,0.2150278293135436,0.83,99.5
2020-12-14,Andhra Pradesh,532,5,523,6453,1377,872,8.24,4,53.9,289913,2419,288454,2.55,1.62,0.119721706864564,0.83,99.5
2020-12-15,Andhra Pradesh,149,0,144,1492,1498,299,9.99,5,53.9,290062,2419,288598,2.78,0.55,0.027680890538033395,0.83,99.5
2020-12-16,Andhra Pradesh,669,5,662,8132,1066,312,8.23,2,53.9,290731,2424,289260,1.98,0.58,0.15087198515769945,0.83,99.49
2020-12-17,Andhra Pradesh,133,1,129,1865,4146,1829,7.13,3,53.9,290864,2425,289389,7.69,3.39,0.03460111317254174,0.83,99.49
2020-12-18,Andhra Pradesh,1198,14,1189,14657,4313,1190,8.17,0,53.9,292062,2439,290578,8.0,2.21,0.2719294990723562,0.84,99.49
2020-12-19,Andhra Pradesh,707,10,700,8305,2872,1805,8.51,0,53.9,292769,2449,291278,5.33,3.35,0.1540816326530612,0.84,99.49
2020-12-20,Andhra Pradesh,806,9,799,10315,857,646,7.81,0,53.9,293575,2458,292077,1.59,1.2,0.19137291280148422,0.84,99.49
2020-12-21,Andhra Pradesh,183,2,177,2630,3137,2231,6.96,4,53.9,293758,2460,292254,5.82,4.14,0.048794063079777364,0.84,99.49
2020-12-22,Andhra Pradesh,683,5,681,8703,2377,717,7.85,0,53.9,294441,2465,292935,4.41,1.33,0.1614656771799629,0.84,99.49
2020-12-23,Andhra Pradesh,1558,21,1555,19576,4430,1751,7.96,0,53.9,295999,2486,294490,8.22,3.25,0.36319109461966603,0.84,99.49
2020-12-24,Andhra Pradesh,282,2,275,4175,3507,1305,6.75,5,53.9,296281,2488,294765,6.51,2.42,0.0774582560296846,0.84,99.49
2020-12-25,Andhra Pradesh,994,7,988,12630,2598,678,7.87,0,53.9,297275,2495,295753,4.82,1.26,0.23432282003710575,0.84,99.49
2020-12-26,Andhra Pradesh,1324,8,1323,16787,4382,3550,7.89,0,53.9,298599,2503,297076,8.13,6.59,0.3114471243042672,0.84,99.49
2020-12-27,Andhra Pradesh,364,1,361,4558,65,35,7.99,2,53.9,298963,2504,297437,0.12,0.06,0.08456400742115028,0.84,99.49
2020-12-28,Andhra Pradesh,198,0,197,2187,4574,1349,9.05,1,53.9,299161,2504,297634,8.49,2.5,0.04057513914656772,0.84,99.49
2020-12-29,Andhra Pradesh,374,5,373,4833,4430,699,7.74,0,53.9,299535,2509,298007,8.22,1.3,0.08966604823747681,0.84,99.49
2020-12-30,Andhra Pradesh,804,3,798,10177,1024,554,7.9,3,53.9,300339,2512,298805,1.9,1.03,0.1888126159554731,0.84,99.49
2020-12-31,Andhra Pradesh,219,3,210,2351,4832,3410,9.32,6,53.9,300558,2515,299015,8.96,6.33,0.043617810760667904,0.84,99.49
2021-01-01,Andhra Pradesh,668,5,665,8272,3873,686,8.08,0,53.9,301226,2520,299680,7.19,1.27,0.15346938775510205,0.84,99.49
2021-01-02,Andhra Pradesh,1057,7,1053,12974,2037,1738,8.15,0,53.9,302283,2527,300733,3.78,3.22,0.24070500927643784,0.84,99.49
2021-01-03,Andhra Pradesh,518,2,518,6910,794,626,7.5,0,53.9,302801,2529,301251,1.47,1.16,0.12820037105751392,0.84,99.49
2021-01-04,Andhra Pradesh,775,4,767,9563,211,134,8.1,4,53.9,303576,2533,302018,0.39,0.25,0.17742115027829314,0.83,99.49
2021-01-05,Andhra Pradesh,617,5,610,7675,2315,546,8.04,2,53.9,304193,2538,302628,4.29,1.01,0.14239332096474955,0.83,99.49
2021-01-06,Andhra Pradesh,269,1,264,3065,3117,1556,8.78,4,53.9,304462,2539,302892,5.78,2.89,0.05686456400742115,0.83,99.48
2021-01-07,Andhra Pradesh,572,4,569,7432,3824,2101,7.7,0,53.9,305034,2543,303461,7.09,3.9,0.13788497217068646,0.83,99.48
2021-01-08,Andhra Pradesh,622,2,615,7816,2380,1775,7.96,5,53.9,305656,2545,304076,4.42,3.29,0.14500927643784786,0.83,99.48
2021-01-09,Andhra Pradesh,689,8,684,8929,4315,780,7.72,0,53.9,306345,2553,304760,8.01,1.45,0.16565862708719853,0.83,99.48
2021-01-10,Andhra Pradesh,1363,7,1362,17104,552,37,7.97,0,53.9,307708,2560,306122,1.02,0.07,0.3173283858998145,0.83,99.48
2021-01-11,Andhra Pradesh,1430,15,1430,18172,770,9,7.87,0,53.9,309138,2575,307552,1.43,0.02,0.33714285714285713,0.83,99.49
2021-01-12,Andhra Pradesh,1160,9,1159,14406,3564,842,8.05,0,53.9,310298,2584,308711,6.61,1.56,0.2672727272727273,0.83,99.49
2021-01-13,Andhra Pradesh,689,9,682,8833,1447,844,7.8,0,53.9,310987,2593,309393,2.68,1.57,0.16387755102040816,0.83,99.49
2021-01-14,Andhra Pradesh,1416,15,1407,17552,2074,160,8.07,0,53.9,312403,2608,310800,3.85,0.3,0.32564007421150276,0.83,99.49
2021-01-15,Andhra Pradesh,1474,20,1467,18524,4938,58,7.96,0,53.9,313877,2628,312267,9.16,0.11,0.3436734693877551,0.84,99.49
2021-01-16,Andhra Pradesh,1006,11,997,12843,1521,386,7.83,0,53.9,314883,2639,313264,2.82,0.72,0.23827458256029685,0.84,99.49
2021-01-17,Andhra Pradesh,708,2,701,8898,1902,1022,7.96,5,53.9,315591,2641,313965,3.53,1.9,0.1650834879406308,0.84,99.48
2021-01-18,Andhra Pradesh,1102,7,1099,13861,3373,3298,7.95,0,53.9,316693,2648,315064,6.26,6.12,0.25716141001855286,0.84,99.49
2021-01-19,Andhra Pradesh,1027,3,1021,12818,968,551,8.01,3,53.9,317720,2651,316085,1.8,1.02,0.23781076066790352,0.83,99.49
2021-01-20,Andhra Pradesh,1171,5,1163,14121,4678,342,8.29,3,53.9,318891,2656,317248,8.68,0.63,0.2619851576994434,0.83,99.48
2021-01-21,Andhra Pradesh,231,2,228,3144,2289,2073,7.35,1,53.9,319122,2658,317476,4.25,3.85,0.058330241187384044,0.83,99.48
2021-01-22,Andhra Pradesh,1244,18,1235,15519,225,95,8.02,0,53.9,320366,2676,318711,0.42,0.18,0.2879220779220779,0.84,99.48
2021-01-23,Andhra Pradesh,915,9,914,11590,40,22,7.89,0,53.9,321281,2685,319625,0.07,0.04,0.2150278293135436,0.84,99.48
2021-01-24,Andhra Pradesh,1005,7,997,12447,3628,1012,8.07,1,53.9,322286,2692,320622,6.73,1.88,0.23092764378478664,0.84,99.48
2021-01-25,Andhra Pradesh,337,4,330,4172,161,137,8.08,3,53.9,322623,2696,320952,0.3,0.25,0.0774025974025974,0.84,99.48
2021-01-26,Andhra Pradesh,1078,3,1071,13210,2695,182,8.16,4,53.9,323701,2699,322023,5.0,0.34,0.24508348794063078,0.83,99.48
2021-01-27,Andhra Pradesh,885,3,883,11229,241,9,7.88,0,53.9,324586,2702,322906,0.45,0.02,0.20833024118738405,0.83,99.48
2021-01-28,Andhra Pradesh,1504,10,1501,18777,1738,1380,8.01,0,53.9,326090,2712,324407,3.22,2.56,0.3483673469387755,0.83,99.48
2021-01-29,Andhra Pradesh,457,4,450,5866,797,770,7.79,3,53.9,326547,2716,324857,1.48,1.43,0.10883116883116883,0.83,99.48
2021-01-30,Andhra Pradesh,823,7,817,10130,4230,3122,8.12,0,53.9,327370,2723,325674,7.85,5.79,0.18794063079777365,0.83,99.48
2021-01-31,Andhra Pradesh,1326,13,1324,16395,3779,366,8.09,0,53.9,328696,2736,326998,7.01,0.68,0.30417439703153987,0.83,99.48
2021-02-01,Andhra Pradesh,1338,10,1332,16952,4548,161,7.89,0,53.9,330034,2746,328330,8.44,0.3,0.3145083487940631,0.83,99.48
2021-02-02,Andhra Pradesh,876,6,873,11127,3356,1014,7.87,0,53.9,330910,2752,329203,6.23,1.88,0.2064378478664193,0.83,99.48
2021-02-03,Andhra Pradesh,681,8,672,8415,797,79,8.09,1,53.9,331591,2760,329875,1.48,0.15,0.15612244897959185,0.83,99.48
2021-02-04,Andhra Pradesh,359,1,359,4255,733,603,8.44,0,53.9,331950,2761,330234,1.36,1.12,0.07894248608534322,0.83,99.48
2021-02-05,Andhra Pradesh,536,2,533,6874,3047,180,7.8,1,53.9,332486,2763,330767,5.65,0.33,0.12753246753246752,0.83,99.48
2021-02-06,Andhra Pradesh,143,1,139,2043,846,632,7.0,3,53.9,332629,2764,330906,1.57,1.17,0.03790352504638219,0.83,99.48
2021-02-07,Andhra Pradesh,1160,16,1155,14234,4066,919,8.15,0,53.9,333789,2780,332061,7.54,1.71,0.2640816326530612,0.83,99.48
2021-02-08,Andhra Pradesh,1270,6,1266,16067,959,264,7.9,0,53.9,335059,2786,333327,1.78,0.49,0.2980890538033395,0.83,99.48
2021-02-09,Andhra Pradesh,132,1,123,1970,2530,85,6.7,8,53.9,335191,2787,333450,4.69,0.16,0.03654916512059369,0.83,99.48
2021-02-10,Andhra Pradesh,1243,15,1238,15339,2558,1892,8.1,0,53.9,336434,2802,334688,4.75,3.51,0.28458256029684603,0.83,99.48
2021-02-11,Andhra Pradesh,1522,20,1519,18896,2438,575,8.05,0,53.9,337956,2822,336207,4.52,1.07,0.35057513914656774,0.84,99.48
2021-02-12,Andhra Pradesh,502,2,493,6525,1302,875,7.69,7,53.9,338458,2824,336700,2.42,1.62,0.12105751391465677,0.83,99.48
2021-02-13,Andhra Pradesh,201,1,196,2702,2451,1634,7.44,4,53.9,338659,2825,336896,4.55,3.03,0.05012987012987013,0.83,99.48
2021-02-14,Andhra Pradesh,926,12,924,11444,1652,909,8.09,0,53.9,339585,2837,337820,3.06,1.69,0.2123191094619666,0.84,99.48
2021-02-15,Andhra Pradesh,409,2,402,5270,426,376,7.76,5,53.9,339994,2839,338222,0.79,0.7,0.09777365491651206,0.84,99.48
2021-02-16,Andhra Pradesh,1200,15,1196,15146,4639,3876,7.92,0,53.9,341194,2854,339418,8.61,7.19,0.28100185528756955,0.84,99.48
2021-02-17,Andhra Pradesh,1578,6,1570,19835,2396,2290,7.96,2,53.9,342772,2860,340988,4.45,4.25,0.36799628942486085,0.83,99.48
2021-02-18,Andhra Pradesh,136,1,135,1998,2302,1346,6.81,0,53.9,342908,2861,341123,4.27,2.5,0.03706864564007421,0.83,99.48
2021-02-19,Andhra Pradesh,352,3,344,4085,3486,2916,8.62,5,53.9,343260,2864,341467,6.47,5.41,0.07578849721706865,0.83,99.48
2021-02-20,Andhra Pradesh,1309,3,1306,15799,4250,3102,8.29,0,53.9,344569,2867,342773,7.88,5.76,0.2931168831168831,0.83,99.48
2021-02-21,Andhra Pradesh,988,13,987,12505,4162,4140,7.9,0,53.9,345557,2880,343760,7.72,7.68,0.23200371057513916,0.83,99.48
2021-02-22,Andhra Pradesh,50,0,47,650,4831,2661,7.69,3,53.9,345607,2880,343807,8.96,4.94,0.012059369202226345,0.83,99.48
2021-02-23,Andhra Pradesh,564,2,558,6896,542,407,8.18,4,53.9,346171,2882,344365,1.01,0.76,0.12794063079777365,0.83,99.48
2021-02-24,Andhra Pradesh,1361,11,1360,16959,2198,1469,8.03,0,53.9,347532,2893,345725,4.08,2.73,0.31463821892393323,0.83,99.48
2021-02-25,Andhra Pradesh,374,2,367,4630,4760,1191,8.08,5,53.9,347906,2895,346092,8.83,2.21,0.08589981447124305,0.83,99.48
2021-02-26,Andhra Pradesh,628,2,619,8126,1112,834,7.73,7,53.9,348534,2897,346711,2.06,1.55,0.15076066790352505,0.83,99.48
2021-02-27,Andhra Pradesh,299,2,292,3604,826,66,8.3,5,53.9,348833,2899,347003,1.53,0.12,0.06686456400742115,0.83,99.48
2021-02-28,Andhra Pradesh,66,0,58,1095,2736,529,6.03,8,53.9,348899,2899,347061,5.08,0.98,0.020315398886827457,0.83,99.47
2021-03-01,Andhra Pradesh,218,1,215,2820,4566,3022,7.73,2,53.9,349117,2900,347276,8.47,5.61,0.052319109461966606,0.83,99.47
2021-03-02,Andhra Pradesh,418,4,411,5535,445,76,7.55,3,53.9,349535,2904,347687,0.83,0.14,0.10269016697588126,0.83,99.47
2021-03-03,Andhra Pradesh,228,3,220,2750,3197,2260,8.29,5,53.9,349763,2907,347907,5.93,4.19,0.05102040816326531,0.83,99.47
2021-03-04,Andhra Pradesh,372,4,364,4410,1123,385,8.44,4,53.9,350135,2911,348271,2.08,0.71,0.08181818181818182,0.83,99.47
2021-03-05,Andhra Pradesh,807,7,804,10600,368,45,7.61,0,53.9,350942,2918,349075,0.68,0.08,0.19666048237476808,0.83,99.47
2021-03-06,Andhra Pradesh,941,10,938,11718,1435,623,8.03,0,53.9,351883,2928,350013,2.66,1.16,0.2174025974025974,0.83,99.47
2021-03-07,Andhra Pradesh,1072,9,1065,13563,1332,630,7.9,0,53.9,352955,2937,351078,2.47,1.17,0.2516326530612245,0.83,99.47
2021-03-08,Andhra Pradesh,1333,14,1325,16711,4827,1271,7.98,0,53.9,354288,2951,352403,8.96,2.36,0.3100371057513915,0.83,99.47
2021-03-09,Andhra Pradesh,1563,22,1554,19530,1455,922,8.0,0,53.9,355851,2973,353957,2.7,1.71,0.36233766233766235,0.84,99.47
2021-03-10,Andhra Pradesh,559,2,558,6913,4256,3918,8.09,0,53.9,356410,2975,354515,7.9,7.27,0.12825602968460112,0.83,99.47
2021-03-11,Andhra Pradesh,263,1,259,3355,896,144,7.84,3,53.9,356673,2976,354774,1.66,0.27,0.06224489795918367,0.83,99.47
2021-03-12,Andhra Pradesh,758,9,755,9631,166,50,7.87,0,53.9,357431,2985,355529,0.31,0.09,0.17868274582560298,0.84,99.47
2021-03-13,Andhra Pradesh,1411,5,1407,17525,3565,1036,8.05,0,53.9,358842,2990,356936,6.61,1.92,0.325139146567718,0.83,99.47
2021-03-14,Andhra Pradesh,1068,13,1062,13568,1103,636,7.87,0,53.9,359910,3003,357998,2.05,1.18,0.25172541743970317,0.83,99.47
2021-03-15,Andhra Pradesh,210,2,210,2600,2240,2078,8.08,0,53.9,360120,3005,358208,4.16,3.86,0.04823747680890538,0.83,99.47
2021-03-16,Andhra Pradesh,506,2,500,6830,4216,3285,7.41,4,53.9,360626,3007,358708,7.82,6.09,0.1267161410018553,0.83,99.47
2021-03-17,Andhra Pradesh,886,3,883,11118,3865,861,7.97,0,53.9,361512,3010,359591,7.17,1.6,0.2062708719851577,0.83,99.47
2021-03-18,Andhra Pradesh,1192,8,1190,15029,4072,946,7.93,0,53.9,362704,3018,360781,7.55,1.76,0.2788311688311688,0.83,99.47
2021-03-19,Andhra Pradesh,414,2,414,5191,4915,981,7.98,0,53.9,363118,3020,361195,9.12,1.82,0.09630797773654917,0.83,99.47
2021-03-20,Andhra Pradesh,243,1,240,3347,1661,316,7.26,2,53.9,363361,3021,361435,3.08,0.59,0.06209647495361781,0.83,99.47
2021-03-21,Andhra Pradesh,1391,16,1391,17570,3147,1059,7.92,0,53.9,364752,3037,362826,5.84,1.96,0.32597402597402597,0.83,99.47
2021-03-22,Andhra Pradesh,585,4,585,6966,250,213,8.4,0,53.9,365337,3041,363411,0.46,0.4,0.12923933209647495,0.83,99.47
2021-03-23,Andhra Pradesh,602,6,599,7889,624,137,7.63,0,53.9,365939,3047,364010,1.16,0.25,0.14636363636363636,0.83,99.47
2021-03-24,Andhra Pradesh,1222,4,1220,15210,3690,417,8.03,0,53.9,367161,3051,365230,6.85,0.77,0.2821892393320965,0.83,99.47
2021-03-25,Andhra Pradesh,1504,18,1502,18943,50,16,7.94,0,53.9,368665,3069,366732,0.09,0.03,0.35144712430426717,0.83,99.48
2021-03-26,Andhra Pradesh,997,10,989,12533,2228,529,7.95,0,53.9,369662,3079,367721,4.13,0.98,0.23252319109461966,0.83,99.47
2021-03-27,Andhra Pradesh,1373,17,1369,17011,3673,3154,8.07,0,53.9,371035,3096,369090,6.81,5.85,0.3156029684601113,0.83,99.48
2021-03-28,Andhra Pradesh,885,11,877,11351,1687,743,7.8,0,53.9,371920,3107,369967,3.13,1.38,0.21059369202226344,0.84,99.47
2021-03-29,Andhra Pradesh,1452,19,1443,18259,1695,1581,7.95,0,53.9,373372,3126,371410,3.14,2.93,0.3387569573283859,0.84,99.47
2021-03-30,Andhra Pradesh,958,8,951,11754,350,278,8.15,0,53.9,374330,3134,372361,0.65,0.52,0.2180705009276438,0.84,99.47
2021-03-31,Andhra Pradesh,1519,4,1510,18866,2077,850,8.05,5,53.9,375849,3138,373871,3.85,1.58,0.3500185528756957,0.83,99.47
2021-04-01,Andhra Pradesh,569,4,565,6781,4024,1209,8.39,0,53.9,376418,3142,374436,7.47,2.24,0.12580705009276438,0.83,99.47
2021-04-02,Andhra Pradesh,532,7,524,6460,3973,3185,8.24,1,53.9,376950,3149,374960,7.37,5.91,0.11985157699443413,0.84,99.47
2021-04-03,Andhra Pradesh,641,4,637,7705,369,328,8.32,0,53.9,377591,3153,375597,0.68,0.61,0.1429499072356215,0.84,99.47
2021-04-04,Andhra Pradesh,419,4,415,5434,3109,308,7.71,0,53.9,378010,3157,376012,5.77,0.57,0.10081632653061225,0.84,99.47
2021-04-05,Andhra Pradesh,1240,15,1238,15393,2802,766,8.06,0,53.9,379250,3172,377250,5.2,1.42,0.2855844155844156,0.84,99.47
2021-04-06,Andhra Pradesh,912,6,903,11493,3638,3203,7.94,3,53.9,380162,3178,378153,6.75,5.94,0.21322820037105752,0.84,99.47
2021-04-07,Andhra Pradesh,929,5,925,11420,3310,1704,8.13,0,53.9,381091,3183,379078,6.14,3.16,0.21187384044526902,0.84,99.47
2021-04-08,Andhra Pradesh,1316,5,1312,16658,575,55,7.9,0,53.9,382407,3188,380390,1.07,0.1,0.30905380333951765,0.83,99.47
2021-04-09,Andhra Pradesh,1074,3,1069,13042,3589,2854,8.23,2,53.9,383481,3191,381459,6.66,5.29,0.24196660482374768,0.83,99.47
2021-04-10,Andhra Pradesh,441,5,434,5944,3903,830,7.42,2,53.9,383922,3196,381893,7.24,1.54,0.110278293135436,0.83,99.47
2021-04-11,Andhra Pradesh,1384,11,1380,17180,3384,2570,8.06,0,53.9,385306,3207,383273,6.28,4.77,0.3187384044526902,0.83,99.47
2021-04-12,Andhra Pradesh,698,2,690,8752,1685,592,7.98,6,53.9,386004,3209,383963,3.13,1.1,0.1623747680890538,0.83,99.47
2021-04-13,Andhra Pradesh,1567,15,1560,19296,4785,3261,8.12,0,53.9,387571,3224,385523,8.88,6.05,0.35799628942486084,0.83,99.47
2021-04-14,Andhra Pradesh,582,5,578,6696,4096,1880,8.69,0,53.9,388153,3229,386101,7.6,3.49,0.12423005565862709,0.83,99.47
2021-04-15,Andhra Pradesh,996,3,993,12722,4729,2854,7.83,0,53.9,389149,3232,387094,8.77,5.29,0.23602968460111318,0.83,99.47
2021-04-16,Andhra Pradesh,1201,15,1195,15223,3403,2157,7.89,0,53.9,390350,3247,388289,6.31,4.0,0.282430426716141,0.83,99.47
2021-04-17,Andhra Pradesh,841,10,836,11043,1846,436,7.62,0,53.9,391191,3257,389125,3.42,0.81,0.20487940630797774,0.83,99.47
2021-04-18,Andhra Pradesh,386,3,382,4752,4902,1499,8.12,1,53.9,391577,3260,389507,9.09,2.78,0.08816326530612245,0.83,99.47
2021-04-19,Andhra Pradesh,560,7,556,7248,2775,2440,7.73,0,53.9,392137,3267,390063,5.15,4.53,0.1344712430426716,0.83,99.47
2021-04-20,Andhra Pradesh,1126,4,1125,13992,112,72,8.05,0,53.9,393263,3271,391188,0.21,0.13,0.2595918367346939,0.83,99.47
2021-04-21,Andhra Pradesh,733,3,726,9541,379,192,7.68,4,53.9,393996,3274,391914,0.7,0.36,0.177012987012987,0.83,99.47
2021-04-22,Andhra Pradesh,533,5,532,6953,2548,228,7.67,0,53.9,394529,3279,392446,4.73,0.42,0.12899814471243043,0.83,99.47
2021-04-23,Andhra Pradesh,299,1,291,3957,3601,1063,7.56,7,53.9,394828,3280,392737,6.68,1.97,0.07341372912801485,0.83,99.47
2021-04-24,Andhra Pradesh,1356,9,1354,17519,2289,1040,7.74,0,53.9,396184,3289,394091,4.25,1.93,0.3250278293135436,0.83,99.47
2021-04-25,Andhra Pradesh,1007,9,1001,12730,4187,177,7.91,0,53.9,397191,3298,395092,7.77,0.33,0.23617810760667904,0.83,99.47
2021-04-26,Andhra Pradesh,1135,13,1132,14368,4806,676,7.9,0,53.9,398326,3311,396224,8.92,1.25,0.2665677179962894,0.83,99.47
2021-04-27,Andhra Pradesh,192,1,187,2593,340,139,7.4,4,53.9,398518,3312,396411,0.63,0.26,0.04810760667903525,0.83,99.47
2021-04-28,Andhra Pradesh,1220,14,1217,15063,3692,1224,8.1,0,53.9,399738,3326,397628,6.85,2.27,0.27946196660482375,0.83,99.47
2021-04-29,Andhra Pradesh,454,4,450,5709,710,651,7.95,0,53.9,400192,3330,398078,1.32,1.21,0.10591836734693877,0.83,99.47
2021-04-30,Andhra Pradesh,587,3,580,7126,1240,772,8.24,4,53.9,400779,3333,398658,2.3,1.43,0.13220779220779222,0.83,99.47
2021-05-01,Andhra Pradesh,125,1,125,1420,4670,2614,8.8,0,53.9,400904,3334,398783,8.66,4.85,0.02634508348794063,0.83,99.47
2021-05-02,Andhra Pradesh,499,3,491,6470,323,307,7.71,5,53.9,401403,3337,399274,0.6,0.57,0.12003710575139147,0.83,99.47
2021-05-03,Andhra Pradesh,681,8,678,8176,4014,600,8.33,0,53.9,402084,3345,399952,7.45,1.11,0.15168831168831168,0.83,99.47
2021-05-04,Andhra Pradesh,240,2,232,3181,627,415,7.54,6,53.9,402324,3347,400184,1.16,0.77,0.05901669758812616,0.83,99.47
2021-05-05,Andhra Pradesh,1230,12,1230,15592,421,157,7.89,0,53.9,403554,3359,401414,0.78,0.29,0.28927643784786644,0.83,99.47
2021-05-06,Andhra Pradesh,1042,4,1036,13021,4702,2526,8.0,2,53.9,404596,3363,402450,8.72,4.69,0.2415769944341373,0.83,99.47
2021-05-07,Andhra Pradesh,299,4,291,3163,230,155,9.45,4,53.9,404895,3367,402741,0.43,0.29,0.05868274582560297,0.83,99.47
2021-05-08,Andhra Pradesh,362,3,353,4717,4745,657,7.67,6,53.9,405257,3370,403094,8.8,1.22,0.0875139146567718,0.83,99.47
2021-05-09,Andhra Pradesh,698,2,690,8747,2012,416,7.98,6,53.9,405955,3372,403784,3.73,0.77,0.16228200371057513,0.83,99.47
2021-05-10,Andhra Pradesh,1008,5,999,12628,2289,1053,7.98,4,53.9,406963,3377,404783,4.25,1.95,0.2342857142857143,0.83,99.46
2021-05-11,Andhra Pradesh,47,0,43,511,4384,314,9.2,4,53.9,407010,3377,404826,8.13,0.58,0.00948051948051948,0.83,99.46
2021-05-12,Andhra Pradesh,970,6,964,11981,2119,647,8.1,0,53.9,407980,3383,405790,3.93,1.2,0.22228200371057513,0.83,99.46
2021-05-13,Andhra Pradesh,1214,7,1214,14761,2933,17,8.22,0,53.9,409194,3390,407004,5.44,0.03,0.27385899814471243,0.83,99.46
2021-05-14,Andhra Pradesh,475,6,466,6223,985,978,7.63,3,53.9,409669,3396,407470,1.83,1.81,0.11545454545454545,0.83,99.46
2021-05-15,Andhra Pradesh,1233,6,1231,15471,3122,1906,7.97,0,53.9,410902,3402,408701,5.79,3.54,0.28703153988868274,0.83,99.46
2021-05-16,Andhra Pradesh,612,3,604,7827,4494,2606,7.82,5,53.9,411514,3405,409305,8.34,4.83,0.14521335807050093,0.83,99.46
2021-05-17,Andhra Pradesh,617,7,613,7531,573,326,8.19,0,53.9,412131,3412,409918,1.06,0.6,0.139721706864564,0.83,99.46
2021-05-18,Andhra Pradesh,240,2,235,3022,428,297,7.94,3,53.9,412371,3414,410153,0.79,0.55,0.056066790352504635,0.83,99.46
2021-05-19,Andhra Pradesh,1421,14,1421,17469,3100,944,8.13,0,53.9,413792,3428,411574,5.75,1.75,0.32410018552875697,0.83,99.46
2021-05-20,Andhra Pradesh,514,4,514,6409,1257,192,8.02,0,53.9,414306,3432,412088,2.33,0.36,0.11890538033395176,0.83,99.46
2021-05-21,Andhra Pradesh,658,3,652,7632,346,215,8.62,3,53.9,414964,3435,412740,0.64,0.4,0.14159554730983304,0.83,99.46
2021-05-22,Andhra Pradesh,961,10,957,12357,3925,2434,7.78,0,53.9,415925,3445,413697,7.28,4.52,0.2292578849721707,0.83,99.46
2021-05-23,Andhra Pradesh,946,4,944,11627,2484,564,8.14,0,53.9,416871,3449,414641,4.61,1.05,0.21571428571428572,0.83,99.47
2021-05-24,Andhra Pradesh,1359,18,1350,17542,2726,425,7.75,0,53.9,418230,3467,415991,5.06,0.79,0.32545454545454544,0.83,99.46
2021-05-25,Andhra Pradesh,603,7,595,7825,2406,1683,7.71,1,53.9,418833,3474,416586,4.46,3.12,0.14517625231910947,0.83,99.46
2021-05-26,Andhra Pradesh,374,3,373,4522,2603,1032,8.27,0,53.9,419207,3477,416959,4.83,1.91,0.0838961038961039,0.83,99.46
2021-05-27,Andhra Pradesh,1360,8,1357,16610,606,571,8.19,0,53.9,420567,3485,418316,1.12,1.06,0.3081632653061224,0.83,99.46
2021-05-28,Andhra Pradesh,373,4,366,4313,1728,1414,8.65,3,53.9,420940,3489,418682,3.21,2.62,0.08001855287569573,0.83,99.46
2021-05-29,Andhra Pradesh,1067,13,1065,13019,3292,1525,8.2,0,53.9,422007,3502,419747,6.11,2.83,0.2415398886827458,0.83,99.46
2021-05-30,Andhra Pradesh,713,5,707,9045,4496,4149,7.88,1,53.9,422720,3507,420454,8.34,7.7,0.1678107606679035,0.83,99.46
2021-05-31,Andhra Pradesh,1558,11,1555,19479,1338,886,8.0,0,53.9,424278,3518,422009,2.48,1.64,0.36139146567717995,0.83,99.47
2021-06-01,Andhra Pradesh,1192,3,1188,15145,4045,1022,7.87,1,53.9,425470,3521,423197,7.5,1.9,0.28098330241187386,0.83,99.47
2021-06-02,Andhra Pradesh,525,5,524,6201,2499,1179,8.47,0,53.9,425995,3526,423721,4.64,2.19,0.11504638218923934,0.83,99.47
2021-06-03,Andhra Pradesh,1086,15,1077,13724,4231,4020,7.91,0,53.9,427081,3541,424798,7.85,7.46,0.2546196660482375,0.83,99.47
2021-06-04,Andhra Pradesh,544,3,537,6939,4415,821,7.84,4,53.9,427625,3544,425335,8.19,1.52,0.12873840445269016,0.83,99.46
2021-06-05,Andhra Pradesh,1288,9,1280,15855,4779,2253,8.12,0,53.9,428913,3553,426615,8.87,4.18,0.29415584415584417,0.83,99.46
2021-06-06,Andhra Pradesh,615,4,611,7460,3203,1610,8.24,0,53.9,429528,3557,427226,5.94,2.99,0.13840445269016696,0.83,99.46
2021-06-07,Andhra Pradesh,675,4,670,8792,570,312,7.68,1,53.9,430203,3561,427896,1.06,0.58,0.1631168831168831,0.83,99.46
2021-06-08,Andhra Pradesh,723,6,721,9027,942,321,8.01,0,53.9,430926,3567,428617,1.75,0.6,0.16747680890538033,0.83,99.46
2021-06-09,Andhra Pradesh,775,6,767,10024,264,48,7.73,2,53.9,431701,3573,429384,0.49,0.09,0.18597402597402599,0.83,99.46
2021-06-10,Andhra Pradesh,1406,18,1404,17896,2419,1491,7.86,0,53.9,433107,3591,430788,4.49,2.77,0.33202226345083485,0.83,99.46
2021-06-11,Andhra Pradesh,1407,8,1398,17314,4577,3790,8.13,1,53.9,434514,3599,432186,8.49,7.03,0.3212244897959184,0.83,99.46
2021-06-12,Andhra Pradesh,1053,4,1052,13110,1547,828,8.03,0,53.9,435567,3603,433238,2.87,1.54,0.24322820037105752,0.83,99.47
2021-06-13,Andhra Pradesh,567,4,561,7537,3470,1281,7.52,2,53.9,436134,3607,433799,6.44,2.38,0.1398330241187384,0.83,99.46
2021-06-14,Andhra Pradesh,1110,15,1110,13642,2905,2296,8.14,0,53.9,437244,3622,434909,5.39,4.26,0.2530983302411874,0.83,99.47
2021-06-15,Andhra Pradesh,1044,6,1042,13361,3712,2917,7.81,0,53.9,438288,3628,435951,6.89,5.41,0.24788497217068645,0.83,99.47
2021-06-16,Andhra Pradesh,1425,15,1419,17776,1014,35,8.02,0,53.9,439713,3643,437370,1.88,0.06,0.32979591836734695,0.83,99.47
2021-06-17,Andhra Pradesh,403,2,395,4707,2391,255,8.56,6,53.9,440116,3645,437765,4.44,0.47,0.08732838589981447,0.83,99.47
2021-06-18,Andhra Pradesh,400,2,391,5257,1912,414,7.61,7,53.9,440516,3647,438156,3.55,0.77,0.09753246753246753,0.83,99.46
2021-06-19,Andhra Pradesh,1029,6,1029,12500,2012,1403,8.23,0,53.9,441545,3653,439185,3.73,2.6,0.23191094619666047,0.83,99.47
2021-06-20,Andhra Pradesh,751,5,745,8995,1935,1248,8.35,1,53.9,442296,3658,439930,3.59,2.32,0.16688311688311688,0.83,99.47
2021-06-21,Andhra Pradesh,1397,4,1397,17769,2928,327,7.86,0,53.9,443693,3662,441327,5.43,0.61,0.3296660482374768,0.83,99.47
2021-06-22,Andhra Pradesh,1579,15,1579,19848,1089,903,7.96,0,53.9,445272,3677,442906,2.02,1.68,0.3682374768089054,0.83,99.47
2021-06-23,Andhra Pradesh,362,5,362,4442,3816,1499,8.15,0,53.9,445634,3682,443268,7.08,2.78,0.08241187384044527,0.83,99.47
2021-06-24,Andhra Pradesh,1584,5,1576,19770,1285,519,8.01,3,53.9,447218,3687,444844,2.38,0.96,0.3667903525046382,0.82,99.47
2021-06-25,Andhra Pradesh,1266,16,1263,15943,2763,552,7.94,0,53.9,448484,3703,446107,5.13,1.02,0.2957884972170686,0.83,99.47
2021-06-26,Andhra Pradesh,143,1,138,2001,2638,1428,7.15,4,53.9,448627,3704,446245,4.89,2.65,0.03712430426716141,0.83,99.47
2021-06-27,Andhra Pradesh,734,3,728,8821,1732,509,8.32,3,53.9,449361,3707,446973,3.21,0.94,0.16365491651205938,0.82,99.47
2021-06-28,Andhra Pradesh,1222,10,1214,15441,2907,2810,7.91,0,53.9,450583,3717,448187,5.39,5.21,0.2864749536178108,0.82,99.47
2021-06-29,Andhra Pradesh,1361,17,1360,16898,4169,743,8.05,0,53.9,451944,3734,449547,7.73,1.38,0.3135064935064935,0.83,99.47
2021-06-30,Andhra Pradesh,1018,3,1013,13047,3785,2896,7.8,2,53.9,452962,3737,450560,7.02,5.37,0.24205936920222634,0.83,99.47
2021-07-01,Andhra Pradesh,245,3,237,2910,2387,1075,8.42,5,53.9,453207,3740,450797,4.43,1.99,0.05398886827458256,0.83,99.47
2021-07-02,Andhra Pradesh,1556,5,1551,19208,1997,449,8.1,0,53.9,454763,3745,452348,3.71,0.83,0.3563636363636364,0.82,99.47
2021-07-03,Andhra Pradesh,781,3,777,9656,4347,322,8.09,1,53.9,455544,3748,453125,8.06,0.6,0.17914656771799628,0.82,99.47
2021-07-04,Andhra Pradesh,1448,18,1441,18308,1274,353,7.91,0,53.9,456992,3766,454566,2.36,0.65,0.3396660482374768,0.82,99.47
2021-07-05,Andhra Pradesh,679,8,674,8594,2281,1655,7.9,0,53.9,457671,3774,455240,4.23,3.07,0.15944341372912801,0.82,99.47
2021-07-06,Andhra Pradesh,602,3,600,7143,70,13,8.43,0,53.9,458273,3777,455840,0.13,0.02,0.13252319109461966,0.82,99.47
2021-07-07,Andhra Pradesh,1288,7,1282,15589,489,381,8.26,0,53.9,459561,3784,457122,0.91,0.71,0.2892207792207792,0.82,99.47
2021-07-08,Andhra Pradesh,1427,18,1422,18198,2501,2418,7.84,0,53.9,460988,3802,458544,4.64,4.49,0.3376252319109462,0.82,99.47
2021-07-09,Andhra Pradesh,515,5,514,7105,1136,825,7.25,0,53.9,461503,3807,459058,2.11,1.53,0.1318181818181818,0.82,99.47
2021-07-10,Andhra Pradesh,1325,18,1323,16323,4045,2360,8.12,0,53.9,462828,3825,460381,7.5,4.38,0.30283858998144714,0.83,99.47
2021-07-11,Andhra Pradesh,321,1,319,4144,4547,2532,7.75,1,53.9,463149,3826,460700,8.44,4.7,0.07688311688311689,0.83,99.47
2021-07-12,Andhra Pradesh,1598,15,1591,19947,2844,1143,8.01,0,53.9,464747,3841,462291,5.28,2.12,0.3700742115027829,0.83,99.47
2021-07-13,Andhra Pradesh,930,11,921,12227,1986,41,7.61,0,53.9,465677,3852,463212,3.68,0.08,0.22684601113172542,0.83,99.47
2021-07-14,Andhra Pradesh,1326,15,1321,16561,1602,1141,8.01,0,53.9,467003,3867,464533,2.97,2.12,0.30725417439703157,0.83,99.47
2021-07-15,Andhra Pradesh,53,0,51,1110,2809,2312,4.77,2,53.9,467056,3867,464584,5.21,4.29,0.020593692022263452,0.83,99.47
2021-07-16,Andhra Pradesh,873,10,868,10850,2896,386,8.05,0,53.9,467929,3877,465452,5.37,0.72,0.2012987012987013,0.83,99.47
2021-07-17,Andhra Pradesh,892,8,890,11267,406,387,7.92,0,53.9,468821,3885,466342,0.75,0.72,0.2090352504638219,0.83,99.47
2021-07-18,Andhra Pradesh,1439,8,1433,18205,3042,197,7.9,0,53.9,470260,3893,467775,5.64,0.37,0.3377551020408163,0.83,99.47
2021-07-19,Andhra Pradesh,1418,20,1412,17766,528,96,7.98,0,53.9,471678,3913,469187,0.98,0.18,0.32961038961038963,0.83,99.47
2021-07-20,Andhra Pradesh,279,2,277,3471,156,153,8.04,0,53.9,471957,3915,469464,0.29,0.28,0.06439703153988868,0.83,99.47
2021-07-21,Andhra Pradesh,169,0,161,2142,1635,419,7.89,8,53.9,472126,3915,469625,3.03,0.78,0.03974025974025974,0.83,99.47
2021-07-22,Andhra Pradesh,756,3,748,9437,4900,527,8.01,5,53.9,472882,3918,470373,9.09,0.98,0.1750834879406308,0.83,99.47
2021-07-23,Andhra Pradesh,1029,13,1023,12428,2509,2315,8.28,0,53.9,473911,3931,471396,4.65,4.29,0.23057513914656771,0.83,99.47
2021-07-24,Andhra Pradesh,271,2,268,3331,4010,153,8.14,1,53.9,474182,3933,471664,7.44,0.28,0.061799628942486085,0.83,99.47
2021-07-25,Andhra Pradesh,1362,5,1357,16943,4197,2351,8.04,0,53.9,475544,3938,473021,7.79,4.36,0.3143413729128015,0.83,99.47
2021-07-26,Andhra Pradesh,1552,12,1548,19904,4066,3223,7.8,0,53.9,477096,3950,474569,7.54,5.98,0.3692764378478664,0.83,99.47
2021-07-27,Andhra Pradesh,909,11,902,11315,4148,3575,8.03,0,53.9,478005,3961,475471,7.7,6.63,0.20992578849721708,0.83,99.47
2021-07-28,Andhra Pradesh,1280,14,1279,15512,4549,915,8.25,0,53.9,479285,3975,476750,8.44,1.7,0.28779220779220777,0.83,99.47
2021-07-29,Andhra Pradesh,534,1,527,6335,2011,785,8.43,6,53.9,479819,3976,477277,3.73,1.46,0.11753246753246753,0.83,99.47
2021-07-30,Andhra Pradesh,1010,5,1004,12799,3608,348,7.89,1,53.9,480829,3981,478281,6.69,0.65,0.2374582560296846,0.83,99.47
2021-07-31,Andhra Pradesh,1371,11,1367,17214,114,0,7.96,0,53.9,482200,3992,479648,0.21,0.0,0.3193692022263451,0.83,99.47
2021-08-01,Andhra Pradesh,932,8,925,11193,4721,4045,8.33,0,53.9,483132,4000,480573,8.76,7.5,0.20766233766233766,0.83,99.47
2021-08-02,Andhra Pradesh,948,12,945,12152,1521,385,7.8,0,53.9,484080,4012,481518,2.82,0.71,0.22545454545454546,0.83,99.47
2021-08-03,Andhra Pradesh,314,3,308,4207,703,280,7.46,3,53.9,484394,4015,481826,1.3,0.52,0.07805194805194805,0.83,99.47
2021-08-04,Andhra Pradesh,1558,12,1558,19579,1810,703,7.96,0,53.9,485952,4027,483384,3.36,1.3,0.36324675324675326,0.83,99.47
2021-08-05,Andhra Pradesh,411,5,404,5215,1726,657,7.88,2,53.9,486363,4032,483788,3.2,1.22,0.09675324675324676,0.83,99.47
2021-08-06,Andhra Pradesh,603,5,594,7660,2583,594,7.87,4,53.9,486966,4037,484382,4.79,1.1,0.14211502782931354,0.83,99.47
2021-08-07,Andhra Pradesh,569,4,569,6996,4934,207,8.13,0,53.9,487535,4041,484951,9.15,0.38,0.12979591836734694,0.83,99.47
2021-08-08,Andhra Pradesh,555,5,547,6881,3623,1662,8.07,3,53.9,488090,4046,485498,6.72,3.08,0.12766233766233767,0.83,99.47
2021-08-09,Andhra Pradesh,554,4,546,7302,3251,1014,7.59,4,53.9,488644,4050,486044,6.03,1.88,0.13547309833024118,0.83,99.47
2021-08-10,Andhra Pradesh,368,4,363,4443,3502,2542,8.28,1,53.9,489012,4054,486407,6.5,4.72,0.08243042671614101,0.83,99.47
2021-08-11,Andhra Pradesh,1122,3,1117,14194,1090,414,7.9,2,53.9,490134,4057,487524,2.02,0.77,0.2633395176252319,0.83,99.47
2021-08-12,Andhra Pradesh,178,1,175,2286,2340,793,7.79,2,53.9,490312,4058,487699,4.34,1.47,0.04241187384044527,0.83,99.47
2021-08-13,Andhra Pradesh,1544,18,1540,19271,4481,2846,8.01,0,53.9,491856,4076,489239,8.31,5.28,0.35753246753246753,0.83,99.47
2021-08-14,Andhra Pradesh,818,3,818,10554,1725,75,7.75,0,53.9,492674,4079,490057,3.2,0.14,0.1958070500927644,0.83,99.47
2021-08-15,Andhra Pradesh,168,1,167,1634,3797,1998,10.28,0,53.9,492842,4080,490224,7.04,3.71,0.03031539888682746,0.83,99.47
2021-08-16,Andhra Pradesh,498,5,490,6116,4264,1642,8.14,3,53.9,493340,4085,490714,7.91,3.05,0.11346938775510204,0.83,99.47
2021-08-17,Andhra Pradesh,930,11,925,11370,446,432,8.18,0,53.9,494270,4096,491639,0.83,0.8,0.21094619666048237,0.83,99.47
2021-08-18,Andhra Pradesh,1207,8,1199,15328,1882,755,7.87,0,53.9,495477,4104,492838,3.49,1.4,0.28437847866419297,0.83,99.47
2021-08-19,Andhra Pradesh,1109,14,1103,13516,2623,403,8.21,0,53.9,496586,4118,493941,4.87,0.75,0.250760667903525,0.83,99.47
2021-08-20,Andhra Pradesh,1171,6,1170,14530,1473,1387,8.06,0,53.9,497757,4124,495111,2.73,2.57,0.26957328385899815,0.83,99.47
2021-08-21,Andhra Pradesh,125,1,122,1974,2510,1664,6.33,2,53.9,497882,4125,495233,4.66,3.09,0.03662337662337662,0.83,99.47
2021-08-22,Andhra Pradesh,1174,13,1167,15044,3829,2993,7.8,0,53.9,499056,4138,496400,7.1,5.55,0.2791094619666048,0.83,99.47
2021-08-23,Andhra Pradesh,1145,11,1140,14314,379,138,8.0,0,53.9,500201,4149,497540,0.7,0.26,0.26556586270871985,0.83,99.47
2021-08-24,Andhra Pradesh,1404,6,1396,17163,2394,2162,8.18,2,53.9,501605,4155,498936,4.44,4.01,0.3184230055658627,0.83,99.47
2021-08-25,Andhra Pradesh,366,2,358,4670,841,375,7.84,6,53.9,501971,4157,499294,1.56,0.7,0.08664192949907236,0.83,99.47
2021-08-26,Andhra Pradesh,277,2,276,3379,4211,4081,8.2,0,53.9,502248,4159,499570,7.81,7.57,0.06269016697588126,0.83,99.47
2021-08-27,Andhra Pradesh,480,6,479,6176,4651,684,7.77,0,53.9,502728,4165,500049,8.63,1.27,0.114582560296846,0.83,99.47
2021-08-28,Andhra Pradesh,285,2,282,3544,59,36,8.04,1,53.9,503013,4167,500331,0.11,0.07,0.06575139146567718,0.83,99.47
2021-08-29,Andhra Pradesh,188,1,186,2429,3456,476,7.74,1,53.9,503201,4168,500517,6.41,0.88,0.045064935064935065,0.83,99.47
2021-08-30,Andhra Pradesh,1524,10,1520,19505,3981,2947,7.81,0,53.9,504725,4178,502037,7.39,5.47,0.361873840445269,0.83,99.47
2021-08-31,Andhra Pradesh,671,10,670,8945,124,4,7.5,0,53.9,505396,4188,502707,0.23,0.01,0.16595547309833025,0.83,99.47
2021-09-01,Andhra Pradesh,1158,8,1151,14163,4041,1394,8.18,0,53.9,506554,4196,503858,7.5,2.59,0.2627643784786642,0.83,99.47
2021-09-02,Andhra Pradesh,1193,17,1186,14998,4926,3727,7.95,0,53.9,507747,4213,505044,9.14,6.91,0.2782560296846011,0.83,99.47
2021-09-03,Andhra Pradesh,762,3,759,9056,3289,1866,8.41,0,53.9,508509,4216,505803,6.1,3.46,0.16801484230055658,0.83,99.47
2021-09-04,Andhra Pradesh,505,3,502,6638,904,278,7.61,0,53.9,509014,4219,506305,1.68,0.52,0.12315398886827458,0.83,99.47
2021-09-05,Andhra Pradesh,171,2,164,2084,1344,1257,8.21,5,53.9,509185,4221,506469,2.49,2.33,0.038664192949907236,0.83,99.47
2021-09-06,Andhra Pradesh,1131,15,1125,14360,4156,1137,7.88,0,53.9,510316,4236,507594,7.71,2.11,0.2664192949907236,0.83,99.47
2021-09-07,Andhra Pradesh,747,8,741,9350,232,143,7.99,0,53.9,511063,4244,508335,0.43,0.27,0.17346938775510204,0.83,99.47
2021-09-08,Andhra Pradesh,142,0,134,1726,3374,1141,8.23,8,53.9,511205,4244,508469,6.26,2.12,0.03202226345083488,0.83,99.46
2021-09-09,Andhra Pradesh,522,6,519,6479,4810,3718,8.06,0,53.9,511727,4250,508988,8.92,6.9,0.12020408163265306,0.83,99.46
2021-09-10,Andhra Pradesh,672,9,667,8415,1249,733,7.99,0,53.9,512399,4259,509655,2.32,1.36,0.15612244897959185,0.83,99.46
2021-09-11,Andhra Pradesh,577,5,575,7150,367,361,8.07,0,53.9,512976,4264,510230,0.68,0.67,0.1326530612244898,0.83,99.46
2021-09-12,Andhra Pradesh,130,1,129,1467,3034,1864,8.86,0,53.9,513106,4265,510359,5.63,3.46,0.027217068645640073,0.83,99.46
2021-09-13,Andhra Pradesh,923,13,918,11544,3363,2536,8.0,0,53.9,514029,4278,511277,6.24,4.71,0.2141743970315399,0.83,99.46
2021-09-14,Andhra Pradesh,964,11,963,12072,896,59,7.99,0,53.9,514993,4289,512240,1.66,0.11,0.22397031539888682,0.83,99.47
2021-09-15,Andhra Pradesh,908,6,901,11644,580,189,7.8,1,53.9,515901,4295,513141,1.08,0.35,0.21602968460111316,0.83,99.47
2021-09-16,Andhra Pradesh,98,1,94,1315,3355,216,7.45,3,53.9,515999,4296,513235,6.22,0.4,0.024397031539888682,0.83,99.46
2021-09-17,Andhra Pradesh,587,7,584,7450,1363,904,7.88,0,53.9,516586,4303,513819,2.53,1.68,0.13821892393320964,0.83,99.46
2021-09-18,Andhra Pradesh,278,3,270,3508,4645,2343,7.92,5,53.9,516864,4306,514089,8.62,4.35,0.06508348794063079,0.83,99.46
2021-09-19,Andhra Pradesh,1263,15,1254,15806,4813,549,7.99,0,53.9,518127,4321,515343,8.93,1.02,0.29324675324675326,0.83,99.46
2021-09-20,Andhra Pradesh,1079,11,1078,13716,57,12,7.87,0,53.9,519206,4332,516421,0.11,0.02,0.2544712430426716,0.83,99.46
2021-09-21,Andhra Pradesh,229,3,220,2729,3465,1933,8.39,6,53.9,519435,4335,516641,6.43,3.59,0.050630797773654916,0.83,99.46
2021-09-22,Andhra Pradesh,1235,8,1228,15321,2574,1247,8.06,0,53.9,520670,4343,517869,4.78,2.31,0.2842486085343228,0.83,99.46
2021-09-23,Andhra Pradesh,235,3,230,2570,1625,174,9.14,2,53.9,520905,4346,518099,3.01,0.32,0.04768089053803339,0.83,99.46
2021-09-24,Andhra Pradesh,894,8,892,11404,3510,777,7.84,0,53.9,521799,4354,518991,6.51,1.44,0.2115769944341373,0.83,99.46
2021-09-25,Andhra Pradesh,1477,13,1474,18782,371,261,7.86,0,53.9,523276,4367,520465,0.69,0.48,0.3484601113172542,0.83,99.46
2021-09-26,Andhra Pradesh,820,3,816,10313,3297,594,7.95,1,53.9,524096,4370,521281,6.12,1.1,0.19133580705009276,0.83,99.46
2021-09-27,Andhra Pradesh,1493,8,1491,18766,4174,1694,7.96,0,53.9,525589,4378,522772,7.74,3.14,0.34816326530612246,0.83,99.46
2021-09-28,Andhra Pradesh,1063,14,1057,13105,4595,4071,8.11,0,53.9,526652,4392,523829,8.53,7.55,0.24313543599257886,0.83,99.46
2021-09-29,Andhra Pradesh,1098,5,1094,13606,2598,920,8.07,0,53.9,527750,4397,524923,4.82,1.71,0.252430426716141,0.83,99.46
2021-09-30,Andhra Pradesh,913,4,909,11363,2402,1267,8.03,0,53.9,528663,4401,525832,4.46,2.35,0.21081632653061225,0.83,99.46
2021-10-01,Andhra Pradesh,594,7,586,7540,1913,1587,7.88,1,53.9,529257,4408,526418,3.55,2.94,0.1398886827458256,0.83,99.46
2021-10-02,Andhra Pradesh,904,7,899,11214,1524,1061,8.06,0,53.9,530161,4415,527317,2.83,1.97,0.20805194805194804,0.83,99.46
2021-10-03,Andhra Pradesh,772,4,764,9496,4302,234,8.13,4,53.9,530933,4419,528081,7.98,0.43,0.17617810760667904,0.83,99.46
2021-10-04,Andhra Pradesh,1163,12,1157,14652,4644,2360,7.94,0,53.9,532096,4431,529238,8.62,4.38,0.27183673469387754,0.83,99.46
2021-10-05,Andhra Pradesh,196,1,191,3048,507,45,6.43,4,53.9,532292,4432,529429,0.94,0.08,0.05654916512059369,0.83,99.46
2021-10-06,Andhra Pradesh,530,4,530,6514,245,99,8.14,0,53.9,532822,4436,529959,0.45,0.18,0.12085343228200371,0.83,99.46
2021-10-07,Andhra Pradesh,673,9,670,8118,3898,1573,8.29,0,53.9,533495,4445,530629,7.23,2.92,0.15061224489795919,0.83,99.46
2021-10-08,Andhra Pradesh,84,0,75,811,4947,3121,10.36,9,53.9,533579,4445,530704,9.18,5.79,0.015046382189239331,0.83,99.46
2021-10-09,Andhra Pradesh,333,3,325,4266,4643,1262,7.81,5,53.9,533912,4448,531029,8.61,2.34,0.07914656771799629,0.83,99.46
2021-10-10,Andhra Pradesh,768,9,759,9379,3857,322,8.19,0,53.9,534680,4457,531788,7.16,0.6,0.17400742115027829,0.83,99.46
2021-10-11,Andhra Pradesh,772,7,763,9748,649,283,7.92,2,53.9,535452,4464,532551,1.2,0.53,0.1808534322820037,0.83,99.46
2021-10-12,Andhra Pradesh,123,0,115,1292,3013,609,9.52,8,53.9,535575,4464,532666,5.59,1.13,0.02397031539888683,0.83,99.46
2021-10-13,Andhra Pradesh,565,2,557,6989,2155,979,8.08,6,53.9,536140,4466,533223,4.0,1.82,0.12966604823747682,0.83,99.46
2021-10-14,Andhra Pradesh,173,0,165,1899,2826,1981,9.11,8,53.9,536313,4466,533388,5.24,3.68,0.03523191094619666,0.83,99.45
2021-10-15,Andhra Pradesh,1198,16,1192,14943,1393,18,8.02,0,53.9,537511,4482,534580,2.58,0.03,0.2772356215213358,0.83,99.45
2021-10-16,Andhra Pradesh,1129,3,1123,13834,2211,743,8.16,3,53.9,538640,4485,535703,4.1,1.38,0.2566604823747681,0.83,99.45
2021-10-17,Andhra Pradesh,601,2,592,7609,3719,2967,7.9,7,53.9,539241,4487,536295,6.9,5.5,0.14116883116883117,0.83,99.45
2021-10-18,Andhra Pradesh,1277,13,1268,16347,4517,1795,7.81,0,53.9,540518,4500,537563,8.38,3.33,0.3032838589981447,0.83,99.45
2021-10-19,Andhra Pradesh,318,4,310,3973,1691,1458,8.0,4,53.9,540836,4504,537873,3.14,2.71,0.07371057513914657,0.83,99.45
2021-10-20,Andhra Pradesh,292,2,284,3691,1207,402,7.91,6,53.9,541128,4506,538157,2.24,0.75,0.0684786641929499,0.83,99.45
2021-10-21,Andhra Pradesh,954,4,954,11724,3780,2350,8.14,0,53.9,542082,4510,539111,7.01,4.36,0.2175139146567718,0.83,99.45
2021-10-22,Andhra Pradesh,158,1,153,1953,377,346,8.09,4,53.9,542240,4511,539264,0.7,0.64,0.036233766233766236,0.83,99.45
2021-10-23,Andhra Pradesh,462,1,457,5934,2211,517,7.79,4,53.9,542702,4512,539721,4.1,0.96,0.11009276437847866,0.83,99.45
2021-10-24,Andhra Pradesh,1121,12,1114,13860,2678,1854,8.09,0,53.9,543823,4524,540835,4.97,3.44,0.2571428571428571,0.83,99.45
2021-10-25,Andhra Pradesh,668,9,665,8343,320,81,8.01,0,53.9,544491,4533,541500,0.59,0.15,0.15478664192949906,0.83,99.45
2021-10-26,Andhra Pradesh,270,1,262,3706,3853,2251,7.29,7,53.9,544761,4534,541762,7.15,4.18,0.0687569573283859,0.83,99.45
2021-10-27,Andhra Pradesh,689,2,689,8436,1974,951,8.17,0,53.9,545450,4536,542451,3.66,1.76,0.15651205936920223,0.83,99.45
2021-10-28,Andhra Pradesh,720,9,711,8799,3068,2093,8.18,0,53.9,546170,4545,543162,5.69,3.88,0.16324675324675325,0.83,99.45
2021-10-29,Andhra Pradesh,1505,15,1504,18942,2867,2344,7.95,0,53.9,547675,4560,544666,5.32,4.35,0.3514285714285714,0.83,99.45
2021-10-30,Andhra Pradesh,340,1,334,4104,1961,956,8.28,5,53.9,548015,4561,545000,3.64,1.77,0.07614100185528756,0.83,99.45
2021-10-31,Andhra Pradesh,1531,22,1522,19121,3736,1713,8.01,0,53.9,549546,4583,546522,6.93,3.18,0.3547495361781076,0.83,99.45
2021-11-01,Andhra Pradesh,1220,18,1211,15056,2977,382,8.1,0,53.9,550766,4601,547733,5.52,0.71,0.2793320964749536,0.84,99.45
2021-11-02,Andhra Pradesh,411,3,402,4980,3516,1759,8.25,6,53.9,551177,4604,548135,6.52,3.26,0.09239332096474953,0.84,99.45
2021-11-03,Andhra Pradesh,1535,20,1533,19399,1018,324,7.91,0,53.9,552712,4624,549668,1.89,0.6,0.3599072356215213,0.84,99.45
2021-11-04,Andhra Pradesh,1224,16,1215,15176,4357,1043,8.07,0,53.9,553936,4640,550883,8.08,1.94,0.28155844155844156,0.84,99.45
2021-11-05,Andhra Pradesh,1093,7,1090,13955,2430,1983,7.83,0,53.9,555029,4647,551973,4.51,3.68,0.2589053803339518,0.84,99.45
2021-11-06,Andhra Pradesh,1420,7,1417,17964,977,763,7.9,0,53.9,556449,4654,553390,1.81,1.42,0.3332838589981447,0.84,99.45
2021-11-07,Andhra Pradesh,1098,3,1097,13395,3778,353,8.2,0,53.9,557547,4657,554487,7.01,0.65,0.24851576994434138,0.84,99.45
2021-11-08,Andhra Pradesh,1226,10,1218,15796,2351,1124,7.76,0,53.9,558773,4667,555705,4.36,2.09,0.29306122448979594,0.84,99.45
2021-11-09,Andhra Pradesh,816,10,815,10244,3652,589,7.97,0,53.9,559589,4677,556520,6.78,1.09,0.1900556586270872,0.84,99.45
2021-11-10,Andhra Pradesh,399,4,398,4857,3906,3200,8.21,0,53.9,559988,4681,556918,7.25,5.94,0.0901113172541744,0.84,99.45
2021-11-11,Andhra Pradesh,421,5,414,5535,2530,1364,7.61,2,53.9,560409,4686,557332,4.69,2.53,0.10269016697588126,0.84,99.45
2021-11-12,Andhra Pradesh,965,3,963,11635,3361,3000,8.29,0,53.9,561374,4689,558295,6.24,5.57,0.21586270871985158,0.84,99.45
2021-11-13,Andhra Pradesh,142,1,136,1690,1469,570,8.4,5,53.9,561516,4690,558431,2.73,1.06,0.0313543599257885,0.84,99.45
2021-11-14,Andhra Pradesh,1067,10,1062,13161,4293,2149,8.11,0,53.9,562583,4700,559493,7.96,3.99,0.2441743970315399,0.84,99.45
2021-11-15,Andhra Pradesh,1093,15,1087,13576,3256,1590,8.05,0,53.9,563676,4715,560580,6.04,2.95,0.251873840445269,0.84,99.45
2021-11-16,Andhra Pradesh,1056,12,1051,13183,3572,3420,8.01,0,53.9,564732,4727,561631,6.63,6.35,0.24458256029684602,0.84,99.45
2021-11-17,Andhra Pradesh,346,1,338,4328,1404,1336,7.99,7,53.9,565078,4728,561969,2.6,2.48,0.08029684601113173,0.84,99.45
2021-11-18,Andhra Pradesh,1467,8,1464,18602,847,338,7.89,0,53.9,566545,4736,563433,1.57,0.63,0.34512059369202225,0.84,99.45
2021-11-19,Andhra Pradesh,708,4,705,8690,791,633,8.15,0,53.9,567253,4740,564138,1.47,1.17,0.16122448979591836,0.84,99.45
2021-11-20,Andhra Pradesh,1193,13,1187,14996,1550,519,7.96,0,53.9,568446,4753,565325,2.88,0.96,0.2782189239332096,0.84,99.45
2021-11-21,Andhra Pradesh,1564,13,1564,19306,3772,2586,8.1,0,53.9,570010,4766,566889,7.0,4.8,0.35818181818181816,0.84,99.45
2021-11-22,Andhra Pradesh,571,3,564,6763,3296,1344,8.44,4,53.9,570581,4769,567453,6.12,2.49,0.1254730983302412,0.84,99.45
2021-11-23,Andhra Pradesh,721,5,715,8795,1877,758,8.2,1,53.9,571302,4774,568168,3.48,1.41,0.1631725417439703,0.84,99.45
2021-11-24,Andhra Pradesh,184,2,175,2149,4358,518,8.56,7,53.9,571486,4776,568343,8.09,0.96,0.03987012987012987,0.84,99.45
2021-11-25,Andhra Pradesh,312,3,311,3908,3305,2174,7.98,0,53.9,571798,4779,568654,6.13,4.03,0.07250463821892393,0.84,99.45
2021-11-26,Andhra Pradesh,761,7,755,9162,2466,361,8.31,0,53.9,572559,4786,569409,4.58,0.67,0.16998144712430427,0.84,99.45
2021-11-27,Andhra Pradesh,903,4,896,11847,3053,2341,7.62,3,53.9,573462,4790,570305,5.66,4.34,0.21979591836734694,0.84,99.45
2021-11-28,Andhra Pradesh,698,6,697,8334,2241,410,8.38,0,53.9,574160,4796,571002,4.16,0.76,0.1546196660482375,0.84,99.45
2021-11-29,Andhra Pradesh,1034,10,1025,13225,4900,106,7.82,0,53.9,575194,4806,572027,9.09,0.2,0.2453617810760668,0.84,99.45
2021-11-30,Andhra Pradesh,693,7,684,8711,27,11,7.96,2,53.9,575887,4813,572711,0.05,0.02,0.16161410018552877,0.84,99.45
2021-12-01,Andhra Pradesh,1394,18,1385,17581,1127,717,7.93,0,53.9,577281,4831,574096,2.09,1.33,0.32617810760667904,0.84,99.45
2021-12-02,Andhra Pradesh,422,1,414,5737,3068,1656,7.36,7,53.9,577703,4832,574510,5.69,3.07,0.1064378478664193,0.84,99.45
2021-12-03,Andhra Pradesh,1172,7,1168,14614,814,794,8.02,0,53.9,578875,4839,575678,1.51,1.47,0.2711317254174397,0.84,99.45
2021-12-04,Andhra Pradesh,359,4,356,4045,4696,1443,8.88,0,53.9,579234,4843,576034,8.71,2.68,0.07504638218923933,0.84,99.45
2021-12-05,Andhra Pradesh,219,1,210,2690,3947,2153,8.14,8,53.9,579453,4844,576244,7.32,3.99,0.049907235621521336,0.84,99.45
2021-12-06,Andhra Pradesh,753,11,745,9069,2555,290,8.3,0,53.9,580206,4855,576989,4.74,0.54,0.1682560296846011,0.84,99.45
2021-12-07,Andhra Pradesh,1252,9,1252,16144,2651,1268,7.76,0,53.9,581458,4864,578241,4.92,2.35,0.29951762523191094,0.84,99.45
2021-12-08,Andhra Pradesh,209,2,206,2908,34,9,7.19,1,53.9,581667,4866,578447,0.06,0.02,0.053951762523191095,0.84,99.45
2021-12-09,Andhra Pradesh,681,2,676,8775,4864,4265,7.76,3,53.9,582348,4868,579123,9.02,7.91,0.16280148423005567,0.84,99.45
2021-12-10,Andhra Pradesh,939,7,938,11846,3091,743,7.93,0,53.9,583287,4875,580061,5.73,1.38,0.2197773654916512,0.84,99.45
2021-12-11,Andhra Pradesh,120,0,114,1612,3688,3649,7.44,6,53.9,583407,4875,580175,6.84,6.77,0.029907235621521335,0.84,99.45
2021-12-12,Andhra Pradesh,1079,9,1078,13340,4283,911,8.09,0,53.9,584486,4884,581253,7.95,1.69,0.24749536178107606,0.84,99.45
2021-12-13,Andhra Pradesh,162,1,160,2422,4861,3771,6.69,1,53.9,584648,4885,581413,9.02,7.0,0.04493506493506493,0.84,99.45
2021-12-14,Andhra Pradesh,572,5,564,7267,2210,452,7.87,3,53.9,585220,4890,581977,4.1,0.84,0.13482374768089053,0.84,99.45
2021-12-15,Andhra Pradesh,1417,19,1417,17908,2335,2244,7.91,0,53.9,586637,4909,583394,4.33,4.16,0.33224489795918366,0.84,99.45
2021-12-16,Andhra Pradesh,816,5,808,10758,2483,1066,7.59,3,53.9,587453,4914,584202,4.61,1.98,0.19959183673469388,0.84,99.45
2021-12-17,Andhra Pradesh,335,2,330,4275,4344,439,7.84,3,53.9,587788,4916,584532,8.06,0.81,0.07931354359925788,0.84,99.45
2021-12-18,Andhra Pradesh,885,5,876,10581,3557,2796,8.36,4,53.9,588673,4921,585408,6.6,5.19,0.19630797773654918,0.84,99.45
2021-12-19,Andhra Pradesh,361,2,352,4653,1163,1045,7.76,7,53.9,589034,4923,585760,2.16,1.94,0.08632653061224489,0.84,99.44
2021-12-20,Andhra Pradesh,1112,13,1111,13991,1931,425,7.95,0,53.9,590146,4936,586871,3.58,0.79,0.25957328385899814,0.84,99.45
2021-12-21,Andhra Pradesh,240,1,233,2678,1492,1312,8.96,6,53.9,590386,4937,587104,2.77,2.43,0.04968460111317254,0.84,99.44
2021-12-22,Andhra Pradesh,1582,8,1578,19742,1217,913,8.01,0,53.9,591968,4945,588682,2.26,1.69,0.3662708719851577,0.84,99.44
2021-12-23,Andhra Pradesh,1419,6,1415,17979,4101,2489,7.89,0,53.9,593387,4951,590097,7.61,4.62,0.3335621521335807,0.83,99.45
2021-12-24,Andhra Pradesh,1246,6,1239,15761,1224,925,7.91,1,53.9,594633,4957,591336,2.27,1.72,0.29241187384044526,0.83,99.45
2021-12-25,Andhra Pradesh,1461,20,1461,18346,4149,2357,7.96,0,53.9,596094,4977,592797,7.7,4.37,0.34037105751391467,0.83,99.45
2021-12-26,Andhra Pradesh,701,2,694,8500,4619,3805,8.25,5,53.9,596795,4979,593491,8.57,7.06,0.15769944341372913,0.83,99.45
2021-12-27,Andhra Pradesh,821,10,820,10321,3827,1277,7.95,0,53.9,597616,4989,594311,7.1,2.37,0.19148423005565862,0.83,99.45
2021-12-28,Andhra Pradesh,1488,5,1480,18728,3830,2846,7.95,3,53.9,599104,4994,595791,7.11,5.28,0.3474582560296846,0.83,99.45
2021-12-29,Andhra Pradesh,933,10,924,11393,4347,735,8.19,0,53.9,600037,5004,596715,8.06,1.36,0.21137291280148424,0.83,99.45
2021-12-30,Andhra Pradesh,466,4,458,5749,1548,510,8.11,4,53.9,600503,5008,597173,2.87,0.95,0.10666048237476809,0.83,99.45
2021-12-31,Andhra Pradesh,1204,5,1201,14688,2123,168,8.2,0,53.9,601707,5013,598374,3.94,0.31,0.27250463821892396,0.83,99.45
2022-01-01,Andhra Pradesh,1176,9,1174,14677,4461,371,8.01,0,53.9,602883,5022,599548,8.28,0.69,0.2723005565862709,0.83,99.45
2022-01-02,Andhra Pradesh,1437,6,1431,17681,3443,104,8.13,0,53.9,604320,5028,600979,6.39,0.19,0.3280333951762523,0.83,99.45
2022-01-03,Andhra Pradesh,818,12,814,10276,4826,1663,7.96,0,53.9,605138,5040,601793,8.95,3.09,0.19064935064935065,0.83,99.45
2022-01-04,Andhra Pradesh,288,2,279,3889,1298,893,7.41,7,53.9,605426,5042,602072,2.41,1.66,0.072152133580705,0.83,99.45
2022-01-05,Andhra Pradesh,760,2,754,9620,1685,836,7.9,4,53.9,606186,5044,602826,3.13,1.55,0.17847866419294992,0.83,99.45
2022-01-06,Andhra Pradesh,1543,5,1539,19142,1875,960,8.06,0,53.9,607729,5049,604365,3.48,1.78,0.355139146567718,0.83,99.45
2022-01-07,Andhra Pradesh,323,1,318,3730,3391,2943,8.66,4,53.9,608052,5050,604683,6.29,5.46,0.06920222634508348,0.83,99.45
2022-01-08,Andhra Pradesh,751,4,744,9104,27,0,8.25,3,53.9,608803,5054,605427,0.05,0.0,0.16890538033395175,0.83,99.45
2022-01-09,Andhra Pradesh,1445,15,1441,18330,4169,1510,7.88,0,53.9,610248,5069,606868,7.73,2.8,0.34007421150278294,0.83,99.45
2022-01-10,Andhra Pradesh,381,4,374,4930,2954,2424,7.73,3,53.9,610629,5073,607242,5.48,4.5,0.0914656771799629,0.83,99.45
2022-01-11,Andhra Pradesh,159,0,159,1736,2457,390,9.16,0,53.9,610788,5073,607401,4.56,0.72,0.032207792207792206,0.83,99.45
2022-01-12,Andhra Pradesh,987,7,985,12133,4520,1165,8.13,0,53.9,611775,5080,608386,8.39,2.16,0.22510204081632654,0.83,99.45
2022-01-13,Andhra Pradesh,1270,18,1267,15576,3578,566,8.15,0,53.9,613045,5098,609653,6.64,1.05,0.2889795918367347,0.83,99.45
2022-01-14,Andhra Pradesh,102,0,95,852,4536,3196,11.97,7,53.9,613147,5098,609748,8.42,5.93,0.01580705009276438,0.83,99.45
2022-01-15,Andhra Pradesh,360,3,358,4768,1246,1022,7.55,0,53.9,613507,5101,610106,2.31,1.9,0.08846011131725418,0.83,99.45
2022-01-16,Andhra Pradesh,1224,13,1221,15280,734,338,8.01,0,53.9,614731,5114,611327,1.36,0.63,0.2834879406307978,0.83,99.45
2022-01-17,Andhra Pradesh,463,1,462,5896,1499,402,7.85,0,53.9,615194,5115,611789,2.78,0.75,0.10938775510204081,0.83,99.45
2022-01-18,Andhra Pradesh,1172,15,1164,13996,4729,1527,8.37,0,53.9,616366,5130,612953,8.77,2.83,0.2596660482374768,0.83,99.45
2022-01-19,Andhra Pradesh,1000,6,991,12514,4168,2399,7.99,3,53.9,617366,5136,613944,7.73,4.45,0.23217068645640074,0.83,99.45
2022-01-20,Andhra Pradesh,646,7,646,7713,2247,2051,8.38,0,53.9,618012,5143,614590,4.17,3.81,0.14309833024118737,0.83,99.45
2022-01-21,Andhra Pradesh,577,4,574,7941,4888,3573,7.27,0,53.9,618589,5147,615164,9.07,6.63,0.14732838589981448,0.83,99.45
2022-01-22,Andhra Pradesh,461,4,456,5885,194,78,7.83,1,53.9,619050,5151,615620,0.36,0.14,0.10918367346938776,0.83,99.45
2022-01-23,Andhra Pradesh,930,3,924,11654,3269,1189,7.98,3,53.9,619980,5154,616544,6.06,2.21,0.2162152133580705,0.83,99.45
2022-01-24,Andhra Pradesh,987,13,979,12301,3930,1687,8.02,0,53.9,620967,5167,617523,7.29,3.13,0.22821892393320964,0.83,99.45
2022-01-25,Andhra Pradesh,528,3,526,6989,2389,593,7.55,0,53.9,621495,5170,618049,4.43,1.1,0.12966604823747682,0.83,99.45
2022-01-26,Andhra Pradesh,1381,9,1376,17263,2174,1182,8.0,0,53.9,622876,5179,619425,4.03,2.19,0.320278293135436,0.83,99.45
2022-01-27,Andhra Pradesh,641,9,637,8058,1802,682,7.95,0,53.9,623517,5188,620062,3.34,1.27,0.1494990723562152,0.83,99.45
2022-01-28,Andhra Pradesh,1579,14,1576,19615,1086,527,8.05,0,53.9,625096,5202,621638,2.01,0.98,0.3639146567717996,0.83,99.45
2022-01-29,Andhra Pradesh,591,2,582,7476,2753,1915,7.91,7,53.9,625687,5204,622220,5.11,3.55,0.13870129870129871,0.83,99.45
2022-01-30,Andhra Pradesh,1384,16,1383,17391,256,149,7.96,0,53.9,627071,5220,623603,0.47,0.28,0.3226530612244898,0.83,99.45
2022-01-31,Andhra Pradesh,512,2,512,6761,625,6,7.57,0,53.9,627583,5222,624115,1.16,0.01,0.12543599257884971,0.83,99.45
2022-02-01,Andhra Pradesh,535,5,534,6577,3138,2432,8.13,0,53.9,628118,5227,624649,5.82,4.51,0.12202226345083488,0.83,99.45
2022-02-02,Andhra Pradesh,243,1,239,2978,230,10,8.16,3,53.9,628361,5228,624888,0.43,0.02,0.055250463821892394,0.83,99.45
2022-02-03,Andhra Pradesh,1379,16,1377,17288,3748,3637,7.98,0,53.9,629740,5244,626265,6.95,6.75,0.3207421150278293,0.83,99.45
2022-02-04,Andhra Pradesh,439,3,430,5729,1265,171,7.66,6,53.9,630179,5247,626695,2.35,0.32,0.10628942486085344,0.83,99.45
2022-02-05,Andhra Pradesh,1605,21,1596,19819,4818,3893,8.1,0,53.9,631784,5268,628291,8.94,7.22,0.3676994434137291,0.83,99.45
2022-02-06,Andhra Pradesh,218,2,211,2587,1858,291,8.43,5,53.9,632002,5270,628502,3.45,0.54,0.04799628942486085,0.83,99.45
2022-02-07,Andhra Pradesh,1052,9,1050,12926,537,371,8.14,0,53.9,633054,5279,629552,1.0,0.69,0.23981447124304267,0.83,99.45
2022-02-08,Andhra Pradesh,665,2,664,8152,2135,826,8.16,0,53.9,633719,5281,630216,3.96,1.53,0.1512430426716141,0.83,99.45
2022-02-09,Andhra Pradesh,1282,14,1276,15957,939,862,8.03,0,53.9,635001,5295,631492,1.74,1.6,0.2960482374768089,0.83,99.45
2022-02-10,Andhra Pradesh,1568,19,1566,19359,2479,317,8.1,0,53.9,636569,5314,633058,4.6,0.59,0.35916512059369204,0.83,99.45
2022-02-11,Andhra Pradesh,833,9,828,10180,2153,1489,8.18,0,53.9,637402,5323,633886,3.99,2.76,0.1888682745825603,0.84,99.45
2022-02-12,Andhra Pradesh,973,3,969,12220,2788,2564,7.96,1,53.9,638375,5326,634855,5.17,4.76,0.22671614100185528,0.83,99.45
2022-02-13,Andhra Pradesh,893,10,893,10941,2772,2434,8.16,0,53.9,639268,5336,635748,5.14,4.52,0.202987012987013,0.83,99.45
2022-02-14,Andhra Pradesh,1104,11,1096,13710,4983,874,8.05,0,53.9,640372,5347,636844,9.24,1.62,0.2543599257884972,0.83,99.45
2022-02-15,Andhra Pradesh,892,10,892,11180,4638,866,7.98,0,53.9,641264,5357,637736,8.6,1.61,0.20742115027829314,0.84,99.45
2022-02-16,Andhra Pradesh,1079,5,1079,13404,725,28,8.05,0,53.9,642343,5362,638815,1.35,0.05,0.24868274582560296,0.83,99.45
2022-02-17,Andhra Pradesh,1045,4,1041,12940,2371,510,8.08,0,53.9,643388,5366,639856,4.4,0.95,0.24007421150278294,0.83,99.45
2022-02-18,Andhra Pradesh,1507,18,1505,18723,2759,424,8.05,0,53.9,644895,5384,641361,5.12,0.79,0.34736549165120595,0.83,99.45
2022-02-19,Andhra Pradesh,394,4,387,4741,3370,861,8.31,3,53.9,645289,5388,641748,6.25,1.6,0.08795918367346939,0.83,99.45
2022-02-20,Andhra Pradesh,706,9,705,8922,4676,4021,7.91,0,53.9,645995,5397,642453,8.68,7.46,0.16552875695732838,0.84,99.45
2022-02-21,Andhra Pradesh,325,1,318,4136,1943,881,7.86,6,53.9,646320,5398,642771,3.6,1.63,0.07673469387755102,0.84,99.45
2022-02-22,Andhra Pradesh,1447,5,1446,17977,512,460,8.05,0,53.9,647767,5403,644217,0.95,0.85,0.3335250463821892,0.83,99.45
2022-02-23,Andhra Pradesh,431,4,429,5338,374,329,8.07,0,53.9,648198,5407,644646,0.69,0.61,0.09903525046382189,0.83,99.45
2022-02-24,Andhra Pradesh,1070,14,1061,13139,3294,2766,8.14,0,53.9,649268,5421,645707,6.11,5.13,0.24376623376623377,0.83,99.45
2022-02-25,Andhra Pradesh,1302,16,1302,16043,2874,2676,8.12,0,53.9,650570,5437,647009,5.33,4.96,0.29764378478664194,0.84,99.45
2022-02-26,Andhra Pradesh,60,0,57,677,420,347,8.86,3,53.9,650630,5437,647066,0.78,0.64,0.012560296846011131,0.84,99.45
2022-02-27,Andhra Pradesh,870,7,870,10644,3550,363,8.17,0,53.9,651500,5444,647936,6.59,0.67,0.19747680890538033,0.84,99.45
2022-02-28,Andhra Pradesh,1536,14,1536,19051,4640,2623,8.06,0,53.9,653036,5458,649472,8.61,4.87,0.3534508348794063,0.84,99.45
2022-03-01,Andhra Pradesh,535,6,528,6777,1850,83,7.89,1,53.9,653571,5464,650000,3.43,0.15,0.12573283858998144,0.84,99.45
2022-03-02,Andhra Pradesh,274,1,273,3432,3180,673,7.98,0,53.9,653845,5465,650273,5.9,1.25,0.0636734693877551,0.84,99.45
2022-03-03,Andhra Pradesh,61,0,59,820,2382,2070,7.44,2,53.9,653906,5465,650332,4.42,3.84,0.015213358070500928,0.84,99.45
2022-03-04,Andhra Pradesh,873,9,870,10848,1335,571,8.05,0,53.9,654779,5474,651202,2.48,1.06,0.20126159554730982,0.84,99.45
2022-03-05,Andhra Pradesh,1068,5,1065,13869,3016,2597,7.7,0,53.9,655847,5479,652267,5.6,4.82,0.25730983302411875,0.84,99.45
2022-03-06,Andhra Pradesh,241,1,235,3010,189,92,8.01,5,53.9,656088,5480,652502,0.35,0.17,0.05584415584415584,0.84,99.45
2022-03-07,Andhra Pradesh,1305,8,1305,16099,1514,119,8.11,0,53.9,657393,5488,653807,2.81,0.22,0.29868274582560295,0.83,99.45
2022-03-08,Andhra Pradesh,901,11,898,11352,3213,422,7.94,0,53.9,658294,5499,654705,5.96,0.78,0.21061224489795918,0.84,99.45
2022-03-09,Andhra Pradesh,1189,6,1188,14487,4729,588,8.21,0,53.9,659483,5505,655893,8.77,1.09,0.26877551020408164,0.83,99.46
2022-03-10,Andhra Pradesh,1060,3,1052,13220,2262,1277,8.02,5,53.9,660543,5508,656945,4.2,2.37,0.24526901669758813,0.83,99.46
2022-03-11,Andhra Pradesh,58,0,54,1083,2989,1921,5.36,4,53.9,660601,5508,656999,5.55,3.56,0.020092764378478664,0.83,99.45
2022-03-12,Andhra Pradesh,1614,5,1611,19996,2482,456,8.07,0,53.9,662215,5513,658610,4.6,0.85,0.3709833024118738,0.83,99.46
2022-03-13,Andhra Pradesh,1570,14,1564,19826,3225,2974,7.92,0,53.9,663785,5527,660174,5.98,5.52,0.36782931354359927,0.83,99.46
2022-03-14,Andhra Pradesh,1480,15,1476,18595,4925,3672,7.96,0,53.9,665265,5542,661650,9.14,6.81,0.34499072356215216,0.83,99.46
2022-03-15,Andhra Pradesh,1344,6,1335,16731,1359,676,8.03,3,53.9,666609,5548,662985,2.52,1.25,0.3104081632653061,0.83,99.46
2022-03-16,Andhra Pradesh,499,2,491,6795,222,0,7.34,6,53.9,667108,5550,663476,0.41,0.0,0.12606679035250465,0.83,99.46
2022-03-17,Andhra Pradesh,844,5,843,10484,2874,1305,8.05,0,53.9,667952,5555,664319,5.33,2.42,0.1945083487940631,0.83,99.46
2022-03-18,Andhra Pradesh,1403,9,1399,17758,1781,452,7.9,0,53.9,669355,5564,665718,3.3,0.84,0.32946196660482374,0.83,99.46
2022-03-19,Andhra Pradesh,726,4,721,8820,714,245,8.23,1,53.9,670081,5568,666439,1.32,0.45,0.16363636363636364,0.83,99.46
2022-03-20,Andhra Pradesh,155,1,148,2069,4425,1417,7.49,6,53.9,670236,5569,666587,8.21,2.63,0.03838589981447124,0.83,99.46
2022-03-21,Andhra Pradesh,234,1,226,3110,1173,718,7.52,7,53.9,670470,5570,666813,2.18,1.33,0.05769944341372913,0.83,99.45
2022-03-22,Andhra Pradesh,269,2,261,3212,145,29,8.37,6,53.9,670739,5572,667074,0.27,0.05,0.05959183673469388,0.83,99.45
2022-03-23,Andhra Pradesh,520,6,520,6940,535,342,7.49,0,53.9,671259,5578,667594,0.99,0.63,0.1287569573283859,0.83,99.45
2022-03-24,Andhra Pradesh,1025,5,1020,12542,1268,191,8.17,0,53.9,672284,5583,668614,2.35,0.35,0.23269016697588127,0.83,99.45
2022-03-25,Andhra Pradesh,949,5,946,12307,4187,400,7.71,0,53.9,673233,5588,669560,7.77,0.74,0.22833024118738404,0.83,99.45
2022-03-26,Andhra Pradesh,134,1,127,1917,244,211,6.99,6,53.9,673367,5589,669687,0.45,0.39,0.03556586270871985,0.83,99.45
2022-03-27,Andhra Pradesh,366,2,357,5007,2259,213,7.31,7,53.9,673733,5591,670044,4.19,0.4,0.09289424860853432,0.83,99.45
2022-03-28,Andhra Pradesh,1240,4,1232,15247,2061,245,8.13,4,53.9,674973,5595,671276,3.82,0.45,0.2828756957328386,0.83,99.45
2022-03-29,Andhra Pradesh,229,2,227,3082,469,98,7.43,0,53.9,675202,5597,671503,0.87,0.18,0.05717996289424861,0.83,99.45
2022-03-30,Andhra Pradesh,1273,15,1269,15782,2300,1179,8.07,0,53.9,676475,5612,672772,4.27,2.19,0.29280148423005564,0.83,99.45
2022-03-31,Andhra Pradesh,1081,10,1080,13720,3948,3690,7.88,0,53.9,677556,5622,673852,7.32,6.85,0.2545454545454545,0.83,99.45
2022-04-01,Andhra Pradesh,1100,4,1091,13448,3998,2216,8.18,5,53.9,678656,5626,674943,7.42,4.11,0.2494990723562152,0.83,99.45
2022-04-02,Andhra Pradesh,348,4,344,4623,925,467,7.53,0,53.9,679004,5630,675287,1.72,0.87,0.08576994434137292,0.83,99.45
2022-04-03,Andhra Pradesh,472,6,463,5398,1750,540,8.74,3,53.9,679476,5636,675750,3.25,1.0,0.10014842300556587,0.83,99.45
2022-04-04,Andhra Pradesh,307,1,303,4144,1855,40,7.41,3,53.9,679783,5637,676053,3.44,0.07,0.07688311688311689,0.83,99.45
2022-04-05,Andhra Pradesh,629,2,628,7979,3005,2345,7.88,0,53.9,680412,5639,676681,5.58,4.35,0.14803339517625233,0.83,99.45
2022-04-06,Andhra Pradesh,1383,9,1374,17211,3904,2110,8.04,0,53.9,681795,5648,678055,7.24,3.91,0.3193135435992579,0.83,99.45
2022-04-07,Andhra Pradesh,305,4,301,4331,1140,448,7.04,0,53.9,682100,5652,678356,2.12,0.83,0.08035250463821893,0.83,99.45
2022-04-08,Andhra Pradesh,1129,11,1120,14467,3040,2357,7.8,0,53.9,683229,5663,679476,5.64,4.37,0.268404452690167,0.83,99.45
2022-04-09,Andhra Pradesh,1534,7,1526,19108,2407,57,8.03,1,53.9,684763,5670,681002,4.47,0.11,0.35450834879406307,0.83,99.45
2022-04-10,Andhra Pradesh,400,3,391,4741,552,454,8.44,6,53.9,685163,5673,681393,1.02,0.84,0.08795918367346939,0.83,99.45
2022-04-11,Andhra Pradesh,203,0,203,2592,4407,4091,7.83,0,53.9,685366,5673,681596,8.18,7.59,0.04808905380333952,0.83,99.45
2022-04-12,Andhra Pradesh,893,12,891,10974,2475,917,8.14,0,53.9,686259,5685,682487,4.59,1.7,0.20359925788497216,0.83,99.45
2022-04-13,Andhra Pradesh,1118,8,1114,14127,2528,2006,7.91,0,53.9,687377,5693,683601,4.69,3.72,0.2620964749536178,0.83,99.45
2022-04-14,Andhra Pradesh,215,0,209,2868,4419,647,7.5,6,53.9,687592,5693,683810,8.2,1.2,0.05320964749536178,0.83,99.45
2022-04-15,Andhra Pradesh,919,7,913,11738,207,87,7.83,0,53.9,688511,5700,684723,0.38,0.16,0.21777365491651207,0.83,99.45
2022-04-16,Andhra Pradesh,879,2,879,10867,4376,2847,8.09,0,53.9,689390,5702,685602,8.12,5.28,0.20161410018552875,0.83,99.45
2022-04-17,Andhra Pradesh,408,3,402,4677,3511,364,8.72,3,53.9,689798,5705,686004,6.51,0.68,0.08677179962894249,0.83,99.45
2022-04-18,Andhra Pradesh,131,1,128,1264,3828,1395,10.36,2,53.9,689929,5706,686132,7.1,2.59,0.02345083487940631,0.83,99.45
2022-04-19,Andhra Pradesh,1011,11,1003,12477,791,329,8.1,0,53.9,690940,5717,687135,1.47,0.61,0.23148423005565863,0.83,99.45
2022-04-20,Andhra Pradesh,754,3,748,9173,3230,1008,8.22,3,53.9,691694,5720,687883,5.99,1.87,0.17018552875695733,0.83,99.45
2022-04-21,Andhra Pradesh,444,3,435,5236,3424,954,8.48,6,53.9,692138,5723,688318,6.35,1.77,0.09714285714285714,0.83,99.45
2022-04-22,Andhra Pradesh,1378,6,1375,17216,4910,4419,8.0,0,53.9,693516,5729,689693,9.11,8.2,0.31940630797773656,0.83,99.45
2022-04-23,Andhra Pradesh,990,5,986,12340,2900,86,8.02,0,53.9,694506,5734,690679,5.38,0.16,0.22894248608534323,0.83,99.45
2022-04-24,Andhra Pradesh,258,1,257,3416,1470,1205,7.55,0,53.9,694764,5735,690936,2.73,2.24,0.06337662337662338,0.83,99.45
2022-04-25,Andhra Pradesh,932,5,924,11287,435,191,8.26,3,53.9,695696,5740,691860,0.81,0.35,0.20940630797773654,0.83,99.45
2022-04-26,Andhra Pradesh,73,0,72,554,1024,452,13.18,1,53.9,695769,5740,691932,1.9,0.84,0.010278293135435993,0.82,99.45
2022-04-27,Andhra Pradesh,807,3,806,10127,4273,4190,7.97,0,53.9,696576,5743,692738,7.93,7.77,0.18788497217068645,0.82,99.45
2022-04-28,Andhra Pradesh,1086,11,1086,13651,2933,2266,7.96,0,53.9,697662,5754,693824,5.44,4.2,0.25326530612244896,0.82,99.45
2022-04-29,Andhra Pradesh,864,9,855,11335,1095,286,7.62,0,53.9,698526,5763,694679,2.03,0.53,0.21029684601113172,0.83,99.45
2022-04-30,Andhra Pradesh,1500,17,1491,18600,1271,284,8.06,0,53.9,700026,5780,696170,2.36,0.53,0.3450834879406308,0.83,99.45
2022-05-01,Andhra Pradesh,870,5,867,10669,105,14,8.15,0,53.9,700896,5785,697037,0.19,0.03,0.19794063079777366,0.83,99.45
2022-05-02,Andhra Pradesh,1426,13,1419,17404,1204,1004,8.19,0,53.9,702322,5798,698456,2.23,1.86,0.32289424860853433,0.83,99.45
2022-05-03,Andhra Pradesh,455,6,449,5169,56,34,8.8,0,53.9,702777,5804,698905,0.1,0.06,0.09589981447124304,0.83,99.45
2022-05-04,Andhra Pradesh,1371,13,1362,17215,4769,3074,7.96,0,53.9,704148,5817,700267,8.85,5.7,0.3193877551020408,0.83,99.45
2022-05-05,Andhra Pradesh,683,2,679,8648,4718,352,7.9,2,53.9,704831,5819,700946,8.75,0.65,0.1604452690166976,0.83,99.45
2022-05-06,Andhra Pradesh,1032,15,1029,12801,2858,2607,8.06,0,53.9,705863,5834,701975,5.3,4.84,0.23749536178107605,0.83,99.45
2022-05-07,Andhra Pradesh,1247,12,1243,15581,1218,581,8.0,0,53.9,707110,5846,703218,2.26,1.08,0.2890723562152134,0.83,99.45
2022-05-08,Andhra Pradesh,936,8,932,11686,3577,1163,8.01,0,53.9,708046,5854,704150,6.64,2.16,0.21680890538033395,0.83,99.45
2022-05-09,Andhra Pradesh,384,1,375,5148,2266,978,7.46,8,53.9,708430,5855,704525,4.2,1.81,0.09551020408163265,0.83,99.45
2022-05-10,Andhra Pradesh,1367,12,1367,17119,657,637,7.99,0,53.9,709797,5867,705892,1.22,1.18,0.31760667903525047,0.83,99.45
2022-05-11,Andhra Pradesh,902,9,898,11631,445,227,7.76,0,53.9,710699,5876,706790,0.83,0.42,0.21578849721706864,0.83,99.45
2022-05-12,Andhra Pradesh,1364,6,1361,17204,3383,2153,7.93,0,53.9,712063,5882,708151,6.28,3.99,0.31918367346938775,0.83,99.45
2022-05-13,Andhra Pradesh,1361,14,1358,17150,4171,785,7.94,0,53.9,713424,5896,709509,7.74,1.46,0.3181818181818182,0.83,99.45
2022-05-14,Andhra Pradesh,659,8,651,8103,4887,703,8.13,0,53.9,714083,5904,710160,9.07,1.3,0.1503339517625232,0.83,99.45
2022-05-15,Andhra Pradesh,479,1,471,5808,1023,958,8.25,7,53.9,714562,5905,710631,1.9,1.78,0.10775510204081633,0.83,99.45
2022-05-16,Andhra Pradesh,434,3,432,5003,608,10,8.67,0,53.9,714996,5908,711063,1.13,0.02,0.09282003710575139,0.83,99.45
2022-05-17,Andhra Pradesh,718,6,710,8883,1054,18,8.08,2,53.9,715714,5914,711773,1.96,0.03,0.16480519480519482,0.83,99.45
2022-05-18,Andhra Pradesh,973,5,966,12144,3985,3248,8.01,2,53.9,716687,5919,712739,7.39,6.03,0.2253061224489796,0.83,99.45
2022-05-19,Andhra Pradesh,1281,6,1273,16021,1781,1565,8.0,2,53.9,717968,5925,714012,3.3,2.9,0.2972356215213358,0.83,99.45
2022-05-20,Andhra Pradesh,554,6,553,6921,2630,825,8.0,0,53.9,718522,5931,714565,4.88,1.53,0.12840445269016698,0.83,99.45
2022-05-21,Andhra Pradesh,1225,7,1220,14877,514,119,8.23,0,53.9,719747,5938,715785,0.95,0.22,0.2760111317254174,0.83,99.45
2022-05-22,Andhra Pradesh,719,9,715,9148,3059,2255,7.86,0,53.9,720466,5947,716500,5.68,4.18,0.169721706864564,0.83,99.45
2022-05-23,Andhra Pradesh,962,12,960,11946,4145,503,8.05,0,53.9,721428,5959,717460,7.69,0.93,0.22163265306122448,0.83,99.45
2022-05-24,Andhra Pradesh,243,3,238,3223,38,4,7.54,2,53.9,721671,5962,717698,0.07,0.01,0.05979591836734694,0.83,99.45
2022-05-25,Andhra Pradesh,353,2,349,4640,1126,1088,7.61,2,53.9,722024,5964,718047,2.09,2.02,0.08608534322820037,0.83,99.45
2022-05-26,Andhra Pradesh,827,6,819,10129,2667,1447,8.16,2,53.9,722851,5970,718866,4.95,2.68,0.18792207792207793,0.83,99.45
2022-05-27,Andhra Pradesh,806,11,798,10181,4500,635,7.92,0,53.9,723657,5981,719664,8.35,1.18,0.18888682745825602,0.83,99.45
2022-05-28,Andhra Pradesh,529,3,528,6903,1744,237,7.66,0,53.9,724186,5984,720192,3.24,0.44,0.12807050092764377,0.83,99.45
2022-05-29,Andhra Pradesh,68,0,60,715,4216,1732,9.51,8,53.9,724254,5984,720252,7.82,3.21,0.013265306122448979,0.83,99.45
2022-05-30,Andhra Pradesh,1115,12,1108,14017,4159,103,7.95,0,53.9,725369,5996,721360,7.72,0.19,0.2600556586270872,0.83,99.45
2022-05-31,Andhra Pradesh,1539,11,1535,19210,290,13,8.01,0,53.9,726908,6007,722895,0.54,0.02,0.3564007421150278,0.83,99.45
2022-06-01,Andhra Pradesh,686,5,680,8794,4615,1013,7.8,1,53.9,727594,6012,723575,8.56,1.88,0.1631539888682746,0.83,99.45
2022-06-02,Andhra Pradesh,975,13,969,12391,2918,2265,7.87,0,53.9,728569,6025,724544,5.41,4.2,0.2298886827458256,0.83,99.45
2022-06-03,Andhra Pradesh,1212,17,1205,15221,1339,435,7.96,0,53.9,729781,6042,725749,2.48,0.81,0.28239332096474956,0.83,99.45
2022-06-04,Andhra Pradesh,1135,5,1130,13797,4332,1269,8.23,0,53.9,730916,6047,726879,8.04,2.35,0.25597402597402596,0.83,99.45
2022-06-05,Andhra Pradesh,533,7,532,7173,3899,3229,7.43,0,53.9,731449,6054,727411,7.23,5.99,0.13307977736549165,0.83,99.45
2022-06-06,Andhra Pradesh,1372,9,1370,16950,1511,1301,8.09,0,53.9,732821,6063,728781,2.8,2.41,0.3144712430426716,0.83,99.45
2022-06-07,Andhra Pradesh,1051,4,1044,13321,4391,458,7.89,3,53.9,733872,6067,729825,8.15,0.85,0.24714285714285714,0.83,99.45
2022-06-08,Andhra Pradesh,1139,12,1131,13613,4042,1248,8.37,0,53.9,735011,6079,730956,7.5,2.32,0.2525602968460111,0.83,99.45
2022-06-09,Andhra Pradesh,53,0,51,672,4467,3196,7.89,2,53.9,735064,6079,731007,8.29,5.93,0.012467532467532468,0.83,99.45
2022-06-10,Andhra Pradesh,1228,12,1223,15324,2392,604,8.01,0,53.9,736292,6091,732230,4.44,1.12,0.28430426716141,0.83,99.45
2022-06-11,Andhra Pradesh,1334,11,1329,16863,942,397,7.91,0,53.9,737626,6102,733559,1.75,0.74,0.31285714285714283,0.83,99.45
2022-06-12,Andhra Pradesh,1524,6,1517,18897,1074,83,8.06,1,53.9,739150,6108,735076,1.99,0.15,0.3505936920222634,0.83,99.45
2022-06-13,Andhra Pradesh,1036,5,1035,13358,807,728,7.76,0,53.9,740186,6113,736111,1.5,1.35,0.24782931354359924,0.83,99.45
2022-06-14,Andhra Pradesh,188,0,185,2583,4221,1440,7.28,3,53.9,740374,6113,736296,7.83,2.67,0.04792207792207792,0.83,99.45
2022-06-15,Andhra Pradesh,1432,8,1424,17674,1316,63,8.1,0,53.9,741806,6121,737720,2.44,0.12,0.3279035250463822,0.83,99.45
2022-06-16,Andhra Pradesh,101,0,98,801,1362,697,12.61,3,53.9,741907,6121,737818,2.53,1.29,0.014860853432282004,0.83,99.45
2022-06-17,Andhra Pradesh,824,10,815,10313,2697,581,7.99,0,53.9,742731,6131,738633,5.0,1.08,0.19133580705009276,0.83,99.45
2022-06-18,Andhra Pradesh,298,1,297,3876,667,22,7.69,0,53.9,743029,6132,738930,1.24,0.04,0.07191094619666048,0.83,99.45
2022-06-19,Andhra Pradesh,1484,9,1479,18544,864,233,8.0,0,53.9,744513,6141,740409,1.6,0.43,0.34404452690166976,0.82,99.45
2022-06-20,Andhra Pradesh,101,1,92,1424,3529,1114,7.09,8,53.9,744614,6142,740501,6.55,2.07,0.02641929499072356,0.82,99.45
2022-06-21,Andhra Pradesh,892,12,884,11266,2266,1607,7.92,0,53.9,745506,6154,741385,4.2,2.98,0.20901669758812616,0.83,99.45
2022-06-22,Andhra Pradesh,1604,9,1603,19383,2176,1269,8.28,0,53.9,747110,6163,742988,4.04,2.35,0.3596103896103896,0.82,99.45
2022-06-23,Andhra Pradesh,498,6,493,5954,4091,875,8.36,0,53.9,747608,6169,743481,7.59,1.62,0.11046382189239332,0.83,99.45
2022-06-24,Andhra Pradesh,962,5,959,12089,525,81,7.96,0,53.9,748570,6174,744440,0.97,0.15,0.22428571428571428,0.82,99.45
2022-06-25,Andhra Pradesh,869,7,867,11108,1803,814,7.82,0,53.9,749439,6181,745307,3.35,1.51,0.20608534322820038,0.82,99.45
2022-06-26,Andhra Pradesh,816,8,807,10462,4604,3250,7.8,1,53.9,750255,6189,746114,8.54,6.03,0.19410018552875696,0.82,99.45
2022-06-27,Andhra Pradesh,796,11,791,10037,1368,798,7.93,0,53.9,751051,6200,746905,2.54,1.48,0.1862152133580705,0.83,99.45
2022-06-28,Andhra Pradesh,1284,8,1283,16075,1409,200,7.99,0,53.9,752335,6208,748188,2.61,0.37,0.2982374768089054,0.83,99.45
2022-06-29,Andhra Pradesh,900,3,899,11020,3108,2495,8.17,0,53.9,753235,6211,749087,5.77,4.63,0.20445269016697587,0.82,99.45
2022-06-30,Andhra Pradesh,582,7,576,7407,998,656,7.86,0,53.9,753817,6218,749663,1.85,1.22,0.13742115027829313,0.82,99.45
2022-07-01,Andhra Pradesh,971,3,971,11984,4230,2518,8.1,0,53.9,754788,6221,750634,7.85,4.67,0.22233766233766233,0.82,99.45
2022-07-02,Andhra Pradesh,302,1,301,4200,338,237,7.19,0,53.9,755090,6222,750935,0.63,0.44,0.07792207792207792,0.82,99.45
2022-07-03,Andhra Pradesh,1007,3,1006,12395,3087,2237,8.12,0,53.9,756097,6225,751941,5.73,4.15,0.22996289424860852,0.82,99.45
2022-07-04,Andhra Pradesh,1446,4,1439,18046,3118,1647,8.01,3,53.9,757543,6229,753380,5.78,3.06,0.33480519480519483,0.82,99.45
2022-07-05,Andhra Pradesh,424,2,419,5481,4472,2210,7.74,3,53.9,757967,6231,753799,8.3,4.1,0.10168831168831169,0.82,99.45
2022-07-06,Andhra Pradesh,1451,11,1442,18338,886,233,7.91,0,53.9,759418,6242,755241,1.64,0.43,0.3402226345083488,0.82,99.45
2022-07-07,Andhra Pradesh,1117,15,1110,14291,4972,4057,7.82,0,53.9,760535,6257,756351,9.22,7.53,0.265139146567718,0.82,99.45
2022-07-08,Andhra Pradesh,521,4,517,6573,1177,320,7.93,0,53.9,761056,6261,756868,2.18,0.59,0.12194805194805194,0.82,99.45
2022-07-09,Andhra Pradesh,186,0,185,2246,558,464,8.28,1,53.9,761242,6261,757053,1.04,0.86,0.041669758812615955,0.82,99.45
2022-07-10,Andhra Pradesh,831,11,827,10125,3836,248,8.21,0,53.9,762073,6272,757880,7.12,0.46,0.187847866419295,0.82,99.45
2022-07-11,Andhra Pradesh,1073,8,1071,13453,4136,1376,7.98,0,53.9,763146,6280,758951,7.67,2.55,0.24959183673469387,0.82,99.45
2022-07-12,Andhra Pradesh,1542,21,1538,19209,3183,264,8.03,0,53.9,764688,6301,760489,5.91,0.49,0.35638218923933207,0.82,99.45
2022-07-13,Andhra Pradesh,782,8,776,9820,2506,1190,7.96,0,53.9,765470,6309,761265,4.65,2.21,0.18218923933209646,0.82,99.45
2022-07-14,Andhra Pradesh,1257,3,1251,15646,1774,340,8.03,3,53.9,766727,6312,762516,3.29,0.63,0.290278293135436,0.82,99.45
2022-07-15,Andhra Pradesh,567,7,565,6970,4651,1213,8.13,0,53.9,767294,6319,763081,8.63,2.25,0.1293135435992579,0.82,99.45
2022-07-16,Andhra Pradesh,354,4,354,4689,4152,1203,7.55,0,53.9,767648,6323,763435,7.7,2.23,0.08699443413729128,0.82,99.45
2022-07-17,Andhra Pradesh,213,1,205,2536,660,566,8.4,7,53.9,767861,6324,763640,1.22,1.05,0.04705009276437848,0.82,99.45
2022-07-18,Andhra Pradesh,1553,22,1549,19559,3776,55,7.94,0,53.9,769414,6346,765189,7.01,0.1,0.36287569573283857,0.82,99.45
2022-07-19,Andhra Pradesh,1585,20,1579,19981,3015,1168,7.93,0,53.9,770999,6366,766768,5.59,2.17,0.37070500927643785,0.83,99.45
2022-07-20,Andhra Pradesh,309,1,308,4014,269,97,7.7,0,53.9,771308,6367,767076,0.5,0.18,0.07447124304267161,0.83,99.45
2022-07-21,Andhra Pradesh,1472,17,1469,18226,2901,2246,8.08,0,53.9,772780,6384,768545,5.38,4.17,0.3381447124304267,0.83,99.45
2022-07-22,Andhra Pradesh,232,1,224,2688,1469,1243,8.63,7,53.9,773012,6385,768769,2.73,2.31,0.04987012987012987,0.83,99.45
2022-07-23,Andhra Pradesh,944,10,944,11767,4952,3617,8.02,0,53.9,773956,6395,769713,9.19,6.71,0.21831168831168832,0.83,99.45
2022-07-24,Andhra Pradesh,550,3,549,6900,533,185,7.97,0,53.9,774506,6398,770262,0.99,0.34,0.1280148423005566,0.83,99.45
2022-07-25,Andhra Pradesh,339,2,333,4590,1032,646,7.39,4,53.9,774845,6400,770595,1.91,1.2,0.08515769944341373,0.83,99.45
2022-07-26,Andhra Pradesh,292,1,286,3520,4734,2433,8.3,5,53.9,775137,6401,770881,8.78,4.51,0.0653061224489796,0.83,99.45
2022-07-27,Andhra Pradesh,442,6,436,5860,4103,929,7.54,0,53.9,775579,6407,771317,7.61,1.72,0.10871985157699443,0.83,99.45
2022-07-28,Andhra Pradesh,383,3,378,4972,3784,1705,7.7,2,53.9,775962,6410,771695,7.02,3.16,0.09224489795918367,0.83,99.45
2022-07-29,Andhra Pradesh,263,2,254,3139,295,19,8.38,7,53.9,776225,6412,771949,0.55,0.04,0.058237476808905383,0.83,99.45
2022-07-30,Andhra Pradesh,577,5,575,7341,256,172,7.86,0,53.9,776802,6417,772524,0.47,0.32,0.13619666048237478,0.83,99.45
2022-07-31,Andhra Pradesh,679,5,670,8994,3443,2493,7.55,4,53.9,777481,6422,773194,6.39,4.63,0.16686456400742114,0.83,99.45
2022-08-01,Andhra Pradesh,1407,16,1401,17499,4007,1220,8.04,0,53.9,778888,6438,774595,7.43,2.26,0.32465677179962893,0.83,99.45
2022-08-02,Andhra Pradesh,573,5,566,7005,3115,2469,8.18,2,53.9,779461,6443,775161,5.78,4.58,0.12996289424860855,0.83,99.45
2022-08-03,Andhra Pradesh,1439,18,1433,18179,1441,783,7.92,0,53.9,780900,6461,776594,2.67,1.45,0.3372727272727273,0.83,99.45
2022-08-04,Andhra Pradesh,699,6,699,8482,2668,342,8.24,0,53.9,781599,6467,777293,4.95,0.63,0.15736549165120595,0.83,99.45
2022-08-05,Andhra Pradesh,1264,8,1262,15623,2126,1387,8.09,0,53.9,782863,6475,778555,3.94,2.57,0.28985157699443415,0.83,99.45
2022-08-06,Andhra Pradesh,990,8,984,12357,4848,4454,8.01,0,53.9,783853,6483,779539,8.99,8.26,0.2292578849721707,0.83,99.45
2022-08-07,Andhra Pradesh,1263,15,1255,16015,1057,818,7.89,0,53.9,785116,6498,780794,1.96,1.52,0.2971243042671614,0.83,99.45
2022-08-08,Andhra Pradesh,582,6,578,7441,1683,334,7.82,0,53.9,785698,6504,781372,3.12,0.62,0.13805194805194806,0.83,99.45
2022-08-09,Andhra Pradesh,622,4,621,7854,440,138,7.92,0,53.9,786320,6508,781993,0.82,0.26,0.1457142857142857,0.83,99.45
2022-08-10,Andhra Pradesh,1187,6,1184,14857,3681,179,7.99,0,53.9,787507,6514,783177,6.83,0.33,0.2756400742115028,0.83,99.45
2022-08-11,Andhra Pradesh,1318,13,1309,16641,1677,1293,7.92,0,53.9,788825,6527,784486,3.11,2.4,0.3087384044526902,0.83,99.45
2022-08-12,Andhra Pradesh,518,1,515,5709,1025,693,9.07,2,53.9,789343,6528,785001,1.9,1.29,0.10591836734693877,0.83,99.45
2022-08-13,Andhra Pradesh,453,2,447,5546,2081,1318,8.17,4,53.9,789796,6530,785448,3.86,2.45,0.10289424860853433,0.83,99.45
2022-08-14,Andhra Pradesh,1510,8,1502,18919,100,3,7.98,0,53.9,791306,6538,786950,0.19,0.01,0.35100185528756955,0.83,99.45
2022-08-15,Andhra Pradesh,684,9,679,8439,2140,717,8.11,0,53.9,791990,6547,787629,3.97,1.33,0.15656771799628943,0.83,99.45
2022-08-16,Andhra Pradesh,1126,11,1119,14216,2746,1596,7.92,0,53.9,793116,6558,788748,5.09,2.96,0.263747680890538,0.83,99.45
2022-08-17,Andhra Pradesh,355,3,350,4780,1373,1042,7.43,2,53.9,793471,6561,789098,2.55,1.93,0.08868274582560297,0.83,99.45
2022-08-18,Andhra Pradesh,1580,11,1580,19482,3927,2642,8.11,0,53.9,795051,6572,790678,7.29,4.9,0.3614471243042672,0.83,99.45
2022-08-19,Andhra Pradesh,1028,11,1021,12804,184,70,8.03,0,53.9,796079,6583,791699,0.34,0.13,0.23755102040816325,0.83,99.45
2022-08-20,Andhra Pradesh,1017,7,1008,12709,4668,3796,8.0,2,53.9,797096,6590,792707,8.66,7.04,0.23578849721706865,0.83,99.45
2022-08-21,Andhra Pradesh,1082,11,1081,13645,831,347,7.93,0,53.9,798178,6601,793788,1.54,0.64,0.25315398886827456,0.83,99.45
2022-08-22,Andhra Pradesh,1302,9,1296,16238,3161,533,8.02,0,53.9,799480,6610,795084,5.86,0.99,0.30126159554730986,0.83,99.45
2022-08-23,Andhra Pradesh,416,5,408,5143,3464,2473,8.09,3,53.9,799896,6615,795492,6.43,4.59,0.09541743970315399,0.83,99.45
2022-08-24,Andhra Pradesh,1217,11,1217,15007,1086,418,8.11,0,53.9,801113,6626,796709,2.01,0.78,0.2784230055658627,0.83,99.45
2022-08-25,Andhra Pradesh,473,5,470,5679,3528,3061,8.33,0,53.9,801586,6631,797179,6.55,5.68,0.1053617810760668,0.83,99.45
2022-08-26,Andhra Pradesh,641,2,632,8094,3933,2358,7.92,7,53.9,802227,6633,797811,7.3,4.37,0.1501669758812616,0.83,99.45
2022-08-27,Andhra Pradesh,1541,16,1532,19479,4186,3292,7.91,0,53.9,803768,6649,799343,7.77,6.11,0.36139146567717995,0.83,99.45
2022-08-28,Andhra Pradesh,1138,15,1136,14327,4191,2663,7.94,0,53.9,804906,6664,800479,7.78,4.94,0.2658070500927644,0.83,99.45
2022-08-29,Andhra Pradesh,884,5,876,10775,732,608,8.2,3,53.9,805790,6669,801355,1.36,1.13,0.19990723562152132,0.83,99.45
2022-08-30,Andhra Pradesh,143,1,136,2188,1278,269,6.54,6,53.9,805933,6670,801491,2.37,0.5,0.04059369202226345,0.83,99.45
2022-08-31,Andhra Pradesh,214,2,214,2740,4297,846,7.81,0,53.9,806147,6672,801705,7.97,1.57,0.05083487940630798,0.83,99.45
2022-09-01,Andhra Pradesh,1590,21,1583,19453,2387,1987,8.17,0,53.9,807737,6693,803288,4.43,3.69,0.3609090909090909,0.83,99.45
2022-09-02,Andhra Pradesh,1410,8,1406,17474,1809,296,8.07,0,53.9,809147,6701,804694,3.36,0.55,0.32419294990723563,0.83,99.45
2022-09-03,Andhra Pradesh,733,4,727,9120,4808,454,8.04,2,53.9,809880,6705,805421,8.92,0.84,0.1692022263450835,0.83,99.45
2022-09-04,Andhra Pradesh,1540,10,1535,19115,201,92,8.06,0,53.9,811420,6715,806956,0.37,0.17,0.3546382189239332,0.83,99.45
2022-09-05,Andhra Pradesh,1371,4,1369,17063,297,6,8.03,0,53.9,812791,6719,808325,0.55,0.01,0.3165677179962894,0.83,99.45
2022-09-06,Andhra Pradesh,861,6,861,11261,1977,1882,7.65,0,53.9,813652,6725,809186,3.67,3.49,0.2089239332096475,0.83,99.45
2022-09-07,Andhra Pradesh,1159,4,1152,13966,1660,1216,8.3,3,53.9,814811,6729,810338,3.08,2.26,0.25910946196660484,0.83,99.45
2022-09-08,Andhra Pradesh,1401,20,1397,17673,3562,2769,7.93,0,53.9,816212,6749,811735,6.61,5.14,0.32788497217068646,0.83,99.45
2022-09-09,Andhra Pradesh,1278,5,1273,16007,4595,112,7.98,0,53.9,817490,6754,813008,8.53,0.21,0.2969758812615955,0.83,99.45
2022-09-10,Andhra Pradesh,233,1,231,2742,3544,1177,8.5,1,53.9,817723,6755,813239,6.58,2.18,0.050871985157699445,0.83,99.45
2022-09-11,Andhra Pradesh,553,2,548,6882,3724,2349,8.04,3,53.9,818276,6757,813787,6.91,4.36,0.1276808905380334,0.83,99.45
2022-09-12,Andhra Pradesh,867,12,865,10831,468,266,8.0,0,53.9,819143,6769,814652,0.87,0.49,0.20094619666048238,0.83,99.45
2022-09-13,Andhra Pradesh,1087,3,1085,13942,265,53,7.8,0,53.9,820230,6772,815737,0.49,0.1,0.2586641929499072,0.83,99.45
2022-09-14,Andhra Pradesh,805,11,804,10464,1074,943,7.69,0,53.9,821035,6783,816541,1.99,1.75,0.19413729128014842,0.83,99.45
2022-09-15,Andhra Pradesh,1143,10,1137,14705,2251,1081,7.77,0,53.9,822178,6793,817678,4.18,2.01,0.27282003710575137,0.83,99.45
2022-09-16,Andhra Pradesh,775,11,770,9734,2893,2146,7.96,0,53.9,822953,6804,818448,5.37,3.98,0.18059369202226344,0.83,99.45
2022-09-17,Andhra Pradesh,468,5,462,6309,74,2,7.42,1,53.9,823421,6809,818910,0.14,0.0,0.11705009276437849,0.83,99.45
2022-09-18,Andhra Pradesh,999,14,999,12077,423,383,8.27,0,53.9,824420,6823,819909,0.78,0.71,0.2240630797773655,0.83,99.45
2022-09-19,Andhra Pradesh,606,5,606,7990,525,209,7.58,0,53.9,825026,6828,820515,0.97,0.39,0.1482374768089054,0.83,99.45
2022-09-20,Andhra Pradesh,1402,8,1394,17280,889,761,8.11,0,53.9,826428,6836,821909,1.65,1.41,0.32059369202226345,0.83,99.45
2022-09-21,Andhra Pradesh,123,1,123,1221,3794,2117,10.07,0,53.9,826551,6837,822032,7.04,3.93,0.022653061224489797,0.83,99.45
2022-09-22,Andhra Pradesh,1357,9,1350,16759,1360,613,8.1,0,53.9,827908,6846,823382,2.52,1.14,0.31092764378478666,0.83,99.45
2022-09-23,Andhra Pradesh,629,6,627,7946,2565,1460,7.92,0,53.9,828537,6852,824009,4.76,2.71,0.14742115027829314,0.83,99.45
2022-09-24,Andhra Pradesh,1382,8,1377,17418,1973,1176,7.93,0,53.9,829919,6860,825386,3.66,2.18,0.32315398886827457,0.83,99.45
2022-09-25,Andhra Pradesh,746,3,742,9725,2105,880,7.67,1,53.9,830665,6863,826128,3.91,1.63,0.18042671614100186,0.83,99.45
2022-09-26,Andhra Pradesh,1415,12,1414,17762,3694,215,7.97,0,53.9,832080,6875,827542,6.85,0.4,0.32953617810760666,0.83,99.45
2022-09-27,Andhra Pradesh,1319,11,1315,16568,2578,1380,7.96,0,53.9,833399,6886,828857,4.78,2.56,0.30738404452690166,0.83,99.46
2022-09-28,Andhra Pradesh,805,6,801,10050,1155,746,8.01,0,53.9,834204,6892,829658,2.14,1.38,0.18645640074211503,0.83,99.46
2022-09-29,Andhra Pradesh,1014,9,1012,13082,3901,348,7.75,0,53.9,835218,6901,830670,7.24,0.65,0.242708719851577,0.83,99.46
2022-09-30,Andhra Pradesh,1111,16,1105,14007,1504,580,7.93,0,53.9,836329,6917,831775,2.79,1.08,0.25987012987012986,0.83,99.46
2022-10-01,Andhra Pradesh,872,3,863,10808,3097,1824,8.07,6,53.9,837201,6920,832638,5.75,3.38,0.20051948051948051,0.83,99.45
2022-10-02,Andhra Pradesh,1233,14,1227,15402,3514,700,8.01,0,53.9,838434,6934,833865,6.52,1.3,0.2857513914656772,0.83,99.46
2022-10-03,Andhra Pradesh,636,9,633,8428,406,217,7.55,0,53.9,839070,6943,834498,0.75,0.4,0.15636363636363637,0.83,99.46
2022-10-04,Andhra Pradesh,530,3,522,6812,2347,1135,7.78,5,53.9,839600,6946,835020,4.35,2.11,0.1263821892393321,0.83,99.45
2022-10-05,Andhra Pradesh,539,4,537,6849,2376,2368,7.87,0,53.9,840139,6950,835557,4.41,4.39,0.12706864564007422,0.83,99.45
2022-10-06,Andhra Pradesh,954,14,954,12365,618,449,7.72,0,53.9,841093,6964,836511,1.15,0.83,0.22940630797773656,0.83,99.46
2022-10-07,Andhra Pradesh,1053,13,1048,12759,1548,271,8.25,0,53.9,842146,6977,837559,2.87,0.5,0.23671614100185528,0.83,99.46
2022-10-08,Andhra Pradesh,839,8,832,10536,4435,4362,7.96,0,53.9,842985,6985,838391,8.23,8.09,0.19547309833024118,0.83,99.46
2022-10-09,Andhra Pradesh,340,1,336,4245,1120,1113,8.01,3,53.9,843325,6986,838727,2.08,2.06,0.0787569573283859,0.83,99.45
2022-10-10,Andhra Pradesh,1026,13,1024,13028,4597,655,7.88,0,53.9,844351,6999,839751,8.53,1.22,0.24170686456400742,0.83,99.46
2022-10-11,Andhra Pradesh,1145,15,1139,14441,1926,1901,7.93,0,53.9,845496,7014,840890,3.57,3.53,0.2679220779220779,0.83,99.46
2022-10-12,Andhra Pradesh,1448,16,1443,18213,3757,644,7.95,0,53.9,846944,7030,842333,6.97,1.19,0.3379035250463822,0.83,99.46
2022-10-13,Andhra Pradesh,170,2,167,2010,4721,3621,8.46,1,53.9,847114,7032,842500,8.76,6.72,0.037291280148423006,0.83,99.46
2022-10-14,Andhra Pradesh,329,1,325,4207,2179,184,7.82,3,53.9,847443,7033,842825,4.04,0.34,0.07805194805194805,0.83,99.46
2022-10-15,Andhra Pradesh,775,3,769,9570,75,47,8.1,3,53.9,848218,7036,843594,0.14,0.09,0.17755102040816326,0.83,99.45
2022-10-16,Andhra Pradesh,569,6,562,6965,2200,174,8.17,1,53.9,848787,7042,844156,4.08,0.32,0.1292207792207792,0.83,99.45
2022-10-17,Andhra Pradesh,1430,12,1430,17692,2833,2641,8.08,0,53.9,850217,7054,845586,5.26,4.9,0.32823747680890536,0.83,99.46
2022-10-18,Andhra Pradesh,430,5,425,5320,4201,1342,8.08,0,53.9,850647,7059,846011,7.79,2.49,0.0987012987012987,0.83,99.46
2022-10-19,Andhra Pradesh,703,4,698,9014,3699,1509,7.8,1,53.9,851350,7063,846709,6.86,2.8,0.1672356215213358,0.83,99.45
2022-10-20,Andhra Pradesh,979,3,978,12193,1625,807,8.03,0,53.9,852329,7066,847687,3.01,1.5,0.2262152133580705,0.83,99.46
2022-10-21,Andhra Pradesh,652,6,651,8219,840,276,7.93,0,53.9,852981,7072,848338,1.56,0.51,0.1524860853432282,0.83,99.46
2022-10-22,Andhra Pradesh,352,3,349,3620,1691,1105,9.72,0,53.9,853333,7075,848687,3.14,2.05,0.06716141001855287,0.83,99.46
2022-10-23,Andhra Pradesh,389,2,385,4183,18,9,9.3,2,53.9,853722,7077,849072,0.03,0.02,0.07760667903525047,0.83,99.46
2022-10-24,Andhra Pradesh,1369,13,1360,17521,2903,2691,7.81,0,53.9,855091,7090,850432,5.39,4.99,0.32506493506493506,0.83,99.46
2022-10-25,Andhra Pradesh,665,6,664,8593,4206,706,7.74,0,53.9,855756,7096,851096,7.8,1.31,0.15942486085343227,0.83,99.46
2022-10-26,Andhra Pradesh,399,5,395,4954,4048,1635,8.05,0,53.9,856155,7101,851491,7.51,3.03,0.09191094619666049,0.83,99.46
2022-10-27,Andhra Pradesh,639,8,639,7740,2522,2349,8.26,0,53.9,856794,7109,852130,4.68,4.36,0.14359925788497216,0.83,99.46
2022-10-28,Andhra Pradesh,752,10,749,9398,4441,4256,8.0,0,53.9,857546,7119,852879,8.24,7.9,0.1743599257884972,0.83,99.46
2022-10-29,Andhra Pradesh,726,9,720,9107,309,216,7.97,0,53.9,858272,7128,853599,0.57,0.4,0.16896103896103895,0.83,99.46
2022-10-30,Andhra Pradesh,471,4,467,5723,2090,1742,8.23,0,53.9,858743,7132,854066,3.88,3.23,0.10617810760667903,0.83,99.46
2022-10-31,Andhra Pradesh,259,1,256,3489,299,189,7.42,2,53.9,859002,7133,854322,0.55,0.35,0.06473098330241188,0.83,99.46
2022-11-01,Andhra Pradesh,1351,20,1351,16726,3523,2498,8.08,0,53.9,860353,7153,855673,6.54,4.63,0.31031539888682746,0.83,99.46
2022-11-02,Andhra Pradesh,968,11,968,12598,1809,30,7.68,0,53.9,861321,7164,856641,3.36,0.06,0.2337291280148423,0.83,99.46
2022-11-03,Andhra Pradesh,98,0,93,1507,1052,475,6.5,5,53.9,861419,7164,856734,1.95,0.88,0.027959183673469386,0.83,99.46
2022-11-04,Andhra Pradesh,248,3,241,2950,888,493,8.41,4,53.9,861667,7167,856975,1.65,0.91,0.05473098330241188,0.83,99.46
2022-11-05,Andhra Pradesh,833,6,832,10906,4889,2548,7.64,0,53.9,862500,7173,857807,9.07,4.73,0.20233766233766234,0.83,99.46
2022-11-06,Andhra Pradesh,933,2,932,12053,1955,922,7.74,0,53.9,863433,7175,858739,3.63,1.71,0.2236178107606679,0.83,99.46
2022-11-07,Andhra Pradesh,880,4,872,11072,117,94,7.95,4,53.9,864313,7179,859611,0.22,0.17,0.205417439703154,0.83,99.46
2022-11-08,Andhra Pradesh,239,1,238,2876,2976,2374,8.31,0,53.9,864552,7180,859849,5.52,4.4,0.05335807050092765,0.83,99.46
2022-11-09,Andhra Pradesh,759,2,751,9264,89,53,8.19,6,53.9,865311,7182,860600,0.17,0.1,0.17187384044526902,0.83,99.46
2022-11-10,Andhra Pradesh,1356,12,1348,16920,4148,3281,8.01,0,53.9,866667,7194,861948,7.7,6.09,0.31391465677179964,0.83,99.46
2022-11-11,Andhra Pradesh,1268,18,1260,15602,3261,2895,8.13,0,53.9,867935,7212,863208,6.05,5.37,0.28946196660482376,0.83,99.46
2022-11-12,Andhra Pradesh,602,2,601,7467,2354,365,8.06,0,53.9,868537,7214,863809,4.37,0.68,0.1385343228200371,0.83,99.46
2022-11-13,Andhra Pradesh,930,3,924,11762,2682,731,7.91,3,53.9,869467,7217,864733,4.98,1.36,0.21821892393320966,0.83,99.46
2022-11-14,Andhra Pradesh,1350,18,1348,16808,2236,1797,8.03,0,53.9,870817,7235,866081,4.15,3.33,0.31183673469387757,0.83,99.46
2022-11-15,Andhra Pradesh,328,4,320,4104,271,116,7.99,4,53.9,871145,7239,866401,0.5,0.22,0.07614100185528756,0.83,99.46
2022-11-16,Andhra Pradesh,1420,5,1411,18066,3093,555,7.86,4,53.9,872565,7244,867812,5.74,1.03,0.33517625231910947,0.83,99.46
2022-11-17,Andhra Pradesh,1586,5,1579,19616,3673,2214,8.09,2,53.9,874151,7249,869391,6.81,4.11,0.36393320964749537,0.83,99.46
2022-11-18,Andhra Pradesh,853,8,845,10896,357,290,7.83,0,53.9,875004,7257,870236,0.66,0.54,0.202152133580705,0.83,99.46
2022-11-19,Andhra Pradesh,1360,6,1360,17160,1253,621,7.93,0,53.9,876364,7263,871596,2.32,1.15,0.3183673469387755,0.83,99.46
2022-11-20,Andhra Pradesh,1581,16,1573,19086,115,17,8.28,0,53.9,877945,7279,873169,0.21,0.03,0.35410018552875694,0.83,99.46
2022-11-21,Andhra Pradesh,825,10,824,9990,2234,1210,8.26,0,53.9,878770,7289,873993,4.14,2.24,0.18534322820037105,0.83,99.46
2022-11-22,Andhra Pradesh,1278,18,1273,15986,64,44,7.99,0,53.9,880048,7307,875266,0.12,0.08,0.29658627087198514,0.83,99.46
2022-11-23,Andhra Pradesh,127,1,121,2074,1850,1205,6.12,5,53.9,880175,7308,875387,3.43,2.24,0.03847866419294991,0.83,99.46
2022-11-24,Andhra Pradesh,1619,11,1613,19970,150,121,8.11,0,53.9,881794,7319,877000,0.28,0.22,0.3705009276437848,0.83,99.46
2022-11-25,Andhra Pradesh,340,1,337,4256,2467,1781,7.99,2,53.9,882134,7320,877337,4.58,3.3,0.07896103896103897,0.83,99.46
2022-11-26,Andhra Pradesh,213,2,213,2677,3701,402,7.96,0,53.9,882347,7322,877550,6.87,0.75,0.049666048237476806,0.83,99.46
2022-11-27,Andhra Pradesh,648,3,647,8217,3467,1748,7.89,0,53.9,882995,7325,878197,6.43,3.24,0.15244897959183673,0.83,99.46
2022-11-28,Andhra Pradesh,1446,13,1441,18143,1470,1301,7.97,0,53.9,884441,7338,879638,2.73,2.41,0.3366048237476809,0.83,99.46
2022-11-29,Andhra Pradesh,491,3,484,6011,2975,2846,8.17,4,53.9,884932,7341,880122,5.52,5.28,0.11152133580705009,0.83,99.46
2022-11-30,Andhra Pradesh,880,9,878,11560,1391,595,7.61,0,53.9,885812,7350,881000,2.58,1.1,0.21447124304267162,0.83,99.46
2022-12-01,Andhra Pradesh,721,5,721,8876,2175,904,8.12,0,53.9,886533,7355,881721,4.04,1.68,0.16467532467532467,0.83,99.46
2022-12-02,Andhra Pradesh,564,4,563,7262,4434,3367,7.77,0,53.9,887097,7359,882284,8.23,6.25,0.13473098330241187,0.83,99.46
2022-12-03,Andhra Pradesh,1234,13,1232,15236,2587,2412,8.1,0,53.9,888331,7372,883516,4.8,4.47,0.28267161410018554,0.83,99.46
2022-12-04,Andhra Pradesh,879,12,876,10880,2086,903,8.08,0,53.9,889210,7384,884392,3.87,1.68,0.20185528756957327,0.83,99.46
2022-12-05,Andhra Pradesh,730,10,724,9005,3657,2216,8.11,0,53.9,889940,7394,885116,6.78,4.11,0.1670686456400742,0.83,99.46
2022-12-06,Andhra Pradesh,1221,17,1214,15235,230,212,8.01,0,53.9,891161,7411,886330,0.43,0.39,0.2826530612244898,0.83,99.46
2022-12-07,Andhra Pradesh,997,5,988,12512,2754,1803,7.97,4,53.9,892158,7416,887318,5.11,3.35,0.23213358070500928,0.83,99.46
2022-12-08,Andhra Pradesh,1488,5,1480,18366,1784,961,8.1,3,53.9,893646,7421,888798,3.31,1.78,0.3407421150278293,0.83,99.46
2022-12-09,Andhra Pradesh,1488,14,1485,18841,4826,3560,7.9,0,53.9,895134,7435,890283,8.95,6.6,0.3495547309833024,0.83,99.46
2022-12-10,Andhra Pradesh,1405,15,1398,17434,4578,1276,8.06,0,53.9,896539,7450,891681,8.49,2.37,0.3234508348794063,0.83,99.46
2022-12-11,Andhra Pradesh,1132,6,1130,14080,2404,1652,8.04,0,53.9,897671,7456,892811,4.46,3.06,0.2612244897959184,0.83,99.46
2022-12-12,Andhra Pradesh,914,10,910,11785,2473,2413,7.76,0,53.9,898585,7466,893721,4.59,4.48,0.2186456400742115,0.83,99.46
2022-12-13,Andhra Pradesh,93,0,92,1281,4006,938,7.26,1,53.9,898678,7466,893813,7.43,1.74,0.023766233766233765,0.83,99.46
2022-12-14,Andhra Pradesh,38,0,37,627,3896,1680,6.06,1,53.9,898716,7466,893850,7.23,3.12,0.01163265306122449,0.83,99.46
2022-12-15,Andhra Pradesh,98,0,94,1220,1689,776,8.03,4,53.9,898814,7466,893944,3.13,1.44,0.022634508348794064,0.83,99.46
2022-12-16,Andhra Pradesh,214,0,213,2363,2506,231,9.06,1,53.9,899028,7466,894157,4.65,0.43,0.043840445269016697,0.83,99.46
2022-12-17,Andhra Pradesh,319,3,319,4261,2749,1562,7.49,0,53.9,899347,7469,894476,5.1,2.9,0.07905380333951763,0.83,99.46
2022-12-18,Andhra Pradesh,267,2,265,3293,3004,1802,8.11,0,53.9,899614,7471,894741,5.57,3.34,0.06109461966604824,0.83,99.46
2022-12-19,Andhra Pradesh,1037,12,1030,12901,184,109,8.04,0,53.9,900651,7483,895771,0.34,0.2,0.23935064935064934,0.83,99.46
2022-12-20,Andhra Pradesh,1120,5,1119,14070,580,545,7.96,0,53.9,901771,7488,896890,1.08,1.01,0.261038961038961,0.83,99.46
2022-12-21,Andhra Pradesh,1448,9,1445,17776,3413,1684,8.15,0,53.9,903219,7497,898335,6.33,3.12,0.32979591836734695,0.83,99.46
2022-12-22,Andhra Pradesh,1264,10,1261,15852,2024,1955,7.97,0,53.9,904483,7507,899596,3.76,3.63,0.29410018552875694,0.83,99.46
2022-12-23,Andhra Pradesh,856,5,847,10385,633,516,8.24,4,53.9,905339,7512,900443,1.17,0.96,0.19267161410018552,0.83,99.46
2022-12-24,Andhra Pradesh,1413,18,1406,17551,410,181,8.05,0,53.9,906752,7530,901849,0.76,0.34,0.3256215213358071,0.83,99.46
2022-12-25,Andhra Pradesh,62,0,59,518,358,54,11.97,3,53.9,906814,7530,901908,0.66,0.1,0.00961038961038961,0.83,99.46
2022-12-26,Andhra Pradesh,464,5,455,6091,3168,674,7.62,4,53.9,907278,7535,902363,5.88,1.25,0.11300556586270873,0.83,99.46
2022-12-27,Andhra Pradesh,1370,19,1369,17043,474,442,8.04,0,53.9,908648,7554,903732,0.88,0.82,0.31619666048237477,0.83,99.46
2022-12-28,Andhra Pradesh,1349,12,1344,17228,60,24,7.83,0,53.9,909997,7566,905076,0.11,0.04,0.31962894248608537,0.83,99.46
2022-12-29,Andhra Pradesh,1465,12,1457,18120,4304,99,8.08,0,53.9,911462,7578,906533,7.99,0.18,0.33617810760667904,0.83,99.46
2022-12-30,Andhra Pradesh,1524,11,1522,18778,2807,1807,8.12,0,53.9,912986,7589,908055,5.21,3.35,0.34838589981447127,0.83,99.46
2022-12-31,Andhra Pradesh,1305,15,1297,16354,3863,1061,7.98,0,53.9,914291,7604,909352,7.17,1.97,0.30341372912801484,0.83,99.46
2020-01-01,Arunachal Pradesh,678,10,676,8448,4144,592,8.03,0,1.6,678,10,676,259.0,37.0,5.28,1.47,99.71
2020-01-02,Arunachal Pradesh,1107,3,1102,13988,3334,97,7.91,2,1.6,1785,13,1778,208.38,6.06,8.7425,0.73,99.61
2020-01-03,Arunachal Pradesh,374,3,366,4559,2155,1417,8.2,5,1.6,2159,16,2144,134.69,88.56,2.849375,0.74,99.31
2020-01-04,Arunachal Pradesh,521,7,515,6302,4418,144,8.27,0,1.6,2680,23,2659,276.12,9.0,3.93875,0.86,99.22
2020-01-05,Arunachal Pradesh,37,0,34,549,2348,2329,6.74,3,1.6,2717,23,2693,146.75,145.56,0.343125,0.85,99.12
2020-01-06,Arunachal Pradesh,643,6,636,7781,384,28,8.26,1,1.6,3360,29,3329,24.0,1.75,4.863125,0.86,99.08
2020-01-07,Arunachal Pradesh,944,11,937,11866,477,320,7.96,0,1.6,4304,40,4266,29.81,20.0,7.41625,0.93,99.12
2020-01-08,Arunachal Pradesh,1058,15,1050,12928,1303,653,8.18,0,1.6,5362,55,5316,81.44,40.81,8.08,1.03,99.14
2020-01-09,Arunachal Pradesh,605,3,596,7585,2306,15,7.98,6,1.6,5967,58,5912,144.12,0.94,4.740625,0.97,99.08
2020-01-10,Arunachal Pradesh,735,10,733,9508,1525,830,7.73,0,1.6,6702,68,6645,95.31,51.88,5.9425,1.01,99.15
2020-01-11,Arunachal Pradesh,1003,6,994,12399,1729,1195,8.09,3,1.6,7705,74,7639,108.06,74.69,7.749375,0.96,99.14
2020-01-12,Arunachal Pradesh,1118,9,1110,14018,2698,822,7.98,0,1.6,8823,83,8749,168.62,51.38,8.76125,0.94,99.16
2020-01-13,Arunachal Pradesh,1218,15,1216,14955,1698,1672,8.14,0,1.6,10041,98,9965,106.12,104.5,9.346875,0.98,99.24
2020-01-14,Arunachal Pradesh,1429,18,1426,17792,4459,3170,8.03,0,1.6,11470,116,11391,278.69,198.12,11.12,1.01,99.31
2020-01-15,Arunachal Pradesh,1028,4,1028,12909,3581,3321,7.96,0,1.6,12498,120,12419,223.81,207.56,8.068125,0.96,99.37
2020-01-16,Arunachal Pradesh,977,11,976,12328,877,8,7.93,0,1.6,13475,131,13395,54.81,0.5,7.705,0.97,99.41
2020-01-17,Arunachal Pradesh,636,6,635,7564,4532,2358,8.41,0,1.6,14111,137,14030,283.25,147.38,4.7275,0.97,99.43
2020-01-18,Arunachal Pradesh,1036,11,1031,12770,1683,1140,8.11,0,1.6,15147,148,15061,105.19,71.25,7.98125,0.98,99.43
2020-01-19,Arunachal Pradesh,1581,15,1575,19369,4340,65,8.16,0,1.6,16728,163,16636,271.25,4.06,12.105625,0.97,99.45
2020-01-20,Arunachal Pradesh,430,6,426,5634,3161,3013,7.63,0,1.6,17158,169,17062,197.56,188.31,3.52125,0.98,99.44
2020-01-21,Arunachal Pradesh,248,3,241,3266,3806,1925,7.59,4,1.6,17406,172,17303,237.88,120.31,2.04125,0.99,99.41
2020-01-22,Arunachal Pradesh,337,2,337,4312,1779,571,7.82,0,1.6,17743,174,17640,111.19,35.69,2.695,0.98,99.42
2020-01-23,Arunachal Pradesh,224,1,221,2856,2991,2609,7.84,2,1.6,17967,175,17861,186.94,163.06,1.785,0.97,99.41
2020-01-24,Arunachal Pradesh,1426,19,1424,17596,4510,1718,8.1,0,1.6,19393,194,19285,281.88,107.38,10.9975,1.0,99.44
2020-01-25,Arunachal Pradesh,339,1,334,4402,4042,2849,7.7,4,1.6,19732,195,19619,252.62,178.06,2.75125,0.99,99.43
2020-01-26,Arunachal Pradesh,323,2,318,3713,824,213,8.7,3,1.6,20055,197,19937,51.5,13.31,2.320625,0.98,99.41
2020-01-27,Arunachal Pradesh,1312,12,1312,16369,2401,2088,8.02,0,1.6,21367,209,21249,150.06,130.5,10.230625,0.98,99.45
2020-01-28,Arunachal Pradesh,115,0,109,1639,1192,345,7.02,6,1.6,21482,209,21358,74.5,21.56,1.024375,0.97,99.42
2020-01-29,Arunachal Pradesh,1116,5,1111,13732,183,40,8.13,0,1.6,22598,214,22469,11.44,2.5,8.5825,0.95,99.43
2020-01-30,Arunachal Pradesh,578,4,575,7179,3823,254,8.05,0,1.6,23176,218,23044,238.94,15.88,4.486875,0.94,99.43
2020-01-31,Arunachal Pradesh,1497,12,1489,18280,2844,29,8.19,0,1.6,24673,230,24533,177.75,1.81,11.425,0.93,99.43
2020-02-01,Arunachal Pradesh,62,0,62,1019,681,241,6.08,0,1.6,24735,230,24595,42.56,15.06,0.636875,0.93,99.43
2020-02-02,Arunachal Pradesh,1273,14,1265,15732,4998,782,8.09,0,1.6,26008,244,25860,312.38,48.88,9.8325,0.94,99.43
2020-02-03,Arunachal Pradesh,1226,11,1221,15304,743,89,8.01,0,1.6,27234,255,27081,46.44,5.56,9.565,0.94,99.44
2020-02-04,Arunachal Pradesh,426,2,424,5192,2562,2487,8.2,0,1.6,27660,257,27505,160.12,155.44,3.245,0.93,99.44
2020-02-05,Arunachal Pradesh,626,7,624,8084,102,61,7.74,0,1.6,28286,264,28129,6.38,3.81,5.0525,0.93,99.44
2020-02-06,Arunachal Pradesh,494,3,491,6465,2465,1092,7.64,0,1.6,28780,267,28620,154.06,68.25,4.040625,0.93,99.44
2020-02-07,Arunachal Pradesh,886,3,879,10757,3545,1737,8.24,4,1.6,29666,270,29499,221.56,108.56,6.723125,0.91,99.44
2020-02-08,Arunachal Pradesh,1575,8,1573,19925,3806,437,7.9,0,1.6,31241,278,31072,237.88,27.31,12.453125,0.89,99.46
2020-02-09,Arunachal Pradesh,124,1,121,1079,504,43,11.49,2,1.6,31365,279,31193,31.5,2.69,0.674375,0.89,99.45
2020-02-10,Arunachal Pradesh,915,6,909,11486,4307,1611,7.97,0,1.6,32280,285,32102,269.19,100.69,7.17875,0.88,99.45
2020-02-11,Arunachal Pradesh,1470,9,1463,18631,822,417,7.89,0,1.6,33750,294,33565,51.38,26.06,11.644375,0.87,99.45
2020-02-12,Arunachal Pradesh,666,7,665,8712,3374,1153,7.64,0,1.6,34416,301,34230,210.88,72.06,5.445,0.87,99.46
2020-02-13,Arunachal Pradesh,1454,16,1454,17911,1963,749,8.12,0,1.6,35870,317,35684,122.69,46.81,11.194375,0.88,99.48
2020-02-14,Arunachal Pradesh,698,4,698,8682,4013,1875,8.04,0,1.6,36568,321,36382,250.81,117.19,5.42625,0.88,99.49
2020-02-15,Arunachal Pradesh,531,2,522,6532,618,533,8.13,7,1.6,37099,323,36904,38.62,33.31,4.0825,0.87,99.47
2020-02-16,Arunachal Pradesh,317,3,312,4098,3110,1566,7.74,2,1.6,37416,326,37216,194.38,97.88,2.56125,0.87,99.47
2020-02-17,Arunachal Pradesh,660,9,660,8114,4486,501,8.13,0,1.6,38076,335,37876,280.38,31.31,5.07125,0.88,99.47
2020-02-18,Arunachal Pradesh,1223,17,1222,15496,1844,1094,7.89,0,1.6,39299,352,39098,115.25,68.38,9.685,0.9,99.49
2020-02-19,Arunachal Pradesh,987,5,979,12413,3143,961,7.95,3,1.6,40286,357,40077,196.44,60.06,7.758125,0.89,99.48
2020-02-20,Arunachal Pradesh,590,3,587,7135,3873,171,8.27,0,1.6,40876,360,40664,242.06,10.69,4.459375,0.88,99.48
2020-02-21,Arunachal Pradesh,772,7,766,9458,1395,191,8.16,0,1.6,41648,367,41430,87.19,11.94,5.91125,0.88,99.48
2020-02-22,Arunachal Pradesh,1356,19,1350,17268,74,59,7.85,0,1.6,43004,386,42780,4.62,3.69,10.7925,0.9,99.48
2020-02-23,Arunachal Pradesh,420,1,411,5632,1234,571,7.46,8,1.6,43424,387,43191,77.12,35.69,3.52,0.89,99.46
2020-02-24,Arunachal Pradesh,357,2,353,4521,3363,1337,7.9,2,1.6,43781,389,43544,210.19,83.56,2.825625,0.89,99.46
2020-02-25,Arunachal Pradesh,338,3,333,4267,3164,2494,7.92,2,1.6,44119,392,43877,197.75,155.88,2.666875,0.89,99.45
2020-02-26,Arunachal Pradesh,1324,13,1321,16517,3448,1698,8.02,0,1.6,45443,405,45198,215.5,106.12,10.323125,0.89,99.46
2020-02-27,Arunachal Pradesh,238,1,233,3054,2933,1420,7.79,4,1.6,45681,406,45431,183.31,88.75,1.90875,0.89,99.45
2020-02-28,Arunachal Pradesh,800,10,792,9960,757,600,8.03,0,1.6,46481,416,46223,47.31,37.5,6.225,0.89,99.44
2020-02-29,Arunachal Pradesh,1272,14,1270,15681,4647,230,8.11,0,1.6,47753,430,47493,290.44,14.37,9.800625,0.9,99.46
2020-03-01,Arunachal Pradesh,201,2,193,2457,262,8,8.18,6,1.6,47954,432,47686,16.38,0.5,1.535625,0.9,99.44
2020-03-02,Arunachal Pradesh,764,2,760,9656,4647,3181,7.91,2,1.6,48718,434,48446,290.44,198.81,6.035,0.89,99.44
2020-03-03,Arunachal Pradesh,1086,11,1077,13792,3668,1549,7.87,0,1.6,49804,445,49523,229.25,96.81,8.62,0.89,99.44
2020-03-04,Arunachal Pradesh,569,4,561,7288,4144,788,7.81,4,1.6,50373,449,50084,259.0,49.25,4.555,0.89,99.43
2020-03-05,Arunachal Pradesh,447,6,439,5336,1537,1377,8.38,2,1.6,50820,455,50523,96.06,86.06,3.335,0.9,99.42
2020-03-06,Arunachal Pradesh,220,2,217,2907,2444,21,7.57,1,1.6,51040,457,50740,152.75,1.31,1.816875,0.9,99.41
2020-03-07,Arunachal Pradesh,381,4,375,4873,3564,957,7.82,2,1.6,51421,461,51115,222.75,59.81,3.045625,0.9,99.4
2020-03-08,Arunachal Pradesh,1091,8,1086,13723,1222,1076,7.95,0,1.6,52512,469,52201,76.38,67.25,8.576875,0.89,99.41
2020-03-09,Arunachal Pradesh,138,1,137,2368,3144,1570,5.83,0,1.6,52650,470,52338,196.5,98.12,1.48,0.89,99.41
2020-03-10,Arunachal Pradesh,1598,16,1590,19801,3874,1983,8.07,0,1.6,54248,486,53928,242.12,123.94,12.375625,0.9,99.41
2020-03-11,Arunachal Pradesh,1258,10,1252,16265,180,72,7.73,0,1.6,55506,496,55180,11.25,4.5,10.165625,0.89,99.41
2020-03-12,Arunachal Pradesh,884,7,877,10750,875,443,8.22,0,1.6,56390,503,56057,54.69,27.69,6.71875,0.89,99.41
2020-03-13,Arunachal Pradesh,799,7,791,9837,76,36,8.12,1,1.6,57189,510,56848,4.75,2.25,6.148125,0.89,99.4
2020-03-14,Arunachal Pradesh,704,9,695,8634,1514,413,8.15,0,1.6,57893,519,57543,94.62,25.81,5.39625,0.9,99.4
2020-03-15,Arunachal Pradesh,1260,9,1253,15323,4155,456,8.22,0,1.6,59153,528,58796,259.69,28.5,9.576875,0.89,99.4
2020-03-16,Arunachal Pradesh,1406,12,1400,17536,2448,417,8.02,0,1.6,60559,540,60196,153.0,26.06,10.96,0.89,99.4
2020-03-17,Arunachal Pradesh,353,4,347,4419,1657,824,7.99,2,1.6,60912,544,60543,103.56,51.5,2.761875,0.89,99.39
2020-03-18,Arunachal Pradesh,876,4,871,11522,1054,207,7.6,1,1.6,61788,548,61414,65.88,12.94,7.20125,0.89,99.39
2020-03-19,Arunachal Pradesh,628,2,627,7769,32,11,8.08,0,1.6,62416,550,62041,2.0,0.69,4.855625,0.88,99.4
2020-03-20,Arunachal Pradesh,950,9,943,11524,1780,1718,8.24,0,1.6,63366,559,62984,111.25,107.38,7.2025,0.88,99.4
2020-03-21,Arunachal Pradesh,1134,6,1134,14369,4752,2678,7.89,0,1.6,64500,565,64118,297.0,167.38,8.980625,0.88,99.41
2020-03-22,Arunachal Pradesh,695,2,690,8638,1567,1241,8.05,3,1.6,65195,567,64808,97.94,77.56,5.39875,0.87,99.41
2020-03-23,Arunachal Pradesh,1387,12,1384,17620,446,85,7.87,0,1.6,66582,579,66192,27.88,5.31,11.0125,0.87,99.41
2020-03-24,Arunachal Pradesh,942,11,935,12316,3393,1990,7.65,0,1.6,67524,590,67127,212.06,124.37,7.6975,0.87,99.41
2020-03-25,Arunachal Pradesh,881,12,879,11054,1871,512,7.97,0,1.6,68405,602,68006,116.94,32.0,6.90875,0.88,99.42
2020-03-26,Arunachal Pradesh,1405,7,1396,16967,1311,810,8.28,2,1.6,69810,609,69402,81.94,50.62,10.604375,0.87,99.42
2020-03-27,Arunachal Pradesh,273,0,267,3247,2777,2512,8.41,6,1.6,70083,609,69669,173.56,157.0,2.029375,0.87,99.41
2020-03-28,Arunachal Pradesh,903,7,900,11046,1526,1268,8.17,0,1.6,70986,616,70569,95.38,79.25,6.90375,0.87,99.41
2020-03-29,Arunachal Pradesh,225,1,220,3073,2409,1904,7.32,4,1.6,71211,617,70789,150.56,119.0,1.920625,0.87,99.41
2020-03-30,Arunachal Pradesh,1584,11,1578,19555,3299,3076,8.1,0,1.6,72795,628,72367,206.19,192.25,12.221875,0.86,99.41
2020-03-31,Arunachal Pradesh,731,2,731,8616,237,14,8.48,0,1.6,73526,630,73098,14.81,0.88,5.385,0.86,99.42
2020-04-01,Arunachal Pradesh,906,10,903,11448,2369,273,7.91,0,1.6,74432,640,74001,148.06,17.06,7.155,0.86,99.42
2020-04-02,Arunachal Pradesh,81,1,75,1256,311,196,6.45,5,1.6,74513,641,74076,19.44,12.25,0.785,0.86,99.41
2020-04-03,Arunachal Pradesh,1562,22,1557,19599,2548,222,7.97,0,1.6,76075,663,75633,159.25,13.88,12.249375,0.87,99.42
2020-04-04,Arunachal Pradesh,502,6,502,6314,4756,2058,7.95,0,1.6,76577,669,76135,297.25,128.62,3.94625,0.87,99.42
2020-04-05,Arunachal Pradesh,1318,6,1316,16268,3591,374,8.1,0,1.6,77895,675,77451,224.44,23.38,10.1675,0.87,99.43
2020-04-06,Arunachal Pradesh,1437,10,1431,17790,3868,3053,8.08,0,1.6,79332,685,78882,241.75,190.81,11.11875,0.86,99.43
2020-04-07,Arunachal Pradesh,255,1,250,3407,2007,1623,7.48,4,1.6,79587,686,79132,125.44,101.44,2.129375,0.86,99.43
2020-04-08,Arunachal Pradesh,517,6,514,6391,263,168,8.09,0,1.6,80104,692,79646,16.44,10.5,3.994375,0.86,99.43
2020-04-09,Arunachal Pradesh,952,12,946,11862,1870,1761,8.03,0,1.6,81056,704,80592,116.88,110.06,7.41375,0.87,99.43
2020-04-10,Arunachal Pradesh,1566,9,1565,19242,396,261,8.14,0,1.6,82622,713,82157,24.75,16.31,12.02625,0.86,99.44
2020-04-11,Arunachal Pradesh,468,2,462,6000,501,485,7.8,4,1.6,83090,715,82619,31.31,30.31,3.75,0.86,99.43
2020-04-12,Arunachal Pradesh,1094,4,1086,13627,303,239,8.03,4,1.6,84184,719,83705,18.94,14.94,8.516875,0.85,99.43
2020-04-13,Arunachal Pradesh,800,11,795,9730,2252,1206,8.22,0,1.6,84984,730,84500,140.75,75.38,6.08125,0.86,99.43
2020-04-14,Arunachal Pradesh,1055,6,1053,13089,4956,3271,8.06,0,1.6,86039,736,85553,309.75,204.44,8.180625,0.86,99.44
2020-04-15,Arunachal Pradesh,381,1,374,4794,3591,1323,7.95,6,1.6,86420,737,85927,224.44,82.69,2.99625,0.85,99.43
2020-04-16,Arunachal Pradesh,614,2,607,7245,2646,452,8.47,5,1.6,87034,739,86534,165.38,28.25,4.528125,0.85,99.43
2020-04-17,Arunachal Pradesh,1145,10,1141,14443,265,255,7.93,0,1.6,88179,749,87675,16.56,15.94,9.026875,0.85,99.43
2020-04-18,Arunachal Pradesh,1380,15,1372,17005,1375,784,8.12,0,1.6,89559,764,89047,85.94,49.0,10.628125,0.85,99.43
2020-04-19,Arunachal Pradesh,700,3,697,8655,529,213,8.09,0,1.6,90259,767,89744,33.06,13.31,5.409375,0.85,99.43
2020-04-20,Arunachal Pradesh,1599,15,1590,19919,184,152,8.03,0,1.6,91858,782,91334,11.5,9.5,12.449375,0.85,99.43
2020-04-21,Arunachal Pradesh,1003,10,1003,12351,401,148,8.12,0,1.6,92861,792,92337,25.06,9.25,7.719375,0.85,99.44
2020-04-22,Arunachal Pradesh,681,8,677,8349,2772,923,8.16,0,1.6,93542,800,93014,173.25,57.69,5.218125,0.86,99.44
2020-04-23,Arunachal Pradesh,1589,22,1587,19902,3645,899,7.98,0,1.6,95131,822,94601,227.81,56.19,12.43875,0.86,99.44
2020-04-24,Arunachal Pradesh,76,1,70,1276,4274,4223,5.96,5,1.6,95207,823,94671,267.12,263.94,0.7975,0.86,99.44
2020-04-25,Arunachal Pradesh,68,0,64,1323,1543,599,5.14,4,1.6,95275,823,94735,96.44,37.44,0.826875,0.86,99.43
2020-04-26,Arunachal Pradesh,1399,7,1391,17622,731,170,7.94,1,1.6,96674,830,96126,45.69,10.62,11.01375,0.86,99.43
2020-04-27,Arunachal Pradesh,384,4,376,4833,4910,3214,7.95,4,1.6,97058,834,96502,306.88,200.88,3.020625,0.86,99.43
2020-04-28,Arunachal Pradesh,355,2,350,4567,4847,1535,7.77,3,1.6,97413,836,96852,302.94,95.94,2.854375,0.86,99.42
2020-04-29,Arunachal Pradesh,453,1,444,5540,724,649,8.18,8,1.6,97866,837,97296,45.25,40.56,3.4625,0.86,99.42
2020-04-30,Arunachal Pradesh,105,0,102,785,1491,1099,13.38,3,1.6,97971,837,97398,93.19,68.69,0.490625,0.85,99.42
2020-05-01,Arunachal Pradesh,932,8,931,11422,2958,438,8.16,0,1.6,98903,845,98329,184.88,27.38,7.13875,0.85,99.42
2020-05-02,Arunachal Pradesh,1495,19,1489,18505,4056,1925,8.08,0,1.6,100398,864,99818,253.5,120.31,11.565625,0.86,99.42
2020-05-03,Arunachal Pradesh,1087,13,1086,13731,4927,1039,7.92,0,1.6,101485,877,100904,307.94,64.94,8.581875,0.86,99.43
2020-05-04,Arunachal Pradesh,426,3,423,5613,3964,2925,7.59,0,1.6,101911,880,101327,247.75,182.81,3.508125,0.86,99.43
2020-05-05,Arunachal Pradesh,1531,10,1530,18908,4927,3512,8.1,0,1.6,103442,890,102857,307.94,219.5,11.8175,0.86,99.43
2020-05-06,Arunachal Pradesh,1066,13,1064,13655,419,319,7.81,0,1.6,104508,903,103921,26.19,19.94,8.534375,0.86,99.44
2020-05-07,Arunachal Pradesh,1468,17,1460,18435,1859,487,7.96,0,1.6,105976,920,105381,116.19,30.44,11.521875,0.87,99.44
2020-05-08,Arunachal Pradesh,1418,17,1410,17819,4565,2116,7.96,0,1.6,107394,937,106791,285.31,132.25,11.136875,0.87,99.44
2020-05-09,Arunachal Pradesh,249,2,245,3467,4680,1170,7.18,2,1.6,107643,939,107036,292.5,73.12,2.166875,0.87,99.44
2020-05-10,Arunachal Pradesh,166,2,159,2201,4693,1880,7.54,5,1.6,107809,941,107195,293.31,117.5,1.375625,0.87,99.43
2020-05-11,Arunachal Pradesh,610,3,603,7768,717,473,7.85,4,1.6,108419,944,107798,44.81,29.56,4.855,0.87,99.43
2020-05-12,Arunachal Pradesh,563,5,558,6686,1578,347,8.42,0,1.6,108982,949,108356,98.62,21.69,4.17875,0.87,99.43
2020-05-13,Arunachal Pradesh,1182,12,1178,14400,768,690,8.21,0,1.6,110164,961,109534,48.0,43.12,9.0,0.87,99.43
2020-05-14,Arunachal Pradesh,281,1,275,3132,2238,203,8.97,5,1.6,110445,962,109809,139.88,12.69,1.9575,0.87,99.42
2020-05-15,Arunachal Pradesh,1397,10,1388,17339,118,14,8.06,0,1.6,111842,972,111197,7.38,0.88,10.836875,0.87,99.42
2020-05-16,Arunachal Pradesh,829,9,825,10590,1486,561,7.83,0,1.6,112671,981,112022,92.88,35.06,6.61875,0.87,99.42
2020-05-17,Arunachal Pradesh,702,10,695,8480,4883,4016,8.28,0,1.6,113373,991,112717,305.19,251.0,5.3,0.87,99.42
2020-05-18,Arunachal Pradesh,1115,6,1111,14124,2245,58,7.89,0,1.6,114488,997,113828,140.31,3.62,8.8275,0.87,99.42
2020-05-19,Arunachal Pradesh,1224,17,1224,15687,313,57,7.8,0,1.6,115712,1014,115052,19.56,3.56,9.804375,0.88,99.43
2020-05-20,Arunachal Pradesh,903,3,896,11568,1397,80,7.81,4,1.6,116615,1017,115948,87.31,5.0,7.23,0.87,99.43
2020-05-21,Arunachal Pradesh,346,1,339,4451,499,10,7.77,6,1.6,116961,1018,116287,31.19,0.62,2.781875,0.87,99.42
2020-05-22,Arunachal Pradesh,912,9,910,11873,1136,102,7.68,0,1.6,117873,1027,117197,71.0,6.38,7.420625,0.87,99.43
2020-05-23,Arunachal Pradesh,964,9,961,11884,705,539,8.11,0,1.6,118837,1036,118158,44.06,33.69,7.4275,0.87,99.43
2020-05-24,Arunachal Pradesh,303,3,294,4017,2044,1498,7.54,6,1.6,119140,1039,118452,127.75,93.62,2.510625,0.87,99.42
2020-05-25,Arunachal Pradesh,755,9,750,9510,2586,709,7.94,0,1.6,119895,1048,119202,161.62,44.31,5.94375,0.87,99.42
2020-05-26,Arunachal Pradesh,746,2,743,9692,2317,2156,7.7,1,1.6,120641,1050,119945,144.81,134.75,6.0575,0.87,99.42
2020-05-27,Arunachal Pradesh,1502,4,1500,18467,1425,63,8.13,0,1.6,122143,1054,121445,89.06,3.94,11.541875,0.86,99.43
2020-05-28,Arunachal Pradesh,1364,10,1358,16960,1820,1368,8.04,0,1.6,123507,1064,122803,113.75,85.5,10.6,0.86,99.43
2020-05-29,Arunachal Pradesh,1115,13,1114,13818,812,265,8.07,0,1.6,124622,1077,123917,50.75,16.56,8.63625,0.86,99.43
2020-05-30,Arunachal Pradesh,1447,12,1445,17841,3120,2091,8.11,0,1.6,126069,1089,125362,195.0,130.69,11.150625,0.86,99.44
2020-05-31,Arunachal Pradesh,1554,4,1550,19300,4764,3579,8.05,0,1.6,127623,1093,126912,297.75,223.69,12.0625,0.86,99.44
2020-06-01,Arunachal Pradesh,115,1,113,1673,3981,20,6.87,1,1.6,127738,1094,127025,248.81,1.25,1.045625,0.86,99.44
2020-06-02,Arunachal Pradesh,415,5,409,5039,4960,3677,8.24,1,1.6,128153,1099,127434,310.0,229.81,3.149375,0.86,99.44
2020-06-03,Arunachal Pradesh,951,6,944,11598,3158,497,8.2,1,1.6,129104,1105,128378,197.38,31.06,7.24875,0.86,99.44
2020-06-04,Arunachal Pradesh,173,0,169,2114,2142,852,8.18,4,1.6,129277,1105,128547,133.88,53.25,1.32125,0.85,99.44
2020-06-05,Arunachal Pradesh,1066,10,1061,13236,2738,338,8.05,0,1.6,130343,1115,129608,171.12,21.12,8.2725,0.86,99.44
2020-06-06,Arunachal Pradesh,304,1,302,3923,2713,1110,7.75,1,1.6,130647,1116,129910,169.56,69.38,2.451875,0.85,99.44
2020-06-07,Arunachal Pradesh,1178,10,1169,14716,566,43,8.0,0,1.6,131825,1126,131079,35.38,2.69,9.1975,0.85,99.43
2020-06-08,Arunachal Pradesh,238,1,235,3187,2450,1141,7.47,2,1.6,132063,1127,131314,153.12,71.31,1.991875,0.85,99.43
2020-06-09,Arunachal Pradesh,1417,7,1412,17985,431,350,7.88,0,1.6,133480,1134,132726,26.94,21.88,11.240625,0.85,99.44
2020-06-10,Arunachal Pradesh,58,0,57,582,506,72,9.97,1,1.6,133538,1134,132783,31.62,4.5,0.36375,0.85,99.43
2020-06-11,Arunachal Pradesh,942,2,942,11434,4549,1125,8.24,0,1.6,134480,1136,133725,284.31,70.31,7.14625,0.84,99.44
2020-06-12,Arunachal Pradesh,453,3,451,5681,1648,412,7.97,0,1.6,134933,1139,134176,103.0,25.75,3.550625,0.84,99.44
2020-06-13,Arunachal Pradesh,1151,5,1148,13925,3707,1540,8.27,0,1.6,136084,1144,135324,231.69,96.25,8.703125,0.84,99.44
2020-06-14,Arunachal Pradesh,617,3,610,8009,4932,3892,7.7,4,1.6,136701,1147,135934,308.25,243.25,5.005625,0.84,99.44
2020-06-15,Arunachal Pradesh,844,3,843,10542,4593,3435,8.01,0,1.6,137545,1150,136777,287.06,214.69,6.58875,0.84,99.44
2020-06-16,Arunachal Pradesh,577,2,571,7196,1396,981,8.02,4,1.6,138122,1152,137348,87.25,61.31,4.4975,0.83,99.44
2020-06-17,Arunachal Pradesh,1050,9,1049,13395,609,159,7.84,0,1.6,139172,1161,138397,38.06,9.94,8.371875,0.83,99.44
2020-06-18,Arunachal Pradesh,194,2,190,2135,3859,2202,9.09,2,1.6,139366,1163,138587,241.19,137.62,1.334375,0.83,99.44
2020-06-19,Arunachal Pradesh,1076,11,1069,13271,1304,1126,8.11,0,1.6,140442,1174,139656,81.5,70.38,8.294375,0.84,99.44
2020-06-20,Arunachal Pradesh,1503,20,1496,19264,250,146,7.8,0,1.6,141945,1194,141152,15.62,9.12,12.04,0.84,99.44
2020-06-21,Arunachal Pradesh,1514,10,1505,19322,318,174,7.84,0,1.6,143459,1204,142657,19.88,10.88,12.07625,0.84,99.44
2020-06-22,Arunachal Pradesh,1242,4,1233,15704,827,264,7.91,5,1.6,144701,1208,143890,51.69,16.5,9.815,0.83,99.44
2020-06-23,Arunachal Pradesh,1550,10,1547,19036,307,138,8.14,0,1.6,146251,1218,145437,19.19,8.62,11.8975,0.83,99.44
2020-06-24,Arunachal Pradesh,453,1,447,5440,3271,1769,8.33,5,1.6,146704,1219,145884,204.44,110.56,3.4,0.83,99.44
2020-06-25,Arunachal Pradesh,1568,10,1562,19598,4211,3028,8.0,0,1.6,148272,1229,147446,263.19,189.25,12.24875,0.83,99.44
2020-06-26,Arunachal Pradesh,828,7,819,10510,2263,1807,7.88,2,1.6,149100,1236,148265,141.44,112.94,6.56875,0.83,99.44
2020-06-27,Arunachal Pradesh,204,2,201,2087,1824,320,9.77,1,1.6,149304,1238,148466,114.0,20.0,1.304375,0.83,99.44
2020-06-28,Arunachal Pradesh,1417,5,1411,17572,1958,1655,8.06,1,1.6,150721,1243,149877,122.37,103.44,10.9825,0.82,99.44
2020-06-29,Arunachal Pradesh,559,8,557,6686,640,219,8.36,0,1.6,151280,1251,150434,40.0,13.69,4.17875,0.83,99.44
2020-06-30,Arunachal Pradesh,924,13,916,11473,3128,2742,8.05,0,1.6,152204,1264,151350,195.5,171.38,7.170625,0.83,99.44
2020-07-01,Arunachal Pradesh,1309,5,1309,16822,4662,3248,7.78,0,1.6,153513,1269,152659,291.38,203.0,10.51375,0.83,99.44
2020-07-02,Arunachal Pradesh,1165,7,1163,14786,2113,271,7.88,0,1.6,154678,1276,153822,132.06,16.94,9.24125,0.82,99.45
2020-07-03,Arunachal Pradesh,1463,5,1463,18432,2889,617,7.94,0,1.6,156141,1281,155285,180.56,38.56,11.52,0.82,99.45
2020-07-04,Arunachal Pradesh,1045,10,1044,13108,4161,2422,7.97,0,1.6,157186,1291,156329,260.06,151.38,8.1925,0.82,99.45
2020-07-05,Arunachal Pradesh,1323,9,1317,16727,4536,2353,7.91,0,1.6,158509,1300,157646,283.5,147.06,10.454375,0.82,99.46
2020-07-06,Arunachal Pradesh,181,1,180,2213,4069,594,8.18,0,1.6,158690,1301,157826,254.31,37.12,1.383125,0.82,99.46
2020-07-07,Arunachal Pradesh,753,8,753,9217,2530,573,8.17,0,1.6,159443,1309,158579,158.12,35.81,5.760625,0.82,99.46
2020-07-08,Arunachal Pradesh,494,3,493,6645,4120,438,7.43,0,1.6,159937,1312,159072,257.5,27.38,4.153125,0.82,99.46
2020-07-09,Arunachal Pradesh,622,2,617,8148,444,150,7.63,3,1.6,160559,1314,159689,27.75,9.38,5.0925,0.82,99.46
2020-07-10,Arunachal Pradesh,615,8,614,7679,1509,933,8.01,0,1.6,161174,1322,160303,94.31,58.31,4.799375,0.82,99.46
2020-07-11,Arunachal Pradesh,1141,12,1139,14166,629,420,8.05,0,1.6,162315,1334,161442,39.31,26.25,8.85375,0.82,99.46
2020-07-12,Arunachal Pradesh,1433,17,1430,17916,2844,347,8.0,0,1.6,163748,1351,162872,177.75,21.69,11.1975,0.83,99.47
2020-07-13,Arunachal Pradesh,395,5,394,4794,132,96,8.24,0,1.6,164143,1356,163266,8.25,6.0,2.99625,0.83,99.47
2020-07-14,Arunachal Pradesh,1143,16,1139,14261,1019,45,8.01,0,1.6,165286,1372,164405,63.69,2.81,8.913125,0.83,99.47
2020-07-15,Arunachal Pradesh,106,1,105,1425,3383,3085,7.44,0,1.6,165392,1373,164510,211.44,192.81,0.890625,0.83,99.47
2020-07-16,Arunachal Pradesh,657,6,652,8668,3170,3047,7.58,0,1.6,166049,1379,165162,198.12,190.44,5.4175,0.83,99.47
2020-07-17,Arunachal Pradesh,1438,5,1433,17991,1058,757,7.99,0,1.6,167487,1384,166595,66.12,47.31,11.244375,0.83,99.47
2020-07-18,Arunachal Pradesh,1241,8,1234,15462,2863,2462,8.03,0,1.6,168728,1392,167829,178.94,153.88,9.66375,0.82,99.47
2020-07-19,Arunachal Pradesh,1065,12,1060,13197,4374,1392,8.07,0,1.6,169793,1404,168889,273.38,87.0,8.248125,0.83,99.47
2020-07-20,Arunachal Pradesh,1562,21,1556,19702,1309,504,7.93,0,1.6,171355,1425,170445,81.81,31.5,12.31375,0.83,99.47
2020-07-21,Arunachal Pradesh,192,0,190,2405,1098,772,7.98,2,1.6,171547,1425,170635,68.62,48.25,1.503125,0.83,99.47
2020-07-22,Arunachal Pradesh,717,5,715,8922,4894,3267,8.04,0,1.6,172264,1430,171350,305.88,204.19,5.57625,0.83,99.47
2020-07-23,Arunachal Pradesh,604,8,596,7299,4307,469,8.28,0,1.6,172868,1438,171946,269.19,29.31,4.561875,0.83,99.47
2020-07-24,Arunachal Pradesh,1495,10,1489,18729,4595,859,7.98,0,1.6,174363,1448,173435,287.19,53.69,11.705625,0.83,99.47
2020-07-25,Arunachal Pradesh,914,5,912,11607,4974,1456,7.87,0,1.6,175277,1453,174347,310.88,91.0,7.254375,0.83,99.47
2020-07-26,Arunachal Pradesh,570,5,563,7055,4344,3339,8.08,2,1.6,175847,1458,174910,271.5,208.69,4.409375,0.83,99.47
2020-07-27,Arunachal Pradesh,296,1,293,3802,1318,35,7.79,2,1.6,176143,1459,175203,82.38,2.19,2.37625,0.83,99.47
2020-07-28,Arunachal Pradesh,944,7,935,11850,1539,121,7.97,2,1.6,177087,1466,176138,96.19,7.56,7.40625,0.83,99.46
2020-07-29,Arunachal Pradesh,1295,16,1292,16063,2959,1533,8.06,0,1.6,178382,1482,177430,184.94,95.81,10.039375,0.83,99.47
2020-07-30,Arunachal Pradesh,817,4,811,10323,2706,936,7.91,2,1.6,179199,1486,178241,169.12,58.5,6.451875,0.83,99.47
2020-07-31,Arunachal Pradesh,1085,9,1083,13562,4368,2913,8.0,0,1.6,180284,1495,179324,273.0,182.06,8.47625,0.83,99.47
2020-08-01,Arunachal Pradesh,585,2,582,7632,2214,1434,7.67,1,1.6,180869,1497,179906,138.38,89.62,4.77,0.83,99.47
2020-08-02,Arunachal Pradesh,761,9,758,9472,1252,919,8.03,0,1.6,181630,1506,180664,78.25,57.44,5.92,0.83,99.47
2020-08-03,Arunachal Pradesh,353,1,348,4188,801,598,8.43,4,1.6,181983,1507,181012,50.06,37.38,2.6175,0.83,99.47
2020-08-04,Arunachal Pradesh,1084,12,1084,13532,2485,1856,8.01,0,1.6,183067,1519,182096,155.31,116.0,8.4575,0.83,99.47
2020-08-05,Arunachal Pradesh,1492,7,1486,18892,3323,1187,7.9,0,1.6,184559,1526,183582,207.69,74.19,11.8075,0.83,99.47
2020-08-06,Arunachal Pradesh,376,4,372,4764,3468,1332,7.89,0,1.6,184935,1530,183954,216.75,83.25,2.9775,0.83,99.47
2020-08-07,Arunachal Pradesh,122,1,121,1384,287,160,8.82,0,1.6,185057,1531,184075,17.94,10.0,0.865,0.83,99.47
2020-08-08,Arunachal Pradesh,904,11,897,11365,1400,1365,7.95,0,1.6,185961,1542,184972,87.5,85.31,7.103125,0.83,99.47
2020-08-09,Arunachal Pradesh,769,10,767,9583,4116,484,8.02,0,1.6,186730,1552,185739,257.25,30.25,5.989375,0.83,99.47
2020-08-10,Arunachal Pradesh,778,10,769,9947,1231,386,7.82,0,1.6,187508,1562,186508,76.94,24.12,6.216875,0.83,99.47
2020-08-11,Arunachal Pradesh,1379,14,1370,17483,158,151,7.89,0,1.6,188887,1576,187878,9.88,9.44,10.926875,0.83,99.47
2020-08-12,Arunachal Pradesh,446,4,445,5206,99,52,8.57,0,1.6,189333,1580,188323,6.19,3.25,3.25375,0.83,99.47
2020-08-13,Arunachal Pradesh,736,5,735,9515,3520,1196,7.74,0,1.6,190069,1585,189058,220.0,74.75,5.946875,0.83,99.47
2020-08-14,Arunachal Pradesh,439,1,439,5451,3747,232,8.05,0,1.6,190508,1586,189497,234.19,14.5,3.406875,0.83,99.47
2020-08-15,Arunachal Pradesh,1477,4,1468,18253,4200,2953,8.09,5,1.6,191985,1590,190965,262.5,184.56,11.408125,0.83,99.47
2020-08-16,Arunachal Pradesh,135,1,129,1567,4811,1719,8.62,5,1.6,192120,1591,191094,300.69,107.44,0.979375,0.83,99.47
2020-08-17,Arunachal Pradesh,1547,18,1540,19321,167,9,8.01,0,1.6,193667,1609,192634,10.44,0.56,12.075625,0.83,99.47
2020-08-18,Arunachal Pradesh,874,9,872,10594,4272,1319,8.25,0,1.6,194541,1618,193506,267.0,82.44,6.62125,0.83,99.47
2020-08-19,Arunachal Pradesh,133,1,124,1819,4767,2019,7.31,8,1.6,194674,1619,193630,297.94,126.19,1.136875,0.83,99.46
2020-08-20,Arunachal Pradesh,856,4,851,10691,3419,3091,8.01,1,1.6,195530,1623,194481,213.69,193.19,6.681875,0.83,99.46
2020-08-21,Arunachal Pradesh,1457,11,1449,18130,2472,33,8.04,0,1.6,196987,1634,195930,154.5,2.06,11.33125,0.83,99.46
2020-08-22,Arunachal Pradesh,1454,5,1452,18059,1771,1280,8.05,0,1.6,198441,1639,197382,110.69,80.0,11.286875,0.83,99.47
2020-08-23,Arunachal Pradesh,239,3,234,3332,85,35,7.17,2,1.6,198680,1642,197616,5.31,2.19,2.0825,0.83,99.46
2020-08-24,Arunachal Pradesh,1556,7,1547,19518,3359,2211,7.97,2,1.6,200236,1649,199163,209.94,138.19,12.19875,0.82,99.46
2020-08-25,Arunachal Pradesh,1171,12,1168,14724,2280,353,7.95,0,1.6,201407,1661,200331,142.5,22.06,9.2025,0.82,99.47
2020-08-26,Arunachal Pradesh,1400,11,1400,17701,1708,580,7.91,0,1.6,202807,1672,201731,106.75,36.25,11.063125,0.82,99.47
2020-08-27,Arunachal Pradesh,1437,19,1429,18497,1452,255,7.77,0,1.6,204244,1691,203160,90.75,15.94,11.560625,0.83,99.47
2020-08-28,Arunachal Pradesh,778,9,775,9295,4721,2365,8.37,0,1.6,205022,1700,203935,295.06,147.81,5.809375,0.83,99.47
2020-08-29,Arunachal Pradesh,374,1,370,4159,3315,584,8.99,3,1.6,205396,1701,204305,207.19,36.5,2.599375,0.83,99.47
2020-08-30,Arunachal Pradesh,658,6,653,7983,1230,163,8.24,0,1.6,206054,1707,204958,76.88,10.19,4.989375,0.83,99.47
2020-08-31,Arunachal Pradesh,429,4,423,5745,1280,903,7.47,2,1.6,206483,1711,205381,80.0,56.44,3.590625,0.83,99.47
2020-09-01,Arunachal Pradesh,1070,10,1062,13385,2853,1859,7.99,0,1.6,207553,1721,206443,178.31,116.19,8.365625,0.83,99.47
2020-09-02,Arunachal Pradesh,913,10,906,11357,1681,895,8.04,0,1.6,208466,1731,207349,105.06,55.94,7.098125,0.83,99.46
2020-09-03,Arunachal Pradesh,1323,8,1318,16160,4805,2519,8.19,0,1.6,209789,1739,208667,300.31,157.44,10.1,0.83,99.47
2020-09-04,Arunachal Pradesh,934,5,931,11802,4441,3233,7.91,0,1.6,210723,1744,209598,277.56,202.06,7.37625,0.83,99.47
2020-09-05,Arunachal Pradesh,634,5,629,7418,3753,2871,8.55,0,1.6,211357,1749,210227,234.56,179.44,4.63625,0.83,99.47
2020-09-06,Arunachal Pradesh,421,1,420,5456,4123,2688,7.72,0,1.6,211778,1750,210647,257.69,168.0,3.41,0.83,99.47
2020-09-07,Arunachal Pradesh,1281,12,1281,16016,1342,788,8.0,0,1.6,213059,1762,211928,83.88,49.25,10.01,0.83,99.47
2020-09-08,Arunachal Pradesh,1438,18,1436,17847,1846,1475,8.06,0,1.6,214497,1780,213364,115.38,92.19,11.154375,0.83,99.47
2020-09-09,Arunachal Pradesh,205,1,198,2362,1240,346,8.68,6,1.6,214702,1781,213562,77.5,21.62,1.47625,0.83,99.47
2020-09-10,Arunachal Pradesh,321,3,315,4267,364,84,7.52,3,1.6,215023,1784,213877,22.75,5.25,2.666875,0.83,99.47
2020-09-11,Arunachal Pradesh,1509,10,1500,18884,4877,1874,7.99,0,1.6,216532,1794,215377,304.81,117.12,11.8025,0.83,99.47
2020-09-12,Arunachal Pradesh,1196,4,1190,14789,1000,58,8.09,2,1.6,217728,1798,216567,62.5,3.62,9.243125,0.83,99.47
2020-09-13,Arunachal Pradesh,318,3,318,3758,4882,3936,8.46,0,1.6,218046,1801,216885,305.12,246.0,2.34875,0.83,99.47
2020-09-14,Arunachal Pradesh,699,2,694,8867,3289,1696,7.88,3,1.6,218745,1803,217579,205.56,106.0,5.541875,0.82,99.47
2020-09-15,Arunachal Pradesh,1014,10,1005,12937,4280,4004,7.84,0,1.6,219759,1813,218584,267.5,250.25,8.085625,0.82,99.47
2020-09-16,Arunachal Pradesh,640,2,632,8170,3811,615,7.83,6,1.6,220399,1815,219216,238.19,38.44,5.10625,0.82,99.46
2020-09-17,Arunachal Pradesh,89,0,83,1151,2415,1563,7.73,6,1.6,220488,1815,219299,150.94,97.69,0.719375,0.82,99.46
2020-09-18,Arunachal Pradesh,431,2,424,4995,4447,2068,8.63,5,1.6,220919,1817,219723,277.94,129.25,3.121875,0.82,99.46
2020-09-19,Arunachal Pradesh,95,0,86,873,684,636,10.88,9,1.6,221014,1817,219809,42.75,39.75,0.545625,0.82,99.45
2020-09-20,Arunachal Pradesh,167,2,160,1773,433,424,9.42,5,1.6,221181,1819,219969,27.06,26.5,1.108125,0.82,99.45
2020-09-21,Arunachal Pradesh,349,1,343,4643,2648,217,7.52,5,1.6,221530,1820,220312,165.5,13.56,2.901875,0.82,99.45
2020-09-22,Arunachal Pradesh,992,12,986,12784,2068,1431,7.76,0,1.6,222522,1832,221298,129.25,89.44,7.99,0.82,99.45
2020-09-23,Arunachal Pradesh,263,3,256,3315,339,310,7.93,4,1.6,222785,1835,221554,21.19,19.38,2.071875,0.82,99.45
2020-09-24,Arunachal Pradesh,876,12,872,10866,222,96,8.06,0,1.6,223661,1847,222426,13.88,6.0,6.79125,0.83,99.45
2020-09-25,Arunachal Pradesh,830,7,827,10640,3791,2612,7.8,0,1.6,224491,1854,223253,236.94,163.25,6.65,0.83,99.45
2020-09-26,Arunachal Pradesh,370,3,364,4524,3821,3213,8.18,3,1.6,224861,1857,223617,238.81,200.81,2.8275,0.83,99.45
2020-09-27,Arunachal Pradesh,761,2,752,9631,4588,4561,7.9,7,1.6,225622,1859,224369,286.75,285.06,6.019375,0.82,99.44
2020-09-28,Arunachal Pradesh,225,2,224,2441,1699,856,9.22,0,1.6,225847,1861,224593,106.19,53.5,1.525625,0.82,99.44
2020-09-29,Arunachal Pradesh,1146,16,1139,14540,976,853,7.88,0,1.6,226993,1877,225732,61.0,53.31,9.0875,0.83,99.44
2020-09-30,Arunachal Pradesh,692,5,688,8468,2195,879,8.17,0,1.6,227685,1882,226420,137.19,54.94,5.2925,0.83,99.44
2020-10-01,Arunachal Pradesh,748,3,741,9287,3682,3315,8.05,4,1.6,228433,1885,227161,230.12,207.19,5.804375,0.83,99.44
2020-10-02,Arunachal Pradesh,410,1,408,4850,4644,2903,8.45,1,1.6,228843,1886,227569,290.25,181.44,3.03125,0.82,99.44
2020-10-03,Arunachal Pradesh,1384,8,1375,16944,1569,604,8.17,1,1.6,230227,1894,228944,98.06,37.75,10.59,0.82,99.44
2020-10-04,Arunachal Pradesh,563,5,559,6636,4009,2772,8.48,0,1.6,230790,1899,229503,250.56,173.25,4.1475,0.82,99.44
2020-10-05,Arunachal Pradesh,617,7,616,7662,4553,3908,8.05,0,1.6,231407,1906,230119,284.56,244.25,4.78875,0.82,99.44
2020-10-06,Arunachal Pradesh,598,4,597,7042,2096,2003,8.49,0,1.6,232005,1910,230716,131.0,125.19,4.40125,0.82,99.44
2020-10-07,Arunachal Pradesh,1347,19,1342,16570,1786,845,8.13,0,1.6,233352,1929,232058,111.62,52.81,10.35625,0.83,99.45
2020-10-08,Arunachal Pradesh,934,11,934,11331,779,35,8.24,0,1.6,234286,1940,232992,48.69,2.19,7.081875,0.83,99.45
2020-10-09,Arunachal Pradesh,356,4,349,4671,1593,714,7.62,3,1.6,234642,1944,233341,99.56,44.62,2.919375,0.83,99.45
2020-10-10,Arunachal Pradesh,1046,15,1039,12905,3408,63,8.11,0,1.6,235688,1959,234380,213.0,3.94,8.065625,0.83,99.45
2020-10-11,Arunachal Pradesh,1032,4,1023,12553,4735,3219,8.22,5,1.6,236720,1963,235403,295.94,201.19,7.845625,0.83,99.44
2020-10-12,Arunachal Pradesh,1356,17,1349,16899,558,531,8.02,0,1.6,238076,1980,236752,34.88,33.19,10.561875,0.83,99.44
2020-10-13,Arunachal Pradesh,395,3,394,4840,4937,4059,8.16,0,1.6,238471,1983,237146,308.56,253.69,3.025,0.83,99.44
2020-10-14,Arunachal Pradesh,1373,4,1370,16885,185,28,8.13,0,1.6,239844,1987,238516,11.56,1.75,10.553125,0.83,99.45
2020-10-15,Arunachal Pradesh,338,3,335,3808,1647,1099,8.88,0,1.6,240182,1990,238851,102.94,68.69,2.38,0.83,99.45
2020-10-16,Arunachal Pradesh,1272,5,1270,15801,2782,1411,8.05,0,1.6,241454,1995,240121,173.88,88.19,9.875625,0.83,99.45
2020-10-17,Arunachal Pradesh,1310,16,1306,16751,1462,1437,7.82,0,1.6,242764,2011,241427,91.38,89.81,10.469375,0.83,99.45
2020-10-18,Arunachal Pradesh,468,2,466,5704,4108,887,8.2,0,1.6,243232,2013,241893,256.75,55.44,3.565,0.83,99.45
2020-10-19,Arunachal Pradesh,866,7,860,10958,3808,3755,7.9,0,1.6,244098,2020,242753,238.0,234.69,6.84875,0.83,99.45
2020-10-20,Arunachal Pradesh,736,8,732,9533,1793,214,7.72,0,1.6,244834,2028,243485,112.06,13.38,5.958125,0.83,99.45
2020-10-21,Arunachal Pradesh,1224,5,1220,15865,1378,1364,7.72,0,1.6,246058,2033,244705,86.12,85.25,9.915625,0.83,99.45
2020-10-22,Arunachal Pradesh,1106,14,1098,14086,4232,2666,7.85,0,1.6,247164,2047,245803,264.5,166.62,8.80375,0.83,99.45
2020-10-23,Arunachal Pradesh,1546,4,1541,19039,4439,772,8.12,1,1.6,248710,2051,247344,277.44,48.25,11.899375,0.82,99.45
2020-10-24,Arunachal Pradesh,1146,15,1137,13973,700,48,8.2,0,1.6,249856,2066,248481,43.75,3.0,8.733125,0.83,99.45
2020-10-25,Arunachal Pradesh,48,0,41,896,1314,1191,5.36,7,1.6,249904,2066,248522,82.12,74.44,0.56,0.83,99.45
2020-10-26,Arunachal Pradesh,419,2,417,5011,1669,914,8.36,0,1.6,250323,2068,248939,104.31,57.12,3.131875,0.83,99.45
2020-10-27,Arunachal Pradesh,1585,8,1582,19948,2444,2372,7.95,0,1.6,251908,2076,250521,152.75,148.25,12.4675,0.82,99.45
2020-10-28,Arunachal Pradesh,867,11,864,11090,3720,2019,7.82,0,1.6,252775,2087,251385,232.5,126.19,6.93125,0.83,99.45
2020-10-29,Arunachal Pradesh,1444,10,1436,18533,2425,1801,7.79,0,1.6,254219,2097,252821,151.56,112.56,11.583125,0.82,99.45
2020-10-30,Arunachal Pradesh,614,7,610,7860,395,127,7.81,0,1.6,254833,2104,253431,24.69,7.94,4.9125,0.83,99.45
2020-10-31,Arunachal Pradesh,1203,4,1198,15037,189,153,8.0,1,1.6,256036,2108,254629,11.81,9.56,9.398125,0.82,99.45
2020-11-01,Arunachal Pradesh,879,9,873,10264,4240,3116,8.56,0,1.6,256915,2117,255502,265.0,194.75,6.415,0.82,99.45
2020-11-02,Arunachal Pradesh,604,3,598,7411,504,152,8.15,3,1.6,257519,2120,256100,31.5,9.5,4.631875,0.82,99.45
2020-11-03,Arunachal Pradesh,1316,5,1309,16316,2466,2009,8.07,2,1.6,258835,2125,257409,154.12,125.56,10.1975,0.82,99.45
2020-11-04,Arunachal Pradesh,962,7,956,11993,582,359,8.02,0,1.6,259797,2132,258365,36.38,22.44,7.495625,0.82,99.45
2020-11-05,Arunachal Pradesh,801,7,795,9758,3568,1672,8.21,0,1.6,260598,2139,259160,223.0,104.5,6.09875,0.82,99.45
2020-11-06,Arunachal Pradesh,1471,8,1463,18148,1230,578,8.11,0,1.6,262069,2147,260623,76.88,36.12,11.3425,0.82,99.45
2020-11-07,Arunachal Pradesh,366,4,359,4576,1986,1233,8.0,3,1.6,262435,2151,260982,124.12,77.06,2.86,0.82,99.45
2020-11-08,Arunachal Pradesh,1550,7,1545,19265,484,154,8.05,0,1.6,263985,2158,262527,30.25,9.62,12.040625,0.82,99.45
2020-11-09,Arunachal Pradesh,1413,5,1412,17519,4345,2595,8.07,0,1.6,265398,2163,263939,271.56,162.19,10.949375,0.82,99.45
2020-11-10,Arunachal Pradesh,912,3,906,11365,2293,1449,8.02,3,1.6,266310,2166,264845,143.31,90.56,7.103125,0.81,99.45
2020-11-11,Arunachal Pradesh,641,5,639,8066,3485,2818,7.95,0,1.6,266951,2171,265484,217.81,176.12,5.04125,0.81,99.45
2020-11-12,Arunachal Pradesh,1478,17,1473,18110,2738,212,8.16,0,1.6,268429,2188,266957,171.12,13.25,11.31875,0.82,99.45
2020-11-13,Arunachal Pradesh,1049,9,1042,13683,845,796,7.67,0,1.6,269478,2197,267999,52.81,49.75,8.551875,0.82,99.45
2020-11-14,Arunachal Pradesh,606,6,600,7175,3192,1456,8.45,0,1.6,270084,2203,268599,199.5,91.0,4.484375,0.82,99.45
2020-11-15,Arunachal Pradesh,1107,8,1103,13639,4885,3451,8.12,0,1.6,271191,2211,269702,305.31,215.69,8.524375,0.82,99.45
2020-11-16,Arunachal Pradesh,949,5,947,11534,4389,3439,8.23,0,1.6,272140,2216,270649,274.31,214.94,7.20875,0.81,99.45
2020-11-17,Arunachal Pradesh,1317,7,1311,16453,2380,1192,8.0,0,1.6,273457,2223,271960,148.75,74.5,10.283125,0.81,99.45
2020-11-18,Arunachal Pradesh,1241,10,1241,15484,99,83,8.01,0,1.6,274698,2233,273201,6.19,5.19,9.6775,0.81,99.46
2020-11-19,Arunachal Pradesh,1092,11,1092,14035,1365,98,7.78,0,1.6,275790,2244,274293,85.31,6.12,8.771875,0.81,99.46
2020-11-20,Arunachal Pradesh,869,12,866,10709,2423,92,8.11,0,1.6,276659,2256,275159,151.44,5.75,6.693125,0.82,99.46
2020-11-21,Arunachal Pradesh,722,5,718,8985,2553,98,8.04,0,1.6,277381,2261,275877,159.56,6.12,5.615625,0.82,99.46
2020-11-22,Arunachal Pradesh,766,8,758,9894,4364,3279,7.74,0,1.6,278147,2269,276635,272.75,204.94,6.18375,0.82,99.46
2020-11-23,Arunachal Pradesh,957,9,957,12359,740,494,7.74,0,1.6,279104,2278,277592,46.25,30.88,7.724375,0.82,99.46
2020-11-24,Arunachal Pradesh,54,0,45,702,1201,304,7.69,9,1.6,279158,2278,277637,75.06,19.0,0.43875,0.82,99.46
2020-11-25,Arunachal Pradesh,851,9,844,10514,546,18,8.09,0,1.6,280009,2287,278481,34.12,1.12,6.57125,0.82,99.45
2020-11-26,Arunachal Pradesh,775,2,772,9510,1745,331,8.15,1,1.6,280784,2289,279253,109.06,20.69,5.94375,0.82,99.45
2020-11-27,Arunachal Pradesh,87,0,81,1398,986,272,6.22,6,1.6,280871,2289,279334,61.62,17.0,0.87375,0.81,99.45
2020-11-28,Arunachal Pradesh,1141,9,1136,13829,532,16,8.25,0,1.6,282012,2298,280470,33.25,1.0,8.643125,0.81,99.45
2020-11-29,Arunachal Pradesh,1222,11,1215,15331,1838,1244,7.97,0,1.6,283234,2309,281685,114.88,77.75,9.581875,0.82,99.45
2020-11-30,Arunachal Pradesh,1440,17,1437,17910,823,615,8.04,0,1.6,284674,2326,283122,51.44,38.44,11.19375,0.82,99.45
2020-12-01,Arunachal Pradesh,1504,19,1502,18569,756,61,8.1,0,1.6,286178,2345,284624,47.25,3.81,11.605625,0.82,99.46
2020-12-02,Arunachal Pradesh,1042,8,1037,13226,2062,772,7.88,0,1.6,287220,2353,285661,128.88,48.25,8.26625,0.82,99.46
2020-12-03,Arunachal Pradesh,1422,18,1417,17797,4629,1441,7.99,0,1.6,288642,2371,287078,289.31,90.06,11.123125,0.82,99.46
2020-12-04,Arunachal Pradesh,1337,13,1330,16444,3342,10,8.13,0,1.6,289979,2384,288408,208.88,0.62,10.2775,0.82,99.46
2020-12-05,Arunachal Pradesh,710,3,705,8954,4108,844,7.93,2,1.6,290689,2387,289113,256.75,52.75,5.59625,0.82,99.46
2020-12-06,Arunachal Pradesh,1554,17,1547,19245,383,42,8.07,0,1.6,292243,2404,290660,23.94,2.62,12.028125,0.82,99.46
2020-12-07,Arunachal Pradesh,1565,13,1565,19460,3672,1822,8.04,0,1.6,293808,2417,292225,229.5,113.88,12.1625,0.82,99.46
2020-12-08,Arunachal Pradesh,1574,7,1571,19639,2839,1257,8.01,0,1.6,295382,2424,293796,177.44,78.56,12.274375,0.82,99.46
2020-12-09,Arunachal Pradesh,233,1,229,2863,2265,2161,8.14,3,1.6,295615,2425,294025,141.56,135.06,1.789375,0.82,99.46
2020-12-10,Arunachal Pradesh,979,5,973,12585,438,41,7.78,1,1.6,296594,2430,294998,27.38,2.56,7.865625,0.82,99.46
2020-12-11,Arunachal Pradesh,1119,4,1111,14063,4927,1661,7.96,4,1.6,297713,2434,296109,307.94,103.81,8.789375,0.82,99.46
2020-12-12,Arunachal Pradesh,530,3,529,6876,4067,3358,7.71,0,1.6,298243,2437,296638,254.19,209.88,4.2975,0.82,99.46
2020-12-13,Arunachal Pradesh,935,4,928,11675,239,15,8.01,3,1.6,299178,2441,297566,14.94,0.94,7.296875,0.82,99.46
2020-12-14,Arunachal Pradesh,1073,6,1064,13472,4036,3046,7.96,3,1.6,300251,2447,298630,252.25,190.38,8.42,0.81,99.46
2020-12-15,Arunachal Pradesh,362,2,359,4431,4242,3545,8.17,1,1.6,300613,2449,298989,265.12,221.56,2.769375,0.81,99.46
2020-12-16,Arunachal Pradesh,425,3,425,5401,4203,380,7.87,0,1.6,301038,2452,299414,262.69,23.75,3.375625,0.81,99.46
2020-12-17,Arunachal Pradesh,238,1,234,2982,962,708,7.98,3,1.6,301276,2453,299648,60.12,44.25,1.86375,0.81,99.46
2020-12-18,Arunachal Pradesh,1298,5,1291,16436,691,416,7.9,2,1.6,302574,2458,300939,43.19,26.0,10.2725,0.81,99.46
2020-12-19,Arunachal Pradesh,949,9,944,11685,3122,1811,8.12,0,1.6,303523,2467,301883,195.12,113.19,7.303125,0.81,99.46
2020-12-20,Arunachal Pradesh,232,3,228,2763,2698,1032,8.4,1,1.6,303755,2470,302111,168.62,64.5,1.726875,0.81,99.46
2020-12-21,Arunachal Pradesh,1286,8,1285,15569,2129,887,8.26,0,1.6,305041,2478,303396,133.06,55.44,9.730625,0.81,99.46
2020-12-22,Arunachal Pradesh,717,6,713,8760,783,528,8.18,0,1.6,305758,2484,304109,48.94,33.0,5.475,0.81,99.46
2020-12-23,Arunachal Pradesh,1424,17,1424,17831,4590,428,7.99,0,1.6,307182,2501,305533,286.88,26.75,11.144375,0.81,99.46
2020-12-24,Arunachal Pradesh,271,1,268,3251,3860,3130,8.34,2,1.6,307453,2502,305801,241.25,195.62,2.031875,0.81,99.46
2020-12-25,Arunachal Pradesh,1150,13,1150,14440,1152,1104,7.96,0,1.6,308603,2515,306951,72.0,69.0,9.025,0.81,99.46
2020-12-26,Arunachal Pradesh,302,3,299,3434,4220,1425,8.79,0,1.6,308905,2518,307250,263.75,89.06,2.14625,0.82,99.46
2020-12-27,Arunachal Pradesh,77,1,76,833,2320,1027,9.24,0,1.6,308982,2519,307326,145.0,64.19,0.520625,0.82,99.46
2020-12-28,Arunachal Pradesh,1475,15,1466,18430,2926,1357,8.0,0,1.6,310457,2534,308792,182.88,84.81,11.51875,0.82,99.46
2020-12-29,Arunachal Pradesh,534,7,532,6593,3222,1556,8.1,0,1.6,310991,2541,309324,201.38,97.25,4.120625,0.82,99.46
2020-12-30,Arunachal Pradesh,143,1,134,1776,1473,1000,8.05,8,1.6,311134,2542,309458,92.06,62.5,1.11,0.82,99.46
2020-12-31,Arunachal Pradesh,1608,9,1600,19975,754,152,8.05,0,1.6,312742,2551,311058,47.12,9.5,12.484375,0.82,99.46
2021-01-01,Arunachal Pradesh,211,1,202,2152,3573,417,9.8,8,1.6,312953,2552,311260,223.31,26.06,1.345,0.82,99.46
2021-01-02,Arunachal Pradesh,1056,13,1051,12962,2897,681,8.15,0,1.6,314009,2565,312311,181.06,42.56,8.10125,0.82,99.46
2021-01-03,Arunachal Pradesh,44,0,40,712,2727,1979,6.18,4,1.6,314053,2565,312351,170.44,123.69,0.445,0.82,99.46
2021-01-04,Arunachal Pradesh,300,2,296,3692,3517,3017,8.13,2,1.6,314353,2567,312647,219.81,188.56,2.3075,0.82,99.46
2021-01-05,Arunachal Pradesh,883,9,876,10916,4617,4464,8.09,0,1.6,315236,2576,313523,288.56,279.0,6.8225,0.82,99.46
2021-01-06,Arunachal Pradesh,1595,9,1594,19685,1823,689,8.1,0,1.6,316831,2585,315117,113.94,43.06,12.303125,0.82,99.46
2021-01-07,Arunachal Pradesh,335,4,332,4238,4514,870,7.9,0,1.6,317166,2589,315449,282.12,54.37,2.64875,0.82,99.46
2021-01-08,Arunachal Pradesh,794,3,786,10020,2983,801,7.92,5,1.6,317960,2592,316235,186.44,50.06,6.2625,0.82,99.46
2021-01-09,Arunachal Pradesh,143,0,137,1410,2106,79,10.14,6,1.6,318103,2592,316372,131.62,4.94,0.88125,0.81,99.46
2021-01-10,Arunachal Pradesh,89,0,88,1258,899,700,7.07,1,1.6,318192,2592,316460,56.19,43.75,0.78625,0.81,99.46
2021-01-11,Arunachal Pradesh,1141,12,1135,14082,2378,849,8.1,0,1.6,319333,2604,317595,148.62,53.06,8.80125,0.82,99.46
2021-01-12,Arunachal Pradesh,1329,16,1321,16742,2355,315,7.94,0,1.6,320662,2620,318916,147.19,19.69,10.46375,0.82,99.46
2021-01-13,Arunachal Pradesh,386,1,383,4934,2068,275,7.82,2,1.6,321048,2621,319299,129.25,17.19,3.08375,0.82,99.46
2021-01-14,Arunachal Pradesh,1272,17,1267,15946,583,100,7.98,0,1.6,322320,2638,320566,36.44,6.25,9.96625,0.82,99.46
2021-01-15,Arunachal Pradesh,570,5,562,7191,2059,376,7.93,3,1.6,322890,2643,321128,128.69,23.5,4.494375,0.82,99.45
2021-01-16,Arunachal Pradesh,1063,15,1054,13250,3245,630,8.02,0,1.6,323953,2658,322182,202.81,39.38,8.28125,0.82,99.45
2021-01-17,Arunachal Pradesh,63,0,57,820,4089,163,7.68,6,1.6,324016,2658,322239,255.56,10.19,0.5125,0.82,99.45
2021-01-18,Arunachal Pradesh,225,1,217,2759,1666,1475,8.16,7,1.6,324241,2659,322456,104.12,92.19,1.724375,0.82,99.45
2021-01-19,Arunachal Pradesh,176,2,175,1773,1702,862,9.93,0,1.6,324417,2661,322631,106.38,53.87,1.108125,0.82,99.45
2021-01-20,Arunachal Pradesh,178,2,169,2323,1824,1363,7.66,7,1.6,324595,2663,322800,114.0,85.19,1.451875,0.82,99.45
2021-01-21,Arunachal Pradesh,325,1,324,4108,61,18,7.91,0,1.6,324920,2664,323124,3.81,1.12,2.5675,0.82,99.45
2021-01-22,Arunachal Pradesh,1337,8,1336,16734,3961,3779,7.99,0,1.6,326257,2672,324460,247.56,236.19,10.45875,0.82,99.45
2021-01-23,Arunachal Pradesh,906,4,898,11448,114,30,7.91,4,1.6,327163,2676,325358,7.12,1.88,7.155,0.82,99.45
2021-01-24,Arunachal Pradesh,1305,8,1297,15811,1855,1849,8.25,0,1.6,328468,2684,326655,115.94,115.56,9.881875,0.82,99.45
2021-01-25,Arunachal Pradesh,1022,14,1019,12860,4393,4355,7.95,0,1.6,329490,2698,327674,274.56,272.19,8.0375,0.82,99.45
2021-01-26,Arunachal Pradesh,712,2,709,8901,3526,81,8.0,1,1.6,330202,2700,328383,220.38,5.06,5.563125,0.82,99.45
2021-01-27,Arunachal Pradesh,1246,4,1241,15651,1719,136,7.96,1,1.6,331448,2704,329624,107.44,8.5,9.781875,0.82,99.45
2021-01-28,Arunachal Pradesh,1348,5,1346,16981,1032,184,7.94,0,1.6,332796,2709,330970,64.5,11.5,10.613125,0.81,99.45
2021-01-29,Arunachal Pradesh,866,7,857,10636,2362,1931,8.14,2,1.6,333662,2716,331827,147.62,120.69,6.6475,0.81,99.45
2021-01-30,Arunachal Pradesh,156,0,152,2091,891,370,7.46,4,1.6,333818,2716,331979,55.69,23.12,1.306875,0.81,99.45
2021-01-31,Arunachal Pradesh,296,2,293,4014,4090,916,7.37,1,1.6,334114,2718,332272,255.62,57.25,2.50875,0.81,99.45
2021-02-01,Arunachal Pradesh,484,5,484,6094,259,114,7.94,0,1.6,334598,2723,332756,16.19,7.12,3.80875,0.81,99.45
2021-02-02,Arunachal Pradesh,319,1,317,3960,1315,396,8.06,1,1.6,334917,2724,333073,82.19,24.75,2.475,0.81,99.45
2021-02-03,Arunachal Pradesh,727,3,720,8816,4268,2567,8.25,4,1.6,335644,2727,333793,266.75,160.44,5.51,0.81,99.45
2021-02-04,Arunachal Pradesh,65,0,65,1013,4791,3776,6.42,0,1.6,335709,2727,333858,299.44,236.0,0.633125,0.81,99.45
2021-02-05,Arunachal Pradesh,1220,16,1220,15308,2391,2208,7.97,0,1.6,336929,2743,335078,149.44,138.0,9.5675,0.81,99.45
2021-02-06,Arunachal Pradesh,1286,7,1281,16159,1757,540,7.96,0,1.6,338215,2750,336359,109.81,33.75,10.099375,0.81,99.45
2021-02-07,Arunachal Pradesh,474,1,467,6132,3270,1092,7.73,6,1.6,338689,2751,336826,204.38,68.25,3.8325,0.81,99.45
2021-02-08,Arunachal Pradesh,182,1,182,2393,1592,351,7.61,0,1.6,338871,2752,337008,99.5,21.94,1.495625,0.81,99.45
2021-02-09,Arunachal Pradesh,1208,7,1205,14775,4031,1791,8.18,0,1.6,340079,2759,338213,251.94,111.94,9.234375,0.81,99.45
2021-02-10,Arunachal Pradesh,1593,21,1593,19944,2691,1016,7.99,0,1.6,341672,2780,339806,168.19,63.5,12.465,0.81,99.45
2021-02-11,Arunachal Pradesh,1003,7,1000,12602,1679,1224,7.96,0,1.6,342675,2787,340806,104.94,76.5,7.87625,0.81,99.45
2021-02-12,Arunachal Pradesh,93,1,88,1192,2048,697,7.8,4,1.6,342768,2788,340894,128.0,43.56,0.745,0.81,99.45
2021-02-13,Arunachal Pradesh,64,0,59,662,4558,1315,9.67,5,1.6,342832,2788,340953,284.88,82.19,0.41375,0.81,99.45
2021-02-14,Arunachal Pradesh,1501,18,1493,19078,4103,1610,7.87,0,1.6,344333,2806,342446,256.44,100.63,11.92375,0.81,99.45
2021-02-15,Arunachal Pradesh,890,11,889,11135,3192,812,7.99,0,1.6,345223,2817,343335,199.5,50.75,6.959375,0.82,99.45
2021-02-16,Arunachal Pradesh,601,4,593,7532,2999,892,7.98,4,1.6,345824,2821,343928,187.44,55.75,4.7075,0.82,99.45
2021-02-17,Arunachal Pradesh,959,11,950,11949,2635,2024,8.03,0,1.6,346783,2832,344878,164.69,126.5,7.468125,0.82,99.45
2021-02-18,Arunachal Pradesh,356,5,353,4216,700,603,8.44,0,1.6,347139,2837,345231,43.75,37.69,2.635,0.82,99.45
2021-02-19,Arunachal Pradesh,314,1,310,3467,3126,1323,9.06,3,1.6,347453,2838,345541,195.38,82.69,2.166875,0.82,99.45
2021-02-20,Arunachal Pradesh,639,7,631,8078,390,126,7.91,1,1.6,348092,2845,346172,24.38,7.88,5.04875,0.82,99.45
2021-02-21,Arunachal Pradesh,1137,15,1130,13952,1791,1124,8.15,0,1.6,349229,2860,347302,111.94,70.25,8.72,0.82,99.45
2021-02-22,Arunachal Pradesh,156,1,148,1402,865,480,11.13,7,1.6,349385,2861,347450,54.06,30.0,0.87625,0.82,99.45
2021-02-23,Arunachal Pradesh,733,5,726,9203,1336,409,7.96,2,1.6,350118,2866,348176,83.5,25.56,5.751875,0.82,99.45
2021-02-24,Arunachal Pradesh,276,2,273,3426,3567,1849,8.06,1,1.6,350394,2868,348449,222.94,115.56,2.14125,0.82,99.44
2021-02-25,Arunachal Pradesh,455,5,449,5841,1287,1040,7.79,1,1.6,350849,2873,348898,80.44,65.0,3.650625,0.82,99.44
2021-02-26,Arunachal Pradesh,138,0,133,1901,4808,1033,7.26,5,1.6,350987,2873,349031,300.5,64.56,1.188125,0.82,99.44
2021-02-27,Arunachal Pradesh,1508,16,1505,18620,4656,3964,8.1,0,1.6,352495,2889,350536,291.0,247.75,11.6375,0.82,99.44
2021-02-28,Arunachal Pradesh,104,1,96,1337,2038,1784,7.78,7,1.6,352599,2890,350632,127.38,111.5,0.835625,0.82,99.44
2021-03-01,Arunachal Pradesh,123,0,119,1196,4040,696,10.28,4,1.6,352722,2890,350751,252.5,43.5,0.7475,0.82,99.44
2021-03-02,Arunachal Pradesh,425,1,425,5186,4001,3986,8.2,0,1.6,353147,2891,351176,250.06,249.12,3.24125,0.82,99.44
2021-03-03,Arunachal Pradesh,760,7,756,10057,3488,2005,7.56,0,1.6,353907,2898,351932,218.0,125.31,6.285625,0.82,99.44
2021-03-04,Arunachal Pradesh,1388,19,1383,17572,2890,1170,7.9,0,1.6,355295,2917,353315,180.62,73.12,10.9825,0.82,99.44
2021-03-05,Arunachal Pradesh,1193,5,1190,15188,1670,1015,7.85,0,1.6,356488,2922,354505,104.38,63.44,9.4925,0.82,99.44
2021-03-06,Arunachal Pradesh,1518,5,1515,18977,219,16,8.0,0,1.6,358006,2927,356020,13.69,1.0,11.860625,0.82,99.45
2021-03-07,Arunachal Pradesh,356,1,349,4917,4570,2633,7.24,6,1.6,358362,2928,356369,285.62,164.56,3.073125,0.82,99.44
2021-03-08,Arunachal Pradesh,831,3,831,10179,1266,665,8.16,0,1.6,359193,2931,357200,79.12,41.56,6.361875,0.82,99.45
2021-03-09,Arunachal Pradesh,1528,9,1519,19028,1044,724,8.03,0,1.6,360721,2940,358719,65.25,45.25,11.8925,0.82,99.45
2021-03-10,Arunachal Pradesh,1274,5,1271,16187,1546,1504,7.87,0,1.6,361995,2945,359990,96.62,94.0,10.116875,0.81,99.45
2021-03-11,Arunachal Pradesh,184,1,183,2455,2626,1352,7.49,0,1.6,362179,2946,360173,164.12,84.5,1.534375,0.81,99.45
2021-03-12,Arunachal Pradesh,787,8,783,9722,1027,24,8.1,0,1.6,362966,2954,360956,64.19,1.5,6.07625,0.81,99.45
2021-03-13,Arunachal Pradesh,385,4,384,4533,4412,3403,8.49,0,1.6,363351,2958,361340,275.75,212.69,2.833125,0.81,99.45
2021-03-14,Arunachal Pradesh,1115,10,1110,14003,739,699,7.96,0,1.6,364466,2968,362450,46.19,43.69,8.751875,0.81,99.45
2021-03-15,Arunachal Pradesh,1286,15,1277,15779,3505,3060,8.15,0,1.6,365752,2983,363727,219.06,191.25,9.861875,0.82,99.45
2021-03-16,Arunachal Pradesh,582,3,575,7781,4283,1738,7.48,4,1.6,366334,2986,364302,267.69,108.62,4.863125,0.82,99.45
2021-03-17,Arunachal Pradesh,799,7,798,9927,2112,1189,8.05,0,1.6,367133,2993,365100,132.0,74.31,6.204375,0.82,99.45
2021-03-18,Arunachal Pradesh,1405,8,1402,17444,1406,489,8.05,0,1.6,368538,3001,366502,87.88,30.56,10.9025,0.81,99.45
2021-03-19,Arunachal Pradesh,898,8,895,11468,1050,376,7.83,0,1.6,369436,3009,367397,65.62,23.5,7.1675,0.81,99.45
2021-03-20,Arunachal Pradesh,1561,19,1560,19092,4717,1603,8.18,0,1.6,370997,3028,368957,294.81,100.19,11.9325,0.82,99.45
2021-03-21,Arunachal Pradesh,191,2,184,2363,3302,3058,8.08,5,1.6,371188,3030,369141,206.38,191.12,1.476875,0.82,99.45
2021-03-22,Arunachal Pradesh,1034,10,1028,13056,3713,2188,7.92,0,1.6,372222,3040,370169,232.06,136.75,8.16,0.82,99.45
2021-03-23,Arunachal Pradesh,956,7,956,11897,1133,280,8.04,0,1.6,373178,3047,371125,70.81,17.5,7.435625,0.82,99.45
2021-03-24,Arunachal Pradesh,970,6,970,12279,1589,364,7.9,0,1.6,374148,3053,372095,99.31,22.75,7.674375,0.82,99.45
2021-03-25,Arunachal Pradesh,92,1,88,1255,3848,59,7.33,3,1.6,374240,3054,372183,240.5,3.69,0.784375,0.82,99.45
2021-03-26,Arunachal Pradesh,1332,6,1324,16721,2890,1324,7.97,2,1.6,375572,3060,373507,180.62,82.75,10.450625,0.81,99.45
2021-03-27,Arunachal Pradesh,1289,4,1282,15877,4794,434,8.12,3,1.6,376861,3064,374789,299.62,27.12,9.923125,0.81,99.45
2021-03-28,Arunachal Pradesh,245,2,242,3288,2331,1180,7.45,1,1.6,377106,3066,375031,145.69,73.75,2.055,0.81,99.45
2021-03-29,Arunachal Pradesh,1188,12,1188,14535,2788,1166,8.17,0,1.6,378294,3078,376219,174.25,72.88,9.084375,0.81,99.45
2021-03-30,Arunachal Pradesh,555,5,552,6973,4326,3901,7.96,0,1.6,378849,3083,376771,270.38,243.81,4.358125,0.81,99.45
2021-03-31,Arunachal Pradesh,275,0,274,3611,4561,2697,7.62,1,1.6,379124,3083,377045,285.06,168.56,2.256875,0.81,99.45
2021-04-01,Arunachal Pradesh,355,1,348,4708,3523,2750,7.54,6,1.6,379479,3084,377393,220.19,171.88,2.9425,0.81,99.45
2021-04-02,Arunachal Pradesh,1531,16,1526,18990,1681,713,8.06,0,1.6,381010,3100,378919,105.06,44.56,11.86875,0.81,99.45
2021-04-03,Arunachal Pradesh,1324,13,1322,16289,297,151,8.13,0,1.6,382334,3113,380241,18.56,9.44,10.180625,0.81,99.45
2021-04-04,Arunachal Pradesh,1184,16,1175,14898,769,532,7.95,0,1.6,383518,3129,381416,48.06,33.25,9.31125,0.82,99.45
2021-04-05,Arunachal Pradesh,1311,11,1302,16515,2648,640,7.94,0,1.6,384829,3140,382718,165.5,40.0,10.321875,0.82,99.45
2021-04-06,Arunachal Pradesh,491,4,488,5894,3219,2008,8.33,0,1.6,385320,3144,383206,201.19,125.5,3.68375,0.82,99.45
2021-04-07,Arunachal Pradesh,742,9,737,9344,136,106,7.94,0,1.6,386062,3153,383943,8.5,6.62,5.84,0.82,99.45
2021-04-08,Arunachal Pradesh,206,0,198,2874,3503,1445,7.17,8,1.6,386268,3153,384141,218.94,90.31,1.79625,0.82,99.45
2021-04-09,Arunachal Pradesh,1049,3,1048,12778,1859,152,8.21,0,1.6,387317,3156,385189,116.19,9.5,7.98625,0.81,99.45
2021-04-10,Arunachal Pradesh,545,2,540,6914,2069,1584,7.88,3,1.6,387862,3158,385729,129.31,99.0,4.32125,0.81,99.45
2021-04-11,Arunachal Pradesh,1543,9,1534,19423,1716,651,7.94,0,1.6,389405,3167,387263,107.25,40.69,12.139375,0.81,99.45
2021-04-12,Arunachal Pradesh,536,2,532,6893,2936,2754,7.78,2,1.6,389941,3169,387795,183.5,172.12,4.308125,0.81,99.45
2021-04-13,Arunachal Pradesh,1368,15,1361,17233,1325,1110,7.94,0,1.6,391309,3184,389156,82.81,69.38,10.770625,0.81,99.45
2021-04-14,Arunachal Pradesh,1006,3,1000,12318,2595,1936,8.17,3,1.6,392315,3187,390156,162.19,121.0,7.69875,0.81,99.45
2021-04-15,Arunachal Pradesh,1280,12,1276,15630,357,27,8.19,0,1.6,393595,3199,391432,22.31,1.69,9.76875,0.81,99.45
2021-04-16,Arunachal Pradesh,1379,19,1376,16988,3311,1769,8.12,0,1.6,394974,3218,392808,206.94,110.56,10.6175,0.81,99.45
2021-04-17,Arunachal Pradesh,420,4,419,5446,3423,888,7.71,0,1.6,395394,3222,393227,213.94,55.5,3.40375,0.81,99.45
2021-04-18,Arunachal Pradesh,1549,9,1544,19397,1720,667,7.99,0,1.6,396943,3231,394771,107.5,41.69,12.123125,0.81,99.45
2021-04-19,Arunachal Pradesh,1199,7,1192,14924,1735,1487,8.03,0,1.6,398142,3238,395963,108.44,92.94,9.3275,0.81,99.45
2021-04-20,Arunachal Pradesh,544,6,537,6834,110,14,7.96,1,1.6,398686,3244,396500,6.88,0.88,4.27125,0.81,99.45
2021-04-21,Arunachal Pradesh,1562,7,1560,19662,4611,1572,7.94,0,1.6,400248,3251,398060,288.19,98.25,12.28875,0.81,99.45
2021-04-22,Arunachal Pradesh,1382,6,1378,17195,2292,2215,8.04,0,1.6,401630,3257,399438,143.25,138.44,10.746875,0.81,99.45
2021-04-23,Arunachal Pradesh,221,2,212,2958,1322,386,7.47,7,1.6,401851,3259,399650,82.62,24.12,1.84875,0.81,99.45
2021-04-24,Arunachal Pradesh,1196,6,1191,15358,2241,1250,7.79,0,1.6,403047,3265,400841,140.06,78.12,9.59875,0.81,99.45
2021-04-25,Arunachal Pradesh,317,1,311,4207,4839,1388,7.54,5,1.6,403364,3266,401152,302.44,86.75,2.629375,0.81,99.45
2021-04-26,Arunachal Pradesh,610,3,602,7491,73,32,8.14,5,1.6,403974,3269,401754,4.56,2.0,4.681875,0.81,99.45
2021-04-27,Arunachal Pradesh,291,4,286,4028,2921,308,7.22,1,1.6,404265,3273,402040,182.56,19.25,2.5175,0.81,99.45
2021-04-28,Arunachal Pradesh,205,2,200,2503,2769,763,8.19,3,1.6,404470,3275,402240,173.06,47.69,1.564375,0.81,99.45
2021-04-29,Arunachal Pradesh,381,5,376,4971,285,100,7.66,0,1.6,404851,3280,402616,17.81,6.25,3.106875,0.81,99.45
2021-04-30,Arunachal Pradesh,1332,11,1324,16858,3935,3247,7.9,0,1.6,406183,3291,403940,245.94,202.94,10.53625,0.81,99.45
2021-05-01,Arunachal Pradesh,646,3,641,8189,1752,1034,7.89,2,1.6,406829,3294,404581,109.5,64.62,5.118125,0.81,99.45
2021-05-02,Arunachal Pradesh,248,2,240,3250,1926,604,7.63,6,1.6,407077,3296,404821,120.38,37.75,2.03125,0.81,99.45
2021-05-03,Arunachal Pradesh,810,2,801,10336,4444,3056,7.84,7,1.6,407887,3298,405622,277.75,191.0,6.46,0.81,99.44
2021-05-04,Arunachal Pradesh,419,4,413,5305,4573,1173,7.9,2,1.6,408306,3302,406035,285.81,73.31,3.315625,0.81,99.44
2021-05-05,Arunachal Pradesh,147,1,141,1687,1198,333,8.71,5,1.6,408453,3303,406176,74.88,20.81,1.054375,0.81,99.44
2021-05-06,Arunachal Pradesh,997,8,993,12322,3855,1885,8.09,0,1.6,409450,3311,407169,240.94,117.81,7.70125,0.81,99.44
2021-05-07,Arunachal Pradesh,1080,14,1074,13552,1684,683,7.97,0,1.6,410530,3325,408243,105.25,42.69,8.47,0.81,99.44
2021-05-08,Arunachal Pradesh,762,7,761,9924,2055,1232,7.68,0,1.6,411292,3332,409004,128.44,77.0,6.2025,0.81,99.44
2021-05-09,Arunachal Pradesh,580,7,576,7460,3906,1148,7.77,0,1.6,411872,3339,409580,244.12,71.75,4.6625,0.81,99.44
2021-05-10,Arunachal Pradesh,1461,15,1460,18135,714,576,8.06,0,1.6,413333,3354,411040,44.62,36.0,11.334375,0.81,99.45
2021-05-11,Arunachal Pradesh,1054,3,1051,12556,1952,864,8.39,0,1.6,414387,3357,412091,122.0,54.0,7.8475,0.81,99.45
2021-05-12,Arunachal Pradesh,1602,8,1601,19546,1442,719,8.2,0,1.6,415989,3365,413692,90.12,44.94,12.21625,0.81,99.45
2021-05-13,Arunachal Pradesh,771,6,768,9712,4644,3451,7.94,0,1.6,416760,3371,414460,290.25,215.69,6.07,0.81,99.45
2021-05-14,Arunachal Pradesh,722,6,714,8770,4558,1073,8.23,2,1.6,417482,3377,415174,284.88,67.06,5.48125,0.81,99.45
2021-05-15,Arunachal Pradesh,568,7,564,7352,1089,911,7.73,0,1.6,418050,3384,415738,68.06,56.94,4.595,0.81,99.45
2021-05-16,Arunachal Pradesh,1346,7,1338,16500,1205,1056,8.16,1,1.6,419396,3391,417076,75.31,66.0,10.3125,0.81,99.45
2021-05-17,Arunachal Pradesh,337,3,328,4218,1316,939,7.99,6,1.6,419733,3394,417404,82.25,58.69,2.63625,0.81,99.45
2021-05-18,Arunachal Pradesh,331,2,322,4139,2797,1872,8.0,7,1.6,420064,3396,417726,174.81,117.0,2.586875,0.81,99.44
2021-05-19,Arunachal Pradesh,1223,8,1222,15070,2578,2365,8.12,0,1.6,421287,3404,418948,161.12,147.81,9.41875,0.81,99.44
2021-05-20,Arunachal Pradesh,1500,12,1499,19098,1304,92,7.85,0,1.6,422787,3416,420447,81.5,5.75,11.93625,0.81,99.45
2021-05-21,Arunachal Pradesh,700,7,693,8731,3813,694,8.02,0,1.6,423487,3423,421140,238.31,43.38,5.456875,0.81,99.45
2021-05-22,Arunachal Pradesh,1036,3,1031,12790,2625,99,8.1,2,1.6,424523,3426,422171,164.06,6.19,7.99375,0.81,99.45
2021-05-23,Arunachal Pradesh,378,3,369,5069,1821,974,7.46,6,1.6,424901,3429,422540,113.81,60.88,3.168125,0.81,99.44
2021-05-24,Arunachal Pradesh,1224,12,1220,15016,4333,286,8.15,0,1.6,426125,3441,423760,270.81,17.88,9.385,0.81,99.44
2021-05-25,Arunachal Pradesh,1085,10,1076,13573,3503,1034,7.99,0,1.6,427210,3451,424836,218.94,64.62,8.483125,0.81,99.44
2021-05-26,Arunachal Pradesh,146,1,138,1970,1666,1347,7.41,7,1.6,427356,3452,424974,104.12,84.19,1.23125,0.81,99.44
2021-05-27,Arunachal Pradesh,292,4,286,3761,4492,218,7.76,2,1.6,427648,3456,425260,280.75,13.63,2.350625,0.81,99.44
2021-05-28,Arunachal Pradesh,550,5,548,6762,272,70,8.13,0,1.6,428198,3461,425808,17.0,4.38,4.22625,0.81,99.44
2021-05-29,Arunachal Pradesh,513,6,512,6703,3182,1595,7.65,0,1.6,428711,3467,426320,198.88,99.69,4.189375,0.81,99.44
2021-05-30,Arunachal Pradesh,752,3,750,9749,776,488,7.71,0,1.6,429463,3470,427070,48.5,30.5,6.093125,0.81,99.44
2021-05-31,Arunachal Pradesh,1377,14,1375,17414,1963,1262,7.91,0,1.6,430840,3484,428445,122.69,78.88,10.88375,0.81,99.44
2021-06-01,Arunachal Pradesh,1103,8,1096,13934,1024,85,7.92,0,1.6,431943,3492,429541,64.0,5.31,8.70875,0.81,99.44
2021-06-02,Arunachal Pradesh,46,0,38,504,2868,1263,9.13,8,1.6,431989,3492,429579,179.25,78.94,0.315,0.81,99.44
2021-06-03,Arunachal Pradesh,615,3,609,7709,4555,1108,7.98,3,1.6,432604,3495,430188,284.69,69.25,4.818125,0.81,99.44
2021-06-04,Arunachal Pradesh,1246,15,1239,15846,585,84,7.86,0,1.6,433850,3510,431427,36.56,5.25,9.90375,0.81,99.44
2021-06-05,Arunachal Pradesh,1412,10,1412,17626,2196,1780,8.01,0,1.6,435262,3520,432839,137.25,111.25,11.01625,0.81,99.44
2021-06-06,Arunachal Pradesh,867,8,867,11135,4474,2327,7.79,0,1.6,436129,3528,433706,279.62,145.44,6.959375,0.81,99.44
2021-06-07,Arunachal Pradesh,994,12,989,12321,2400,197,8.07,0,1.6,437123,3540,434695,150.0,12.31,7.700625,0.81,99.44
2021-06-08,Arunachal Pradesh,802,10,801,10095,1253,548,7.94,0,1.6,437925,3550,435496,78.31,34.25,6.309375,0.81,99.45
2021-06-09,Arunachal Pradesh,412,2,412,5198,4007,3348,7.93,0,1.6,438337,3552,435908,250.44,209.25,3.24875,0.81,99.45
2021-06-10,Arunachal Pradesh,1189,4,1181,14736,2759,1083,8.07,4,1.6,439526,3556,437089,172.44,67.69,9.21,0.81,99.45
2021-06-11,Arunachal Pradesh,47,0,47,631,1675,1463,7.45,0,1.6,439573,3556,437136,104.69,91.44,0.394375,0.81,99.45
2021-06-12,Arunachal Pradesh,84,1,83,786,505,342,10.69,0,1.6,439657,3557,437219,31.56,21.38,0.49125,0.81,99.45
2021-06-13,Arunachal Pradesh,291,3,289,3281,2038,899,8.87,0,1.6,439948,3560,437508,127.38,56.19,2.050625,0.81,99.45
2021-06-14,Arunachal Pradesh,216,1,208,2702,2510,2466,7.99,7,1.6,440164,3561,437716,156.88,154.12,1.68875,0.81,99.44
2021-06-15,Arunachal Pradesh,609,5,603,7482,1393,345,8.14,1,1.6,440773,3566,438319,87.06,21.56,4.67625,0.81,99.44
2021-06-16,Arunachal Pradesh,1212,5,1206,15266,646,166,7.94,1,1.6,441985,3571,439525,40.38,10.38,9.54125,0.81,99.44
2021-06-17,Arunachal Pradesh,1584,23,1584,19755,2392,1375,8.02,0,1.6,443569,3594,441109,149.5,85.94,12.346875,0.81,99.45
2021-06-18,Arunachal Pradesh,118,1,116,1051,1634,1127,11.23,1,1.6,443687,3595,441225,102.12,70.44,0.656875,0.81,99.45
2021-06-19,Arunachal Pradesh,1082,9,1081,13536,3037,1224,7.99,0,1.6,444769,3604,442306,189.81,76.5,8.46,0.81,99.45
2021-06-20,Arunachal Pradesh,934,4,926,11533,2806,2247,8.1,4,1.6,445703,3608,443232,175.38,140.44,7.208125,0.81,99.45
2021-06-21,Arunachal Pradesh,1227,10,1226,15593,3757,1477,7.87,0,1.6,446930,3618,444458,234.81,92.31,9.745625,0.81,99.45
2021-06-22,Arunachal Pradesh,445,2,439,5849,3507,1035,7.61,4,1.6,447375,3620,444897,219.19,64.69,3.655625,0.81,99.45
2021-06-23,Arunachal Pradesh,374,5,367,4481,1388,982,8.35,2,1.6,447749,3625,445264,86.75,61.38,2.800625,0.81,99.45
2021-06-24,Arunachal Pradesh,1337,15,1331,16482,1124,923,8.11,0,1.6,449086,3640,446595,70.25,57.69,10.30125,0.81,99.45
2021-06-25,Arunachal Pradesh,465,3,457,5660,4750,3566,8.22,5,1.6,449551,3643,447052,296.88,222.87,3.5375,0.81,99.44
2021-06-26,Arunachal Pradesh,792,10,786,9762,3982,3711,8.11,0,1.6,450343,3653,447838,248.88,231.94,6.10125,0.81,99.44
2021-06-27,Arunachal Pradesh,522,2,520,6495,4277,4003,8.04,0,1.6,450865,3655,448358,267.31,250.19,4.059375,0.81,99.44
2021-06-28,Arunachal Pradesh,1211,11,1210,14886,1086,457,8.14,0,1.6,452076,3666,449568,67.88,28.56,9.30375,0.81,99.45
2021-06-29,Arunachal Pradesh,1561,16,1557,18919,367,305,8.25,0,1.6,453637,3682,451125,22.94,19.06,11.824375,0.81,99.45
2021-06-30,Arunachal Pradesh,762,10,758,9593,2465,1258,7.94,0,1.6,454399,3692,451883,154.06,78.62,5.995625,0.81,99.45
2021-07-01,Arunachal Pradesh,564,8,563,7076,2106,1044,7.97,0,1.6,454963,3700,452446,131.62,65.25,4.4225,0.81,99.45
2021-07-02,Arunachal Pradesh,745,6,740,9289,1882,1650,8.02,0,1.6,455708,3706,453186,117.62,103.12,5.805625,0.81,99.45
2021-07-03,Arunachal Pradesh,1353,7,1353,17082,2519,1015,7.92,0,1.6,457061,3713,454539,157.44,63.44,10.67625,0.81,99.45
2021-07-04,Arunachal Pradesh,827,12,825,10206,549,214,8.1,0,1.6,457888,3725,455364,34.31,13.38,6.37875,0.81,99.45
2021-07-05,Arunachal Pradesh,1010,11,1009,12687,1919,1166,7.96,0,1.6,458898,3736,456373,119.94,72.88,7.929375,0.81,99.45
2021-07-06,Arunachal Pradesh,320,1,319,3572,639,596,8.96,0,1.6,459218,3737,456692,39.94,37.25,2.2325,0.81,99.45
2021-07-07,Arunachal Pradesh,487,2,487,6231,3388,1436,7.82,0,1.6,459705,3739,457179,211.75,89.75,3.894375,0.81,99.45
2021-07-08,Arunachal Pradesh,266,1,266,3428,4755,861,7.76,0,1.6,459971,3740,457445,297.19,53.81,2.1425,0.81,99.45
2021-07-09,Arunachal Pradesh,289,2,284,3767,4877,4088,7.67,3,1.6,460260,3742,457729,304.81,255.5,2.354375,0.81,99.45
2021-07-10,Arunachal Pradesh,387,1,380,4715,3727,1347,8.21,6,1.6,460647,3743,458109,232.94,84.19,2.946875,0.81,99.45
2021-07-11,Arunachal Pradesh,1511,12,1511,18925,1941,652,7.98,0,1.6,462158,3755,459620,121.31,40.75,11.828125,0.81,99.45
2021-07-12,Arunachal Pradesh,124,1,118,1568,2135,875,7.91,5,1.6,462282,3756,459738,133.44,54.69,0.98,0.81,99.45
2021-07-13,Arunachal Pradesh,826,6,817,10526,4107,915,7.85,3,1.6,463108,3762,460555,256.69,57.19,6.57875,0.81,99.45
2021-07-14,Arunachal Pradesh,1414,17,1409,17465,3117,1799,8.1,0,1.6,464522,3779,461964,194.81,112.44,10.915625,0.81,99.45
2021-07-15,Arunachal Pradesh,441,2,434,5611,3003,2547,7.86,5,1.6,464963,3781,462398,187.69,159.19,3.506875,0.81,99.45
2021-07-16,Arunachal Pradesh,560,5,560,6871,1654,1515,8.15,0,1.6,465523,3786,462958,103.38,94.69,4.294375,0.81,99.45
2021-07-17,Arunachal Pradesh,653,9,653,8012,4149,2799,8.15,0,1.6,466176,3795,463611,259.31,174.94,5.0075,0.81,99.45
2021-07-18,Arunachal Pradesh,23,0,17,545,2065,537,4.22,6,1.6,466199,3795,463628,129.06,33.56,0.340625,0.81,99.45
2021-07-19,Arunachal Pradesh,985,4,977,12208,3896,875,8.07,4,1.6,467184,3799,464605,243.5,54.69,7.63,0.81,99.45
2021-07-20,Arunachal Pradesh,1447,19,1444,17981,4713,517,8.05,0,1.6,468631,3818,466049,294.56,32.31,11.238125,0.81,99.45
2021-07-21,Arunachal Pradesh,1307,6,1299,16344,4212,3300,8.0,2,1.6,469938,3824,467348,263.25,206.25,10.215,0.81,99.45
2021-07-22,Arunachal Pradesh,1472,19,1465,18757,1636,783,7.85,0,1.6,471410,3843,468813,102.25,48.94,11.723125,0.82,99.45
2021-07-23,Arunachal Pradesh,446,2,445,5439,2692,948,8.2,0,1.6,471856,3845,469258,168.25,59.25,3.399375,0.81,99.45
2021-07-24,Arunachal Pradesh,100,0,95,1294,4182,1714,7.73,5,1.6,471956,3845,469353,261.38,107.12,0.80875,0.81,99.45
2021-07-25,Arunachal Pradesh,654,6,650,8070,188,172,8.1,0,1.6,472610,3851,470003,11.75,10.75,5.04375,0.81,99.45
2021-07-26,Arunachal Pradesh,1104,13,1101,13861,2634,703,7.96,0,1.6,473714,3864,471104,164.62,43.94,8.663125,0.82,99.45
2021-07-27,Arunachal Pradesh,797,2,789,9523,2483,876,8.37,6,1.6,474511,3866,471893,155.19,54.75,5.951875,0.81,99.45
2021-07-28,Arunachal Pradesh,1270,13,1270,15734,1090,966,8.07,0,1.6,475781,3879,473163,68.12,60.38,9.83375,0.82,99.45
2021-07-29,Arunachal Pradesh,825,7,817,10483,4958,321,7.87,1,1.6,476606,3886,473980,309.88,20.06,6.551875,0.82,99.45
2021-07-30,Arunachal Pradesh,163,1,157,2093,4861,3543,7.79,5,1.6,476769,3887,474137,303.81,221.44,1.308125,0.82,99.45
2021-07-31,Arunachal Pradesh,166,1,158,1529,3370,1854,10.86,7,1.6,476935,3888,474295,210.63,115.88,0.955625,0.82,99.45
2021-08-01,Arunachal Pradesh,1142,9,1142,14474,3691,814,7.89,0,1.6,478077,3897,475437,230.69,50.88,9.04625,0.82,99.45
2021-08-02,Arunachal Pradesh,432,2,428,5252,1370,565,8.23,2,1.6,478509,3899,475865,85.62,35.31,3.2825,0.81,99.45
2021-08-03,Arunachal Pradesh,1460,11,1455,18082,3121,1310,8.07,0,1.6,479969,3910,477320,195.06,81.88,11.30125,0.81,99.45
2021-08-04,Arunachal Pradesh,1417,5,1416,18027,1363,221,7.86,0,1.6,481386,3915,478736,85.19,13.81,11.266875,0.81,99.45
2021-08-05,Arunachal Pradesh,310,4,305,3955,87,64,7.84,1,1.6,481696,3919,479041,5.44,4.0,2.471875,0.81,99.45
2021-08-06,Arunachal Pradesh,1317,14,1315,16722,4434,660,7.88,0,1.6,483013,3933,480356,277.12,41.25,10.45125,0.81,99.45
2021-08-07,Arunachal Pradesh,1336,17,1333,16614,2068,887,8.04,0,1.6,484349,3950,481689,129.25,55.44,10.38375,0.82,99.45
2021-08-08,Arunachal Pradesh,1363,19,1355,16849,1180,843,8.09,0,1.6,485712,3969,483044,73.75,52.69,10.530625,0.82,99.45
2021-08-09,Arunachal Pradesh,115,1,115,1288,2268,1517,8.93,0,1.6,485827,3970,483159,141.75,94.81,0.805,0.82,99.45
2021-08-10,Arunachal Pradesh,777,9,769,9770,2585,2317,7.95,0,1.6,486604,3979,483928,161.56,144.81,6.10625,0.82,99.45
2021-08-11,Arunachal Pradesh,526,7,520,6547,3662,3642,8.03,0,1.6,487130,3986,484448,228.87,227.62,4.091875,0.82,99.45
2021-08-12,Arunachal Pradesh,1152,14,1151,14277,2095,1259,8.07,0,1.6,488282,4000,485599,130.94,78.69,8.923125,0.82,99.45
2021-08-13,Arunachal Pradesh,1342,5,1335,17300,2408,1954,7.76,2,1.6,489624,4005,486934,150.5,122.12,10.8125,0.82,99.45
2021-08-14,Arunachal Pradesh,1124,11,1121,14156,711,330,7.94,0,1.6,490748,4016,488055,44.44,20.62,8.8475,0.82,99.45
2021-08-15,Arunachal Pradesh,33,0,30,526,4429,1050,6.27,3,1.6,490781,4016,488085,276.81,65.62,0.32875,0.82,99.45
2021-08-16,Arunachal Pradesh,959,10,951,11861,3035,46,8.09,0,1.6,491740,4026,489036,189.69,2.88,7.413125,0.82,99.45
2021-08-17,Arunachal Pradesh,1549,7,1544,19286,2045,1056,8.03,0,1.6,493289,4033,490580,127.81,66.0,12.05375,0.82,99.45
2021-08-18,Arunachal Pradesh,85,0,79,962,767,378,8.84,6,1.6,493374,4033,490659,47.94,23.62,0.60125,0.82,99.45
2021-08-19,Arunachal Pradesh,642,2,640,7832,3962,3494,8.2,0,1.6,494016,4035,491299,247.62,218.38,4.895,0.82,99.45
2021-08-20,Arunachal Pradesh,288,3,285,4050,2015,1200,7.11,0,1.6,494304,4038,491584,125.94,75.0,2.53125,0.82,99.45
2021-08-21,Arunachal Pradesh,1278,15,1272,16068,300,34,7.95,0,1.6,495582,4053,492856,18.75,2.12,10.0425,0.82,99.45
2021-08-22,Arunachal Pradesh,791,3,783,10014,1555,1336,7.9,5,1.6,496373,4056,493639,97.19,83.5,6.25875,0.82,99.45
2021-08-23,Arunachal Pradesh,901,9,899,11332,2313,178,7.95,0,1.6,497274,4065,494538,144.56,11.12,7.0825,0.82,99.45
2021-08-24,Arunachal Pradesh,1509,9,1501,18868,2745,2633,8.0,0,1.6,498783,4074,496039,171.56,164.56,11.7925,0.82,99.45
2021-08-25,Arunachal Pradesh,657,8,652,8467,4354,726,7.76,0,1.6,499440,4082,496691,272.12,45.38,5.291875,0.82,99.45
2021-08-26,Arunachal Pradesh,287,3,279,3516,4544,3126,8.16,5,1.6,499727,4085,496970,284.0,195.38,2.1975,0.82,99.45
2021-08-27,Arunachal Pradesh,505,3,502,6147,2156,1933,8.22,0,1.6,500232,4088,497472,134.75,120.81,3.841875,0.82,99.45
2021-08-28,Arunachal Pradesh,1237,15,1230,15518,3644,897,7.97,0,1.6,501469,4103,498702,227.75,56.06,9.69875,0.82,99.45
2021-08-29,Arunachal Pradesh,1160,8,1157,14520,3835,2211,7.99,0,1.6,502629,4111,499859,239.69,138.19,9.075,0.82,99.45
2021-08-30,Arunachal Pradesh,822,3,819,10530,3418,1149,7.81,0,1.6,503451,4114,500678,213.62,71.81,6.58125,0.82,99.45
2021-08-31,Arunachal Pradesh,924,3,916,11642,4559,1495,7.94,5,1.6,504375,4117,501594,284.94,93.44,7.27625,0.82,99.45
2021-09-01,Arunachal Pradesh,143,1,143,2350,3749,2382,6.09,0,1.6,504518,4118,501737,234.31,148.88,1.46875,0.82,99.45
2021-09-02,Arunachal Pradesh,1074,6,1067,13471,4320,3615,7.97,1,1.6,505592,4124,502804,270.0,225.94,8.419375,0.82,99.45
2021-09-03,Arunachal Pradesh,707,8,707,9474,2711,503,7.46,0,1.6,506299,4132,503511,169.44,31.44,5.92125,0.82,99.45
2021-09-04,Arunachal Pradesh,241,3,239,2974,4658,3084,8.1,0,1.6,506540,4135,503750,291.12,192.75,1.85875,0.82,99.45
2021-09-05,Arunachal Pradesh,330,4,321,4224,1057,1030,7.81,5,1.6,506870,4139,504071,66.06,64.38,2.64,0.82,99.45
2021-09-06,Arunachal Pradesh,1093,6,1093,13359,377,34,8.18,0,1.6,507963,4145,505164,23.56,2.12,8.349375,0.82,99.45
2021-09-07,Arunachal Pradesh,121,0,121,2132,2948,829,5.68,0,1.6,508084,4145,505285,184.25,51.81,1.3325,0.82,99.45
2021-09-08,Arunachal Pradesh,378,4,375,4856,1768,368,7.78,0,1.6,508462,4149,505660,110.5,23.0,3.035,0.82,99.45
2021-09-09,Arunachal Pradesh,621,4,619,7525,1571,180,8.25,0,1.6,509083,4153,506279,98.19,11.25,4.703125,0.82,99.45
2021-09-10,Arunachal Pradesh,528,7,522,6986,3122,721,7.56,0,1.6,509611,4160,506801,195.12,45.06,4.36625,0.82,99.45
2021-09-11,Arunachal Pradesh,390,4,388,4698,3172,2406,8.3,0,1.6,510001,4164,507189,198.25,150.38,2.93625,0.82,99.45
2021-09-12,Arunachal Pradesh,596,3,591,7657,931,100,7.78,2,1.6,510597,4167,507780,58.19,6.25,4.785625,0.82,99.45
2021-09-13,Arunachal Pradesh,269,1,266,3345,4140,931,8.04,2,1.6,510866,4168,508046,258.75,58.19,2.090625,0.82,99.45
2021-09-14,Arunachal Pradesh,905,12,904,11073,3252,3133,8.17,0,1.6,511771,4180,508950,203.25,195.81,6.920625,0.82,99.45
2021-09-15,Arunachal Pradesh,594,7,591,7257,3979,1986,8.19,0,1.6,512365,4187,509541,248.69,124.12,4.535625,0.82,99.45
2021-09-16,Arunachal Pradesh,64,0,58,550,1537,1269,11.64,6,1.6,512429,4187,509599,96.06,79.31,0.34375,0.82,99.45
2021-09-17,Arunachal Pradesh,1046,7,1038,13021,3112,2039,8.03,1,1.6,513475,4194,510637,194.5,127.44,8.138125,0.82,99.45
2021-09-18,Arunachal Pradesh,1273,11,1270,15766,2685,1948,8.07,0,1.6,514748,4205,511907,167.81,121.75,9.85375,0.82,99.45
2021-09-19,Arunachal Pradesh,393,4,391,4902,2275,247,8.02,0,1.6,515141,4209,512298,142.19,15.44,3.06375,0.82,99.45
2021-09-20,Arunachal Pradesh,241,0,238,3038,3676,480,7.93,3,1.6,515382,4209,512536,229.75,30.0,1.89875,0.82,99.45
2021-09-21,Arunachal Pradesh,1336,12,1331,16689,1628,992,8.01,0,1.6,516718,4221,513867,101.75,62.0,10.430625,0.82,99.45
2021-09-22,Arunachal Pradesh,761,8,760,9652,451,41,7.88,0,1.6,517479,4229,514627,28.19,2.56,6.0325,0.82,99.45
2021-09-23,Arunachal Pradesh,170,1,162,1985,3123,1659,8.56,7,1.6,517649,4230,514789,195.19,103.69,1.240625,0.82,99.45
2021-09-24,Arunachal Pradesh,507,3,501,5874,2265,1627,8.63,3,1.6,518156,4233,515290,141.56,101.69,3.67125,0.82,99.45
2021-09-25,Arunachal Pradesh,1537,14,1534,19387,1309,374,7.93,0,1.6,519693,4247,516824,81.81,23.38,12.116875,0.82,99.45
2021-09-26,Arunachal Pradesh,1049,5,1041,13198,1796,469,7.95,3,1.6,520742,4252,517865,112.25,29.31,8.24875,0.82,99.45
2021-09-27,Arunachal Pradesh,377,5,368,4544,2988,12,8.3,4,1.6,521119,4257,518233,186.75,0.75,2.84,0.82,99.45
2021-09-28,Arunachal Pradesh,150,1,148,1332,4849,2650,11.26,1,1.6,521269,4258,518381,303.06,165.62,0.8325,0.82,99.45
2021-09-29,Arunachal Pradesh,656,4,654,8180,4508,4130,8.02,0,1.6,521925,4262,519035,281.75,258.12,5.1125,0.82,99.45
2021-09-30,Arunachal Pradesh,529,6,522,6761,800,471,7.82,1,1.6,522454,4268,519557,50.0,29.44,4.225625,0.82,99.45
2021-10-01,Arunachal Pradesh,757,6,755,9370,855,539,8.08,0,1.6,523211,4274,520312,53.44,33.69,5.85625,0.82,99.45
2021-10-02,Arunachal Pradesh,1302,6,1300,16073,1984,1538,8.1,0,1.6,524513,4280,521612,124.0,96.12,10.045625,0.82,99.45
2021-10-03,Arunachal Pradesh,917,2,917,10936,2154,791,8.39,0,1.6,525430,4282,522529,134.62,49.44,6.835,0.81,99.45
2021-10-04,Arunachal Pradesh,1579,7,1570,19834,4010,3945,7.96,2,1.6,527009,4289,524099,250.62,246.56,12.39625,0.81,99.45
2021-10-05,Arunachal Pradesh,1221,9,1215,15554,2715,1032,7.85,0,1.6,528230,4298,525314,169.69,64.5,9.72125,0.81,99.45
2021-10-06,Arunachal Pradesh,276,0,267,3589,3527,960,7.69,9,1.6,528506,4298,525581,220.44,60.0,2.243125,0.81,99.45
2021-10-07,Arunachal Pradesh,1387,8,1386,17197,4132,2501,8.07,0,1.6,529893,4306,526967,258.25,156.31,10.748125,0.81,99.45
2021-10-08,Arunachal Pradesh,806,9,805,9637,4736,1682,8.36,0,1.6,530699,4315,527772,296.0,105.12,6.023125,0.81,99.45
2021-10-09,Arunachal Pradesh,404,5,398,5039,648,444,8.02,1,1.6,531103,4320,528170,40.5,27.75,3.149375,0.81,99.45
2021-10-10,Arunachal Pradesh,1535,11,1527,19006,1620,235,8.08,0,1.6,532638,4331,529697,101.25,14.69,11.87875,0.81,99.45
2021-10-11,Arunachal Pradesh,302,2,296,4032,1955,756,7.49,4,1.6,532940,4333,529993,122.19,47.25,2.52,0.81,99.45
2021-10-12,Arunachal Pradesh,1308,6,1308,16050,4338,4332,8.15,0,1.6,534248,4339,531301,271.12,270.75,10.03125,0.81,99.45
2021-10-13,Arunachal Pradesh,1111,6,1102,13863,4717,2291,8.01,3,1.6,535359,4345,532403,294.81,143.19,8.664375,0.81,99.45
2021-10-14,Arunachal Pradesh,686,6,684,8591,2766,1128,7.99,0,1.6,536045,4351,533087,172.88,70.5,5.369375,0.81,99.45
2021-10-15,Arunachal Pradesh,1218,12,1212,15390,3549,2666,7.91,0,1.6,537263,4363,534299,221.81,166.62,9.61875,0.81,99.45
2021-10-16,Arunachal Pradesh,294,4,291,3932,96,65,7.48,0,1.6,537557,4367,534590,6.0,4.06,2.4575,0.81,99.45
2021-10-17,Arunachal Pradesh,1100,14,1098,13986,2823,267,7.87,0,1.6,538657,4381,535688,176.44,16.69,8.74125,0.81,99.45
2021-10-18,Arunachal Pradesh,1094,3,1086,13713,2554,982,7.98,5,1.6,539751,4384,536774,159.62,61.38,8.570625,0.81,99.45
2021-10-19,Arunachal Pradesh,237,3,234,2890,1096,554,8.2,0,1.6,539988,4387,537008,68.5,34.62,1.80625,0.81,99.45
2021-10-20,Arunachal Pradesh,1594,18,1588,19844,1163,230,8.03,0,1.6,541582,4405,538596,72.69,14.37,12.4025,0.81,99.45
2021-10-21,Arunachal Pradesh,585,4,585,6760,1427,1354,8.65,0,1.6,542167,4409,539181,89.19,84.62,4.225,0.81,99.45
2021-10-22,Arunachal Pradesh,381,2,373,4489,4023,2301,8.49,6,1.6,542548,4411,539554,251.44,143.81,2.805625,0.81,99.45
2021-10-23,Arunachal Pradesh,845,2,842,10772,2183,2000,7.84,1,1.6,543393,4413,540396,136.44,125.0,6.7325,0.81,99.45
2021-10-24,Arunachal Pradesh,228,2,223,2390,2290,715,9.54,3,1.6,543621,4415,540619,143.12,44.69,1.49375,0.81,99.45
2021-10-25,Arunachal Pradesh,301,3,300,3713,1557,889,8.11,0,1.6,543922,4418,540919,97.31,55.56,2.320625,0.81,99.45
2021-10-26,Arunachal Pradesh,607,7,603,7704,3830,2952,7.88,0,1.6,544529,4425,541522,239.37,184.5,4.815,0.81,99.45
2021-10-27,Arunachal Pradesh,817,2,812,10492,78,24,7.79,3,1.6,545346,4427,542334,4.88,1.5,6.5575,0.81,99.45
2021-10-28,Arunachal Pradesh,518,4,514,6637,981,212,7.8,0,1.6,545864,4431,542848,61.31,13.25,4.148125,0.81,99.45
2021-10-29,Arunachal Pradesh,1509,14,1504,18863,3714,3520,8.0,0,1.6,547373,4445,544352,232.12,220.0,11.789375,0.81,99.45
2021-10-30,Arunachal Pradesh,390,2,382,4368,487,141,8.93,6,1.6,547763,4447,544734,30.44,8.81,2.73,0.81,99.45
2021-10-31,Arunachal Pradesh,1385,14,1376,17118,3256,1496,8.09,0,1.6,549148,4461,546110,203.5,93.5,10.69875,0.81,99.45
2021-11-01,Arunachal Pradesh,477,3,473,5680,4283,1554,8.4,1,1.6,549625,4464,546583,267.69,97.12,3.55,0.81,99.45
2021-11-02,Arunachal Pradesh,568,2,564,7174,861,131,7.92,2,1.6,550193,4466,547147,53.81,8.19,4.48375,0.81,99.45
2021-11-03,Arunachal Pradesh,564,3,560,7626,4594,1905,7.4,1,1.6,550757,4469,547707,287.12,119.06,4.76625,0.81,99.45
2021-11-04,Arunachal Pradesh,1017,9,1009,13355,4714,4560,7.62,0,1.6,551774,4478,548716,294.62,285.0,8.346875,0.81,99.45
2021-11-05,Arunachal Pradesh,1189,12,1180,14781,3622,474,8.04,0,1.6,552963,4490,549896,226.38,29.62,9.238125,0.81,99.45
2021-11-06,Arunachal Pradesh,1362,12,1357,16528,3167,2782,8.24,0,1.6,554325,4502,551253,197.94,173.88,10.33,0.81,99.45
2021-11-07,Arunachal Pradesh,1254,17,1254,15622,557,519,8.03,0,1.6,555579,4519,552507,34.81,32.44,9.76375,0.81,99.45
2021-11-08,Arunachal Pradesh,421,2,413,5203,3996,2498,8.09,6,1.6,556000,4521,552920,249.75,156.12,3.251875,0.81,99.45
2021-11-09,Arunachal Pradesh,551,7,542,6829,433,299,8.07,2,1.6,556551,4528,553462,27.06,18.69,4.268125,0.81,99.44
2021-11-10,Arunachal Pradesh,1212,4,1203,15122,2193,69,8.01,5,1.6,557763,4532,554665,137.06,4.31,9.45125,0.81,99.44
2021-11-11,Arunachal Pradesh,916,3,916,11734,3612,3052,7.81,0,1.6,558679,4535,555581,225.75,190.75,7.33375,0.81,99.45
2021-11-12,Arunachal Pradesh,1334,16,1325,16645,2781,2674,8.01,0,1.6,560013,4551,556906,173.81,167.12,10.403125,0.81,99.45
2021-11-13,Arunachal Pradesh,1061,10,1060,13664,2649,972,7.76,0,1.6,561074,4561,557966,165.56,60.75,8.54,0.81,99.45
2021-11-14,Arunachal Pradesh,1117,14,1114,13881,3747,2080,8.05,0,1.6,562191,4575,559080,234.19,130.0,8.675625,0.81,99.45
2021-11-15,Arunachal Pradesh,1071,12,1069,13271,2214,164,8.07,0,1.6,563262,4587,560149,138.38,10.25,8.294375,0.81,99.45
2021-11-16,Arunachal Pradesh,54,0,47,515,4624,4564,10.49,7,1.6,563316,4587,560196,289.0,285.25,0.321875,0.81,99.45
2021-11-17,Arunachal Pradesh,1218,11,1217,15476,4867,1586,7.87,0,1.6,564534,4598,561413,304.19,99.12,9.6725,0.81,99.45
2021-11-18,Arunachal Pradesh,1062,15,1053,13655,3060,695,7.78,0,1.6,565596,4613,562466,191.25,43.44,8.534375,0.82,99.45
2021-11-19,Arunachal Pradesh,347,2,339,4531,4147,147,7.66,6,1.6,565943,4615,562805,259.19,9.19,2.831875,0.82,99.45
2021-11-20,Arunachal Pradesh,1343,19,1339,16602,1492,1198,8.09,0,1.6,567286,4634,564144,93.25,74.88,10.37625,0.82,99.45
2021-11-21,Arunachal Pradesh,193,1,184,2487,1377,939,7.76,8,1.6,567479,4635,564328,86.06,58.69,1.554375,0.82,99.44
2021-11-22,Arunachal Pradesh,1583,12,1583,19659,2157,867,8.05,0,1.6,569062,4647,565911,134.81,54.19,12.286875,0.82,99.45
2021-11-23,Arunachal Pradesh,521,3,519,6555,4371,3364,7.95,0,1.6,569583,4650,566430,273.19,210.25,4.096875,0.82,99.45
2021-11-24,Arunachal Pradesh,1010,11,1009,12826,2310,622,7.87,0,1.6,570593,4661,567439,144.38,38.88,8.01625,0.82,99.45
2021-11-25,Arunachal Pradesh,581,7,572,6771,3938,1100,8.58,2,1.6,571174,4668,568011,246.13,68.75,4.231875,0.82,99.45
2021-11-26,Arunachal Pradesh,499,3,495,6146,831,51,8.12,1,1.6,571673,4671,568506,51.94,3.19,3.84125,0.82,99.45
2021-11-27,Arunachal Pradesh,1161,8,1159,14833,1566,755,7.83,0,1.6,572834,4679,569665,97.88,47.19,9.270625,0.82,99.45
2021-11-28,Arunachal Pradesh,555,5,548,6849,658,535,8.1,2,1.6,573389,4684,570213,41.12,33.44,4.280625,0.82,99.45
2021-11-29,Arunachal Pradesh,1282,12,1276,15817,3152,1046,8.11,0,1.6,574671,4696,571489,197.0,65.38,9.885625,0.82,99.45
2021-11-30,Arunachal Pradesh,507,2,499,6836,2260,2129,7.42,6,1.6,575178,4698,571988,141.25,133.06,4.2725,0.82,99.45
2021-12-01,Arunachal Pradesh,116,1,112,1382,3294,2317,8.39,3,1.6,575294,4699,572100,205.88,144.81,0.86375,0.82,99.44
2021-12-02,Arunachal Pradesh,236,3,232,3097,4887,3232,7.62,1,1.6,575530,4702,572332,305.44,202.0,1.935625,0.82,99.44
2021-12-03,Arunachal Pradesh,1329,9,1324,16831,4975,4481,7.9,0,1.6,576859,4711,573656,310.94,280.06,10.519375,0.82,99.44
2021-12-04,Arunachal Pradesh,1302,4,1297,15975,3473,1437,8.15,1,1.6,578161,4715,574953,217.06,89.81,9.984375,0.82,99.45
2021-12-05,Arunachal Pradesh,1289,9,1285,16127,1155,907,7.99,0,1.6,579450,4724,576238,72.19,56.69,10.079375,0.82,99.45
2021-12-06,Arunachal Pradesh,431,1,431,5266,1482,895,8.18,0,1.6,579881,4725,576669,92.62,55.94,3.29125,0.81,99.45
2021-12-07,Arunachal Pradesh,406,3,404,4830,3039,170,8.41,0,1.6,580287,4728,577073,189.94,10.62,3.01875,0.81,99.45
2021-12-08,Arunachal Pradesh,993,6,990,12201,907,555,8.14,0,1.6,581280,4734,578063,56.69,34.69,7.625625,0.81,99.45
2021-12-09,Arunachal Pradesh,1300,12,1297,16580,3321,2619,7.84,0,1.6,582580,4746,579360,207.56,163.69,10.3625,0.81,99.45
2021-12-10,Arunachal Pradesh,1199,10,1196,15372,3365,3340,7.8,0,1.6,583779,4756,580556,210.31,208.75,9.6075,0.81,99.45
2021-12-11,Arunachal Pradesh,421,1,416,5307,2408,281,7.93,4,1.6,584200,4757,580972,150.5,17.56,3.316875,0.81,99.45
2021-12-12,Arunachal Pradesh,1330,8,1327,16294,828,321,8.16,0,1.6,585530,4765,582299,51.75,20.06,10.18375,0.81,99.45
2021-12-13,Arunachal Pradesh,336,1,335,4272,4482,2544,7.87,0,1.6,585866,4766,582634,280.12,159.0,2.67,0.81,99.45
2021-12-14,Arunachal Pradesh,1389,16,1385,17641,4906,4302,7.87,0,1.6,587255,4782,584019,306.62,268.88,11.025625,0.81,99.45
2021-12-15,Arunachal Pradesh,1586,17,1584,19795,4753,1199,8.01,0,1.6,588841,4799,585603,297.06,74.94,12.371875,0.81,99.45
2021-12-16,Arunachal Pradesh,1239,4,1231,15409,1752,1394,8.04,4,1.6,590080,4803,586834,109.5,87.12,9.630625,0.81,99.45
2021-12-17,Arunachal Pradesh,55,0,52,651,992,930,8.45,3,1.6,590135,4803,586886,62.0,58.13,0.406875,0.81,99.45
2021-12-18,Arunachal Pradesh,246,3,244,3403,813,474,7.23,0,1.6,590381,4806,587130,50.81,29.62,2.126875,0.81,99.45
2021-12-19,Arunachal Pradesh,975,14,973,12013,296,162,8.12,0,1.6,591356,4820,588103,18.5,10.12,7.508125,0.82,99.45
2021-12-20,Arunachal Pradesh,1100,3,1098,13531,2343,2299,8.13,0,1.6,592456,4823,589201,146.44,143.69,8.456875,0.81,99.45
2021-12-21,Arunachal Pradesh,1194,9,1191,14954,3846,3473,7.98,0,1.6,593650,4832,590392,240.38,217.06,9.34625,0.81,99.45
2021-12-22,Arunachal Pradesh,1334,14,1334,16234,4678,438,8.22,0,1.6,594984,4846,591726,292.38,27.38,10.14625,0.81,99.45
2021-12-23,Arunachal Pradesh,276,3,269,3527,1178,1007,7.83,4,1.6,595260,4849,591995,73.62,62.94,2.204375,0.81,99.45
2021-12-24,Arunachal Pradesh,545,6,536,6817,2067,59,7.99,3,1.6,595805,4855,592531,129.19,3.69,4.260625,0.81,99.45
2021-12-25,Arunachal Pradesh,1287,14,1280,15839,1735,819,8.13,0,1.6,597092,4869,593811,108.44,51.19,9.899375,0.82,99.45
2021-12-26,Arunachal Pradesh,818,11,814,10292,4448,79,7.95,0,1.6,597910,4880,594625,278.0,4.94,6.4325,0.82,99.45
2021-12-27,Arunachal Pradesh,894,9,889,11535,229,9,7.75,0,1.6,598804,4889,595514,14.31,0.56,7.209375,0.82,99.45
2021-12-28,Arunachal Pradesh,189,1,188,2581,2528,942,7.32,0,1.6,598993,4890,595702,158.0,58.88,1.613125,0.82,99.45
2021-12-29,Arunachal Pradesh,394,5,393,4732,2794,1248,8.33,0,1.6,599387,4895,596095,174.62,78.0,2.9575,0.82,99.45
2021-12-30,Arunachal Pradesh,356,2,349,5220,981,707,6.82,5,1.6,599743,4897,596444,61.31,44.19,3.2625,0.82,99.45
2021-12-31,Arunachal Pradesh,605,2,602,7449,3769,290,8.12,1,1.6,600348,4899,597046,235.56,18.12,4.655625,0.82,99.45
2022-01-01,Arunachal Pradesh,771,8,762,9717,678,340,7.93,1,1.6,601119,4907,597808,42.38,21.25,6.073125,0.82,99.45
2022-01-02,Arunachal Pradesh,989,12,986,12135,688,51,8.15,0,1.6,602108,4919,598794,43.0,3.19,7.584375,0.82,99.45
2022-01-03,Arunachal Pradesh,662,2,659,7829,77,18,8.46,1,1.6,602770,4921,599453,4.81,1.12,4.893125,0.82,99.45
2022-01-04,Arunachal Pradesh,1330,6,1325,16649,3223,261,7.99,0,1.6,604100,4927,600778,201.44,16.31,10.405625,0.82,99.45
2022-01-05,Arunachal Pradesh,1253,13,1253,16025,387,75,7.82,0,1.6,605353,4940,602031,24.19,4.69,10.015625,0.82,99.45
2022-01-06,Arunachal Pradesh,939,9,931,11711,3379,849,8.02,0,1.6,606292,4949,602962,211.19,53.06,7.319375,0.82,99.45
2022-01-07,Arunachal Pradesh,325,3,316,4603,1077,1067,7.06,6,1.6,606617,4952,603278,67.31,66.69,2.876875,0.82,99.45
2022-01-08,Arunachal Pradesh,1255,14,1252,15567,592,286,8.06,0,1.6,607872,4966,604530,37.0,17.88,9.729375,0.82,99.45
2022-01-09,Arunachal Pradesh,797,6,796,10384,733,338,7.68,0,1.6,608669,4972,605326,45.81,21.12,6.49,0.82,99.45
2022-01-10,Arunachal Pradesh,1544,8,1538,19625,1885,1471,7.87,0,1.6,610213,4980,606864,117.81,91.94,12.265625,0.82,99.45
2022-01-11,Arunachal Pradesh,1596,22,1596,19995,3183,1161,7.98,0,1.6,611809,5002,608460,198.94,72.56,12.496875,0.82,99.45
2022-01-12,Arunachal Pradesh,1536,21,1530,19065,1661,730,8.06,0,1.6,613345,5023,609990,103.81,45.62,11.915625,0.82,99.45
2022-01-13,Arunachal Pradesh,1044,10,1038,13035,3143,2446,8.01,0,1.6,614389,5033,611028,196.44,152.88,8.146875,0.82,99.45
2022-01-14,Arunachal Pradesh,315,2,314,4469,2818,145,7.05,0,1.6,614704,5035,611342,176.12,9.06,2.793125,0.82,99.45
2022-01-15,Arunachal Pradesh,136,1,136,1803,4331,244,7.54,0,1.6,614840,5036,611478,270.69,15.25,1.126875,0.82,99.45
2022-01-16,Arunachal Pradesh,1504,11,1498,18396,269,218,8.18,0,1.6,616344,5047,612976,16.81,13.63,11.4975,0.82,99.45
2022-01-17,Arunachal Pradesh,1489,7,1487,18314,1685,522,8.13,0,1.6,617833,5054,614463,105.31,32.62,11.44625,0.82,99.45
2022-01-18,Arunachal Pradesh,710,8,704,8787,2264,40,8.08,0,1.6,618543,5062,615167,141.5,2.5,5.491875,0.82,99.45
2022-01-19,Arunachal Pradesh,544,6,544,6671,2852,2676,8.15,0,1.6,619087,5068,615711,178.25,167.25,4.169375,0.82,99.45
2022-01-20,Arunachal Pradesh,563,3,562,7237,2908,1372,7.78,0,1.6,619650,5071,616273,181.75,85.75,4.523125,0.82,99.46
2022-01-21,Arunachal Pradesh,1343,16,1341,16741,3584,2572,8.02,0,1.6,620993,5087,617614,224.0,160.75,10.463125,0.82,99.46
2022-01-22,Arunachal Pradesh,1315,15,1308,16829,64,4,7.81,0,1.6,622308,5102,618922,4.0,0.25,10.518125,0.82,99.46
2022-01-23,Arunachal Pradesh,743,2,740,9487,747,492,7.83,1,1.6,623051,5104,619662,46.69,30.75,5.929375,0.82,99.46
2022-01-24,Arunachal Pradesh,916,10,911,11717,3168,3056,7.82,0,1.6,623967,5114,620573,198.0,191.0,7.323125,0.82,99.46
2022-01-25,Arunachal Pradesh,371,4,364,4997,208,45,7.42,3,1.6,624338,5118,620937,13.0,2.81,3.123125,0.82,99.46
2022-01-26,Arunachal Pradesh,620,2,611,7484,2204,175,8.28,7,1.6,624958,5120,621548,137.75,10.94,4.6775,0.82,99.45
2022-01-27,Arunachal Pradesh,1097,6,1092,14010,2675,720,7.83,0,1.6,626055,5126,622640,167.19,45.0,8.75625,0.82,99.45
2022-01-28,Arunachal Pradesh,1188,3,1180,15043,2640,2027,7.9,5,1.6,627243,5129,623820,165.0,126.69,9.401875,0.82,99.45
2022-01-29,Arunachal Pradesh,1509,8,1502,19271,1465,1142,7.83,0,1.6,628752,5137,625322,91.56,71.38,12.044375,0.82,99.45
2022-01-30,Arunachal Pradesh,780,3,780,9748,1119,43,8.0,0,1.6,629532,5140,626102,69.94,2.69,6.0925,0.82,99.46
2022-01-31,Arunachal Pradesh,1585,16,1578,19797,4061,1202,8.01,0,1.6,631117,5156,627680,253.81,75.12,12.373125,0.82,99.46
2022-02-01,Arunachal Pradesh,893,5,893,11422,3930,1330,7.82,0,1.6,632010,5161,628573,245.62,83.12,7.13875,0.82,99.46
2022-02-02,Arunachal Pradesh,292,3,285,3763,476,150,7.76,4,1.6,632302,5164,628858,29.75,9.38,2.351875,0.82,99.46
2022-02-03,Arunachal Pradesh,46,0,42,574,4688,1895,8.01,4,1.6,632348,5164,628900,293.0,118.44,0.35875,0.82,99.45
2022-02-04,Arunachal Pradesh,1306,17,1304,15904,2289,2141,8.21,0,1.6,633654,5181,630204,143.06,133.81,9.94,0.82,99.46
2022-02-05,Arunachal Pradesh,1508,4,1505,18619,2947,2922,8.1,0,1.6,635162,5185,631709,184.19,182.62,11.636875,0.82,99.46
2022-02-06,Arunachal Pradesh,390,4,390,5051,4412,25,7.72,0,1.6,635552,5189,632099,275.75,1.56,3.156875,0.82,99.46
2022-02-07,Arunachal Pradesh,299,1,297,3501,1130,828,8.54,1,1.6,635851,5190,632396,70.62,51.75,2.188125,0.82,99.46
2022-02-08,Arunachal Pradesh,1538,9,1537,19141,1905,479,8.04,0,1.6,637389,5199,633933,119.06,29.94,11.963125,0.82,99.46
2022-02-09,Arunachal Pradesh,981,10,979,12310,2459,1357,7.97,0,1.6,638370,5209,634912,153.69,84.81,7.69375,0.82,99.46
2022-02-10,Arunachal Pradesh,1475,11,1475,18412,220,196,8.01,0,1.6,639845,5220,636387,13.75,12.25,11.5075,0.82,99.46
2022-02-11,Arunachal Pradesh,43,0,43,920,2051,89,4.67,0,1.6,639888,5220,636430,128.19,5.56,0.575,0.82,99.46
2022-02-12,Arunachal Pradesh,1172,15,1165,14907,4561,1586,7.86,0,1.6,641060,5235,637595,285.06,99.12,9.316875,0.82,99.46
2022-02-13,Arunachal Pradesh,844,4,843,10607,2791,372,7.96,0,1.6,641904,5239,638438,174.44,23.25,6.629375,0.82,99.46
2022-02-14,Arunachal Pradesh,496,6,488,6164,4325,1254,8.05,2,1.6,642400,5245,638926,270.31,78.38,3.8525,0.82,99.46
2022-02-15,Arunachal Pradesh,840,2,835,10552,3128,1216,7.96,3,1.6,643240,5247,639761,195.5,76.0,6.595,0.82,99.46
2022-02-16,Arunachal Pradesh,1112,9,1111,13975,682,176,7.96,0,1.6,644352,5256,640872,42.62,11.0,8.734375,0.82,99.46
2022-02-17,Arunachal Pradesh,1410,10,1401,17742,4016,3087,7.95,0,1.6,645762,5266,642273,251.0,192.94,11.08875,0.82,99.46
2022-02-18,Arunachal Pradesh,1440,13,1435,17726,861,638,8.12,0,1.6,647202,5279,643708,53.81,39.88,11.07875,0.82,99.46
2022-02-19,Arunachal Pradesh,236,2,233,3150,442,423,7.49,1,1.6,647438,5281,643941,27.62,26.44,1.96875,0.82,99.46
2022-02-20,Arunachal Pradesh,354,3,345,4578,3892,2375,7.73,6,1.6,647792,5284,644286,243.25,148.44,2.86125,0.82,99.46
2022-02-21,Arunachal Pradesh,1485,18,1483,18792,4850,3028,7.9,0,1.6,649277,5302,645769,303.12,189.25,11.745,0.82,99.46
2022-02-22,Arunachal Pradesh,745,10,741,8754,4416,1559,8.51,0,1.6,650022,5312,646510,276.0,97.44,5.47125,0.82,99.46
2022-02-23,Arunachal Pradesh,619,7,616,8054,3409,2338,7.69,0,1.6,650641,5319,647126,213.06,146.12,5.03375,0.82,99.46
2022-02-24,Arunachal Pradesh,492,6,491,5989,765,190,8.22,0,1.6,651133,5325,647617,47.81,11.88,3.743125,0.82,99.46
2022-02-25,Arunachal Pradesh,120,0,120,1201,4081,3396,9.99,0,1.6,651253,5325,647737,255.06,212.25,0.750625,0.82,99.46
2022-02-26,Arunachal Pradesh,919,5,915,11736,2019,157,7.83,0,1.6,652172,5330,648652,126.19,9.81,7.335,0.82,99.46
2022-02-27,Arunachal Pradesh,805,2,797,9985,4809,4225,8.06,6,1.6,652977,5332,649449,300.56,264.06,6.240625,0.82,99.46
2022-02-28,Arunachal Pradesh,119,0,118,1450,4448,2098,8.21,1,1.6,653096,5332,649567,278.0,131.12,0.90625,0.82,99.46
2022-03-01,Arunachal Pradesh,309,4,300,3921,1840,1414,7.88,5,1.6,653405,5336,649867,115.0,88.38,2.450625,0.82,99.46
2022-03-02,Arunachal Pradesh,830,4,829,10355,4837,4179,8.02,0,1.6,654235,5340,650696,302.31,261.19,6.471875,0.82,99.46
2022-03-03,Arunachal Pradesh,81,0,78,1019,1080,853,7.95,3,1.6,654316,5340,650774,67.5,53.31,0.636875,0.82,99.46
2022-03-04,Arunachal Pradesh,173,1,166,2120,3954,205,8.16,6,1.6,654489,5341,650940,247.12,12.81,1.325,0.82,99.46
2022-03-05,Arunachal Pradesh,1583,14,1576,19538,419,167,8.1,0,1.6,656072,5355,652516,26.19,10.44,12.21125,0.82,99.46
2022-03-06,Arunachal Pradesh,872,5,865,11710,1134,536,7.45,2,1.6,656944,5360,653381,70.88,33.5,7.31875,0.82,99.46
2022-03-07,Arunachal Pradesh,1051,3,1046,13248,2826,2676,7.93,2,1.6,657995,5363,654427,176.62,167.25,8.28,0.82,99.46
2022-03-08,Arunachal Pradesh,516,1,507,6625,317,89,7.79,8,1.6,658511,5364,654934,19.81,5.56,4.140625,0.81,99.46
2022-03-09,Arunachal Pradesh,392,5,385,5072,2941,1058,7.73,2,1.6,658903,5369,655319,183.81,66.12,3.17,0.81,99.46
2022-03-10,Arunachal Pradesh,1078,15,1071,13037,2946,1565,8.27,0,1.6,659981,5384,656390,184.12,97.81,8.148125,0.82,99.46
2022-03-11,Arunachal Pradesh,1349,12,1342,16799,4999,2944,8.03,0,1.6,661330,5396,657732,312.44,184.0,10.499375,0.82,99.46
2022-03-12,Arunachal Pradesh,1319,15,1310,16486,2076,1179,8.0,0,1.6,662649,5411,659042,129.75,73.69,10.30375,0.82,99.46
2022-03-13,Arunachal Pradesh,1055,15,1050,12945,991,936,8.15,0,1.6,663704,5426,660092,61.94,58.5,8.090625,0.82,99.46
2022-03-14,Arunachal Pradesh,1031,14,1023,12655,3134,1071,8.15,0,1.6,664735,5440,661115,195.88,66.94,7.909375,0.82,99.46
2022-03-15,Arunachal Pradesh,220,1,213,2516,4158,0,8.74,6,1.6,664955,5441,661328,259.88,0.0,1.5725,0.82,99.45
2022-03-16,Arunachal Pradesh,1075,7,1073,13574,2000,1721,7.92,0,1.6,666030,5448,662401,125.0,107.56,8.48375,0.82,99.46
2022-03-17,Arunachal Pradesh,927,8,923,11225,1137,1129,8.26,0,1.6,666957,5456,663324,71.06,70.56,7.015625,0.82,99.46
2022-03-18,Arunachal Pradesh,191,0,189,2575,4592,485,7.42,2,1.6,667148,5456,663513,287.0,30.31,1.609375,0.82,99.46
2022-03-19,Arunachal Pradesh,1397,14,1393,17677,3277,977,7.9,0,1.6,668545,5470,664906,204.81,61.06,11.048125,0.82,99.46
2022-03-20,Arunachal Pradesh,1221,5,1220,15559,4603,3552,7.85,0,1.6,669766,5475,666126,287.69,222.0,9.724375,0.82,99.46
2022-03-21,Arunachal Pradesh,1477,8,1476,18416,224,16,8.02,0,1.6,671243,5483,667602,14.0,1.0,11.51,0.82,99.46
2022-03-22,Arunachal Pradesh,977,12,968,11961,263,9,8.17,0,1.6,672220,5495,668570,16.44,0.56,7.475625,0.82,99.46
2022-03-23,Arunachal Pradesh,591,6,582,7529,2205,1733,7.85,3,1.6,672811,5501,669152,137.81,108.31,4.705625,0.82,99.46
2022-03-24,Arunachal Pradesh,1304,4,1298,16193,3617,1174,8.05,2,1.6,674115,5505,670450,226.06,73.38,10.120625,0.82,99.46
2022-03-25,Arunachal Pradesh,612,1,603,8093,1405,1251,7.56,8,1.6,674727,5506,671053,87.81,78.19,5.058125,0.82,99.46
2022-03-26,Arunachal Pradesh,227,2,220,2718,3351,2045,8.35,5,1.6,674954,5508,671273,209.44,127.81,1.69875,0.82,99.45
2022-03-27,Arunachal Pradesh,1442,10,1439,17836,4392,927,8.08,0,1.6,676396,5518,672712,274.5,57.94,11.1475,0.82,99.46
2022-03-28,Arunachal Pradesh,292,4,290,3903,1435,399,7.48,0,1.6,676688,5522,673002,89.69,24.94,2.439375,0.82,99.46
2022-03-29,Arunachal Pradesh,1251,13,1244,15356,4521,140,8.15,0,1.6,677939,5535,674246,282.56,8.75,9.5975,0.82,99.46
2022-03-30,Arunachal Pradesh,841,7,840,10941,290,290,7.69,0,1.6,678780,5542,675086,18.12,18.12,6.838125,0.82,99.46
2022-03-31,Arunachal Pradesh,1043,10,1041,13028,3518,2871,8.01,0,1.6,679823,5552,676127,219.88,179.44,8.1425,0.82,99.46
2022-04-01,Arunachal Pradesh,258,2,252,3672,4828,4579,7.03,4,1.6,680081,5554,676379,301.75,286.19,2.295,0.82,99.46
2022-04-02,Arunachal Pradesh,589,3,589,7547,4983,4330,7.8,0,1.6,680670,5557,676968,311.44,270.62,4.716875,0.82,99.46
2022-04-03,Arunachal Pradesh,895,11,893,11331,1744,1553,7.9,0,1.6,681565,5568,677861,109.0,97.06,7.081875,0.82,99.46
2022-04-04,Arunachal Pradesh,1396,5,1387,17308,669,593,8.07,4,1.6,682961,5573,679248,41.81,37.06,10.8175,0.82,99.46
2022-04-05,Arunachal Pradesh,436,4,432,5282,1874,849,8.25,0,1.6,683397,5577,679680,117.12,53.06,3.30125,0.82,99.46
2022-04-06,Arunachal Pradesh,867,12,859,10834,1267,48,8.0,0,1.6,684264,5589,680539,79.19,3.0,6.77125,0.82,99.46
2022-04-07,Arunachal Pradesh,993,7,986,12532,2095,1521,7.92,0,1.6,685257,5596,681525,130.94,95.06,7.8325,0.82,99.46
2022-04-08,Arunachal Pradesh,608,5,601,7803,333,211,7.79,2,1.6,685865,5601,682126,20.81,13.19,4.876875,0.82,99.45
2022-04-09,Arunachal Pradesh,1254,18,1250,15427,2565,195,8.13,0,1.6,687119,5619,683376,160.31,12.19,9.641875,0.82,99.46
2022-04-10,Arunachal Pradesh,1408,9,1405,17597,3469,3159,8.0,0,1.6,688527,5628,684781,216.81,197.44,10.998125,0.82,99.46
2022-04-11,Arunachal Pradesh,952,11,944,12014,3589,1665,7.92,0,1.6,689479,5639,685725,224.31,104.06,7.50875,0.82,99.46
2022-04-12,Arunachal Pradesh,1285,15,1281,15983,3063,136,8.04,0,1.6,690764,5654,687006,191.44,8.5,9.989375,0.82,99.46
2022-04-13,Arunachal Pradesh,1091,5,1088,13611,2473,440,8.02,0,1.6,691855,5659,688094,154.56,27.5,8.506875,0.82,99.46
2022-04-14,Arunachal Pradesh,131,1,122,1191,1648,1599,11.0,8,1.6,691986,5660,688216,103.0,99.94,0.744375,0.82,99.46
2022-04-15,Arunachal Pradesh,847,7,845,10744,3382,41,7.88,0,1.6,692833,5667,689061,211.38,2.56,6.715,0.82,99.46
2022-04-16,Arunachal Pradesh,450,3,442,5533,4049,2002,8.13,5,1.6,693283,5670,689503,253.06,125.12,3.458125,0.82,99.45
2022-04-17,Arunachal Pradesh,1442,9,1442,17910,4502,2953,8.05,0,1.6,694725,5679,690945,281.38,184.56,11.19375,0.82,99.46
2022-04-18,Arunachal Pradesh,790,5,785,9870,2803,2773,8.0,0,1.6,695515,5684,691730,175.19,173.31,6.16875,0.82,99.46
2022-04-19,Arunachal Pradesh,1549,21,1546,19251,1361,568,8.05,0,1.6,697064,5705,693276,85.06,35.5,12.031875,0.82,99.46
2022-04-20,Arunachal Pradesh,347,1,338,4310,1110,284,8.05,8,1.6,697411,5706,693614,69.38,17.75,2.69375,0.82,99.46
2022-04-21,Arunachal Pradesh,628,4,619,7656,329,37,8.2,5,1.6,698039,5710,694233,20.56,2.31,4.785,0.82,99.45
2022-04-22,Arunachal Pradesh,381,3,379,4844,2235,118,7.87,0,1.6,698420,5713,694612,139.69,7.38,3.0275,0.82,99.45
2022-04-23,Arunachal Pradesh,898,11,890,11340,3258,2099,7.92,0,1.6,699318,5724,695502,203.62,131.19,7.0875,0.82,99.45
2022-04-24,Arunachal Pradesh,731,3,725,9002,475,133,8.12,3,1.6,700049,5727,696227,29.69,8.31,5.62625,0.82,99.45
2022-04-25,Arunachal Pradesh,342,2,337,4156,4649,3855,8.23,3,1.6,700391,5729,696564,290.56,240.94,2.5975,0.82,99.45
2022-04-26,Arunachal Pradesh,295,4,287,3771,2702,2462,7.82,4,1.6,700686,5733,696851,168.88,153.88,2.356875,0.82,99.45
2022-04-27,Arunachal Pradesh,1400,17,1398,18078,4796,2687,7.74,0,1.6,702086,5750,698249,299.75,167.94,11.29875,0.82,99.45
2022-04-28,Arunachal Pradesh,450,5,441,5889,820,506,7.64,4,1.6,702536,5755,698690,51.25,31.62,3.680625,0.82,99.45
2022-04-29,Arunachal Pradesh,185,1,183,2336,118,20,7.92,1,1.6,702721,5756,698873,7.38,1.25,1.46,0.82,99.45
2022-04-30,Arunachal Pradesh,1114,11,1105,14330,2084,203,7.77,0,1.6,703835,5767,699978,130.25,12.69,8.95625,0.82,99.45
2022-05-01,Arunachal Pradesh,302,1,297,3628,2733,1497,8.32,4,1.6,704137,5768,700275,170.81,93.56,2.2675,0.82,99.45
2022-05-02,Arunachal Pradesh,175,1,175,2267,4930,806,7.72,0,1.6,704312,5769,700450,308.12,50.38,1.416875,0.82,99.45
2022-05-03,Arunachal Pradesh,278,1,278,3456,1735,193,8.04,0,1.6,704590,5770,700728,108.44,12.06,2.16,0.82,99.45
2022-05-04,Arunachal Pradesh,865,12,861,11155,3176,2438,7.75,0,1.6,705455,5782,701589,198.5,152.38,6.971875,0.82,99.45
2022-05-05,Arunachal Pradesh,1558,19,1552,18823,3237,286,8.28,0,1.6,707013,5801,703141,202.31,17.88,11.764375,0.82,99.45
2022-05-06,Arunachal Pradesh,552,2,547,6817,2470,697,8.1,3,1.6,707565,5803,703688,154.38,43.56,4.260625,0.82,99.45
2022-05-07,Arunachal Pradesh,529,4,527,6549,754,437,8.08,0,1.6,708094,5807,704215,47.12,27.31,4.093125,0.82,99.45
2022-05-08,Arunachal Pradesh,1189,14,1186,14868,4781,3138,8.0,0,1.6,709283,5821,705401,298.81,196.12,9.2925,0.82,99.45
2022-05-09,Arunachal Pradesh,1613,14,1608,19882,4306,2864,8.11,0,1.6,710896,5835,707009,269.12,179.0,12.42625,0.82,99.45
2022-05-10,Arunachal Pradesh,895,13,894,11313,4988,4524,7.91,0,1.6,711791,5848,707903,311.75,282.75,7.070625,0.82,99.45
2022-05-11,Arunachal Pradesh,1466,13,1461,18364,237,27,7.98,0,1.6,713257,5861,709364,14.81,1.69,11.4775,0.82,99.45
2022-05-12,Arunachal Pradesh,1411,13,1404,17679,6,5,7.98,0,1.6,714668,5874,710768,0.38,0.31,11.049375,0.82,99.45
2022-05-13,Arunachal Pradesh,972,11,965,12196,1569,550,7.97,0,1.6,715640,5885,711733,98.06,34.38,7.6225,0.82,99.45
2022-05-14,Arunachal Pradesh,62,0,53,547,1958,390,11.33,9,1.6,715702,5885,711786,122.37,24.38,0.341875,0.82,99.45
2022-05-15,Arunachal Pradesh,248,2,240,3086,2482,918,8.04,6,1.6,715950,5887,712026,155.12,57.38,1.92875,0.82,99.45
2022-05-16,Arunachal Pradesh,1518,10,1517,18679,2958,2236,8.13,0,1.6,717468,5897,713543,184.88,139.75,11.674375,0.82,99.45
2022-05-17,Arunachal Pradesh,1457,20,1456,18170,1271,183,8.02,0,1.6,718925,5917,714999,79.44,11.44,11.35625,0.82,99.45
2022-05-18,Arunachal Pradesh,930,6,928,11273,3813,2390,8.25,0,1.6,719855,5923,715927,238.31,149.38,7.045625,0.82,99.45
2022-05-19,Arunachal Pradesh,808,8,808,9898,1475,996,8.16,0,1.6,720663,5931,716735,92.19,62.25,6.18625,0.82,99.45
2022-05-20,Arunachal Pradesh,631,3,623,7718,198,63,8.18,5,1.6,721294,5934,717358,12.38,3.94,4.82375,0.82,99.45
2022-05-21,Arunachal Pradesh,1250,17,1247,15689,1014,478,7.97,0,1.6,722544,5951,718605,63.38,29.88,9.805625,0.82,99.45
2022-05-22,Arunachal Pradesh,628,4,626,7635,1229,1004,8.23,0,1.6,723172,5955,719231,76.81,62.75,4.771875,0.82,99.46
2022-05-23,Arunachal Pradesh,52,0,46,780,4308,4000,6.67,6,1.6,723224,5955,719277,269.25,250.0,0.4875,0.82,99.45
2022-05-24,Arunachal Pradesh,1156,12,1148,14549,2494,2228,7.95,0,1.6,724380,5967,720425,155.88,139.25,9.093125,0.82,99.45
2022-05-25,Arunachal Pradesh,403,3,401,5258,428,95,7.66,0,1.6,724783,5970,720826,26.75,5.94,3.28625,0.82,99.45
2022-05-26,Arunachal Pradesh,1093,10,1089,13811,1897,858,7.91,0,1.6,725876,5980,721915,118.56,53.62,8.631875,0.82,99.45
2022-05-27,Arunachal Pradesh,1531,20,1527,19074,703,194,8.03,0,1.6,727407,6000,723442,43.94,12.12,11.92125,0.82,99.45
2022-05-28,Arunachal Pradesh,856,2,849,10639,2270,1286,8.05,5,1.6,728263,6002,724291,141.88,80.38,6.649375,0.82,99.45
2022-05-29,Arunachal Pradesh,840,4,835,10714,3654,3056,7.84,1,1.6,729103,6006,725126,228.38,191.0,6.69625,0.82,99.45
2022-05-30,Arunachal Pradesh,1581,22,1578,19746,2257,236,8.01,0,1.6,730684,6028,726704,141.06,14.75,12.34125,0.82,99.46
2022-05-31,Arunachal Pradesh,1583,14,1581,19454,3795,2244,8.14,0,1.6,732267,6042,728285,237.19,140.25,12.15875,0.83,99.46
2022-06-01,Arunachal Pradesh,1261,16,1255,15531,102,18,8.12,0,1.6,733528,6058,729540,6.38,1.12,9.706875,0.83,99.46
2022-06-02,Arunachal Pradesh,672,6,665,8334,1490,1423,8.06,1,1.6,734200,6064,730205,93.12,88.94,5.20875,0.83,99.46
2022-06-03,Arunachal Pradesh,1312,4,1304,16411,4207,2248,7.99,4,1.6,735512,6068,731509,262.94,140.5,10.256875,0.83,99.46
2022-06-04,Arunachal Pradesh,1509,18,1500,18874,1687,337,8.0,0,1.6,737021,6086,733009,105.44,21.06,11.79625,0.83,99.46
2022-06-05,Arunachal Pradesh,457,4,451,6013,3587,1072,7.6,2,1.6,737478,6090,733460,224.19,67.0,3.758125,0.83,99.46
2022-06-06,Arunachal Pradesh,1203,14,1200,14961,3831,2599,8.04,0,1.6,738681,6104,734660,239.44,162.44,9.350625,0.83,99.46
2022-06-07,Arunachal Pradesh,910,6,904,10877,896,344,8.37,0,1.6,739591,6110,735564,56.0,21.5,6.798125,0.83,99.46
2022-06-08,Arunachal Pradesh,87,0,84,690,1823,259,12.61,3,1.6,739678,6110,735648,113.94,16.19,0.43125,0.83,99.46
2022-06-09,Arunachal Pradesh,239,1,235,2538,2779,808,9.42,3,1.6,739917,6111,735883,173.69,50.5,1.58625,0.83,99.45
2022-06-10,Arunachal Pradesh,1207,10,1207,15152,4769,3733,7.97,0,1.6,741124,6121,737090,298.06,233.31,9.47,0.83,99.46
2022-06-11,Arunachal Pradesh,637,8,628,7883,404,121,8.08,1,1.6,741761,6129,737718,25.25,7.56,4.926875,0.83,99.45
2022-06-12,Arunachal Pradesh,698,4,690,8701,2637,1088,8.02,4,1.6,742459,6133,738408,164.81,68.0,5.438125,0.83,99.45
2022-06-13,Arunachal Pradesh,523,3,518,6374,4314,3476,8.21,2,1.6,742982,6136,738926,269.62,217.25,3.98375,0.83,99.45
2022-06-14,Arunachal Pradesh,669,3,662,8624,1344,521,7.76,4,1.6,743651,6139,739588,84.0,32.56,5.39,0.83,99.45
2022-06-15,Arunachal Pradesh,1580,6,1573,19884,834,404,7.95,1,1.6,745231,6145,741161,52.12,25.25,12.4275,0.82,99.45
2022-06-16,Arunachal Pradesh,753,7,751,9417,3483,1371,8.0,0,1.6,745984,6152,741912,217.69,85.69,5.885625,0.82,99.45
2022-06-17,Arunachal Pradesh,176,1,170,1873,3095,2604,9.4,5,1.6,746160,6153,742082,193.44,162.75,1.170625,0.82,99.45
2022-06-18,Arunachal Pradesh,1385,15,1384,17060,271,67,8.12,0,1.6,747545,6168,743466,16.94,4.19,10.6625,0.83,99.45
2022-06-19,Arunachal Pradesh,128,1,122,1854,4900,2942,6.9,5,1.6,747673,6169,743588,306.25,183.88,1.15875,0.83,99.45
2022-06-20,Arunachal Pradesh,1421,8,1415,17898,4440,3254,7.94,0,1.6,749094,6177,745003,277.5,203.38,11.18625,0.82,99.45
2022-06-21,Arunachal Pradesh,1027,4,1024,12655,720,662,8.12,0,1.6,750121,6181,746027,45.0,41.38,7.909375,0.82,99.45
2022-06-22,Arunachal Pradesh,1066,13,1062,13301,2374,831,8.01,0,1.6,751187,6194,747089,148.38,51.94,8.313125,0.82,99.45
2022-06-23,Arunachal Pradesh,1302,8,1294,16505,1444,1059,7.89,0,1.6,752489,6202,748383,90.25,66.19,10.315625,0.82,99.45
2022-06-24,Arunachal Pradesh,540,2,536,6832,666,194,7.9,2,1.6,753029,6204,748919,41.62,12.12,4.27,0.82,99.45
2022-06-25,Arunachal Pradesh,1249,5,1243,15508,2333,2040,8.05,1,1.6,754278,6209,750162,145.81,127.5,9.6925,0.82,99.45
2022-06-26,Arunachal Pradesh,1026,10,1020,12922,492,4,7.94,0,1.6,755304,6219,751182,30.75,0.25,8.07625,0.82,99.45
2022-06-27,Arunachal Pradesh,245,2,238,3214,4768,1781,7.62,5,1.6,755549,6221,751420,298.0,111.31,2.00875,0.82,99.45
2022-06-28,Arunachal Pradesh,281,3,273,3588,718,560,7.83,5,1.6,755830,6224,751693,44.88,35.0,2.2425,0.82,99.45
2022-06-29,Arunachal Pradesh,1094,5,1090,14042,2365,972,7.79,0,1.6,756924,6229,752783,147.81,60.75,8.77625,0.82,99.45
2022-06-30,Arunachal Pradesh,1532,22,1532,18904,194,77,8.1,0,1.6,758456,6251,754315,12.12,4.81,11.815,0.82,99.45
2022-07-01,Arunachal Pradesh,493,3,489,6240,404,144,7.9,1,1.6,758949,6254,754804,25.25,9.0,3.9,0.82,99.45
2022-07-02,Arunachal Pradesh,489,1,482,6552,809,476,7.46,6,1.6,759438,6255,755286,50.56,29.75,4.095,0.82,99.45
2022-07-03,Arunachal Pradesh,572,4,566,7019,2722,655,8.15,2,1.6,760010,6259,755852,170.12,40.94,4.386875,0.82,99.45
2022-07-04,Arunachal Pradesh,136,1,128,2218,4044,284,6.13,7,1.6,760146,6260,755980,252.75,17.75,1.38625,0.82,99.45
2022-07-05,Arunachal Pradesh,817,2,808,10416,3135,1205,7.84,7,1.6,760963,6262,756788,195.94,75.31,6.51,0.82,99.45
2022-07-06,Arunachal Pradesh,995,4,990,12615,4940,1365,7.89,1,1.6,761958,6266,757778,308.75,85.31,7.884375,0.82,99.45
2022-07-07,Arunachal Pradesh,146,1,142,2585,4311,2397,5.65,3,1.6,762104,6267,757920,269.44,149.81,1.615625,0.82,99.45
2022-07-08,Arunachal Pradesh,346,1,340,4499,3224,920,7.69,5,1.6,762450,6268,758260,201.5,57.5,2.811875,0.82,99.45
2022-07-09,Arunachal Pradesh,1551,22,1549,19182,3355,3054,8.09,0,1.6,764001,6290,759809,209.69,190.88,11.98875,0.82,99.45
2022-07-10,Arunachal Pradesh,799,8,799,10249,3017,729,7.8,0,1.6,764800,6298,760608,188.56,45.56,6.405625,0.82,99.45
2022-07-11,Arunachal Pradesh,208,1,203,2605,4973,1084,7.98,4,1.6,765008,6299,760811,310.81,67.75,1.628125,0.82,99.45
2022-07-12,Arunachal Pradesh,252,3,252,3167,729,657,7.96,0,1.6,765260,6302,761063,45.56,41.06,1.979375,0.82,99.45
2022-07-13,Arunachal Pradesh,629,4,622,7454,2197,68,8.44,3,1.6,765889,6306,761685,137.31,4.25,4.65875,0.82,99.45
2022-07-14,Arunachal Pradesh,1116,11,1108,13874,539,378,8.04,0,1.6,767005,6317,762793,33.69,23.62,8.67125,0.82,99.45
2022-07-15,Arunachal Pradesh,199,2,193,2521,1267,183,7.89,4,1.6,767204,6319,762986,79.19,11.44,1.575625,0.82,99.45
2022-07-16,Arunachal Pradesh,606,5,606,7803,4753,64,7.77,0,1.6,767810,6324,763592,297.06,4.0,4.876875,0.82,99.45
2022-07-17,Arunachal Pradesh,1213,16,1212,15457,261,251,7.85,0,1.6,769023,6340,764804,16.31,15.69,9.660625,0.82,99.45
2022-07-18,Arunachal Pradesh,930,9,922,11431,4894,4378,8.14,0,1.6,769953,6349,765726,305.88,273.62,7.144375,0.82,99.45
2022-07-19,Arunachal Pradesh,411,5,407,5099,794,389,8.06,0,1.6,770364,6354,766133,49.62,24.31,3.186875,0.82,99.45
2022-07-20,Arunachal Pradesh,790,3,783,9573,184,29,8.25,4,1.6,771154,6357,766916,11.5,1.81,5.983125,0.82,99.45
2022-07-21,Arunachal Pradesh,843,6,843,10745,3964,381,7.85,0,1.6,771997,6363,767759,247.75,23.81,6.715625,0.82,99.45
2022-07-22,Arunachal Pradesh,1180,6,1176,14790,3323,2537,7.98,0,1.6,773177,6369,768935,207.69,158.56,9.24375,0.82,99.45
2022-07-23,Arunachal Pradesh,1560,8,1557,19178,3676,1138,8.13,0,1.6,774737,6377,770492,229.75,71.12,11.98625,0.82,99.45
2022-07-24,Arunachal Pradesh,763,5,763,9029,868,142,8.45,0,1.6,775500,6382,771255,54.25,8.88,5.643125,0.82,99.45
2022-07-25,Arunachal Pradesh,1330,18,1327,16353,182,171,8.13,0,1.6,776830,6400,772582,11.38,10.69,10.220625,0.82,99.45
2022-07-26,Arunachal Pradesh,136,0,128,1425,1270,750,9.54,8,1.6,776966,6400,772710,79.38,46.88,0.890625,0.82,99.45
2022-07-27,Arunachal Pradesh,1110,5,1105,14235,1697,1214,7.8,0,1.6,778076,6405,773815,106.06,75.88,8.896875,0.82,99.45
2022-07-28,Arunachal Pradesh,938,7,934,11886,1542,875,7.89,0,1.6,779014,6412,774749,96.38,54.69,7.42875,0.82,99.45
2022-07-29,Arunachal Pradesh,1420,10,1413,17556,404,248,8.09,0,1.6,780434,6422,776162,25.25,15.5,10.9725,0.82,99.45
2022-07-30,Arunachal Pradesh,819,7,819,10449,3517,2699,7.84,0,1.6,781253,6429,776981,219.81,168.69,6.530625,0.82,99.45
2022-07-31,Arunachal Pradesh,394,4,386,5085,4622,850,7.75,4,1.6,781647,6433,777367,288.88,53.12,3.178125,0.82,99.45
2022-08-01,Arunachal Pradesh,1542,19,1535,19303,4356,2134,7.99,0,1.6,783189,6452,778902,272.25,133.38,12.064375,0.82,99.45
2022-08-02,Arunachal Pradesh,1541,20,1533,19340,4982,1137,7.97,0,1.6,784730,6472,780435,311.38,71.06,12.0875,0.82,99.45
2022-08-03,Arunachal Pradesh,1416,12,1415,17600,2695,2574,8.05,0,1.6,786146,6484,781850,168.44,160.88,11.0,0.82,99.45
2022-08-04,Arunachal Pradesh,463,1,462,5337,2725,1374,8.68,0,1.6,786609,6485,782312,170.31,85.88,3.335625,0.82,99.45
2022-08-05,Arunachal Pradesh,889,9,884,11136,3067,377,7.98,0,1.6,787498,6494,783196,191.69,23.56,6.96,0.82,99.45
2022-08-06,Arunachal Pradesh,562,6,560,6553,3978,1672,8.58,0,1.6,788060,6500,783756,248.62,104.5,4.095625,0.82,99.45
2022-08-07,Arunachal Pradesh,380,4,374,4739,2353,1077,8.02,2,1.6,788440,6504,784130,147.06,67.31,2.961875,0.82,99.45
2022-08-08,Arunachal Pradesh,1566,9,1557,19274,2580,1513,8.12,0,1.6,790006,6513,785687,161.25,94.56,12.04625,0.82,99.45
2022-08-09,Arunachal Pradesh,611,5,606,7616,4729,952,8.02,0,1.6,790617,6518,786293,295.56,59.5,4.76,0.82,99.45
2022-08-10,Arunachal Pradesh,554,7,545,7022,2176,16,7.89,2,1.6,791171,6525,786838,136.0,1.0,4.38875,0.82,99.45
2022-08-11,Arunachal Pradesh,583,3,575,7425,83,9,7.85,5,1.6,791754,6528,787413,5.19,0.56,4.640625,0.82,99.45
2022-08-12,Arunachal Pradesh,1334,9,1325,16254,3311,528,8.21,0,1.6,793088,6537,788738,206.94,33.0,10.15875,0.82,99.45
2022-08-13,Arunachal Pradesh,1299,18,1297,16703,3019,2203,7.78,0,1.6,794387,6555,790035,188.69,137.69,10.439375,0.83,99.45
2022-08-14,Arunachal Pradesh,516,1,512,6392,291,236,8.07,3,1.6,794903,6556,790547,18.19,14.75,3.995,0.82,99.45
2022-08-15,Arunachal Pradesh,258,2,254,3498,985,170,7.38,2,1.6,795161,6558,790801,61.56,10.62,2.18625,0.82,99.45
2022-08-16,Arunachal Pradesh,897,5,894,10943,3141,96,8.2,0,1.6,796058,6563,791695,196.31,6.0,6.839375,0.82,99.45
2022-08-17,Arunachal Pradesh,954,4,952,11883,2251,1652,8.03,0,1.6,797012,6567,792647,140.69,103.25,7.426875,0.82,99.45
2022-08-18,Arunachal Pradesh,1136,15,1134,14145,2123,1417,8.03,0,1.6,798148,6582,793781,132.69,88.56,8.840625,0.82,99.45
2022-08-19,Arunachal Pradesh,868,5,861,10823,1420,780,8.02,2,1.6,799016,6587,794642,88.75,48.75,6.764375,0.82,99.45
2022-08-20,Arunachal Pradesh,1104,4,1103,14078,3071,2269,7.84,0,1.6,800120,6591,795745,191.94,141.81,8.79875,0.82,99.45
2022-08-21,Arunachal Pradesh,760,5,751,9408,563,486,8.08,4,1.6,800880,6596,796496,35.19,30.38,5.88,0.82,99.45
2022-08-22,Arunachal Pradesh,907,6,902,11421,4908,2277,7.94,0,1.6,801787,6602,797398,306.75,142.31,7.138125,0.82,99.45
2022-08-23,Arunachal Pradesh,376,2,367,4798,3445,2609,7.84,7,1.6,802163,6604,797765,215.31,163.06,2.99875,0.82,99.45
2022-08-24,Arunachal Pradesh,532,2,529,6599,2141,1414,8.06,1,1.6,802695,6606,798294,133.81,88.38,4.124375,0.82,99.45
2022-08-25,Arunachal Pradesh,1558,21,1551,19411,608,159,8.03,0,1.6,804253,6627,799845,38.0,9.94,12.131875,0.82,99.45
2022-08-26,Arunachal Pradesh,1215,13,1206,15522,2011,1980,7.83,0,1.6,805468,6640,801051,125.69,123.75,9.70125,0.82,99.45
2022-08-27,Arunachal Pradesh,1529,15,1522,19131,1491,938,7.99,0,1.6,806997,6655,802573,93.19,58.63,11.956875,0.82,99.45
2022-08-28,Arunachal Pradesh,118,0,114,1472,312,236,8.02,4,1.6,807115,6655,802687,19.5,14.75,0.92,0.82,99.45
2022-08-29,Arunachal Pradesh,621,2,615,8020,4930,1233,7.74,4,1.6,807736,6657,803302,308.12,77.06,5.0125,0.82,99.45
2022-08-30,Arunachal Pradesh,645,4,644,7767,2789,2418,8.3,0,1.6,808381,6661,803946,174.31,151.12,4.854375,0.82,99.45
2022-08-31,Arunachal Pradesh,672,9,671,8402,3589,3548,8.0,0,1.6,809053,6670,804617,224.31,221.75,5.25125,0.82,99.45
2022-09-01,Arunachal Pradesh,573,6,569,7356,766,94,7.79,0,1.6,809626,6676,805186,47.88,5.88,4.5975,0.82,99.45
2022-09-02,Arunachal Pradesh,705,7,700,8386,1640,1133,8.41,0,1.6,810331,6683,805886,102.5,70.81,5.24125,0.82,99.45
2022-09-03,Arunachal Pradesh,633,6,630,7819,2078,48,8.1,0,1.6,810964,6689,806516,129.88,3.0,4.886875,0.82,99.45
2022-09-04,Arunachal Pradesh,531,2,527,6364,4639,496,8.34,2,1.6,811495,6691,807043,289.94,31.0,3.9775,0.82,99.45
2022-09-05,Arunachal Pradesh,913,5,904,11533,2090,772,7.92,4,1.6,812408,6696,807947,130.62,48.25,7.208125,0.82,99.45
2022-09-06,Arunachal Pradesh,783,9,779,9774,2067,1912,8.01,0,1.6,813191,6705,808726,129.19,119.5,6.10875,0.82,99.45
2022-09-07,Arunachal Pradesh,1149,14,1145,14322,4042,2427,8.02,0,1.6,814340,6719,809871,252.62,151.69,8.95125,0.83,99.45
2022-09-08,Arunachal Pradesh,334,4,330,4230,3297,1945,7.9,0,1.6,814674,6723,810201,206.06,121.56,2.64375,0.83,99.45
2022-09-09,Arunachal Pradesh,541,1,540,6750,1469,262,8.01,0,1.6,815215,6724,810741,91.81,16.38,4.21875,0.82,99.45
2022-09-10,Arunachal Pradesh,247,1,240,3204,2264,1009,7.71,6,1.6,815462,6725,810981,141.5,63.06,2.0025,0.82,99.45
2022-09-11,Arunachal Pradesh,610,5,605,7735,2919,1111,7.89,0,1.6,816072,6730,811586,182.44,69.44,4.834375,0.82,99.45
2022-09-12,Arunachal Pradesh,1473,9,1468,18413,1720,1567,8.0,0,1.6,817545,6739,813054,107.5,97.94,11.508125,0.82,99.45
2022-09-13,Arunachal Pradesh,106,1,102,1247,1106,650,8.5,3,1.6,817651,6740,813156,69.12,40.62,0.779375,0.82,99.45
2022-09-14,Arunachal Pradesh,1501,15,1501,18874,3557,2770,7.95,0,1.6,819152,6755,814657,222.31,173.12,11.79625,0.82,99.45
2022-09-15,Arunachal Pradesh,822,11,815,9931,745,158,8.28,0,1.6,819974,6766,815472,46.56,9.88,6.206875,0.83,99.45
2022-09-16,Arunachal Pradesh,876,12,876,10574,4484,3578,8.28,0,1.6,820850,6778,816348,280.25,223.62,6.60875,0.83,99.45
2022-09-17,Arunachal Pradesh,1418,17,1412,17894,575,544,7.92,0,1.6,822268,6795,817760,35.94,34.0,11.18375,0.83,99.45
2022-09-18,Arunachal Pradesh,330,3,321,4179,1968,1921,7.9,6,1.6,822598,6798,818081,123.0,120.06,2.611875,0.83,99.45
2022-09-19,Arunachal Pradesh,598,3,591,7871,3019,2106,7.6,4,1.6,823196,6801,818672,188.69,131.62,4.919375,0.83,99.45
2022-09-20,Arunachal Pradesh,464,4,456,5664,1933,1500,8.19,4,1.6,823660,6805,819128,120.81,93.75,3.54,0.83,99.45
2022-09-21,Arunachal Pradesh,1540,21,1536,18930,2121,866,8.14,0,1.6,825200,6826,820664,132.56,54.12,11.83125,0.83,99.45
2022-09-22,Arunachal Pradesh,736,4,736,9253,1724,367,7.95,0,1.6,825936,6830,821400,107.75,22.94,5.783125,0.83,99.45
2022-09-23,Arunachal Pradesh,420,1,411,5613,1565,192,7.48,8,1.6,826356,6831,821811,97.81,12.0,3.508125,0.83,99.45
2022-09-24,Arunachal Pradesh,1470,16,1466,18240,1306,873,8.06,0,1.6,827826,6847,823277,81.62,54.56,11.4,0.83,99.45
2022-09-25,Arunachal Pradesh,1080,12,1077,13835,3616,1217,7.81,0,1.6,828906,6859,824354,226.0,76.06,8.646875,0.83,99.45
2022-09-26,Arunachal Pradesh,950,9,942,12298,531,376,7.72,0,1.6,829856,6868,825296,33.19,23.5,7.68625,0.83,99.45
2022-09-27,Arunachal Pradesh,358,5,355,4810,816,565,7.44,0,1.6,830214,6873,825651,51.0,35.31,3.00625,0.83,99.45
2022-09-28,Arunachal Pradesh,1433,10,1433,18337,3013,1142,7.81,0,1.6,831647,6883,827084,188.31,71.38,11.460625,0.83,99.45
2022-09-29,Arunachal Pradesh,1059,14,1050,13160,264,148,8.05,0,1.6,832706,6897,828134,16.5,9.25,8.225,0.83,99.45
2022-09-30,Arunachal Pradesh,1347,11,1342,16823,1983,1966,8.01,0,1.6,834053,6908,829476,123.94,122.88,10.514375,0.83,99.45
2022-10-01,Arunachal Pradesh,1541,21,1537,19414,3531,3505,7.94,0,1.6,835594,6929,831013,220.69,219.06,12.13375,0.83,99.45
2022-10-02,Arunachal Pradesh,1167,14,1163,14573,3246,2896,8.01,0,1.6,836761,6943,832176,202.88,181.0,9.108125,0.83,99.45
2022-10-03,Arunachal Pradesh,1237,7,1236,15767,4518,1953,7.85,0,1.6,837998,6950,833412,282.38,122.06,9.854375,0.83,99.45
2022-10-04,Arunachal Pradesh,669,5,664,8633,4505,1636,7.75,0,1.6,838667,6955,834076,281.56,102.25,5.395625,0.83,99.45
2022-10-05,Arunachal Pradesh,344,4,340,4192,3012,2240,8.21,0,1.6,839011,6959,834416,188.25,140.0,2.62,0.83,99.45
2022-10-06,Arunachal Pradesh,1586,16,1582,19805,1321,261,8.01,0,1.6,840597,6975,835998,82.56,16.31,12.378125,0.83,99.45
2022-10-07,Arunachal Pradesh,717,6,711,9131,327,37,7.85,0,1.6,841314,6981,836709,20.44,2.31,5.706875,0.83,99.45
2022-10-08,Arunachal Pradesh,687,10,678,8951,1970,10,7.68,0,1.6,842001,6991,837387,123.12,0.62,5.594375,0.83,99.45
2022-10-09,Arunachal Pradesh,1133,15,1128,14297,724,234,7.92,0,1.6,843134,7006,838515,45.25,14.62,8.935625,0.83,99.45
2022-10-10,Arunachal Pradesh,1351,9,1349,16695,1186,678,8.09,0,1.6,844485,7015,839864,74.12,42.38,10.434375,0.83,99.45
2022-10-11,Arunachal Pradesh,1148,3,1147,14271,4983,1874,8.04,0,1.6,845633,7018,841011,311.44,117.12,8.919375,0.83,99.45
2022-10-12,Arunachal Pradesh,1160,16,1158,14344,3985,395,8.09,0,1.6,846793,7034,842169,249.06,24.69,8.965,0.83,99.45
2022-10-13,Arunachal Pradesh,1447,10,1442,17644,414,313,8.2,0,1.6,848240,7044,843611,25.87,19.56,11.0275,0.83,99.45
2022-10-14,Arunachal Pradesh,1076,5,1067,13677,4404,2075,7.87,4,1.6,849316,7049,844678,275.25,129.69,8.548125,0.83,99.45
2022-10-15,Arunachal Pradesh,1450,9,1443,17934,3680,1812,8.09,0,1.6,850766,7058,846121,230.0,113.25,11.20875,0.83,99.45
2022-10-16,Arunachal Pradesh,1518,19,1515,18953,3374,627,8.01,0,1.6,852284,7077,847636,210.88,39.19,11.845625,0.83,99.45
2022-10-17,Arunachal Pradesh,106,0,98,1531,1895,216,6.92,8,1.6,852390,7077,847734,118.44,13.5,0.956875,0.83,99.45
2022-10-18,Arunachal Pradesh,1309,18,1304,16662,4480,504,7.86,0,1.6,853699,7095,849038,280.0,31.5,10.41375,0.83,99.45
2022-10-19,Arunachal Pradesh,768,5,767,9077,3073,1397,8.46,0,1.6,854467,7100,849805,192.06,87.31,5.673125,0.83,99.45
2022-10-20,Arunachal Pradesh,820,7,813,9844,1321,1299,8.33,0,1.6,855287,7107,850618,82.56,81.19,6.1525,0.83,99.45
2022-10-21,Arunachal Pradesh,1124,11,1115,13665,188,57,8.23,0,1.6,856411,7118,851733,11.75,3.56,8.540625,0.83,99.45
2022-10-22,Arunachal Pradesh,1540,9,1539,19425,4968,1660,7.93,0,1.6,857951,7127,853272,310.5,103.75,12.140625,0.83,99.45
2022-10-23,Arunachal Pradesh,1550,22,1547,19075,4392,3389,8.13,0,1.6,859501,7149,854819,274.5,211.81,11.921875,0.83,99.46
2022-10-24,Arunachal Pradesh,536,5,529,6284,691,553,8.53,2,1.6,860037,7154,855348,43.19,34.56,3.9275,0.83,99.45
2022-10-25,Arunachal Pradesh,838,5,833,10537,2919,1758,7.95,0,1.6,860875,7159,856181,182.44,109.87,6.585625,0.83,99.45
2022-10-26,Arunachal Pradesh,1014,14,1013,12507,4042,1246,8.11,0,1.6,861889,7173,857194,252.62,77.88,7.816875,0.83,99.46
2022-10-27,Arunachal Pradesh,1232,4,1226,15437,4793,3713,7.98,2,1.6,863121,7177,858420,299.56,232.06,9.648125,0.83,99.46
2022-10-28,Arunachal Pradesh,539,6,531,6963,1642,600,7.74,2,1.6,863660,7183,858951,102.63,37.5,4.351875,0.83,99.45
2022-10-29,Arunachal Pradesh,459,3,450,5753,4503,466,7.98,6,1.6,864119,7186,859401,281.44,29.12,3.595625,0.83,99.45
2022-10-30,Arunachal Pradesh,1456,7,1453,18335,458,37,7.94,0,1.6,865575,7193,860854,28.62,2.31,11.459375,0.83,99.45
2022-10-31,Arunachal Pradesh,1293,14,1284,16166,1567,410,8.0,0,1.6,866868,7207,862138,97.94,25.62,10.10375,0.83,99.45
2022-11-01,Arunachal Pradesh,1235,12,1234,15048,222,102,8.21,0,1.6,868103,7219,863372,13.88,6.38,9.405,0.83,99.46
2022-11-02,Arunachal Pradesh,293,3,285,3567,2823,1494,8.21,5,1.6,868396,7222,863657,176.44,93.38,2.229375,0.83,99.45
2022-11-03,Arunachal Pradesh,979,13,976,11866,4306,821,8.25,0,1.6,869375,7235,864633,269.12,51.31,7.41625,0.83,99.45
2022-11-04,Arunachal Pradesh,1375,14,1373,17384,1013,998,7.91,0,1.6,870750,7249,866006,63.31,62.38,10.865,0.83,99.46
2022-11-05,Arunachal Pradesh,1059,11,1052,13233,3483,2752,8.0,0,1.6,871809,7260,867058,217.69,172.0,8.270625,0.83,99.46
2022-11-06,Arunachal Pradesh,85,0,83,1145,4412,849,7.42,2,1.6,871894,7260,867141,275.75,53.06,0.715625,0.83,99.45
2022-11-07,Arunachal Pradesh,1484,18,1483,18815,2574,164,7.89,0,1.6,873378,7278,868624,160.88,10.25,11.759375,0.83,99.46
2022-11-08,Arunachal Pradesh,903,4,897,11021,3467,995,8.19,2,1.6,874281,7282,869521,216.69,62.19,6.888125,0.83,99.46
2022-11-09,Arunachal Pradesh,1285,8,1281,15947,2369,212,8.06,0,1.6,875566,7290,870802,148.06,13.25,9.966875,0.83,99.46
2022-11-10,Arunachal Pradesh,1453,17,1446,17818,4841,2107,8.15,0,1.6,877019,7307,872248,302.56,131.69,11.13625,0.83,99.46
2022-11-11,Arunachal Pradesh,537,3,537,6659,1136,335,8.06,0,1.6,877556,7310,872785,71.0,20.94,4.161875,0.83,99.46
2022-11-12,Arunachal Pradesh,1247,11,1241,15611,3946,1305,7.99,0,1.6,878803,7321,874026,246.62,81.56,9.756875,0.83,99.46
2022-11-13,Arunachal Pradesh,1252,11,1249,15511,3529,1735,8.07,0,1.6,880055,7332,875275,220.56,108.44,9.694375,0.83,99.46
2022-11-14,Arunachal Pradesh,242,2,240,3530,1962,842,6.86,0,1.6,880297,7334,875515,122.62,52.62,2.20625,0.83,99.46
2022-11-15,Arunachal Pradesh,464,5,461,6003,3119,1589,7.73,0,1.6,880761,7339,875976,194.94,99.31,3.751875,0.83,99.46
2022-11-16,Arunachal Pradesh,61,0,56,942,152,47,6.48,5,1.6,880822,7339,876032,9.5,2.94,0.58875,0.83,99.46
2022-11-17,Arunachal Pradesh,925,4,919,11762,702,102,7.86,2,1.6,881747,7343,876951,43.88,6.38,7.35125,0.83,99.46
2022-11-18,Arunachal Pradesh,139,1,132,2235,3984,1787,6.22,6,1.6,881886,7344,877083,249.0,111.69,1.396875,0.83,99.46
2022-11-19,Arunachal Pradesh,259,2,254,3771,2715,1931,6.87,3,1.6,882145,7346,877337,169.69,120.69,2.356875,0.83,99.45
2022-11-20,Arunachal Pradesh,1523,5,1516,18827,781,467,8.09,2,1.6,883668,7351,878853,48.81,29.19,11.766875,0.83,99.46
2022-11-21,Arunachal Pradesh,944,11,939,11980,1721,1565,7.88,0,1.6,884612,7362,879792,107.56,97.81,7.4875,0.83,99.46
2022-11-22,Arunachal Pradesh,1098,15,1090,13574,3954,3532,8.09,0,1.6,885710,7377,880882,247.12,220.75,8.48375,0.83,99.45
2022-11-23,Arunachal Pradesh,1109,10,1101,13948,3504,68,7.95,0,1.6,886819,7387,881983,219.0,4.25,8.7175,0.83,99.45
2022-11-24,Arunachal Pradesh,1130,14,1127,14309,137,1,7.9,0,1.6,887949,7401,883110,8.56,0.06,8.943125,0.83,99.46
2022-11-25,Arunachal Pradesh,1301,10,1300,16299,3922,560,7.98,0,1.6,889250,7411,884410,245.12,35.0,10.186875,0.83,99.46
2022-11-26,Arunachal Pradesh,844,11,835,10675,2612,283,7.91,0,1.6,890094,7422,885245,163.25,17.69,6.671875,0.83,99.46
2022-11-27,Arunachal Pradesh,1504,18,1501,18506,1515,1075,8.13,0,1.6,891598,7440,886746,94.69,67.19,11.56625,0.83,99.46
2022-11-28,Arunachal Pradesh,1537,4,1532,19003,964,420,8.09,1,1.6,893135,7444,888278,60.25,26.25,11.876875,0.83,99.46
2022-11-29,Arunachal Pradesh,1539,20,1532,19030,690,365,8.09,0,1.6,894674,7464,889810,43.12,22.81,11.89375,0.83,99.46
2022-11-30,Arunachal Pradesh,678,4,675,8503,38,16,7.97,0,1.6,895352,7468,890485,2.38,1.0,5.314375,0.83,99.46
2022-12-01,Arunachal Pradesh,1597,16,1588,19962,303,122,8.0,0,1.6,896949,7484,892073,18.94,7.62,12.47625,0.83,99.46
2022-12-02,Arunachal Pradesh,217,1,214,2784,3692,2623,7.79,2,1.6,897166,7485,892287,230.75,163.94,1.74,0.83,99.46
2022-12-03,Arunachal Pradesh,1225,13,1225,15610,3104,559,7.85,0,1.6,898391,7498,893512,194.0,34.94,9.75625,0.83,99.46
2022-12-04,Arunachal Pradesh,1313,9,1312,15957,3574,371,8.23,0,1.6,899704,7507,894824,223.38,23.19,9.973125,0.83,99.46
2022-12-05,Arunachal Pradesh,871,7,864,10993,3535,2590,7.92,0,1.6,900575,7514,895688,220.94,161.88,6.870625,0.83,99.46
2022-12-06,Arunachal Pradesh,1546,20,1537,19634,984,18,7.87,0,1.6,902121,7534,897225,61.5,1.12,12.27125,0.84,99.46
2022-12-07,Arunachal Pradesh,100,1,92,1129,92,42,8.86,7,1.6,902221,7535,897317,5.75,2.62,0.705625,0.84,99.46
2022-12-08,Arunachal Pradesh,954,8,947,11628,4365,973,8.2,0,1.6,903175,7543,898264,272.81,60.81,7.2675,0.84,99.46
2022-12-09,Arunachal Pradesh,1227,13,1220,15604,935,340,7.86,0,1.6,904402,7556,899484,58.44,21.25,9.7525,0.84,99.46
2022-12-10,Arunachal Pradesh,768,5,767,9592,3023,96,8.01,0,1.6,905170,7561,900251,188.94,6.0,5.995,0.84,99.46
2022-12-11,Arunachal Pradesh,433,6,425,5727,1045,280,7.56,2,1.6,905603,7567,900676,65.31,17.5,3.579375,0.84,99.46
2022-12-12,Arunachal Pradesh,226,1,226,3227,65,27,7.0,0,1.6,905829,7568,900902,4.06,1.69,2.016875,0.84,99.46
2022-12-13,Arunachal Pradesh,1564,16,1556,19598,4233,1223,7.98,0,1.6,907393,7584,902458,264.56,76.44,12.24875,0.84,99.46
2022-12-14,Arunachal Pradesh,873,11,866,10855,2093,1486,8.04,0,1.6,908266,7595,903324,130.81,92.88,6.784375,0.84,99.46
2022-12-15,Arunachal Pradesh,773,8,772,9291,2460,2266,8.32,0,1.6,909039,7603,904096,153.75,141.62,5.806875,0.84,99.46
2022-12-16,Arunachal Pradesh,1042,13,1040,12933,786,731,8.06,0,1.6,910081,7616,905136,49.12,45.69,8.083125,0.84,99.46
2022-12-17,Arunachal Pradesh,1415,13,1409,17577,2118,1702,8.05,0,1.6,911496,7629,906545,132.38,106.38,10.985625,0.84,99.46
2022-12-18,Arunachal Pradesh,105,0,96,1572,654,480,6.68,9,1.6,911601,7629,906641,40.88,30.0,0.9825,0.84,99.46
2022-12-19,Arunachal Pradesh,377,3,375,4698,915,70,8.02,0,1.6,911978,7632,907016,57.19,4.38,2.93625,0.84,99.46
2022-12-20,Arunachal Pradesh,1138,16,1130,14514,3065,906,7.84,0,1.6,913116,7648,908146,191.56,56.62,9.07125,0.84,99.46
2022-12-21,Arunachal Pradesh,301,3,299,4138,2281,253,7.27,0,1.6,913417,7651,908445,142.56,15.81,2.58625,0.84,99.46
2022-12-22,Arunachal Pradesh,387,2,381,4857,4846,3613,7.97,4,1.6,913804,7653,908826,302.88,225.81,3.035625,0.84,99.46
2022-12-23,Arunachal Pradesh,495,2,492,5977,13,13,8.28,1,1.6,914299,7655,909318,0.81,0.81,3.735625,0.84,99.46
2022-12-24,Arunachal Pradesh,383,2,375,4510,960,771,8.49,6,1.6,914682,7657,909693,60.0,48.19,2.81875,0.84,99.45
2022-12-25,Arunachal Pradesh,85,0,85,1179,1388,1041,7.21,0,1.6,914767,7657,909778,86.75,65.06,0.736875,0.84,99.45
2022-12-26,Arunachal Pradesh,364,4,356,4717,3010,328,7.72,4,1.6,915131,7661,910134,188.12,20.5,2.948125,0.84,99.45
2022-12-27,Arunachal Pradesh,703,4,695,9321,2952,117,7.54,4,1.6,915834,7665,910829,184.5,7.31,5.825625,0.84,99.45
2022-12-28,Arunachal Pradesh,1269,10,1267,15891,1350,1291,7.99,0,1.6,917103,7675,912096,84.38,80.69,9.931875,0.84,99.45
2022-12-29,Arunachal Pradesh,608,4,607,7527,1618,1412,8.08,0,1.6,917711,7679,912703,101.12,88.25,4.704375,0.84,99.45
2022-12-30,Arunachal Pradesh,1128,14,1124,14558,429,2,7.75,0,1.6,918839,7693,913827,26.81,0.12,9.09875,0.84,99.45
2022-12-31,Arunachal Pradesh,1246,17,1242,15586,3337,2005,7.99,0,1.6,920085,7710,915069,208.56,125.31,9.74125,0.84,99.45
2020-01-01,Assam,1061,4,1054,13261,2226,1485,8.0,3,36.0,1061,4,1054,6.18,4.12,0.3683611111111111,0.38,99.34
2020-01-02,Assam,1444,12,1443,18023,3138,177,8.01,0,36.0,2505,16,2497,8.72,0.49,0.5006388888888889,0.64,99.68
2020-01-03,Assam,879,2,871,10899,4892,2734,8.06,6,36.0,3384,18,3368,13.59,7.59,0.30275,0.53,99.53
2020-01-04,Assam,1081,10,1072,13344,3156,1579,8.1,0,36.0,4465,28,4440,8.77,4.39,0.37066666666666664,0.63,99.44
2020-01-05,Assam,897,9,893,11575,1771,789,7.75,0,36.0,5362,37,5333,4.92,2.19,0.3215277777777778,0.69,99.46
2020-01-06,Assam,1264,14,1261,15657,855,777,8.07,0,36.0,6626,51,6594,2.38,2.16,0.4349166666666667,0.77,99.52
2020-01-07,Assam,1109,3,1103,13591,1823,416,8.16,3,36.0,7735,54,7697,5.06,1.16,0.3775277777777778,0.7,99.51
2020-01-08,Assam,754,3,745,9737,3258,521,7.74,6,36.0,8489,57,8442,9.05,1.45,0.2704722222222222,0.67,99.45
2020-01-09,Assam,443,3,440,5481,3016,615,8.08,0,36.0,8932,60,8882,8.38,1.71,0.15225,0.67,99.44
2020-01-10,Assam,325,3,321,4146,1143,1143,7.84,1,36.0,9257,63,9203,3.18,3.18,0.11516666666666667,0.68,99.42
2020-01-11,Assam,1111,7,1104,13423,1523,1294,8.28,0,36.0,10368,70,10307,4.23,3.59,0.3728611111111111,0.68,99.41
2020-01-12,Assam,445,3,439,5934,1310,471,7.5,3,36.0,10813,73,10746,3.64,1.31,0.16483333333333333,0.68,99.38
2020-01-13,Assam,694,5,685,8585,2560,1087,8.08,4,36.0,11507,78,11431,7.11,3.02,0.23847222222222222,0.68,99.34
2020-01-14,Assam,36,0,33,797,2526,1754,4.52,3,36.0,11543,78,11464,7.02,4.87,0.02213888888888889,0.68,99.32
2020-01-15,Assam,500,2,496,6174,3327,479,8.1,2,36.0,12043,80,11960,9.24,1.33,0.1715,0.66,99.31
2020-01-16,Assam,402,4,396,5048,158,124,7.96,2,36.0,12445,84,12356,0.44,0.34,0.14022222222222222,0.67,99.28
2020-01-17,Assam,739,3,736,8984,3526,2498,8.23,0,36.0,13184,87,13092,9.79,6.94,0.24955555555555556,0.66,99.3
2020-01-18,Assam,1415,19,1409,18003,4631,3660,7.86,0,36.0,14599,106,14501,12.86,10.17,0.5000833333333333,0.73,99.33
2020-01-19,Assam,69,0,69,897,2409,289,7.69,0,36.0,14668,106,14570,6.69,0.8,0.024916666666666667,0.72,99.33
2020-01-20,Assam,1048,6,1046,12905,2016,1350,8.12,0,36.0,15716,112,15616,5.6,3.75,0.35847222222222225,0.71,99.36
2020-01-21,Assam,114,0,111,992,2083,1546,11.49,3,36.0,15830,112,15727,5.79,4.29,0.027555555555555555,0.71,99.35
2020-01-22,Assam,779,3,779,9553,4124,2442,8.15,0,36.0,16609,115,16506,11.46,6.78,0.2653611111111111,0.69,99.38
2020-01-23,Assam,1594,21,1591,19652,3935,1357,8.11,0,36.0,18203,136,18097,10.93,3.77,0.5458888888888889,0.75,99.42
2020-01-24,Assam,1314,6,1308,16393,3455,2470,8.02,0,36.0,19517,142,19405,9.6,6.86,0.4553611111111111,0.73,99.43
2020-01-25,Assam,577,1,576,7204,581,235,8.01,0,36.0,20094,143,19981,1.61,0.65,0.2001111111111111,0.71,99.44
2020-01-26,Assam,918,8,916,12073,3430,1236,7.6,0,36.0,21012,151,20897,9.53,3.43,0.3353611111111111,0.72,99.45
2020-01-27,Assam,1312,6,1305,16894,4218,3330,7.77,1,36.0,22324,157,22202,11.72,9.25,0.4692777777777778,0.7,99.45
2020-01-28,Assam,968,13,964,12138,2598,2318,7.97,0,36.0,23292,170,23166,7.22,6.44,0.33716666666666667,0.73,99.46
2020-01-29,Assam,1316,6,1310,16630,1010,244,7.91,0,36.0,24608,176,24476,2.81,0.68,0.46194444444444444,0.72,99.46
2020-01-30,Assam,878,8,870,10809,1899,573,8.12,0,36.0,25486,184,25346,5.28,1.59,0.30025,0.72,99.45
2020-01-31,Assam,164,1,159,1970,1067,452,8.32,4,36.0,25650,185,25505,2.96,1.26,0.05472222222222222,0.72,99.43
2020-02-01,Assam,429,5,425,5143,4635,2342,8.34,0,36.0,26079,190,25930,12.88,6.51,0.1428611111111111,0.73,99.43
2020-02-02,Assam,62,0,61,608,1375,68,10.2,1,36.0,26141,190,25991,3.82,0.19,0.016888888888888887,0.73,99.43
2020-02-03,Assam,1067,7,1062,13591,152,119,7.85,0,36.0,27208,197,27053,0.42,0.33,0.3775277777777778,0.72,99.43
2020-02-04,Assam,1393,19,1393,17283,4328,2856,8.06,0,36.0,28601,216,28446,12.02,7.93,0.4800833333333333,0.76,99.46
2020-02-05,Assam,1164,8,1157,14460,4547,3848,8.05,0,36.0,29765,224,29603,12.63,10.69,0.40166666666666667,0.75,99.46
2020-02-06,Assam,637,5,631,8294,4418,185,7.68,1,36.0,30402,229,30234,12.27,0.51,0.2303888888888889,0.75,99.45
2020-02-07,Assam,357,5,355,4480,1989,1000,7.97,0,36.0,30759,234,30589,5.52,2.78,0.12444444444444444,0.76,99.45
2020-02-08,Assam,284,1,280,3804,1686,364,7.47,3,36.0,31043,235,30869,4.68,1.01,0.10566666666666667,0.76,99.44
2020-02-09,Assam,1039,7,1031,13127,2929,1981,7.91,1,36.0,32082,242,31900,8.14,5.5,0.3646388888888889,0.75,99.43
2020-02-10,Assam,868,6,860,10988,2278,1304,7.9,2,36.0,32950,248,32760,6.33,3.62,0.30522222222222223,0.75,99.42
2020-02-11,Assam,581,3,581,7478,2465,1953,7.77,0,36.0,33531,251,33341,6.85,5.42,0.20772222222222222,0.75,99.43
2020-02-12,Assam,977,7,968,12251,454,139,7.97,2,36.0,34508,258,34309,1.26,0.39,0.34030555555555553,0.75,99.42
2020-02-13,Assam,1066,6,1057,13491,3179,2761,7.9,3,36.0,35574,264,35366,8.83,7.67,0.37475,0.74,99.42
2020-02-14,Assam,635,5,632,7877,4917,4382,8.06,0,36.0,36209,269,35998,13.66,12.17,0.21880555555555556,0.74,99.42
2020-02-15,Assam,962,13,961,11875,3304,881,8.1,0,36.0,37171,282,36959,9.18,2.45,0.3298611111111111,0.76,99.43
2020-02-16,Assam,346,5,338,4659,2619,948,7.43,3,36.0,37517,287,37297,7.28,2.63,0.12941666666666668,0.76,99.41
2020-02-17,Assam,356,1,348,4507,4025,804,7.9,7,36.0,37873,288,37645,11.18,2.23,0.12519444444444444,0.76,99.4
2020-02-18,Assam,890,11,888,11231,1805,788,7.92,0,36.0,38763,299,38533,5.01,2.19,0.3119722222222222,0.77,99.41
2020-02-19,Assam,648,6,643,8454,398,179,7.67,0,36.0,39411,305,39176,1.11,0.5,0.23483333333333334,0.77,99.4
2020-02-20,Assam,1149,6,1140,14109,2029,1003,8.14,3,36.0,40560,311,40316,5.64,2.79,0.3919166666666667,0.77,99.4
2020-02-21,Assam,1052,6,1049,13085,2101,157,8.04,0,36.0,41612,317,41365,5.84,0.44,0.3634722222222222,0.76,99.41
2020-02-22,Assam,1201,13,1197,15060,4983,2283,7.97,0,36.0,42813,330,42562,13.84,6.34,0.41833333333333333,0.77,99.41
2020-02-23,Assam,237,2,230,3144,4159,2971,7.54,5,36.0,43050,332,42792,11.55,8.25,0.08733333333333333,0.77,99.4
2020-02-24,Assam,211,1,202,3084,4702,1442,6.84,8,36.0,43261,333,42994,13.06,4.01,0.08566666666666667,0.77,99.38
2020-02-25,Assam,811,5,805,10203,4446,659,7.95,1,36.0,44072,338,43799,12.35,1.83,0.28341666666666665,0.77,99.38
2020-02-26,Assam,923,12,920,11419,1827,575,8.08,0,36.0,44995,350,44719,5.08,1.6,0.31719444444444445,0.78,99.39
2020-02-27,Assam,916,7,915,11451,44,40,8.0,0,36.0,45911,357,45634,0.12,0.11,0.31808333333333333,0.78,99.4
2020-02-28,Assam,216,0,216,2759,3865,2539,7.83,0,36.0,46127,357,45850,10.74,7.05,0.0766388888888889,0.77,99.4
2020-02-29,Assam,119,1,113,1367,3571,3418,8.71,5,36.0,46246,358,45963,9.92,9.49,0.03797222222222222,0.77,99.39
2020-03-01,Assam,624,2,618,7739,955,533,8.06,4,36.0,46870,360,46581,2.65,1.48,0.21497222222222223,0.77,99.38
2020-03-02,Assam,162,2,158,1595,1253,937,10.16,2,36.0,47032,362,46739,3.48,2.6,0.044305555555555556,0.77,99.38
2020-03-03,Assam,258,3,256,3282,1705,613,7.86,0,36.0,47290,365,46995,4.74,1.7,0.09116666666666666,0.77,99.38
2020-03-04,Assam,527,2,527,6718,3312,2411,7.84,0,36.0,47817,367,47522,9.2,6.7,0.18661111111111112,0.77,99.38
2020-03-05,Assam,738,7,734,9389,790,98,7.86,0,36.0,48555,374,48256,2.19,0.27,0.26080555555555557,0.77,99.38
2020-03-06,Assam,84,0,77,1155,4058,780,7.27,7,36.0,48639,374,48333,11.27,2.17,0.03208333333333333,0.77,99.37
2020-03-07,Assam,582,6,577,7604,2829,2264,7.65,0,36.0,49221,380,48910,7.86,6.29,0.21122222222222223,0.77,99.37
2020-03-08,Assam,1205,17,1202,14942,2080,640,8.06,0,36.0,50426,397,50112,5.78,1.78,0.41505555555555557,0.79,99.38
2020-03-09,Assam,954,8,947,11830,1752,351,8.06,0,36.0,51380,405,51059,4.87,0.98,0.32861111111111113,0.79,99.38
2020-03-10,Assam,140,2,138,1703,2907,1522,8.22,0,36.0,51520,407,51197,8.08,4.23,0.04730555555555556,0.79,99.37
2020-03-11,Assam,733,8,731,8778,4222,3301,8.35,0,36.0,52253,415,51928,11.73,9.17,0.24383333333333335,0.79,99.38
2020-03-12,Assam,845,10,837,10547,1109,967,8.01,0,36.0,53098,425,52765,3.08,2.69,0.29297222222222224,0.8,99.37
2020-03-13,Assam,957,2,957,12074,3841,592,7.93,0,36.0,54055,427,53722,10.67,1.64,0.3353888888888889,0.79,99.38
2020-03-14,Assam,52,0,49,782,970,565,6.65,3,36.0,54107,427,53771,2.69,1.57,0.021722222222222223,0.79,99.38
2020-03-15,Assam,458,1,449,5416,197,157,8.46,8,36.0,54565,428,54220,0.55,0.44,0.15044444444444444,0.78,99.37
2020-03-16,Assam,1232,11,1229,15254,2721,693,8.08,0,36.0,55797,439,55449,7.56,1.92,0.4237222222222222,0.79,99.38
2020-03-17,Assam,1077,15,1076,13697,2593,1137,7.86,0,36.0,56874,454,56525,7.2,3.16,0.3804722222222222,0.8,99.39
2020-03-18,Assam,605,6,602,7634,1255,145,7.93,0,36.0,57479,460,57127,3.49,0.4,0.21205555555555555,0.8,99.39
2020-03-19,Assam,1043,13,1035,13513,3864,2749,7.72,0,36.0,58522,473,58162,10.73,7.64,0.3753611111111111,0.81,99.38
2020-03-20,Assam,167,1,166,2453,720,266,6.81,0,36.0,58689,474,58328,2.0,0.74,0.06813888888888889,0.81,99.38
2020-03-21,Assam,426,5,419,4949,2064,852,8.61,2,36.0,59115,479,58747,5.73,2.37,0.13747222222222222,0.81,99.38
2020-03-22,Assam,504,3,500,6001,740,394,8.4,1,36.0,59619,482,59247,2.06,1.09,0.16669444444444445,0.81,99.38
2020-03-23,Assam,325,3,323,3692,2986,1413,8.8,0,36.0,59944,485,59570,8.29,3.92,0.10255555555555555,0.81,99.38
2020-03-24,Assam,216,1,209,2633,1011,345,8.2,6,36.0,60160,486,59779,2.81,0.96,0.07313888888888889,0.81,99.37
2020-03-25,Assam,566,4,564,6893,2136,2122,8.21,0,36.0,60726,490,60343,5.93,5.89,0.1914722222222222,0.81,99.37
2020-03-26,Assam,299,1,293,3887,4663,2198,7.69,5,36.0,61025,491,60636,12.95,6.11,0.10797222222222222,0.8,99.36
2020-03-27,Assam,541,3,541,6327,2978,874,8.55,0,36.0,61566,494,61177,8.27,2.43,0.17575,0.8,99.37
2020-03-28,Assam,926,8,926,11574,2391,2368,8.0,0,36.0,62492,502,62103,6.64,6.58,0.3215,0.8,99.38
2020-03-29,Assam,228,1,222,2623,4688,3478,8.69,5,36.0,62720,503,62325,13.02,9.66,0.07286111111111111,0.8,99.37
2020-03-30,Assam,94,0,94,1206,2608,904,7.79,0,36.0,62814,503,62419,7.24,2.51,0.0335,0.8,99.37
2020-03-31,Assam,1571,9,1562,19844,2605,1992,7.92,0,36.0,64385,512,63981,7.24,5.53,0.5512222222222222,0.8,99.37
2020-04-01,Assam,802,7,793,10192,2017,76,7.87,2,36.0,65187,519,64774,5.6,0.21,0.2831111111111111,0.8,99.37
2020-04-02,Assam,991,11,983,12216,3082,292,8.11,0,36.0,66178,530,65757,8.56,0.81,0.3393333333333333,0.8,99.36
2020-04-03,Assam,911,12,911,11187,3736,3572,8.14,0,36.0,67089,542,66668,10.38,9.92,0.31075,0.81,99.37
2020-04-04,Assam,1044,13,1036,12809,3933,623,8.15,0,36.0,68133,555,67704,10.92,1.73,0.35580555555555554,0.81,99.37
2020-04-05,Assam,1389,13,1381,17282,1185,530,8.04,0,36.0,69522,568,69085,3.29,1.47,0.48005555555555557,0.82,99.37
2020-04-06,Assam,1076,6,1073,13040,1591,1377,8.25,0,36.0,70598,574,70158,4.42,3.82,0.3622222222222222,0.81,99.38
2020-04-07,Assam,224,3,220,2969,2362,2020,7.54,1,36.0,70822,577,70378,6.56,5.61,0.08247222222222222,0.81,99.37
2020-04-08,Assam,230,2,228,3191,3532,746,7.21,0,36.0,71052,579,70606,9.81,2.07,0.08863888888888889,0.81,99.37
2020-04-09,Assam,802,6,800,10087,4366,1595,7.95,0,36.0,71854,585,71406,12.13,4.43,0.28019444444444447,0.81,99.38
2020-04-10,Assam,998,11,993,12460,4272,1160,8.01,0,36.0,72852,596,72399,11.87,3.22,0.3461111111111111,0.82,99.38
2020-04-11,Assam,1217,14,1213,15214,2603,237,8.0,0,36.0,74069,610,73612,7.23,0.66,0.4226111111111111,0.82,99.38
2020-04-12,Assam,798,11,792,9310,1633,1477,8.57,0,36.0,74867,621,74404,4.54,4.1,0.2586111111111111,0.83,99.38
2020-04-13,Assam,776,8,770,9432,4501,2021,8.23,0,36.0,75643,629,75174,12.5,5.61,0.262,0.83,99.38
2020-04-14,Assam,440,2,435,5571,1480,453,7.9,3,36.0,76083,631,75609,4.11,1.26,0.15475,0.83,99.38
2020-04-15,Assam,168,2,161,1988,257,193,8.45,5,36.0,76251,633,75770,0.71,0.54,0.05522222222222222,0.83,99.37
2020-04-16,Assam,1605,21,1605,19698,669,162,8.15,0,36.0,77856,654,77375,1.86,0.45,0.5471666666666667,0.84,99.38
2020-04-17,Assam,715,9,709,8519,1563,1431,8.39,0,36.0,78571,663,78084,4.34,3.98,0.2366388888888889,0.84,99.38
2020-04-18,Assam,1002,5,994,12072,1776,914,8.3,3,36.0,79573,668,79078,4.93,2.54,0.3353333333333333,0.84,99.38
2020-04-19,Assam,149,2,149,2230,3915,1029,6.68,0,36.0,79722,670,79227,10.88,2.86,0.06194444444444445,0.84,99.38
2020-04-20,Assam,138,1,135,1778,4258,3254,7.76,2,36.0,79860,671,79362,11.83,9.04,0.04938888888888889,0.84,99.38
2020-04-21,Assam,523,4,522,6576,3481,2485,7.95,0,36.0,80383,675,79884,9.67,6.9,0.18266666666666667,0.84,99.38
2020-04-22,Assam,736,7,727,9531,1030,611,7.72,2,36.0,81119,682,80611,2.86,1.7,0.26475,0.84,99.37
2020-04-23,Assam,1227,14,1224,15478,2675,101,7.93,0,36.0,82346,696,81835,7.43,0.28,0.42994444444444446,0.85,99.38
2020-04-24,Assam,73,0,68,1052,1481,399,6.94,5,36.0,82419,696,81903,4.11,1.11,0.029222222222222222,0.84,99.37
2020-04-25,Assam,317,2,308,3753,668,596,8.45,7,36.0,82736,698,82211,1.86,1.66,0.10425,0.84,99.37
2020-04-26,Assam,561,5,557,6880,1025,297,8.15,0,36.0,83297,703,82768,2.85,0.82,0.19111111111111112,0.84,99.36
2020-04-27,Assam,103,1,94,1769,4524,1914,5.82,8,36.0,83400,704,82862,12.57,5.32,0.04913888888888889,0.84,99.35
2020-04-28,Assam,887,4,886,10769,4608,58,8.24,0,36.0,84287,708,83748,12.8,0.16,0.2991388888888889,0.84,99.36
2020-04-29,Assam,1406,5,1403,17381,1159,512,8.09,0,36.0,85693,713,85151,3.22,1.42,0.48280555555555554,0.83,99.37
2020-04-30,Assam,1590,13,1590,19601,1366,1087,8.11,0,36.0,87283,726,86741,3.79,3.02,0.5444722222222222,0.83,99.38
2020-05-01,Assam,160,0,159,2428,83,79,6.59,1,36.0,87443,726,86900,0.23,0.22,0.06744444444444445,0.83,99.38
2020-05-02,Assam,481,3,478,5709,1958,158,8.43,0,36.0,87924,729,87378,5.44,0.44,0.15858333333333333,0.83,99.38
2020-05-03,Assam,1354,14,1348,16980,4250,4085,7.97,0,36.0,89278,743,88726,11.81,11.35,0.4716666666666667,0.83,99.38
2020-05-04,Assam,785,9,779,9734,176,151,8.06,0,36.0,90063,752,89505,0.49,0.42,0.2703888888888889,0.83,99.38
2020-05-05,Assam,204,3,196,2302,436,275,8.86,5,36.0,90267,755,89701,1.21,0.76,0.06394444444444444,0.84,99.37
2020-05-06,Assam,41,0,33,582,4787,3056,7.04,8,36.0,90308,755,89734,13.3,8.49,0.016166666666666666,0.84,99.36
2020-05-07,Assam,1254,8,1254,15867,3189,1993,7.9,0,36.0,91562,763,90988,8.86,5.54,0.44075,0.83,99.37
2020-05-08,Assam,449,2,440,5922,3693,2772,7.58,7,36.0,92011,765,91428,10.26,7.7,0.1645,0.83,99.37
2020-05-09,Assam,799,3,791,10040,3617,1585,7.96,5,36.0,92810,768,92219,10.05,4.4,0.2788888888888889,0.83,99.36
2020-05-10,Assam,168,2,163,2179,836,105,7.71,3,36.0,92978,770,92382,2.32,0.29,0.06052777777777778,0.83,99.36
2020-05-11,Assam,1601,9,1596,19527,3956,2941,8.2,0,36.0,94579,779,93978,10.99,8.17,0.5424166666666667,0.82,99.36
2020-05-12,Assam,228,2,221,2995,395,314,7.61,5,36.0,94807,781,94199,1.1,0.87,0.08319444444444445,0.82,99.36
2020-05-13,Assam,825,11,818,10924,748,661,7.55,0,36.0,95632,792,95017,2.08,1.84,0.30344444444444446,0.83,99.36
2020-05-14,Assam,1015,7,1006,12761,2465,43,7.95,2,36.0,96647,799,96023,6.85,0.12,0.35447222222222224,0.83,99.35
2020-05-15,Assam,1547,21,1546,19371,174,13,7.99,0,36.0,98194,820,97569,0.48,0.04,0.5380833333333334,0.84,99.36
2020-05-16,Assam,1228,7,1228,15471,1313,207,7.94,0,36.0,99422,827,98797,3.65,0.57,0.42975,0.83,99.37
2020-05-17,Assam,968,8,967,12004,3790,3367,8.06,0,36.0,100390,835,99764,10.53,9.35,0.33344444444444443,0.83,99.38
2020-05-18,Assam,1479,22,1471,18425,4443,2931,8.03,0,36.0,101869,857,101235,12.34,8.14,0.5118055555555555,0.84,99.38
2020-05-19,Assam,179,1,176,1974,2896,366,9.07,2,36.0,102048,858,101411,8.04,1.02,0.05483333333333333,0.84,99.38
2020-05-20,Assam,894,11,889,11080,287,245,8.07,0,36.0,102942,869,102300,0.8,0.68,0.30777777777777776,0.84,99.38
2020-05-21,Assam,291,1,286,3968,1694,1251,7.33,4,36.0,103233,870,102586,4.71,3.48,0.11022222222222222,0.84,99.37
2020-05-22,Assam,963,6,962,12396,4561,692,7.77,0,36.0,104196,876,103548,12.67,1.92,0.3443333333333333,0.84,99.38
2020-05-23,Assam,487,6,484,6166,2015,518,7.9,0,36.0,104683,882,104032,5.6,1.44,0.17127777777777778,0.84,99.38
2020-05-24,Assam,236,1,236,3257,212,121,7.25,0,36.0,104919,883,104268,0.59,0.34,0.09047222222222222,0.84,99.38
2020-05-25,Assam,446,3,438,5544,2398,667,8.04,5,36.0,105365,886,104706,6.66,1.85,0.154,0.84,99.37
2020-05-26,Assam,855,6,846,11146,3768,2794,7.67,3,36.0,106220,892,105552,10.47,7.76,0.3096111111111111,0.84,99.37
2020-05-27,Assam,1386,10,1378,17171,1492,177,8.07,0,36.0,107606,902,106930,4.14,0.49,0.47697222222222224,0.84,99.37
2020-05-28,Assam,1555,23,1551,19443,1136,371,8.0,0,36.0,109161,925,108481,3.16,1.03,0.5400833333333334,0.85,99.38
2020-05-29,Assam,875,11,873,10541,4475,2409,8.3,0,36.0,110036,936,109354,12.43,6.69,0.29280555555555554,0.85,99.38
2020-05-30,Assam,152,1,146,1523,3668,2525,9.98,5,36.0,110188,937,109500,10.19,7.01,0.042305555555555555,0.85,99.38
2020-05-31,Assam,104,0,99,1451,3488,2985,7.17,5,36.0,110292,937,109599,9.69,8.29,0.04030555555555555,0.85,99.37
2020-06-01,Assam,692,9,691,8874,20,6,7.8,0,36.0,110984,946,110290,0.06,0.02,0.2465,0.85,99.37
2020-06-02,Assam,1401,9,1398,17315,4775,1626,8.09,0,36.0,112385,955,111688,13.26,4.52,0.48097222222222225,0.85,99.38
2020-06-03,Assam,364,3,359,4782,4725,925,7.61,2,36.0,112749,958,112047,13.12,2.57,0.13283333333333333,0.85,99.38
2020-06-04,Assam,681,7,676,8653,2135,405,7.87,0,36.0,113430,965,112723,5.93,1.12,0.2403611111111111,0.85,99.38
2020-06-05,Assam,668,3,668,8587,4671,237,7.78,0,36.0,114098,968,113391,12.98,0.66,0.23852777777777778,0.85,99.38
2020-06-06,Assam,1160,9,1158,14456,1284,915,8.02,0,36.0,115258,977,114549,3.57,2.54,0.40155555555555555,0.85,99.38
2020-06-07,Assam,1577,5,1572,19567,1319,301,8.06,0,36.0,116835,982,116121,3.66,0.84,0.5435277777777778,0.84,99.39
2020-06-08,Assam,824,3,819,11012,303,222,7.48,2,36.0,117659,985,116940,0.84,0.62,0.3058888888888889,0.84,99.39
2020-06-09,Assam,1154,13,1152,14628,1198,367,7.89,0,36.0,118813,998,118092,3.33,1.02,0.4063333333333333,0.84,99.39
2020-06-10,Assam,847,7,847,10651,2001,1777,7.95,0,36.0,119660,1005,118939,5.56,4.94,0.29586111111111113,0.84,99.4
2020-06-11,Assam,75,0,71,900,4999,4280,8.33,4,36.0,119735,1005,119010,13.89,11.89,0.025,0.84,99.39
2020-06-12,Assam,1250,11,1247,15460,2166,1547,8.09,0,36.0,120985,1016,120257,6.02,4.3,0.42944444444444446,0.84,99.4
2020-06-13,Assam,1372,10,1369,17226,3886,2348,7.96,0,36.0,122357,1026,121626,10.79,6.52,0.4785,0.84,99.4
2020-06-14,Assam,908,6,902,11130,2553,2233,8.16,0,36.0,123265,1032,122528,7.09,6.2,0.30916666666666665,0.84,99.4
2020-06-15,Assam,1176,4,1170,14642,1648,968,8.03,2,36.0,124441,1036,123698,4.58,2.69,0.4067222222222222,0.83,99.4
2020-06-16,Assam,46,0,40,841,1407,203,5.47,6,36.0,124487,1036,123738,3.91,0.56,0.02336111111111111,0.83,99.4
2020-06-17,Assam,1438,20,1436,17683,4133,2478,8.13,0,36.0,125925,1056,125174,11.48,6.88,0.49119444444444443,0.84,99.4
2020-06-18,Assam,275,3,267,3478,3060,1511,7.91,5,36.0,126200,1059,125441,8.5,4.2,0.0966111111111111,0.84,99.4
2020-06-19,Assam,1471,4,1466,18186,4843,913,8.09,1,36.0,127671,1063,126907,13.45,2.54,0.5051666666666667,0.83,99.4
2020-06-20,Assam,535,1,529,6847,4173,3730,7.81,5,36.0,128206,1064,127436,11.59,10.36,0.19019444444444444,0.83,99.4
2020-06-21,Assam,273,3,265,3633,2717,712,7.51,5,36.0,128479,1067,127701,7.55,1.98,0.10091666666666667,0.83,99.39
2020-06-22,Assam,966,4,965,11391,2439,757,8.48,0,36.0,129445,1071,128666,6.78,2.1,0.3164166666666667,0.83,99.4
2020-06-23,Assam,1554,11,1549,19499,2996,186,7.97,0,36.0,130999,1082,130215,8.32,0.52,0.5416388888888889,0.83,99.4
2020-06-24,Assam,1572,7,1563,19614,1672,1611,8.01,2,36.0,132571,1089,131778,4.64,4.47,0.5448333333333333,0.82,99.4
2020-06-25,Assam,1445,9,1442,18068,3229,2847,8.0,0,36.0,134016,1098,133220,8.97,7.91,0.5018888888888889,0.82,99.41
2020-06-26,Assam,1597,12,1589,19905,4134,3748,8.02,0,36.0,135613,1110,134809,11.48,10.41,0.5529166666666666,0.82,99.41
2020-06-27,Assam,1583,13,1583,19853,3788,721,7.97,0,36.0,137196,1123,136392,10.52,2.0,0.5514722222222223,0.82,99.41
2020-06-28,Assam,528,7,523,6862,3810,1965,7.69,0,36.0,137724,1130,136915,10.58,5.46,0.19061111111111112,0.82,99.41
2020-06-29,Assam,1418,18,1418,17861,2663,942,7.94,0,36.0,139142,1148,138333,7.4,2.62,0.4961388888888889,0.83,99.42
2020-06-30,Assam,1381,19,1378,17574,1617,295,7.86,0,36.0,140523,1167,139711,4.49,0.82,0.4881666666666667,0.83,99.42
2020-07-01,Assam,1476,10,1469,18126,3961,2447,8.14,0,36.0,141999,1177,141180,11.0,6.8,0.5035,0.83,99.42
2020-07-02,Assam,1497,11,1496,18880,2900,1958,7.93,0,36.0,143496,1188,142676,8.06,5.44,0.5244444444444445,0.83,99.43
2020-07-03,Assam,1565,20,1560,19888,4330,2009,7.87,0,36.0,145061,1208,144236,12.03,5.58,0.5524444444444444,0.83,99.43
2020-07-04,Assam,1289,10,1280,16207,130,9,7.95,0,36.0,146350,1218,145516,0.36,0.02,0.45019444444444445,0.83,99.43
2020-07-05,Assam,840,3,833,10602,98,39,7.92,4,36.0,147190,1221,146349,0.27,0.11,0.2945,0.83,99.43
2020-07-06,Assam,1481,8,1472,18631,1984,1101,7.95,1,36.0,148671,1229,147821,5.51,3.06,0.5175277777777778,0.83,99.43
2020-07-07,Assam,632,4,631,8115,3380,2061,7.79,0,36.0,149303,1233,148452,9.39,5.72,0.22541666666666665,0.83,99.43
2020-07-08,Assam,237,2,231,3086,124,92,7.68,4,36.0,149540,1235,148683,0.34,0.26,0.08572222222222223,0.83,99.43
2020-07-09,Assam,765,5,761,9668,3739,418,7.91,0,36.0,150305,1240,149444,10.39,1.16,0.26855555555555555,0.82,99.43
2020-07-10,Assam,330,2,330,4224,3390,492,7.81,0,36.0,150635,1242,149774,9.42,1.37,0.11733333333333333,0.82,99.43
2020-07-11,Assam,264,3,261,3505,3342,180,7.53,0,36.0,150899,1245,150035,9.28,0.5,0.0973611111111111,0.83,99.43
2020-07-12,Assam,492,7,491,6141,3833,245,8.01,0,36.0,151391,1252,150526,10.65,0.68,0.17058333333333334,0.83,99.43
2020-07-13,Assam,542,1,539,6976,126,56,7.77,2,36.0,151933,1253,151065,0.35,0.16,0.19377777777777777,0.82,99.43
2020-07-14,Assam,872,10,871,10551,4453,2776,8.26,0,36.0,152805,1263,151936,12.37,7.71,0.2930833333333333,0.83,99.43
2020-07-15,Assam,177,1,172,2297,4819,639,7.71,4,36.0,152982,1264,152108,13.39,1.78,0.06380555555555556,0.83,99.43
2020-07-16,Assam,1209,13,1208,15084,1324,100,8.02,0,36.0,154191,1277,153316,3.68,0.28,0.419,0.83,99.43
2020-07-17,Assam,699,6,693,9110,3638,1724,7.67,0,36.0,154890,1283,154009,10.11,4.79,0.25305555555555553,0.83,99.43
2020-07-18,Assam,417,2,409,4674,3300,2616,8.92,6,36.0,155307,1285,154418,9.17,7.27,0.12983333333333333,0.83,99.43
2020-07-19,Assam,130,0,126,1577,2493,1869,8.24,4,36.0,155437,1285,154544,6.93,5.19,0.043805555555555556,0.83,99.43
2020-07-20,Assam,479,5,479,5665,1257,87,8.46,0,36.0,155916,1290,155023,3.49,0.24,0.15736111111111112,0.83,99.43
2020-07-21,Assam,208,0,200,2491,1896,1689,8.35,8,36.0,156124,1290,155223,5.27,4.69,0.06919444444444445,0.83,99.42
2020-07-22,Assam,1079,15,1073,13494,4005,1140,8.0,0,36.0,157203,1305,156296,11.12,3.17,0.37483333333333335,0.83,99.42
2020-07-23,Assam,1036,8,1036,12846,4656,552,8.06,0,36.0,158239,1313,157332,12.93,1.53,0.35683333333333334,0.83,99.43
2020-07-24,Assam,256,1,252,3366,137,77,7.61,3,36.0,158495,1314,157584,0.38,0.21,0.0935,0.83,99.43
2020-07-25,Assam,913,3,912,11263,3515,3017,8.11,0,36.0,159408,1317,158496,9.76,8.38,0.3128611111111111,0.83,99.43
2020-07-26,Assam,288,2,279,3410,2014,390,8.45,7,36.0,159696,1319,158775,5.59,1.08,0.09472222222222222,0.83,99.42
2020-07-27,Assam,571,6,569,6525,1310,1289,8.75,0,36.0,160267,1325,159344,3.64,3.58,0.18125,0.83,99.42
2020-07-28,Assam,220,1,218,2312,1805,1681,9.52,1,36.0,160487,1326,159562,5.01,4.67,0.06422222222222222,0.83,99.42
2020-07-29,Assam,271,1,263,3612,4323,855,7.5,7,36.0,160758,1327,159825,12.01,2.38,0.10033333333333333,0.83,99.42
2020-07-30,Assam,147,0,146,1960,4761,2378,7.5,1,36.0,160905,1327,159971,13.23,6.61,0.05444444444444444,0.82,99.42
2020-07-31,Assam,1029,9,1020,13190,472,133,7.8,0,36.0,161934,1336,160991,1.31,0.37,0.3663888888888889,0.83,99.42
2020-08-01,Assam,86,0,79,1661,88,82,5.18,7,36.0,162020,1336,161070,0.24,0.23,0.04613888888888889,0.82,99.41
2020-08-02,Assam,1491,11,1486,19209,1178,748,7.76,0,36.0,163511,1347,162556,3.27,2.08,0.5335833333333333,0.82,99.42
2020-08-03,Assam,1461,11,1453,18311,4116,62,7.98,0,36.0,164972,1358,164009,11.43,0.17,0.5086388888888889,0.82,99.42
2020-08-04,Assam,1531,22,1522,19195,52,9,7.98,0,36.0,166503,1380,165531,0.14,0.02,0.5331944444444444,0.83,99.42
2020-08-05,Assam,351,3,345,4689,843,699,7.49,3,36.0,166854,1383,165876,2.34,1.94,0.13025,0.83,99.41
2020-08-06,Assam,324,3,319,4148,4418,1541,7.81,2,36.0,167178,1386,166195,12.27,4.28,0.11522222222222223,0.83,99.41
2020-08-07,Assam,1018,8,1017,12682,4890,799,8.03,0,36.0,168196,1394,167212,13.58,2.22,0.3522777777777778,0.83,99.41
2020-08-08,Assam,1284,16,1276,15976,107,87,8.04,0,36.0,169480,1410,168488,0.3,0.24,0.44377777777777777,0.83,99.41
2020-08-09,Assam,1493,5,1493,18997,2992,2327,7.86,0,36.0,170973,1415,169981,8.31,6.46,0.5276944444444445,0.83,99.42
2020-08-10,Assam,390,5,381,5150,2738,38,7.57,4,36.0,171363,1420,170362,7.61,0.11,0.14305555555555555,0.83,99.42
2020-08-11,Assam,1523,14,1514,19312,4957,206,7.89,0,36.0,172886,1434,171876,13.77,0.57,0.5364444444444444,0.83,99.42
2020-08-12,Assam,1452,16,1450,17968,1182,1010,8.08,0,36.0,174338,1450,173326,3.28,2.81,0.4991111111111111,0.83,99.42
2020-08-13,Assam,1005,5,1005,12794,2374,2027,7.86,0,36.0,175343,1455,174331,6.59,5.63,0.35538888888888887,0.83,99.42
2020-08-14,Assam,1388,8,1385,17223,3682,2143,8.06,0,36.0,176731,1463,175716,10.23,5.95,0.47841666666666666,0.83,99.43
2020-08-15,Assam,533,7,532,6624,4610,3949,8.05,0,36.0,177264,1470,176248,12.81,10.97,0.184,0.83,99.43
2020-08-16,Assam,939,6,938,11890,1054,678,7.9,0,36.0,178203,1476,177186,2.93,1.88,0.3302777777777778,0.83,99.43
2020-08-17,Assam,1143,16,1135,14614,2642,2384,7.82,0,36.0,179346,1492,178321,7.34,6.62,0.40594444444444444,0.83,99.43
2020-08-18,Assam,1060,9,1055,13562,495,301,7.82,0,36.0,180406,1501,179376,1.38,0.84,0.37672222222222224,0.83,99.43
2020-08-19,Assam,515,4,506,6288,158,56,8.19,5,36.0,180921,1505,179882,0.44,0.16,0.17466666666666666,0.83,99.43
2020-08-20,Assam,301,1,299,3858,1349,1312,7.8,1,36.0,181222,1506,180181,3.75,3.64,0.10716666666666666,0.83,99.43
2020-08-21,Assam,1278,6,1273,15864,4022,3749,8.06,0,36.0,182500,1512,181454,11.17,10.41,0.44066666666666665,0.83,99.43
2020-08-22,Assam,47,0,44,786,4351,3483,5.98,3,36.0,182547,1512,181498,12.09,9.68,0.021833333333333333,0.83,99.43
2020-08-23,Assam,190,1,186,2386,306,286,7.96,3,36.0,182737,1513,181684,0.85,0.79,0.06627777777777778,0.83,99.42
2020-08-24,Assam,685,6,677,8150,384,61,8.4,2,36.0,183422,1519,182361,1.07,0.17,0.2263888888888889,0.83,99.42
2020-08-25,Assam,298,2,297,3964,3231,2646,7.52,0,36.0,183720,1521,182658,8.98,7.35,0.11011111111111112,0.83,99.42
2020-08-26,Assam,724,5,723,9069,3899,418,7.98,0,36.0,184444,1526,183381,10.83,1.16,0.2519166666666667,0.83,99.42
2020-08-27,Assam,77,0,77,1011,2150,209,7.62,0,36.0,184521,1526,183458,5.97,0.58,0.02808333333333333,0.83,99.42
2020-08-28,Assam,741,6,734,8966,4564,489,8.26,1,36.0,185262,1532,184192,12.68,1.36,0.24905555555555556,0.83,99.42
2020-08-29,Assam,783,3,783,9831,2398,480,7.96,0,36.0,186045,1535,184975,6.66,1.33,0.27308333333333334,0.83,99.42
2020-08-30,Assam,126,0,119,1651,2198,1592,7.63,7,36.0,186171,1535,185094,6.11,4.42,0.04586111111111111,0.82,99.42
2020-08-31,Assam,1065,15,1062,13337,682,325,7.99,0,36.0,187236,1550,186156,1.89,0.9,0.3704722222222222,0.83,99.42
2020-09-01,Assam,1265,8,1258,15706,1952,1451,8.05,0,36.0,188501,1558,187414,5.42,4.03,0.43627777777777776,0.83,99.42
2020-09-02,Assam,251,2,251,2805,2234,2025,8.95,0,36.0,188752,1560,187665,6.21,5.62,0.07791666666666666,0.83,99.42
2020-09-03,Assam,368,3,361,4964,3818,1606,7.41,4,36.0,189120,1563,188026,10.61,4.46,0.1378888888888889,0.83,99.42
2020-09-04,Assam,260,1,251,3255,2099,504,7.99,8,36.0,189380,1564,188277,5.83,1.4,0.09041666666666667,0.83,99.42
2020-09-05,Assam,394,3,390,5082,207,85,7.75,1,36.0,189774,1567,188667,0.57,0.24,0.14116666666666666,0.83,99.42
2020-09-06,Assam,1463,4,1458,18414,709,349,7.95,1,36.0,191237,1571,190125,1.97,0.97,0.5115,0.82,99.42
2020-09-07,Assam,70,0,62,1180,3950,252,5.93,8,36.0,191307,1571,190187,10.97,0.7,0.03277777777777778,0.82,99.41
2020-09-08,Assam,241,3,239,2953,1577,939,8.16,0,36.0,191548,1574,190426,4.38,2.61,0.08202777777777778,0.82,99.41
2020-09-09,Assam,47,0,46,513,1962,1101,9.16,1,36.0,191595,1574,190472,5.45,3.06,0.01425,0.82,99.41
2020-09-10,Assam,361,3,353,4189,3743,267,8.62,5,36.0,191956,1577,190825,10.4,0.74,0.11636111111111111,0.82,99.41
2020-09-11,Assam,33,0,29,662,3821,3422,4.98,4,36.0,191989,1577,190854,10.61,9.51,0.01838888888888889,0.82,99.41
2020-09-12,Assam,876,4,870,11357,1836,160,7.71,2,36.0,192865,1581,191724,5.1,0.44,0.3154722222222222,0.82,99.41
2020-09-13,Assam,1439,5,1432,17921,3724,2458,8.03,2,36.0,194304,1586,193156,10.34,6.83,0.49780555555555556,0.82,99.41
2020-09-14,Assam,976,5,971,12261,424,32,7.96,0,36.0,195280,1591,194127,1.18,0.09,0.34058333333333335,0.81,99.41
2020-09-15,Assam,1334,7,1327,16814,3538,1077,7.93,0,36.0,196614,1598,195454,9.83,2.99,0.46705555555555556,0.81,99.41
2020-09-16,Assam,843,11,834,10687,4930,3771,7.89,0,36.0,197457,1609,196288,13.69,10.48,0.29686111111111113,0.81,99.41
2020-09-17,Assam,308,3,300,3730,3351,2693,8.26,5,36.0,197765,1612,196588,9.31,7.48,0.10361111111111111,0.82,99.4
2020-09-18,Assam,1396,5,1393,17442,3140,3005,8.0,0,36.0,199161,1617,197981,8.72,8.35,0.4845,0.81,99.41
2020-09-19,Assam,677,4,674,8777,1621,865,7.71,0,36.0,199838,1621,198655,4.5,2.4,0.24380555555555555,0.81,99.41
2020-09-20,Assam,1451,8,1447,17817,634,144,8.14,0,36.0,201289,1629,200102,1.76,0.4,0.49491666666666667,0.81,99.41
2020-09-21,Assam,1225,18,1224,15436,3127,1257,7.94,0,36.0,202514,1647,201326,8.69,3.49,0.42877777777777776,0.81,99.41
2020-09-22,Assam,369,1,366,4698,3470,323,7.85,2,36.0,202883,1648,201692,9.64,0.9,0.1305,0.81,99.41
2020-09-23,Assam,1230,4,1227,15119,4953,2219,8.14,0,36.0,204113,1652,202919,13.76,6.16,0.41997222222222225,0.81,99.42
2020-09-24,Assam,116,0,111,1410,396,228,8.23,5,36.0,204229,1652,203030,1.1,0.63,0.03916666666666667,0.81,99.41
2020-09-25,Assam,1091,4,1084,13845,4685,4526,7.88,3,36.0,205320,1656,204114,13.01,12.57,0.38458333333333333,0.81,99.41
2020-09-26,Assam,1219,8,1219,14894,160,87,8.18,0,36.0,206539,1664,205333,0.44,0.24,0.4137222222222222,0.81,99.42
2020-09-27,Assam,1215,15,1207,15189,853,802,8.0,0,36.0,207754,1679,206540,2.37,2.23,0.42191666666666666,0.81,99.42
2020-09-28,Assam,1186,4,1179,14249,4970,719,8.32,3,36.0,208940,1683,207719,13.81,2.0,0.3958055555555556,0.81,99.42
2020-09-29,Assam,514,4,507,6624,2167,913,7.76,3,36.0,209454,1687,208226,6.02,2.54,0.184,0.81,99.41
2020-09-30,Assam,938,4,932,11865,3450,2384,7.91,2,36.0,210392,1691,209158,9.58,6.62,0.32958333333333334,0.8,99.41
2020-10-01,Assam,204,1,195,2813,177,138,7.25,8,36.0,210596,1692,209353,0.49,0.38,0.07813888888888888,0.8,99.41
2020-10-02,Assam,1271,10,1267,15903,703,678,7.99,0,36.0,211867,1702,210620,1.95,1.88,0.44175,0.8,99.41
2020-10-03,Assam,941,8,939,12143,4906,137,7.75,0,36.0,212808,1710,211559,13.63,0.38,0.3373055555555556,0.8,99.41
2020-10-04,Assam,84,0,84,790,2159,440,10.63,0,36.0,212892,1710,211643,6.0,1.22,0.021944444444444444,0.8,99.41
2020-10-05,Assam,1103,10,1095,13536,4819,3579,8.15,0,36.0,213995,1720,212738,13.39,9.94,0.376,0.8,99.41
2020-10-06,Assam,40,0,31,785,1719,1529,5.1,9,36.0,214035,1720,212769,4.78,4.25,0.021805555555555557,0.8,99.41
2020-10-07,Assam,922,6,922,11871,835,329,7.77,0,36.0,214957,1726,213691,2.32,0.91,0.32975,0.8,99.41
2020-10-08,Assam,892,7,888,10876,1986,1732,8.2,0,36.0,215849,1733,214579,5.52,4.81,0.3021111111111111,0.8,99.41
2020-10-09,Assam,1276,5,1272,15933,876,673,8.01,0,36.0,217125,1738,215851,2.43,1.87,0.44258333333333333,0.8,99.41
2020-10-10,Assam,1596,15,1593,19808,3840,539,8.06,0,36.0,218721,1753,217444,10.67,1.5,0.5502222222222222,0.8,99.42
2020-10-11,Assam,857,8,855,10573,1256,1208,8.11,0,36.0,219578,1761,218299,3.49,3.36,0.2936944444444444,0.8,99.42
2020-10-12,Assam,570,6,570,6879,2845,307,8.29,0,36.0,220148,1767,218869,7.9,0.85,0.19108333333333333,0.8,99.42
2020-10-13,Assam,1122,10,1122,13643,4562,2066,8.22,0,36.0,221270,1777,219991,12.67,5.74,0.3789722222222222,0.8,99.42
2020-10-14,Assam,1464,6,1457,17925,3887,3462,8.17,1,36.0,222734,1783,221448,10.8,9.62,0.4979166666666667,0.8,99.42
2020-10-15,Assam,786,8,778,9918,2358,447,7.92,0,36.0,223520,1791,222226,6.55,1.24,0.2755,0.8,99.42
2020-10-16,Assam,150,0,146,2393,4584,3529,6.27,4,36.0,223670,1791,222372,12.73,9.8,0.06647222222222222,0.8,99.42
2020-10-17,Assam,1028,5,1026,12447,4720,2725,8.26,0,36.0,224698,1796,223398,13.11,7.57,0.34575,0.8,99.42
2020-10-18,Assam,770,6,768,9242,3693,3644,8.33,0,36.0,225468,1802,224166,10.26,10.12,0.25672222222222224,0.8,99.42
2020-10-19,Assam,602,4,596,7588,3874,2667,7.93,2,36.0,226070,1806,224762,10.76,7.41,0.21077777777777779,0.8,99.42
2020-10-20,Assam,1374,12,1365,16738,4837,941,8.21,0,36.0,227444,1818,226127,13.44,2.61,0.46494444444444444,0.8,99.42
2020-10-21,Assam,1471,13,1471,18249,2679,2237,8.06,0,36.0,228915,1831,227598,7.44,6.21,0.5069166666666667,0.8,99.42
2020-10-22,Assam,1089,6,1087,13658,2863,1787,7.97,0,36.0,230004,1837,228685,7.95,4.96,0.3793888888888889,0.8,99.43
2020-10-23,Assam,1295,12,1293,16414,4397,3383,7.89,0,36.0,231299,1849,229978,12.21,9.4,0.45594444444444443,0.8,99.43
2020-10-24,Assam,1071,14,1069,14168,4714,4405,7.56,0,36.0,232370,1863,231047,13.09,12.24,0.39355555555555555,0.8,99.43
2020-10-25,Assam,619,8,614,7811,61,10,7.92,0,36.0,232989,1871,231661,0.17,0.03,0.21697222222222223,0.8,99.43
2020-10-26,Assam,608,3,606,7536,622,134,8.07,0,36.0,233597,1874,232267,1.73,0.37,0.20933333333333334,0.8,99.43
2020-10-27,Assam,134,0,132,1733,3752,256,7.73,2,36.0,233731,1874,232399,10.42,0.71,0.04813888888888889,0.8,99.43
2020-10-28,Assam,588,3,582,7542,1577,148,7.8,3,36.0,234319,1877,232981,4.38,0.41,0.2095,0.8,99.43
2020-10-29,Assam,474,2,470,5848,870,135,8.11,2,36.0,234793,1879,233451,2.42,0.38,0.16244444444444445,0.8,99.43
2020-10-30,Assam,1182,16,1173,14521,3373,1,8.14,0,36.0,235975,1895,234624,9.37,0.0,0.4033611111111111,0.8,99.43
2020-10-31,Assam,1077,12,1071,13349,1691,723,8.07,0,36.0,237052,1907,235695,4.7,2.01,0.37080555555555555,0.8,99.43
2020-11-01,Assam,207,1,202,2449,3089,364,8.45,4,36.0,237259,1908,235897,8.58,1.01,0.06802777777777778,0.8,99.43
2020-11-02,Assam,185,2,180,1956,896,251,9.46,3,36.0,237444,1910,236077,2.49,0.7,0.05433333333333333,0.8,99.42
2020-11-03,Assam,884,2,876,11038,300,47,8.01,6,36.0,238328,1912,236953,0.83,0.13,0.3066111111111111,0.8,99.42
2020-11-04,Assam,659,6,655,8163,1065,196,8.07,0,36.0,238987,1918,237608,2.96,0.54,0.22675,0.8,99.42
2020-11-05,Assam,1058,6,1057,13455,3470,1476,7.86,0,36.0,240045,1924,238665,9.64,4.1,0.37375,0.8,99.43
2020-11-06,Assam,481,2,479,6145,3149,2414,7.83,0,36.0,240526,1926,239144,8.75,6.71,0.17069444444444445,0.8,99.43
2020-11-07,Assam,401,1,400,4872,2486,553,8.23,0,36.0,240927,1927,239544,6.91,1.54,0.13533333333333333,0.8,99.43
2020-11-08,Assam,261,3,257,3649,2861,23,7.15,1,36.0,241188,1930,239801,7.95,0.06,0.10136111111111111,0.8,99.42
2020-11-09,Assam,1537,19,1537,19249,3144,2563,7.98,0,36.0,242725,1949,241338,8.73,7.12,0.5346944444444445,0.8,99.43
2020-11-10,Assam,619,7,611,7793,196,68,7.94,1,36.0,243344,1956,241949,0.54,0.19,0.21647222222222223,0.8,99.43
2020-11-11,Assam,36,0,30,763,1511,21,4.72,6,36.0,243380,1956,241979,4.2,0.06,0.021194444444444443,0.8,99.42
2020-11-12,Assam,611,8,602,7520,3989,3580,8.12,1,36.0,243991,1964,242581,11.08,9.94,0.2088888888888889,0.8,99.42
2020-11-13,Assam,954,7,950,11541,1574,807,8.27,0,36.0,244945,1971,243531,4.37,2.24,0.32058333333333333,0.8,99.42
2020-11-14,Assam,1069,6,1063,13416,3303,192,7.97,0,36.0,246014,1977,244594,9.18,0.53,0.37266666666666665,0.8,99.42
2020-11-15,Assam,1236,5,1236,15179,132,94,8.14,0,36.0,247250,1982,245830,0.37,0.26,0.4216388888888889,0.8,99.43
2020-11-16,Assam,1381,15,1373,17248,2637,1972,8.01,0,36.0,248631,1997,247203,7.32,5.48,0.4791111111111111,0.8,99.43
2020-11-17,Assam,1499,5,1499,18220,72,21,8.23,0,36.0,250130,2002,248702,0.2,0.06,0.5061111111111111,0.8,99.43
2020-11-18,Assam,709,8,700,8860,3722,2237,8.0,1,36.0,250839,2010,249402,10.34,6.21,0.2461111111111111,0.8,99.43
2020-11-19,Assam,324,4,316,4088,1943,1255,7.93,4,36.0,251163,2014,249718,5.4,3.49,0.11355555555555556,0.8,99.42
2020-11-20,Assam,1503,9,1501,18779,4853,2758,8.0,0,36.0,252666,2023,251219,13.48,7.66,0.5216388888888889,0.8,99.43
2020-11-21,Assam,8,0,3,501,3113,1647,1.6,5,36.0,252674,2023,251222,8.65,4.58,0.013916666666666667,0.8,99.43
2020-11-22,Assam,1606,14,1597,19959,1494,1067,8.05,0,36.0,254280,2037,252819,4.15,2.96,0.5544166666666667,0.8,99.43
2020-11-23,Assam,863,9,862,10834,879,86,7.97,0,36.0,255143,2046,253681,2.44,0.24,0.30094444444444446,0.8,99.43
2020-11-24,Assam,1577,11,1572,19667,4336,2936,8.02,0,36.0,256720,2057,255253,12.04,8.16,0.5463055555555556,0.8,99.43
2020-11-25,Assam,861,4,861,10633,56,49,8.1,0,36.0,257581,2061,256114,0.16,0.14,0.29536111111111113,0.8,99.43
2020-11-26,Assam,554,3,550,6393,3187,1036,8.67,1,36.0,258135,2064,256664,8.85,2.88,0.17758333333333334,0.8,99.43
2020-11-27,Assam,737,9,737,9282,605,339,7.94,0,36.0,258872,2073,257401,1.68,0.94,0.25783333333333336,0.8,99.43
2020-11-28,Assam,522,7,514,6517,4804,1560,8.01,1,36.0,259394,2080,257915,13.34,4.33,0.1810277777777778,0.8,99.43
2020-11-29,Assam,1393,18,1392,17175,2580,1251,8.11,0,36.0,260787,2098,259307,7.17,3.48,0.47708333333333336,0.8,99.43
2020-11-30,Assam,1246,16,1245,15614,1240,360,7.98,0,36.0,262033,2114,260552,3.44,1.0,0.43372222222222223,0.81,99.43
2020-12-01,Assam,979,10,976,12789,1075,551,7.66,0,36.0,263012,2124,261528,2.99,1.53,0.35525,0.81,99.44
2020-12-02,Assam,1474,9,1473,18433,596,595,8.0,0,36.0,264486,2133,263001,1.66,1.65,0.5120277777777777,0.81,99.44
2020-12-03,Assam,1099,4,1097,13759,725,11,7.99,0,36.0,265585,2137,264098,2.01,0.03,0.38219444444444445,0.8,99.44
2020-12-04,Assam,1425,19,1423,17795,93,39,8.01,0,36.0,267010,2156,265521,0.26,0.11,0.49430555555555555,0.81,99.44
2020-12-05,Assam,1285,8,1281,16222,18,16,7.92,0,36.0,268295,2164,266802,0.05,0.04,0.45061111111111113,0.81,99.44
2020-12-06,Assam,356,4,354,4807,2358,993,7.41,0,36.0,268651,2168,267156,6.55,2.76,0.13352777777777777,0.81,99.44
2020-12-07,Assam,732,10,731,9449,4419,1978,7.75,0,36.0,269383,2178,267887,12.28,5.49,0.2624722222222222,0.81,99.44
2020-12-08,Assam,347,2,342,3893,3131,660,8.91,3,36.0,269730,2180,268229,8.7,1.83,0.1081388888888889,0.81,99.44
2020-12-09,Assam,1414,21,1414,17558,4580,4430,8.05,0,36.0,271144,2201,269643,12.72,12.31,0.4877222222222222,0.81,99.45
2020-12-10,Assam,522,7,519,6151,636,385,8.49,0,36.0,271666,2208,270162,1.77,1.07,0.1708611111111111,0.81,99.45
2020-12-11,Assam,1432,17,1428,17726,758,105,8.08,0,36.0,273098,2225,271590,2.11,0.29,0.4923888888888889,0.81,99.45
2020-12-12,Assam,1545,16,1543,19488,2242,421,7.93,0,36.0,274643,2241,273133,6.23,1.17,0.5413333333333333,0.82,99.45
2020-12-13,Assam,278,1,273,3266,4823,129,8.51,4,36.0,274921,2242,273406,13.4,0.36,0.09072222222222222,0.82,99.45
2020-12-14,Assam,924,6,922,11620,4600,193,7.95,0,36.0,275845,2248,274328,12.78,0.54,0.3227777777777778,0.81,99.45
2020-12-15,Assam,1048,6,1041,13237,727,321,7.92,1,36.0,276893,2254,275369,2.02,0.89,0.36769444444444443,0.81,99.45
2020-12-16,Assam,847,2,846,10530,3075,1973,8.04,0,36.0,277740,2256,276215,8.54,5.48,0.2925,0.81,99.45
2020-12-17,Assam,821,5,821,10294,1225,91,7.98,0,36.0,278561,2261,277036,3.4,0.25,0.28594444444444445,0.81,99.45
2020-12-18,Assam,263,2,262,3255,800,318,8.08,0,36.0,278824,2263,277298,2.22,0.88,0.09041666666666667,0.81,99.45
2020-12-19,Assam,1218,16,1215,15626,3692,486,7.79,0,36.0,280042,2279,278513,10.26,1.35,0.43405555555555553,0.81,99.45
2020-12-20,Assam,837,7,832,10451,2201,1292,8.01,0,36.0,280879,2286,279345,6.11,3.59,0.29030555555555554,0.81,99.45
2020-12-21,Assam,1459,6,1457,17977,855,248,8.12,0,36.0,282338,2292,280802,2.38,0.69,0.4993611111111111,0.81,99.46
2020-12-22,Assam,1597,10,1593,19691,165,141,8.11,0,36.0,283935,2302,282395,0.46,0.39,0.5469722222222222,0.81,99.46
2020-12-23,Assam,719,8,710,8819,1599,633,8.15,1,36.0,284654,2310,283105,4.44,1.76,0.24497222222222223,0.81,99.46
2020-12-24,Assam,1226,18,1217,15339,872,296,7.99,0,36.0,285880,2328,284322,2.42,0.82,0.4260833333333333,0.81,99.46
2020-12-25,Assam,1028,5,1021,12396,390,83,8.29,2,36.0,286908,2333,285343,1.08,0.23,0.3443333333333333,0.81,99.45
2020-12-26,Assam,228,0,225,2664,1033,903,8.56,3,36.0,287136,2333,285568,2.87,2.51,0.074,0.81,99.45
2020-12-27,Assam,1249,18,1241,16061,4369,1065,7.78,0,36.0,288385,2351,286809,12.14,2.96,0.44613888888888886,0.82,99.45
2020-12-28,Assam,1274,16,1267,15877,1065,846,8.02,0,36.0,289659,2367,288076,2.96,2.35,0.4410277777777778,0.82,99.45
2020-12-29,Assam,788,3,782,9906,2476,1197,7.95,3,36.0,290447,2370,288858,6.88,3.32,0.27516666666666667,0.82,99.45
2020-12-30,Assam,261,3,255,3397,3088,2426,7.68,3,36.0,290708,2373,289113,8.58,6.74,0.09436111111111112,0.82,99.45
2020-12-31,Assam,142,1,142,2134,2706,2136,6.65,0,36.0,290850,2374,289255,7.52,5.93,0.059277777777777776,0.82,99.45
2021-01-01,Assam,790,8,784,10272,1000,68,7.69,0,36.0,291640,2382,290039,2.78,0.19,0.2853333333333333,0.82,99.45
2021-01-02,Assam,975,3,974,12025,3976,1368,8.11,0,36.0,292615,2385,291013,11.04,3.8,0.33402777777777776,0.82,99.45
2021-01-03,Assam,1207,9,1207,15196,1530,1439,7.94,0,36.0,293822,2394,292220,4.25,4.0,0.4221111111111111,0.81,99.45
2021-01-04,Assam,1265,14,1258,15927,3870,417,7.94,0,36.0,295087,2408,293478,10.75,1.16,0.4424166666666667,0.82,99.45
2021-01-05,Assam,424,3,421,5556,2804,2562,7.63,0,36.0,295511,2411,293899,7.79,7.12,0.15433333333333332,0.82,99.45
2021-01-06,Assam,253,1,248,2843,1492,861,8.9,4,36.0,295764,2412,294147,4.14,2.39,0.07897222222222222,0.82,99.45
2021-01-07,Assam,110,1,107,1208,1537,1290,9.11,2,36.0,295874,2413,294254,4.27,3.58,0.033555555555555554,0.82,99.45
2021-01-08,Assam,709,4,705,8918,1131,827,7.95,0,36.0,296583,2417,294959,3.14,2.3,0.24772222222222223,0.81,99.45
2021-01-09,Assam,476,4,469,5856,2914,1791,8.13,3,36.0,297059,2421,295428,8.09,4.98,0.16266666666666665,0.81,99.45
2021-01-10,Assam,1477,5,1471,18478,3456,2503,7.99,1,36.0,298536,2426,296899,9.6,6.95,0.5132777777777778,0.81,99.45
2021-01-11,Assam,831,2,826,10466,269,243,7.94,3,36.0,299367,2428,297725,0.75,0.68,0.2907222222222222,0.81,99.45
2021-01-12,Assam,1374,17,1369,16979,4451,3644,8.09,0,36.0,300741,2445,299094,12.36,10.12,0.4716388888888889,0.81,99.45
2021-01-13,Assam,1165,16,1158,14214,1704,234,8.2,0,36.0,301906,2461,300252,4.73,0.65,0.3948333333333333,0.82,99.45
2021-01-14,Assam,546,6,541,6958,1432,234,7.85,0,36.0,302452,2467,300793,3.98,0.65,0.19327777777777777,0.82,99.45
2021-01-15,Assam,665,3,665,8040,3525,2240,8.27,0,36.0,303117,2470,301458,9.79,6.22,0.22333333333333333,0.81,99.45
2021-01-16,Assam,438,5,431,4997,4846,2019,8.77,2,36.0,303555,2475,301889,13.46,5.61,0.13880555555555554,0.82,99.45
2021-01-17,Assam,413,5,404,5201,1743,1620,7.94,4,36.0,303968,2480,302293,4.84,4.5,0.14447222222222222,0.82,99.45
2021-01-18,Assam,1279,7,1275,16180,627,389,7.9,0,36.0,305247,2487,303568,1.74,1.08,0.4494444444444444,0.81,99.45
2021-01-19,Assam,881,10,881,10794,1116,786,8.16,0,36.0,306128,2497,304449,3.1,2.18,0.29983333333333334,0.82,99.45
2021-01-20,Assam,1426,8,1424,17785,4218,509,8.02,0,36.0,307554,2505,305873,11.72,1.41,0.4940277777777778,0.81,99.45
2021-01-21,Assam,648,6,642,7822,4740,266,8.28,0,36.0,308202,2511,306515,13.17,0.74,0.21727777777777776,0.81,99.45
2021-01-22,Assam,283,2,276,3135,2333,1859,9.03,5,36.0,308485,2513,306791,6.48,5.16,0.08708333333333333,0.81,99.45
2021-01-23,Assam,1603,14,1601,19925,1070,727,8.05,0,36.0,310088,2527,308392,2.97,2.02,0.5534722222222223,0.81,99.45
2021-01-24,Assam,506,5,506,6015,388,25,8.41,0,36.0,310594,2532,308898,1.08,0.07,0.16708333333333333,0.82,99.45
2021-01-25,Assam,537,7,535,6527,3244,1437,8.23,0,36.0,311131,2539,309433,9.01,3.99,0.18130555555555555,0.82,99.45
2021-01-26,Assam,423,5,420,5278,1427,741,8.01,0,36.0,311554,2544,309853,3.96,2.06,0.1466111111111111,0.82,99.45
2021-01-27,Assam,1577,18,1574,19714,515,201,8.0,0,36.0,313131,2562,311427,1.43,0.56,0.5476111111111112,0.82,99.46
2021-01-28,Assam,1416,9,1413,17618,1216,194,8.04,0,36.0,314547,2571,312840,3.38,0.54,0.4893888888888889,0.82,99.46
2021-01-29,Assam,214,1,214,2644,4675,4221,8.09,0,36.0,314761,2572,313054,12.99,11.72,0.07344444444444445,0.82,99.46
2021-01-30,Assam,1146,16,1146,13861,3714,3478,8.27,0,36.0,315907,2588,314200,10.32,9.66,0.3850277777777778,0.82,99.46
2021-01-31,Assam,335,1,329,3946,3126,2962,8.49,5,36.0,316242,2589,314529,8.68,8.23,0.10961111111111112,0.82,99.46
2021-02-01,Assam,725,4,722,9126,2662,2332,7.94,0,36.0,316967,2593,315251,7.39,6.48,0.2535,0.82,99.46
2021-02-02,Assam,1502,16,1501,18572,795,217,8.09,0,36.0,318469,2609,316752,2.21,0.6,0.5158888888888888,0.82,99.46
2021-02-03,Assam,1356,7,1347,16917,3788,361,8.02,2,36.0,319825,2616,318099,10.52,1.0,0.46991666666666665,0.82,99.46
2021-02-04,Assam,168,1,163,2148,1531,1221,7.82,4,36.0,319993,2617,318262,4.25,3.39,0.059666666666666666,0.82,99.46
2021-02-05,Assam,1440,7,1432,17746,2144,1505,8.11,1,36.0,321433,2624,319694,5.96,4.18,0.49294444444444446,0.82,99.46
2021-02-06,Assam,97,1,97,1223,588,520,7.93,0,36.0,321530,2625,319791,1.63,1.44,0.03397222222222222,0.82,99.46
2021-02-07,Assam,837,2,836,9978,3915,531,8.39,0,36.0,322367,2627,320627,10.88,1.48,0.2771666666666667,0.81,99.46
2021-02-08,Assam,594,6,591,7825,4501,4085,7.59,0,36.0,322961,2633,321218,12.5,11.35,0.21736111111111112,0.82,99.46
2021-02-09,Assam,567,3,558,6892,2718,2453,8.23,6,36.0,323528,2636,321776,7.55,6.81,0.19144444444444444,0.81,99.46
2021-02-10,Assam,675,4,674,8665,2667,1227,7.79,0,36.0,324203,2640,322450,7.41,3.41,0.24069444444444443,0.81,99.46
2021-02-11,Assam,609,3,606,7752,1762,1319,7.86,0,36.0,324812,2643,323056,4.89,3.66,0.21533333333333332,0.81,99.46
2021-02-12,Assam,606,6,600,7518,1581,746,8.06,0,36.0,325418,2649,323656,4.39,2.07,0.20883333333333334,0.81,99.46
2021-02-13,Assam,518,3,517,6320,109,86,8.2,0,36.0,325936,2652,324173,0.3,0.24,0.17555555555555555,0.81,99.46
2021-02-14,Assam,535,5,526,6425,3107,1990,8.33,4,36.0,326471,2657,324699,8.63,5.53,0.17847222222222223,0.81,99.46
2021-02-15,Assam,904,11,895,10898,2581,946,8.3,0,36.0,327375,2668,325594,7.17,2.63,0.3027222222222222,0.81,99.46
2021-02-16,Assam,1346,4,1341,16799,584,3,8.01,1,36.0,328721,2672,326935,1.62,0.01,0.4666388888888889,0.81,99.46
2021-02-17,Assam,62,0,58,971,2712,211,6.39,4,36.0,328783,2672,326993,7.53,0.59,0.026972222222222224,0.81,99.46
2021-02-18,Assam,1221,12,1212,15623,2236,1692,7.82,0,36.0,330004,2684,328205,6.21,4.7,0.4339722222222222,0.81,99.45
2021-02-19,Assam,582,5,581,7368,4691,2914,7.9,0,36.0,330586,2689,328786,13.03,8.09,0.20466666666666666,0.81,99.46
2021-02-20,Assam,1115,4,1111,13959,3803,1743,7.99,0,36.0,331701,2693,329897,10.56,4.84,0.38775,0.81,99.46
2021-02-21,Assam,547,2,546,7074,1494,1190,7.73,0,36.0,332248,2695,330443,4.15,3.31,0.1965,0.81,99.46
2021-02-22,Assam,484,1,476,6121,4055,2431,7.91,7,36.0,332732,2696,330919,11.26,6.75,0.17002777777777778,0.81,99.46
2021-02-23,Assam,1336,13,1331,16710,4761,3248,8.0,0,36.0,334068,2709,332250,13.23,9.02,0.46416666666666667,0.81,99.46
2021-02-24,Assam,929,4,923,11750,3684,1976,7.91,2,36.0,334997,2713,333173,10.23,5.49,0.3263888888888889,0.81,99.46
2021-02-25,Assam,1081,4,1078,13561,1591,1538,7.97,0,36.0,336078,2717,334251,4.42,4.27,0.37669444444444444,0.81,99.46
2021-02-26,Assam,582,4,577,7465,1845,429,7.8,1,36.0,336660,2721,334828,5.12,1.19,0.2073611111111111,0.81,99.46
2021-02-27,Assam,1042,5,1033,13328,3283,2097,7.82,4,36.0,337702,2726,335861,9.12,5.82,0.37022222222222223,0.81,99.45
2021-02-28,Assam,920,10,920,11623,3148,1387,7.92,0,36.0,338622,2736,336781,8.74,3.85,0.3228611111111111,0.81,99.46
2021-03-01,Assam,350,2,343,4223,2504,959,8.29,5,36.0,338972,2738,337124,6.96,2.66,0.11730555555555555,0.81,99.45
2021-03-02,Assam,1591,21,1586,19885,4665,1930,8.0,0,36.0,340563,2759,338710,12.96,5.36,0.5523611111111111,0.81,99.46
2021-03-03,Assam,941,13,936,11903,117,115,7.91,0,36.0,341504,2772,339646,0.32,0.32,0.33063888888888887,0.81,99.46
2021-03-04,Assam,942,3,941,11557,2540,2388,8.15,0,36.0,342446,2775,340587,7.06,6.63,0.3210277777777778,0.81,99.46
2021-03-05,Assam,451,3,449,6065,2467,2030,7.44,0,36.0,342897,2778,341036,6.85,5.64,0.16847222222222222,0.81,99.46
2021-03-06,Assam,1008,11,1000,12759,1463,540,7.9,0,36.0,343905,2789,342036,4.06,1.5,0.35441666666666666,0.81,99.46
2021-03-07,Assam,1145,10,1141,13945,3864,3089,8.21,0,36.0,345050,2799,343177,10.73,8.58,0.3873611111111111,0.81,99.46
2021-03-08,Assam,1509,6,1508,18992,2057,381,7.95,0,36.0,346559,2805,344685,5.71,1.06,0.5275555555555556,0.81,99.46
2021-03-09,Assam,621,5,612,7754,2933,1369,8.01,4,36.0,347180,2810,345297,8.15,3.8,0.21538888888888888,0.81,99.46
2021-03-10,Assam,932,7,926,11774,1121,302,7.92,0,36.0,348112,2817,346223,3.11,0.84,0.32705555555555554,0.81,99.46
2021-03-11,Assam,125,0,121,1405,3919,2225,8.9,4,36.0,348237,2817,346344,10.89,6.18,0.03902777777777778,0.81,99.46
2021-03-12,Assam,1579,11,1570,19976,4543,2000,7.9,0,36.0,349816,2828,347914,12.62,5.56,0.5548888888888889,0.81,99.46
2021-03-13,Assam,244,2,236,3195,4826,2847,7.64,6,36.0,350060,2830,348150,13.41,7.91,0.08875,0.81,99.45
2021-03-14,Assam,237,2,235,3184,1493,817,7.44,0,36.0,350297,2832,348385,4.15,2.27,0.08844444444444445,0.81,99.45
2021-03-15,Assam,1136,5,1133,14172,3047,1858,8.02,0,36.0,351433,2837,349518,8.46,5.16,0.39366666666666666,0.81,99.46
2021-03-16,Assam,1465,19,1461,18440,709,664,7.94,0,36.0,352898,2856,350979,1.97,1.84,0.5122222222222222,0.81,99.46
2021-03-17,Assam,1321,4,1314,16160,760,226,8.17,3,36.0,354219,2860,352293,2.11,0.63,0.4488888888888889,0.81,99.46
2021-03-18,Assam,1355,4,1347,17607,4698,3927,7.7,4,36.0,355574,2864,353640,13.05,10.91,0.4890833333333333,0.81,99.46
2021-03-19,Assam,217,2,208,2700,3432,678,8.04,7,36.0,355791,2866,353848,9.53,1.88,0.075,0.81,99.45
2021-03-20,Assam,1566,10,1564,19972,4318,1404,7.84,0,36.0,357357,2876,355412,11.99,3.9,0.5547777777777778,0.8,99.46
2021-03-21,Assam,576,3,572,6940,3121,2785,8.3,1,36.0,357933,2879,355984,8.67,7.74,0.19277777777777777,0.8,99.46
2021-03-22,Assam,526,1,522,6294,2690,2438,8.36,3,36.0,358459,2880,356506,7.47,6.77,0.17483333333333334,0.8,99.46
2021-03-23,Assam,712,9,703,8672,2681,106,8.21,0,36.0,359171,2889,357209,7.45,0.29,0.2408888888888889,0.8,99.45
2021-03-24,Assam,571,3,562,6843,2882,1041,8.34,6,36.0,359742,2892,357771,8.01,2.89,0.19008333333333333,0.8,99.45
2021-03-25,Assam,1501,5,1496,18368,1284,53,8.17,0,36.0,361243,2897,359267,3.57,0.15,0.5102222222222222,0.8,99.45
2021-03-26,Assam,494,3,487,5901,3977,809,8.37,4,36.0,361737,2900,359754,11.05,2.25,0.16391666666666665,0.8,99.45
2021-03-27,Assam,198,2,190,2575,1626,653,7.69,6,36.0,361935,2902,359944,4.52,1.81,0.07152777777777777,0.8,99.45
2021-03-28,Assam,938,5,938,11367,893,646,8.25,0,36.0,362873,2907,360882,2.48,1.79,0.31575,0.8,99.45
2021-03-29,Assam,137,1,129,1254,2157,1455,10.93,7,36.0,363010,2908,361011,5.99,4.04,0.034833333333333334,0.8,99.45
2021-03-30,Assam,353,1,350,4372,997,498,8.07,2,36.0,363363,2909,361361,2.77,1.38,0.12144444444444444,0.8,99.45
2021-03-31,Assam,1150,5,1145,14456,341,293,7.96,0,36.0,364513,2914,362506,0.95,0.81,0.40155555555555555,0.8,99.45
2021-04-01,Assam,1335,19,1332,16866,4402,1063,7.92,0,36.0,365848,2933,363838,12.23,2.95,0.4685,0.8,99.45
2021-04-02,Assam,1323,9,1320,16367,385,29,8.08,0,36.0,367171,2942,365158,1.07,0.08,0.45463888888888887,0.8,99.45
2021-04-03,Assam,674,8,672,8473,3909,3818,7.95,0,36.0,367845,2950,365830,10.86,10.61,0.2353611111111111,0.8,99.45
2021-04-04,Assam,1478,7,1476,18110,1412,754,8.16,0,36.0,369323,2957,367306,3.92,2.09,0.5030555555555556,0.8,99.45
2021-04-05,Assam,918,3,916,11648,4407,3462,7.88,0,36.0,370241,2960,368222,12.24,9.62,0.32355555555555554,0.8,99.45
2021-04-06,Assam,123,0,123,1633,3233,2376,7.53,0,36.0,370364,2960,368345,8.98,6.6,0.04536111111111111,0.8,99.45
2021-04-07,Assam,360,2,354,4148,1185,1052,8.68,4,36.0,370724,2962,368699,3.29,2.92,0.11522222222222223,0.8,99.45
2021-04-08,Assam,1235,15,1230,15604,1920,1311,7.91,0,36.0,371959,2977,369929,5.33,3.64,0.43344444444444447,0.8,99.45
2021-04-09,Assam,470,3,468,5718,1932,1156,8.22,0,36.0,372429,2980,370397,5.37,3.21,0.15883333333333333,0.8,99.45
2021-04-10,Assam,127,1,123,1683,2451,178,7.55,3,36.0,372556,2981,370520,6.81,0.49,0.04675,0.8,99.45
2021-04-11,Assam,529,2,524,6264,13,12,8.45,3,36.0,373085,2983,371044,0.04,0.03,0.174,0.8,99.45
2021-04-12,Assam,916,12,911,11587,2395,1844,7.91,0,36.0,374001,2995,371955,6.65,5.12,0.3218611111111111,0.8,99.45
2021-04-13,Assam,233,3,231,2946,2950,2297,7.91,0,36.0,374234,2998,372186,8.19,6.38,0.08183333333333333,0.8,99.45
2021-04-14,Assam,1258,17,1252,15770,1661,1116,7.98,0,36.0,375492,3015,373438,4.61,3.1,0.43805555555555553,0.8,99.45
2021-04-15,Assam,889,6,889,11440,4944,340,7.77,0,36.0,376381,3021,374327,13.73,0.94,0.31777777777777777,0.8,99.45
2021-04-16,Assam,380,4,379,4668,911,95,8.14,0,36.0,376761,3025,374706,2.53,0.26,0.12966666666666668,0.8,99.45
2021-04-17,Assam,1441,12,1438,18290,1615,126,7.88,0,36.0,378202,3037,376144,4.49,0.35,0.5080555555555556,0.8,99.46
2021-04-18,Assam,214,3,207,2909,2373,1383,7.36,4,36.0,378416,3040,376351,6.59,3.84,0.08080555555555556,0.8,99.45
2021-04-19,Assam,625,7,616,7443,2902,622,8.4,2,36.0,379041,3047,376967,8.06,1.73,0.20675,0.8,99.45
2021-04-20,Assam,811,5,807,10025,1034,751,8.09,0,36.0,379852,3052,377774,2.87,2.09,0.27847222222222223,0.8,99.45
2021-04-21,Assam,356,2,356,4545,3512,1603,7.83,0,36.0,380208,3054,378130,9.76,4.45,0.12625,0.8,99.45
2021-04-22,Assam,1573,16,1571,19636,1122,327,8.01,0,36.0,381781,3070,379701,3.12,0.91,0.5454444444444444,0.8,99.46
2021-04-23,Assam,342,1,336,4582,4140,2025,7.46,5,36.0,382123,3071,380037,11.5,5.62,0.12727777777777777,0.8,99.45
2021-04-24,Assam,1046,14,1046,13031,4603,3872,8.03,0,36.0,383169,3085,381083,12.79,10.76,0.3619722222222222,0.81,99.46
2021-04-25,Assam,486,2,479,6051,784,138,8.03,5,36.0,383655,3087,381562,2.18,0.38,0.16808333333333333,0.8,99.45
2021-04-26,Assam,191,0,184,2133,1023,561,8.95,7,36.0,383846,3087,381746,2.84,1.56,0.05925,0.8,99.45
2021-04-27,Assam,203,2,194,2496,1705,1375,8.13,7,36.0,384049,3089,381940,4.74,3.82,0.06933333333333333,0.8,99.45
2021-04-28,Assam,1566,17,1564,19549,120,117,8.01,0,36.0,385615,3106,383504,0.33,0.32,0.5430277777777778,0.81,99.45
2021-04-29,Assam,393,5,384,4852,3023,2273,8.1,4,36.0,386008,3111,383888,8.4,6.31,0.13477777777777777,0.81,99.45
2021-04-30,Assam,1475,16,1468,18488,4961,1304,7.98,0,36.0,387483,3127,385356,13.78,3.62,0.5135555555555555,0.81,99.45
2021-05-01,Assam,349,4,340,4408,3958,1469,7.92,5,36.0,387832,3131,385696,10.99,4.08,0.12244444444444444,0.81,99.45
2021-05-02,Assam,1274,4,1273,15738,1865,1287,8.1,0,36.0,389106,3135,386969,5.18,3.58,0.43716666666666665,0.81,99.45
2021-05-03,Assam,1032,8,1025,12368,1929,1702,8.34,0,36.0,390138,3143,387994,5.36,4.73,0.34355555555555556,0.81,99.45
2021-05-04,Assam,956,5,951,12153,1858,673,7.87,0,36.0,391094,3148,388945,5.16,1.87,0.33758333333333335,0.8,99.45
2021-05-05,Assam,723,4,720,8751,3426,2983,8.26,0,36.0,391817,3152,389665,9.52,8.29,0.24308333333333335,0.8,99.45
2021-05-06,Assam,1060,3,1055,13150,1412,819,8.06,2,36.0,392877,3155,390720,3.92,2.28,0.36527777777777776,0.8,99.45
2021-05-07,Assam,1074,13,1074,13082,759,551,8.21,0,36.0,393951,3168,391794,2.11,1.53,0.3633888888888889,0.8,99.45
2021-05-08,Assam,1565,10,1565,19453,4683,3246,8.05,0,36.0,395516,3178,393359,13.01,9.02,0.5403611111111111,0.8,99.45
2021-05-09,Assam,313,3,307,4188,4697,2572,7.47,3,36.0,395829,3181,393666,13.05,7.14,0.11633333333333333,0.8,99.45
2021-05-10,Assam,1430,9,1425,18205,2527,1044,7.85,0,36.0,397259,3190,395091,7.02,2.9,0.5056944444444444,0.8,99.45
2021-05-11,Assam,1010,4,1007,12820,3252,2131,7.88,0,36.0,398269,3194,396098,9.03,5.92,0.3561111111111111,0.8,99.45
2021-05-12,Assam,513,7,513,6024,3400,13,8.52,0,36.0,398782,3201,396611,9.44,0.04,0.16733333333333333,0.8,99.46
2021-05-13,Assam,646,2,639,8125,325,220,7.95,5,36.0,399428,3203,397250,0.9,0.61,0.22569444444444445,0.8,99.45
2021-05-14,Assam,757,8,757,9738,2333,1979,7.77,0,36.0,400185,3211,398007,6.48,5.5,0.2705,0.8,99.46
2021-05-15,Assam,1346,7,1339,16727,4420,2005,8.05,0,36.0,401531,3218,399346,12.28,5.57,0.4646388888888889,0.8,99.46
2021-05-16,Assam,1591,5,1586,19883,1883,18,8.0,0,36.0,403122,3223,400932,5.23,0.05,0.5523055555555556,0.8,99.46
2021-05-17,Assam,231,0,222,2706,58,52,8.54,9,36.0,403353,3223,401154,0.16,0.14,0.07516666666666667,0.8,99.45
2021-05-18,Assam,1361,5,1357,16785,1268,777,8.11,0,36.0,404714,3228,402511,3.52,2.16,0.46625,0.8,99.46
2021-05-19,Assam,1193,17,1186,14651,2638,1653,8.14,0,36.0,405907,3245,403697,7.33,4.59,0.40697222222222224,0.8,99.46
2021-05-20,Assam,1203,7,1197,15628,734,30,7.7,0,36.0,407110,3252,404894,2.04,0.08,0.4341111111111111,0.8,99.46
2021-05-21,Assam,988,12,982,11935,4822,4497,8.28,0,36.0,408098,3264,405876,13.39,12.49,0.33152777777777775,0.8,99.46
2021-05-22,Assam,876,8,874,10918,2375,908,8.02,0,36.0,408974,3272,406750,6.6,2.52,0.30327777777777776,0.8,99.46
2021-05-23,Assam,219,2,212,2788,3170,1440,7.86,5,36.0,409193,3274,406962,8.81,4.0,0.07744444444444444,0.8,99.45
2021-05-24,Assam,1277,19,1276,16295,1912,1037,7.84,0,36.0,410470,3293,408238,5.31,2.88,0.45263888888888887,0.8,99.46
2021-05-25,Assam,1428,14,1427,18238,10,9,7.83,0,36.0,411898,3307,409665,0.03,0.02,0.5066111111111111,0.8,99.46
2021-05-26,Assam,1255,9,1248,15338,3571,2745,8.18,0,36.0,413153,3316,410913,9.92,7.62,0.4260555555555556,0.8,99.46
2021-05-27,Assam,179,2,178,2083,432,117,8.59,0,36.0,413332,3318,411091,1.2,0.32,0.05786111111111111,0.8,99.46
2021-05-28,Assam,1336,17,1333,16848,4212,3231,7.93,0,36.0,414668,3335,412424,11.7,8.98,0.468,0.8,99.46
2021-05-29,Assam,925,12,925,11614,2164,384,7.96,0,36.0,415593,3347,413349,6.01,1.07,0.3226111111111111,0.81,99.46
2021-05-30,Assam,1469,17,1468,18156,3025,1510,8.09,0,36.0,417062,3364,414817,8.4,4.19,0.5043333333333333,0.81,99.46
2021-05-31,Assam,1288,12,1282,15817,1232,215,8.14,0,36.0,418350,3376,416099,3.42,0.6,0.4393611111111111,0.81,99.46
2021-06-01,Assam,691,3,685,8942,738,244,7.73,3,36.0,419041,3379,416784,2.05,0.68,0.24838888888888888,0.81,99.46
2021-06-02,Assam,499,7,490,5662,4799,3920,8.81,2,36.0,419540,3386,417274,13.33,10.89,0.15727777777777777,0.81,99.46
2021-06-03,Assam,455,6,455,5718,3207,2313,7.96,0,36.0,419995,3392,417729,8.91,6.42,0.15883333333333333,0.81,99.46
2021-06-04,Assam,133,0,125,1491,2751,508,8.92,8,36.0,420128,3392,417854,7.64,1.41,0.041416666666666664,0.81,99.46
2021-06-05,Assam,611,5,610,7823,997,768,7.81,0,36.0,420739,3397,418464,2.77,2.13,0.21730555555555556,0.81,99.46
2021-06-06,Assam,1158,9,1149,14543,445,286,7.96,0,36.0,421897,3406,419613,1.24,0.79,0.40397222222222223,0.81,99.46
2021-06-07,Assam,1061,6,1060,13488,2607,2424,7.87,0,36.0,422958,3412,420673,7.24,6.73,0.37466666666666665,0.81,99.46
2021-06-08,Assam,856,4,852,10854,3248,612,7.89,0,36.0,423814,3416,421525,9.02,1.7,0.3015,0.81,99.46
2021-06-09,Assam,432,1,426,5387,2671,1552,8.02,5,36.0,424246,3417,421951,7.42,4.31,0.14963888888888888,0.81,99.46
2021-06-10,Assam,1012,7,1008,12502,2788,2091,8.09,0,36.0,425258,3424,422959,7.74,5.81,0.3472777777777778,0.81,99.46
2021-06-11,Assam,60,0,58,826,669,90,7.26,2,36.0,425318,3424,423017,1.86,0.25,0.022944444444444444,0.81,99.46
2021-06-12,Assam,1144,6,1143,13976,4287,1428,8.19,0,36.0,426462,3430,424160,11.91,3.97,0.38822222222222225,0.8,99.46
2021-06-13,Assam,60,0,56,706,3108,1156,8.5,4,36.0,426522,3430,424216,8.63,3.21,0.01961111111111111,0.8,99.46
2021-06-14,Assam,97,1,91,1582,4773,200,6.13,5,36.0,426619,3431,424307,13.26,0.56,0.043944444444444446,0.8,99.46
2021-06-15,Assam,1211,8,1206,15220,402,295,7.96,0,36.0,427830,3439,425513,1.12,0.82,0.42277777777777775,0.8,99.46
2021-06-16,Assam,367,3,361,4461,2617,2078,8.23,3,36.0,428197,3442,425874,7.27,5.77,0.12391666666666666,0.8,99.46
2021-06-17,Assam,1452,4,1449,18143,4408,199,8.0,0,36.0,429649,3446,427323,12.24,0.55,0.5039722222222223,0.8,99.46
2021-06-18,Assam,1520,19,1517,19029,4791,1744,7.99,0,36.0,431169,3465,428840,13.31,4.84,0.5285833333333333,0.8,99.46
2021-06-19,Assam,1220,13,1219,15576,4960,3974,7.83,0,36.0,432389,3478,430059,13.78,11.04,0.43266666666666664,0.8,99.46
2021-06-20,Assam,1390,15,1381,17230,3617,2715,8.07,0,36.0,433779,3493,431440,10.05,7.54,0.4786111111111111,0.81,99.46
2021-06-21,Assam,87,0,83,970,3228,1879,8.97,4,36.0,433866,3493,431523,8.97,5.22,0.026944444444444444,0.81,99.46
2021-06-22,Assam,50,0,43,730,1273,867,6.85,7,36.0,433916,3493,431566,3.54,2.41,0.020277777777777777,0.8,99.46
2021-06-23,Assam,1052,13,1050,12969,4148,382,8.11,0,36.0,434968,3506,432616,11.52,1.06,0.36025,0.81,99.46
2021-06-24,Assam,1465,6,1460,17912,4141,3682,8.18,0,36.0,436433,3512,434076,11.5,10.23,0.49755555555555553,0.8,99.46
2021-06-25,Assam,1269,6,1265,16109,4622,1127,7.88,0,36.0,437702,3518,435341,12.84,3.13,0.4474722222222222,0.8,99.46
2021-06-26,Assam,110,1,108,1332,2003,827,8.26,1,36.0,437812,3519,435449,5.56,2.3,0.037,0.8,99.46
2021-06-27,Assam,451,3,447,5369,1079,128,8.4,1,36.0,438263,3522,435896,3.0,0.36,0.14913888888888888,0.8,99.46
2021-06-28,Assam,890,12,882,11250,630,17,7.91,0,36.0,439153,3534,436778,1.75,0.05,0.3125,0.8,99.46
2021-06-29,Assam,1434,9,1425,17872,2101,1715,8.02,0,36.0,440587,3543,438203,5.84,4.76,0.49644444444444447,0.8,99.46
2021-06-30,Assam,1363,4,1360,17191,2513,69,7.93,0,36.0,441950,3547,439563,6.98,0.19,0.4775277777777778,0.8,99.46
2021-07-01,Assam,1224,14,1217,15044,430,181,8.14,0,36.0,443174,3561,440780,1.19,0.5,0.41788888888888887,0.8,99.46
2021-07-02,Assam,777,3,768,9811,3069,2234,7.92,6,36.0,443951,3564,441548,8.52,6.21,0.27252777777777776,0.8,99.46
2021-07-03,Assam,483,7,479,6037,190,37,8.0,0,36.0,444434,3571,442027,0.53,0.1,0.16769444444444445,0.8,99.46
2021-07-04,Assam,1210,8,1210,15209,988,5,7.96,0,36.0,445644,3579,443237,2.74,0.01,0.42247222222222225,0.8,99.46
2021-07-05,Assam,1532,6,1529,19645,538,234,7.8,0,36.0,447176,3585,444766,1.49,0.65,0.5456944444444445,0.8,99.46
2021-07-06,Assam,188,2,187,2559,2758,1116,7.35,0,36.0,447364,3587,444953,7.66,3.1,0.07108333333333333,0.8,99.46
2021-07-07,Assam,387,2,382,4965,3522,805,7.79,3,36.0,447751,3589,445335,9.78,2.24,0.13791666666666666,0.8,99.46
2021-07-08,Assam,1241,8,1234,15568,1572,1326,7.97,0,36.0,448992,3597,446569,4.37,3.68,0.43244444444444446,0.8,99.46
2021-07-09,Assam,1023,11,1020,12845,1125,182,7.96,0,36.0,450015,3608,447589,3.12,0.51,0.35680555555555554,0.8,99.46
2021-07-10,Assam,1124,13,1116,13930,615,177,8.07,0,36.0,451139,3621,448705,1.71,0.49,0.3869444444444444,0.8,99.46
2021-07-11,Assam,376,4,375,4680,4936,1326,8.03,0,36.0,451515,3625,449080,13.71,3.68,0.13,0.8,99.46
2021-07-12,Assam,1118,15,1109,13807,3156,819,8.1,0,36.0,452633,3640,450189,8.77,2.28,0.3835277777777778,0.8,99.46
2021-07-13,Assam,1444,19,1439,18203,3803,946,7.93,0,36.0,454077,3659,451628,10.56,2.63,0.5056388888888889,0.81,99.46
2021-07-14,Assam,1263,11,1254,15367,2514,2202,8.22,0,36.0,455340,3670,452882,6.98,6.12,0.42686111111111114,0.81,99.46
2021-07-15,Assam,68,0,62,844,3027,568,8.06,6,36.0,455408,3670,452944,8.41,1.58,0.023444444444444445,0.81,99.46
2021-07-16,Assam,820,2,819,9901,228,197,8.28,0,36.0,456228,3672,453763,0.63,0.55,0.27502777777777776,0.8,99.46
2021-07-17,Assam,1166,16,1163,14446,1274,1182,8.07,0,36.0,457394,3688,454926,3.54,3.28,0.4012777777777778,0.81,99.46
2021-07-18,Assam,1311,15,1303,16210,735,51,8.09,0,36.0,458705,3703,456229,2.04,0.14,0.4502777777777778,0.81,99.46
2021-07-19,Assam,1190,6,1182,14842,3069,421,8.02,2,36.0,459895,3709,457411,8.52,1.17,0.4122777777777778,0.81,99.46
2021-07-20,Assam,707,9,702,8673,3665,397,8.15,0,36.0,460602,3718,458113,10.18,1.1,0.24091666666666667,0.81,99.46
2021-07-21,Assam,1375,12,1375,17191,2803,1845,8.0,0,36.0,461977,3730,459488,7.79,5.12,0.4775277777777778,0.81,99.46
2021-07-22,Assam,1061,4,1055,13390,4408,4249,7.92,2,36.0,463038,3734,460543,12.24,11.8,0.37194444444444447,0.81,99.46
2021-07-23,Assam,863,7,856,11006,3879,568,7.84,0,36.0,463901,3741,461399,10.78,1.58,0.30572222222222223,0.81,99.46
2021-07-24,Assam,1362,17,1356,16937,3805,3099,8.04,0,36.0,465263,3758,462755,10.57,8.61,0.47047222222222224,0.81,99.46
2021-07-25,Assam,309,1,309,3844,2092,2042,8.04,0,36.0,465572,3759,463064,5.81,5.67,0.10677777777777778,0.81,99.46
2021-07-26,Assam,216,1,210,2896,279,18,7.46,5,36.0,465788,3760,463274,0.78,0.05,0.08044444444444444,0.81,99.46
2021-07-27,Assam,207,2,206,2419,1178,385,8.56,0,36.0,465995,3762,463480,3.27,1.07,0.06719444444444445,0.81,99.46
2021-07-28,Assam,380,4,374,4757,3804,1320,7.99,2,36.0,466375,3766,463854,10.57,3.67,0.1321388888888889,0.81,99.46
2021-07-29,Assam,1424,15,1416,17939,4342,768,7.94,0,36.0,467799,3781,465270,12.06,2.13,0.49830555555555556,0.81,99.46
2021-07-30,Assam,131,1,126,1431,1164,441,9.15,4,36.0,467930,3782,465396,3.23,1.23,0.03975,0.81,99.46
2021-07-31,Assam,792,10,785,9961,154,117,7.95,0,36.0,468722,3792,466181,0.43,0.32,0.27669444444444447,0.81,99.46
2021-08-01,Assam,1465,8,1464,18079,1653,641,8.1,0,36.0,470187,3800,467645,4.59,1.78,0.5021944444444445,0.81,99.46
2021-08-02,Assam,1187,8,1183,14834,4284,3007,8.0,0,36.0,471374,3808,468828,11.9,8.35,0.41205555555555556,0.81,99.46
2021-08-03,Assam,1164,16,1163,14421,3282,1355,8.07,0,36.0,472538,3824,469991,9.12,3.76,0.40058333333333335,0.81,99.46
2021-08-04,Assam,65,0,56,1101,4463,1908,5.9,9,36.0,472603,3824,470047,12.4,5.3,0.030583333333333334,0.81,99.46
2021-08-05,Assam,1318,18,1315,16323,3650,3137,8.07,0,36.0,473921,3842,471362,10.14,8.71,0.4534166666666667,0.81,99.46
2021-08-06,Assam,1163,6,1154,14065,3925,2072,8.27,3,36.0,475084,3848,472516,10.9,5.76,0.39069444444444446,0.81,99.46
2021-08-07,Assam,1240,4,1232,15547,1931,505,7.98,4,36.0,476324,3852,473748,5.36,1.4,0.4318611111111111,0.81,99.46
2021-08-08,Assam,1556,18,1548,19511,3008,976,7.97,0,36.0,477880,3870,475296,8.36,2.71,0.5419722222222222,0.81,99.46
2021-08-09,Assam,1035,9,1026,13162,444,394,7.86,0,36.0,478915,3879,476322,1.23,1.09,0.3656111111111111,0.81,99.46
2021-08-10,Assam,1284,13,1283,15881,2476,1816,8.09,0,36.0,480199,3892,477605,6.88,5.04,0.4411388888888889,0.81,99.46
2021-08-11,Assam,180,2,177,2142,1547,1114,8.4,1,36.0,480379,3894,477782,4.3,3.09,0.0595,0.81,99.46
2021-08-12,Assam,374,5,373,4349,3454,1575,8.6,0,36.0,480753,3899,478155,9.59,4.38,0.12080555555555555,0.81,99.46
2021-08-13,Assam,1151,11,1144,14281,3233,1043,8.06,0,36.0,481904,3910,479299,8.98,2.9,0.39669444444444446,0.81,99.46
2021-08-14,Assam,191,1,186,2298,1113,601,8.31,4,36.0,482095,3911,479485,3.09,1.67,0.06383333333333334,0.81,99.46
2021-08-15,Assam,253,3,244,3439,2424,2082,7.36,6,36.0,482348,3914,479729,6.73,5.78,0.09552777777777778,0.81,99.46
2021-08-16,Assam,379,2,373,5016,4321,2317,7.56,4,36.0,482727,3916,480102,12.0,6.44,0.13933333333333334,0.81,99.46
2021-08-17,Assam,834,8,827,10699,1982,382,7.8,0,36.0,483561,3924,480929,5.51,1.06,0.29719444444444443,0.81,99.46
2021-08-18,Assam,99,1,92,1105,2630,647,8.96,6,36.0,483660,3925,481021,7.31,1.8,0.030694444444444444,0.81,99.45
2021-08-19,Assam,887,4,882,11061,1961,1555,8.02,1,36.0,484547,3929,481903,5.45,4.32,0.30725,0.81,99.45
2021-08-20,Assam,181,1,180,1620,257,249,11.17,0,36.0,484728,3930,482083,0.71,0.69,0.045,0.81,99.45
2021-08-21,Assam,306,4,299,3594,3622,362,8.51,3,36.0,485034,3934,482382,10.06,1.01,0.09983333333333333,0.81,99.45
2021-08-22,Assam,732,5,732,9659,347,109,7.58,0,36.0,485766,3939,483114,0.96,0.3,0.2683055555555556,0.81,99.45
2021-08-23,Assam,555,2,548,6660,1554,1465,8.33,5,36.0,486321,3941,483662,4.32,4.07,0.185,0.81,99.45
2021-08-24,Assam,1078,6,1072,13534,1422,804,7.97,0,36.0,487399,3947,484734,3.95,2.23,0.37594444444444447,0.81,99.45
2021-08-25,Assam,700,8,694,8306,1910,1059,8.43,0,36.0,488099,3955,485428,5.31,2.94,0.23072222222222222,0.81,99.45
2021-08-26,Assam,117,0,114,1660,3777,554,7.05,3,36.0,488216,3955,485542,10.49,1.54,0.04611111111111111,0.81,99.45
2021-08-27,Assam,853,2,845,10822,563,240,7.88,6,36.0,489069,3957,486387,1.56,0.67,0.3006111111111111,0.81,99.45
2021-08-28,Assam,1314,16,1314,16412,2649,2501,8.01,0,36.0,490383,3973,487701,7.36,6.95,0.4558888888888889,0.81,99.45
2021-08-29,Assam,556,3,550,7118,2648,1335,7.81,3,36.0,490939,3976,488251,7.36,3.71,0.19772222222222222,0.81,99.45
2021-08-30,Assam,1243,4,1236,15512,141,95,8.01,3,36.0,492182,3980,489487,0.39,0.26,0.4308888888888889,0.81,99.45
2021-08-31,Assam,559,7,559,6899,1425,308,8.1,0,36.0,492741,3987,490046,3.96,0.86,0.1916388888888889,0.81,99.45
2021-09-01,Assam,32,0,31,600,4670,2091,5.33,1,36.0,492773,3987,490077,12.97,5.81,0.016666666666666666,0.81,99.45
2021-09-02,Assam,1223,17,1222,15554,2009,771,7.86,0,36.0,493996,4004,491299,5.58,2.14,0.4320555555555556,0.81,99.45
2021-09-03,Assam,92,0,89,1409,326,179,6.53,3,36.0,494088,4004,491388,0.91,0.5,0.03913888888888889,0.81,99.45
2021-09-04,Assam,266,2,262,3702,1804,696,7.19,2,36.0,494354,4006,491650,5.01,1.93,0.10283333333333333,0.81,99.45
2021-09-05,Assam,1408,16,1403,17630,2844,1428,7.99,0,36.0,495762,4022,493053,7.9,3.97,0.4897222222222222,0.81,99.45
2021-09-06,Assam,356,1,353,4371,1280,584,8.14,2,36.0,496118,4023,493406,3.56,1.62,0.12141666666666667,0.81,99.45
2021-09-07,Assam,1090,5,1089,13723,1886,923,7.94,0,36.0,497208,4028,494495,5.24,2.56,0.38119444444444445,0.81,99.45
2021-09-08,Assam,784,11,775,9557,878,161,8.2,0,36.0,497992,4039,495270,2.44,0.45,0.2654722222222222,0.81,99.45
2021-09-09,Assam,804,11,804,9887,1481,892,8.13,0,36.0,498796,4050,496074,4.11,2.48,0.2746388888888889,0.81,99.45
2021-09-10,Assam,359,1,352,4660,4291,3987,7.7,6,36.0,499155,4051,496426,11.92,11.08,0.12944444444444445,0.81,99.45
2021-09-11,Assam,1187,8,1178,15221,4424,1443,7.8,1,36.0,500342,4059,497604,12.29,4.01,0.42280555555555555,0.81,99.45
2021-09-12,Assam,497,1,497,5972,191,111,8.32,0,36.0,500839,4060,498101,0.53,0.31,0.1658888888888889,0.81,99.45
2021-09-13,Assam,344,4,341,4153,1048,900,8.28,0,36.0,501183,4064,498442,2.91,2.5,0.11536111111111111,0.81,99.45
2021-09-14,Assam,1526,5,1525,19321,3722,1451,7.9,0,36.0,502709,4069,499967,10.34,4.03,0.5366944444444445,0.81,99.45
2021-09-15,Assam,1156,6,1150,14175,1172,673,8.16,0,36.0,503865,4075,501117,3.26,1.87,0.39375,0.81,99.45
2021-09-16,Assam,1063,14,1059,13158,737,416,8.08,0,36.0,504928,4089,502176,2.05,1.16,0.3655,0.81,99.45
2021-09-17,Assam,371,2,371,5017,756,718,7.39,0,36.0,505299,4091,502547,2.1,1.99,0.1393611111111111,0.81,99.46
2021-09-18,Assam,576,4,575,7401,2132,658,7.78,0,36.0,505875,4095,503122,5.92,1.83,0.20558333333333334,0.81,99.46
2021-09-19,Assam,1462,19,1459,18406,3824,2952,7.94,0,36.0,507337,4114,504581,10.62,8.2,0.5112777777777778,0.81,99.46
2021-09-20,Assam,1338,6,1333,16689,139,120,8.02,0,36.0,508675,4120,505914,0.39,0.33,0.46358333333333335,0.81,99.46
2021-09-21,Assam,1041,7,1037,13011,4569,858,8.0,0,36.0,509716,4127,506951,12.69,2.38,0.36141666666666666,0.81,99.46
2021-09-22,Assam,761,9,756,9709,4916,4212,7.84,0,36.0,510477,4136,507707,13.66,11.7,0.26969444444444446,0.81,99.46
2021-09-23,Assam,896,6,887,11290,2232,2000,7.94,3,36.0,511373,4142,508594,6.2,5.56,0.3136111111111111,0.81,99.46
2021-09-24,Assam,1481,6,1477,18762,4034,1584,7.89,0,36.0,512854,4148,510071,11.21,4.4,0.5211666666666667,0.81,99.46
2021-09-25,Assam,261,3,254,3262,4494,4340,8.0,4,36.0,513115,4151,510325,12.48,12.06,0.09061111111111111,0.81,99.46
2021-09-26,Assam,1031,8,1027,12873,1406,876,8.01,0,36.0,514146,4159,511352,3.91,2.43,0.3575833333333333,0.81,99.46
2021-09-27,Assam,621,8,615,8351,1875,196,7.44,0,36.0,514767,4167,511967,5.21,0.54,0.23197222222222222,0.81,99.46
2021-09-28,Assam,287,2,283,3552,1938,1522,8.08,2,36.0,515054,4169,512250,5.38,4.23,0.09866666666666667,0.81,99.46
2021-09-29,Assam,319,2,312,4054,4455,271,7.87,5,36.0,515373,4171,512562,12.38,0.75,0.1126111111111111,0.81,99.45
2021-09-30,Assam,890,13,883,11067,4657,1873,8.04,0,36.0,516263,4184,513445,12.94,5.2,0.30741666666666667,0.81,99.45
2021-10-01,Assam,60,0,53,516,4153,3011,11.63,7,36.0,516323,4184,513498,11.54,8.36,0.014333333333333333,0.81,99.45
2021-10-02,Assam,342,1,339,4296,4508,1798,7.96,2,36.0,516665,4185,513837,12.52,4.99,0.11933333333333333,0.81,99.45
2021-10-03,Assam,567,3,558,7096,2714,1471,7.99,6,36.0,517232,4188,514395,7.54,4.09,0.1971111111111111,0.81,99.45
2021-10-04,Assam,471,2,470,5834,3726,261,8.07,0,36.0,517703,4190,514865,10.35,0.73,0.16205555555555556,0.81,99.45
2021-10-05,Assam,1184,5,1181,15067,2349,1248,7.86,0,36.0,518887,4195,516046,6.52,3.47,0.4185277777777778,0.81,99.45
2021-10-06,Assam,617,6,612,8003,1436,1178,7.71,0,36.0,519504,4201,516658,3.99,3.27,0.22230555555555556,0.81,99.45
2021-10-07,Assam,1211,16,1206,15114,2837,2810,8.01,0,36.0,520715,4217,517864,7.88,7.81,0.41983333333333334,0.81,99.45
2021-10-08,Assam,708,10,699,8984,503,362,7.88,0,36.0,521423,4227,518563,1.4,1.01,0.24955555555555556,0.81,99.45
2021-10-09,Assam,634,2,633,8055,4972,3315,7.87,0,36.0,522057,4229,519196,13.81,9.21,0.22375,0.81,99.45
2021-10-10,Assam,296,4,290,4104,516,489,7.21,2,36.0,522353,4233,519486,1.43,1.36,0.114,0.81,99.45
2021-10-11,Assam,851,9,846,10601,671,18,8.03,0,36.0,523204,4242,520332,1.86,0.05,0.29447222222222225,0.81,99.45
2021-10-12,Assam,1440,17,1435,17715,4438,2957,8.13,0,36.0,524644,4259,521767,12.33,8.21,0.4920833333333333,0.81,99.45
2021-10-13,Assam,1111,3,1108,14242,1087,87,7.8,0,36.0,525755,4262,522875,3.02,0.24,0.39561111111111114,0.81,99.45
2021-10-14,Assam,1061,5,1061,13353,1446,749,7.95,0,36.0,526816,4267,523936,4.02,2.08,0.3709166666666667,0.81,99.45
2021-10-15,Assam,648,5,646,7979,3034,2811,8.12,0,36.0,527464,4272,524582,8.43,7.81,0.22163888888888889,0.81,99.45
2021-10-16,Assam,150,1,149,1623,4354,3650,9.24,0,36.0,527614,4273,524731,12.09,10.14,0.045083333333333336,0.81,99.45
2021-10-17,Assam,1001,4,1000,12386,4243,126,8.08,0,36.0,528615,4277,525731,11.79,0.35,0.34405555555555556,0.81,99.45
2021-10-18,Assam,741,8,740,9417,3813,1069,7.87,0,36.0,529356,4285,526471,10.59,2.97,0.26158333333333333,0.81,99.45
2021-10-19,Assam,108,0,105,1059,3157,2364,10.2,3,36.0,529464,4285,526576,8.77,6.57,0.029416666666666667,0.81,99.45
2021-10-20,Assam,1400,20,1394,16888,2197,802,8.29,0,36.0,530864,4305,527970,6.1,2.23,0.4691111111111111,0.81,99.45
2021-10-21,Assam,55,0,46,807,1948,823,6.82,9,36.0,530919,4305,528016,5.41,2.29,0.022416666666666668,0.81,99.45
2021-10-22,Assam,1024,10,1024,12755,2226,485,8.03,0,36.0,531943,4315,529040,6.18,1.35,0.35430555555555554,0.81,99.45
2021-10-23,Assam,491,5,491,5837,1501,810,8.41,0,36.0,532434,4320,529531,4.17,2.25,0.1621388888888889,0.81,99.45
2021-10-24,Assam,106,0,103,1130,4426,3503,9.38,3,36.0,532540,4320,529634,12.29,9.73,0.03138888888888889,0.81,99.45
2021-10-25,Assam,1024,10,1022,12501,552,313,8.19,0,36.0,533564,4330,530656,1.53,0.87,0.34725,0.81,99.45
2021-10-26,Assam,1140,8,1138,14323,1749,1395,7.96,0,36.0,534704,4338,531794,4.86,3.88,0.3978611111111111,0.81,99.46
2021-10-27,Assam,1524,13,1519,19005,2842,2550,8.02,0,36.0,536228,4351,533313,7.89,7.08,0.5279166666666667,0.81,99.46
2021-10-28,Assam,810,8,806,10180,1965,63,7.96,0,36.0,537038,4359,534119,5.46,0.18,0.2827777777777778,0.81,99.46
2021-10-29,Assam,1553,20,1553,19523,2647,1679,7.95,0,36.0,538591,4379,535672,7.35,4.66,0.5423055555555556,0.81,99.46
2021-10-30,Assam,997,9,995,12388,1637,369,8.05,0,36.0,539588,4388,536667,4.55,1.03,0.3441111111111111,0.81,99.46
2021-10-31,Assam,902,2,895,11100,3434,1712,8.13,5,36.0,540490,4390,537562,9.54,4.76,0.30833333333333335,0.81,99.46
2021-11-01,Assam,1340,14,1339,16754,4088,3267,8.0,0,36.0,541830,4404,538901,11.36,9.07,0.4653888888888889,0.81,99.46
2021-11-02,Assam,1557,20,1554,19437,1796,737,8.01,0,36.0,543387,4424,540455,4.99,2.05,0.5399166666666667,0.81,99.46
2021-11-03,Assam,858,12,850,11195,2866,249,7.66,0,36.0,544245,4436,541305,7.96,0.69,0.3109722222222222,0.82,99.46
2021-11-04,Assam,1176,7,1170,14576,4129,2004,8.07,0,36.0,545421,4443,542475,11.47,5.57,0.4048888888888889,0.81,99.46
2021-11-05,Assam,365,5,361,4692,2086,1058,7.78,0,36.0,545786,4448,542836,5.79,2.94,0.13033333333333333,0.81,99.46
2021-11-06,Assam,331,1,322,4527,74,38,7.31,8,36.0,546117,4449,543158,0.21,0.11,0.12575,0.81,99.46
2021-11-07,Assam,165,1,158,2386,4065,3768,6.92,6,36.0,546282,4450,543316,11.29,10.47,0.06627777777777778,0.81,99.46
2021-11-08,Assam,935,6,929,11623,1147,423,8.04,0,36.0,547217,4456,544245,3.19,1.18,0.3228611111111111,0.81,99.46
2021-11-09,Assam,802,4,802,9853,4833,1066,8.14,0,36.0,548019,4460,545047,13.42,2.96,0.27369444444444446,0.81,99.46
2021-11-10,Assam,801,8,792,9724,255,81,8.24,1,36.0,548820,4468,545839,0.71,0.22,0.27011111111111114,0.81,99.46
2021-11-11,Assam,125,0,119,1351,4053,978,9.25,6,36.0,548945,4468,545958,11.26,2.72,0.03752777777777778,0.81,99.46
2021-11-12,Assam,1398,15,1397,17518,2945,2233,7.98,0,36.0,550343,4483,547355,8.18,6.2,0.4866111111111111,0.81,99.46
2021-11-13,Assam,131,0,123,1790,4915,1094,7.32,8,36.0,550474,4483,547478,13.65,3.04,0.04972222222222222,0.81,99.46
2021-11-14,Assam,183,1,176,2358,1692,1432,7.76,6,36.0,550657,4484,547654,4.7,3.98,0.0655,0.81,99.45
2021-11-15,Assam,1200,12,1191,14431,4689,783,8.32,0,36.0,551857,4496,548845,13.02,2.17,0.4008611111111111,0.81,99.45
2021-11-16,Assam,750,8,746,9296,614,457,8.07,0,36.0,552607,4504,549591,1.71,1.27,0.25822222222222224,0.82,99.45
2021-11-17,Assam,435,1,427,5858,122,36,7.43,7,36.0,553042,4505,550018,0.34,0.1,0.1627222222222222,0.81,99.45
2021-11-18,Assam,337,4,328,4202,31,22,8.02,5,36.0,553379,4509,550346,0.09,0.06,0.11672222222222223,0.81,99.45
2021-11-19,Assam,1340,12,1340,17128,2818,570,7.82,0,36.0,554719,4521,551686,7.83,1.58,0.4757777777777778,0.82,99.45
2021-11-20,Assam,1510,7,1505,19036,2864,950,7.93,0,36.0,556229,4528,553191,7.96,2.64,0.5287777777777778,0.81,99.45
2021-11-21,Assam,779,5,778,9525,1277,1058,8.18,0,36.0,557008,4533,553969,3.55,2.94,0.26458333333333334,0.81,99.45
2021-11-22,Assam,448,3,445,5838,3503,2976,7.67,0,36.0,557456,4536,554414,9.73,8.27,0.16216666666666665,0.81,99.45
2021-11-23,Assam,541,7,536,6389,4415,1943,8.47,0,36.0,557997,4543,554950,12.26,5.4,0.17747222222222223,0.81,99.45
2021-11-24,Assam,1145,3,1139,14074,1748,1055,8.14,3,36.0,559142,4546,556089,4.86,2.93,0.39094444444444443,0.81,99.45
2021-11-25,Assam,402,5,402,5284,3973,1054,7.61,0,36.0,559544,4551,556491,11.04,2.93,0.14677777777777778,0.81,99.45
2021-11-26,Assam,1282,10,1273,15980,3174,767,8.02,0,36.0,560826,4561,557764,8.82,2.13,0.4438888888888889,0.81,99.45
2021-11-27,Assam,393,5,392,5225,932,639,7.52,0,36.0,561219,4566,558156,2.59,1.78,0.1451388888888889,0.81,99.45
2021-11-28,Assam,1598,6,1597,19989,175,5,7.99,0,36.0,562817,4572,559753,0.49,0.01,0.55525,0.81,99.46
2021-11-29,Assam,673,9,673,8313,2318,1458,8.1,0,36.0,563490,4581,560426,6.44,4.05,0.23091666666666666,0.81,99.46
2021-11-30,Assam,1492,9,1488,18659,862,102,8.0,0,36.0,564982,4590,561914,2.39,0.28,0.5183055555555556,0.81,99.46
2021-12-01,Assam,1136,13,1130,14166,68,10,8.02,0,36.0,566118,4603,563044,0.19,0.03,0.3935,0.81,99.46
2021-12-02,Assam,1512,15,1506,18302,2522,1007,8.26,0,36.0,567630,4618,564550,7.01,2.8,0.5083888888888889,0.81,99.46
2021-12-03,Assam,999,8,992,12494,2712,1480,8.0,0,36.0,568629,4626,565542,7.53,4.11,0.34705555555555556,0.81,99.46
2021-12-04,Assam,88,0,80,1332,2761,882,6.61,8,36.0,568717,4626,565622,7.67,2.45,0.037,0.81,99.46
2021-12-05,Assam,1067,6,1059,13615,3541,87,7.84,2,36.0,569784,4632,566681,9.84,0.24,0.37819444444444444,0.81,99.46
2021-12-06,Assam,706,3,698,9129,2445,465,7.73,5,36.0,570490,4635,567379,6.79,1.29,0.2535833333333333,0.81,99.45
2021-12-07,Assam,238,3,236,3298,4142,1892,7.22,0,36.0,570728,4638,567615,11.51,5.26,0.09161111111111112,0.81,99.45
2021-12-08,Assam,1118,4,1113,13688,4050,2477,8.17,1,36.0,571846,4642,568728,11.25,6.88,0.38022222222222224,0.81,99.45
2021-12-09,Assam,1451,10,1447,18234,2922,1426,7.96,0,36.0,573297,4652,570175,8.12,3.96,0.5065,0.81,99.46
2021-12-10,Assam,1099,4,1097,13923,4436,4001,7.89,0,36.0,574396,4656,571272,12.32,11.11,0.38675,0.81,99.46
2021-12-11,Assam,1589,17,1583,19921,1209,1027,7.98,0,36.0,575985,4673,572855,3.36,2.85,0.5533611111111111,0.81,99.46
2021-12-12,Assam,1173,12,1166,14721,1091,447,7.97,0,36.0,577158,4685,574021,3.03,1.24,0.40891666666666665,0.81,99.46
2021-12-13,Assam,1002,12,996,12561,772,127,7.98,0,36.0,578160,4697,575017,2.14,0.35,0.34891666666666665,0.81,99.46
2021-12-14,Assam,1166,12,1166,14389,946,674,8.1,0,36.0,579326,4709,576183,2.63,1.87,0.39969444444444446,0.81,99.46
2021-12-15,Assam,884,10,880,10789,272,141,8.19,0,36.0,580210,4719,577063,0.76,0.39,0.29969444444444443,0.81,99.46
2021-12-16,Assam,136,1,131,1624,367,272,8.37,4,36.0,580346,4720,577194,1.02,0.76,0.04511111111111111,0.81,99.46
2021-12-17,Assam,741,3,732,8764,3589,3108,8.46,6,36.0,581087,4723,577926,9.97,8.63,0.24344444444444444,0.81,99.46
2021-12-18,Assam,551,6,550,6785,4480,2956,8.12,0,36.0,581638,4729,578476,12.44,8.21,0.18847222222222224,0.81,99.46
2021-12-19,Assam,773,8,768,9973,2799,933,7.75,0,36.0,582411,4737,579244,7.78,2.59,0.27702777777777776,0.81,99.46
2021-12-20,Assam,1606,12,1602,19881,4325,3446,8.08,0,36.0,584017,4749,580846,12.01,9.57,0.55225,0.81,99.46
2021-12-21,Assam,622,5,622,8248,1548,950,7.54,0,36.0,584639,4754,581468,4.3,2.64,0.2291111111111111,0.81,99.46
2021-12-22,Assam,282,2,274,3422,3122,1273,8.24,6,36.0,584921,4756,581742,8.67,3.54,0.09505555555555556,0.81,99.46
2021-12-23,Assam,787,8,780,9823,4777,3791,8.01,0,36.0,585708,4764,582522,13.27,10.53,0.2728611111111111,0.81,99.46
2021-12-24,Assam,1484,20,1477,18487,1867,1096,8.03,0,36.0,587192,4784,583999,5.19,3.04,0.5135277777777778,0.81,99.46
2021-12-25,Assam,521,3,514,6468,1619,670,8.06,4,36.0,587713,4787,584513,4.5,1.86,0.17966666666666667,0.81,99.46
2021-12-26,Assam,1217,5,1212,15143,2130,1933,8.04,0,36.0,588930,4792,585725,5.92,5.37,0.4206388888888889,0.81,99.46
2021-12-27,Assam,1563,9,1554,19828,473,125,7.88,0,36.0,590493,4801,587279,1.31,0.35,0.5507777777777778,0.81,99.46
2021-12-28,Assam,1435,6,1432,18090,1668,635,7.93,0,36.0,591928,4807,588711,4.63,1.76,0.5025,0.81,99.46
2021-12-29,Assam,469,6,463,5931,3104,630,7.91,0,36.0,592397,4813,589174,8.62,1.75,0.16475,0.81,99.46
2021-12-30,Assam,1480,15,1473,18885,2370,2255,7.84,0,36.0,593877,4828,590647,6.58,6.26,0.5245833333333333,0.81,99.46
2021-12-31,Assam,797,9,789,9860,769,213,8.08,0,36.0,594674,4837,591436,2.14,0.59,0.2738888888888889,0.81,99.46
2022-01-01,Assam,459,3,451,6295,3668,834,7.29,5,36.0,595133,4840,591887,10.19,2.32,0.1748611111111111,0.81,99.45
2022-01-02,Assam,555,4,549,7063,338,158,7.86,2,36.0,595688,4844,592436,0.94,0.44,0.19619444444444445,0.81,99.45
2022-01-03,Assam,1559,21,1557,19879,2422,1483,7.84,0,36.0,597247,4865,593993,6.73,4.12,0.5521944444444444,0.81,99.46
2022-01-04,Assam,346,4,344,4598,2544,690,7.53,0,36.0,597593,4869,594337,7.07,1.92,0.1277222222222222,0.81,99.46
2022-01-05,Assam,148,1,146,1400,2036,1135,10.57,1,36.0,597741,4870,594483,5.66,3.15,0.03888888888888889,0.81,99.45
2022-01-06,Assam,962,14,953,11888,1096,958,8.09,0,36.0,598703,4884,595436,3.04,2.66,0.3302222222222222,0.82,99.45
2022-01-07,Assam,1188,9,1186,14994,3503,2895,7.92,0,36.0,599891,4893,596622,9.73,8.04,0.4165,0.82,99.46
2022-01-08,Assam,617,6,613,8070,1622,729,7.65,0,36.0,600508,4899,597235,4.51,2.02,0.22416666666666665,0.82,99.45
2022-01-09,Assam,483,2,480,6180,187,173,7.82,1,36.0,600991,4901,597715,0.52,0.48,0.17166666666666666,0.82,99.45
2022-01-10,Assam,1373,4,1367,17125,365,147,8.02,2,36.0,602364,4905,599082,1.01,0.41,0.4756944444444444,0.81,99.46
2022-01-11,Assam,873,3,873,10869,538,156,8.03,0,36.0,603237,4908,599955,1.49,0.43,0.30191666666666667,0.81,99.46
2022-01-12,Assam,1483,17,1483,18686,433,383,7.94,0,36.0,604720,4925,601438,1.2,1.06,0.5190555555555556,0.81,99.46
2022-01-13,Assam,613,7,607,7721,2761,2172,7.94,0,36.0,605333,4932,602045,7.67,6.03,0.21447222222222223,0.81,99.46
2022-01-14,Assam,782,8,778,9907,345,228,7.89,0,36.0,606115,4940,602823,0.96,0.63,0.27519444444444446,0.82,99.46
2022-01-15,Assam,779,10,770,9890,804,293,7.88,0,36.0,606894,4950,603593,2.23,0.81,0.2747222222222222,0.82,99.46
2022-01-16,Assam,1070,15,1064,13375,1621,269,8.0,0,36.0,607964,4965,604657,4.5,0.75,0.3715277777777778,0.82,99.46
2022-01-17,Assam,1388,12,1387,17496,4745,302,7.93,0,36.0,609352,4977,606044,13.18,0.84,0.486,0.82,99.46
2022-01-18,Assam,480,1,472,5987,1702,1484,8.02,7,36.0,609832,4978,606516,4.73,4.12,0.16630555555555557,0.82,99.46
2022-01-19,Assam,1129,3,1121,14156,3438,8,7.98,5,36.0,610961,4981,607637,9.55,0.02,0.3932222222222222,0.82,99.46
2022-01-20,Assam,480,3,477,5914,1074,716,8.12,0,36.0,611441,4984,608114,2.98,1.99,0.16427777777777777,0.82,99.46
2022-01-21,Assam,356,1,348,4595,1874,1203,7.75,7,36.0,611797,4985,608462,5.21,3.34,0.12763888888888889,0.81,99.45
2022-01-22,Assam,569,8,568,7132,1727,1637,7.98,0,36.0,612366,4993,609030,4.8,4.55,0.1981111111111111,0.82,99.46
2022-01-23,Assam,1436,15,1433,17866,210,126,8.04,0,36.0,613802,5008,610463,0.58,0.35,0.49627777777777776,0.82,99.46
2022-01-24,Assam,21,0,14,508,1554,997,4.13,7,36.0,613823,5008,610477,4.32,2.77,0.01411111111111111,0.82,99.45
2022-01-25,Assam,223,1,221,2802,73,34,7.96,1,36.0,614046,5009,610698,0.2,0.09,0.07783333333333334,0.82,99.45
2022-01-26,Assam,1255,15,1246,15999,2640,1534,7.84,0,36.0,615301,5024,611944,7.33,4.26,0.4444166666666667,0.82,99.45
2022-01-27,Assam,134,1,129,1254,3437,1793,10.69,4,36.0,615435,5025,612073,9.55,4.98,0.034833333333333334,0.82,99.45
2022-01-28,Assam,1073,10,1065,13556,2915,1032,7.92,0,36.0,616508,5035,613138,8.1,2.87,0.37655555555555553,0.82,99.45
2022-01-29,Assam,49,0,43,636,1557,374,7.7,6,36.0,616557,5035,613181,4.32,1.04,0.017666666666666667,0.82,99.45
2022-01-30,Assam,395,4,388,5044,1505,1046,7.83,3,36.0,616952,5039,613569,4.18,2.91,0.1401111111111111,0.82,99.45
2022-01-31,Assam,1540,13,1535,19307,3587,1935,7.98,0,36.0,618492,5052,615104,9.96,5.38,0.5363055555555556,0.82,99.45
2022-02-01,Assam,672,7,664,8890,3478,3308,7.56,1,36.0,619164,5059,615768,9.66,9.19,0.24694444444444444,0.82,99.45
2022-02-02,Assam,1144,3,1142,14494,4693,4549,7.89,0,36.0,620308,5062,616910,13.04,12.64,0.4026111111111111,0.82,99.45
2022-02-03,Assam,1198,16,1189,15036,1946,1428,7.97,0,36.0,621506,5078,618099,5.41,3.97,0.4176666666666667,0.82,99.45
2022-02-04,Assam,459,5,451,5511,4814,857,8.33,3,36.0,621965,5083,618550,13.37,2.38,0.15308333333333332,0.82,99.45
2022-02-05,Assam,1281,9,1277,15504,2810,1142,8.26,0,36.0,623246,5092,619827,7.81,3.17,0.43066666666666664,0.82,99.45
2022-02-06,Assam,376,1,369,4628,911,226,8.12,6,36.0,623622,5093,620196,2.53,0.63,0.12855555555555556,0.82,99.45
2022-02-07,Assam,736,5,730,9263,4062,136,7.95,1,36.0,624358,5098,620926,11.28,0.38,0.25730555555555557,0.82,99.45
2022-02-08,Assam,1286,16,1285,16054,1183,86,8.01,0,36.0,625644,5114,622211,3.29,0.24,0.4459444444444444,0.82,99.45
2022-02-09,Assam,125,0,120,1717,211,5,7.28,5,36.0,625769,5114,622331,0.59,0.01,0.04769444444444444,0.82,99.45
2022-02-10,Assam,1065,8,1057,13542,159,81,7.86,0,36.0,626834,5122,623388,0.44,0.22,0.37616666666666665,0.82,99.45
2022-02-11,Assam,1361,15,1352,17115,3200,813,7.95,0,36.0,628195,5137,624740,8.89,2.26,0.47541666666666665,0.82,99.45
2022-02-12,Assam,51,0,47,793,4626,417,6.43,4,36.0,628246,5137,624787,12.85,1.16,0.022027777777777778,0.82,99.45
2022-02-13,Assam,114,0,113,1275,3361,3201,8.94,1,36.0,628360,5137,624900,9.34,8.89,0.035416666666666666,0.82,99.45
2022-02-14,Assam,485,2,478,5722,2051,979,8.48,5,36.0,628845,5139,625378,5.7,2.72,0.15894444444444444,0.82,99.45
2022-02-15,Assam,755,2,754,9586,4199,63,7.88,0,36.0,629600,5141,626132,11.66,0.18,0.2662777777777778,0.82,99.45
2022-02-16,Assam,1402,12,1399,17179,1042,840,8.16,0,36.0,631002,5153,627531,2.89,2.33,0.4771944444444444,0.82,99.45
2022-02-17,Assam,1035,4,1035,12808,80,73,8.08,0,36.0,632037,5157,628566,0.22,0.2,0.3557777777777778,0.82,99.45
2022-02-18,Assam,139,1,138,1817,2695,1095,7.65,0,36.0,632176,5158,628704,7.49,3.04,0.050472222222222224,0.82,99.45
2022-02-19,Assam,1213,17,1213,15220,202,113,7.97,0,36.0,633389,5175,629917,0.56,0.31,0.42277777777777775,0.82,99.45
2022-02-20,Assam,439,3,432,5808,2466,2438,7.56,4,36.0,633828,5178,630349,6.85,6.77,0.16133333333333333,0.82,99.45
2022-02-21,Assam,1083,4,1082,13941,4560,917,7.77,0,36.0,634911,5182,631431,12.67,2.55,0.38725,0.82,99.45
2022-02-22,Assam,1221,5,1221,15659,1978,150,7.8,0,36.0,636132,5187,632652,5.49,0.42,0.4349722222222222,0.82,99.45
2022-02-23,Assam,436,6,435,5612,3845,2089,7.77,0,36.0,636568,5193,633087,10.68,5.8,0.15588888888888888,0.82,99.45
2022-02-24,Assam,1257,13,1248,15736,3253,3092,7.99,0,36.0,637825,5206,634335,9.04,8.59,0.4371111111111111,0.82,99.45
2022-02-25,Assam,752,2,750,8733,2048,1051,8.61,0,36.0,638577,5208,635085,5.69,2.92,0.24258333333333335,0.82,99.45
2022-02-26,Assam,334,2,331,3860,1178,1123,8.65,1,36.0,638911,5210,635416,3.27,3.12,0.10722222222222222,0.82,99.45
2022-02-27,Assam,1208,3,1208,15309,4782,4314,7.89,0,36.0,640119,5213,636624,13.28,11.98,0.42525,0.81,99.45
2022-02-28,Assam,364,4,357,4521,1225,12,8.05,3,36.0,640483,5217,636981,3.4,0.03,0.12558333333333332,0.81,99.45
2022-03-01,Assam,304,2,299,3551,2210,372,8.56,3,36.0,640787,5219,637280,6.14,1.03,0.09863888888888889,0.81,99.45
2022-03-02,Assam,104,0,104,1072,2089,103,9.7,0,36.0,640891,5219,637384,5.8,0.29,0.029777777777777778,0.81,99.45
2022-03-03,Assam,585,5,585,7292,4446,2354,8.02,0,36.0,641476,5224,637969,12.35,6.54,0.20255555555555554,0.81,99.45
2022-03-04,Assam,597,8,597,7675,1652,1619,7.78,0,36.0,642073,5232,638566,4.59,4.5,0.21319444444444444,0.81,99.45
2022-03-05,Assam,554,7,548,6930,3008,1739,7.99,0,36.0,642627,5239,639114,8.36,4.83,0.1925,0.82,99.45
2022-03-06,Assam,796,3,794,10148,4480,3054,7.84,0,36.0,643423,5242,639908,12.44,8.48,0.2818888888888889,0.81,99.45
2022-03-07,Assam,1471,8,1471,18488,3975,3163,7.96,0,36.0,644894,5250,641379,11.04,8.79,0.5135555555555555,0.81,99.45
2022-03-08,Assam,1283,17,1283,16406,1256,483,7.82,0,36.0,646177,5267,642662,3.49,1.34,0.4557222222222222,0.82,99.46
2022-03-09,Assam,1009,5,1008,12373,68,39,8.15,0,36.0,647186,5272,643670,0.19,0.11,0.34369444444444447,0.81,99.46
2022-03-10,Assam,1088,6,1083,14071,1360,1260,7.73,0,36.0,648274,5278,644753,3.78,3.5,0.3908611111111111,0.81,99.46
2022-03-11,Assam,287,3,284,3496,589,219,8.21,0,36.0,648561,5281,645037,1.64,0.61,0.0971111111111111,0.81,99.46
2022-03-12,Assam,358,4,357,4504,1325,1300,7.95,0,36.0,648919,5285,645394,3.68,3.61,0.12511111111111112,0.81,99.46
2022-03-13,Assam,1604,16,1597,19898,4752,1929,8.06,0,36.0,650523,5301,646991,13.2,5.36,0.5527222222222222,0.81,99.46
2022-03-14,Assam,1165,12,1165,14705,893,670,7.92,0,36.0,651688,5313,648156,2.48,1.86,0.40847222222222224,0.82,99.46
2022-03-15,Assam,1234,6,1231,15399,2854,772,8.01,0,36.0,652922,5319,649387,7.93,2.14,0.42775,0.81,99.46
2022-03-16,Assam,1308,4,1299,16439,2288,459,7.96,5,36.0,654230,5323,650686,6.36,1.27,0.45663888888888887,0.81,99.46
2022-03-17,Assam,1459,10,1459,18155,863,142,8.04,0,36.0,655689,5333,652145,2.4,0.39,0.5043055555555556,0.81,99.46
2022-03-18,Assam,425,2,420,5004,4,3,8.49,3,36.0,656114,5335,652565,0.01,0.01,0.139,0.81,99.46
2022-03-19,Assam,1033,14,1026,13092,759,33,7.89,0,36.0,657147,5349,653591,2.11,0.09,0.3636666666666667,0.81,99.46
2022-03-20,Assam,892,9,884,10804,4116,1471,8.26,0,36.0,658039,5358,654475,11.43,4.09,0.3001111111111111,0.81,99.46
2022-03-21,Assam,102,0,96,945,193,53,10.79,6,36.0,658141,5358,654571,0.54,0.15,0.02625,0.81,99.46
2022-03-22,Assam,1412,17,1407,17900,4789,1110,7.89,0,36.0,659553,5375,655978,13.3,3.08,0.49722222222222223,0.81,99.46
2022-03-23,Assam,426,3,418,5171,1888,32,8.24,5,36.0,659979,5378,656396,5.24,0.09,0.1436388888888889,0.81,99.46
2022-03-24,Assam,506,4,499,6153,4188,799,8.22,3,36.0,660485,5382,656895,11.63,2.22,0.17091666666666666,0.81,99.46
2022-03-25,Assam,179,1,173,2471,141,38,7.24,5,36.0,660664,5383,657068,0.39,0.11,0.06863888888888889,0.81,99.46
2022-03-26,Assam,358,4,357,4678,2242,1678,7.65,0,36.0,661022,5387,657425,6.23,4.66,0.12994444444444445,0.81,99.46
2022-03-27,Assam,655,9,647,8427,4560,3592,7.77,0,36.0,661677,5396,658072,12.67,9.98,0.23408333333333334,0.82,99.46
2022-03-28,Assam,197,2,190,2487,2888,1130,7.92,5,36.0,661874,5398,658262,8.02,3.14,0.06908333333333333,0.82,99.45
2022-03-29,Assam,1501,16,1498,18750,3556,193,8.01,0,36.0,663375,5414,659760,9.88,0.54,0.5208333333333334,0.82,99.46
2022-03-30,Assam,1402,9,1393,17488,1141,34,8.02,0,36.0,664777,5423,661153,3.17,0.09,0.48577777777777775,0.82,99.45
2022-03-31,Assam,1358,14,1356,17216,2894,2333,7.89,0,36.0,666135,5437,662509,8.04,6.48,0.4782222222222222,0.82,99.46
2022-04-01,Assam,1310,5,1302,16316,969,625,8.03,3,36.0,667445,5442,663811,2.69,1.74,0.45322222222222225,0.82,99.46
2022-04-02,Assam,260,3,254,3201,11,9,8.12,3,36.0,667705,5445,664065,0.03,0.02,0.08891666666666667,0.82,99.45
2022-04-03,Assam,1385,5,1380,17151,856,352,8.08,0,36.0,669090,5450,665445,2.38,0.98,0.47641666666666665,0.81,99.46
2022-04-04,Assam,527,2,527,6853,2566,532,7.69,0,36.0,669617,5452,665972,7.13,1.48,0.19036111111111112,0.81,99.46
2022-04-05,Assam,151,1,144,1630,1211,1082,9.26,6,36.0,669768,5453,666116,3.36,3.01,0.04527777777777778,0.81,99.45
2022-04-06,Assam,383,2,383,4985,2490,1685,7.68,0,36.0,670151,5455,666499,6.92,4.68,0.13847222222222222,0.81,99.46
2022-04-07,Assam,1149,5,1145,14627,3311,1426,7.86,0,36.0,671300,5460,667644,9.2,3.96,0.40630555555555553,0.81,99.46
2022-04-08,Assam,1153,10,1147,13892,745,329,8.3,0,36.0,672453,5470,668791,2.07,0.91,0.3858888888888889,0.81,99.46
2022-04-09,Assam,598,6,597,7936,2941,1866,7.54,0,36.0,673051,5476,669388,8.17,5.18,0.22044444444444444,0.81,99.46
2022-04-10,Assam,1362,5,1353,16867,2293,551,8.07,4,36.0,674413,5481,670741,6.37,1.53,0.46852777777777777,0.81,99.46
2022-04-11,Assam,1193,7,1185,14812,3389,999,8.05,1,36.0,675606,5488,671926,9.41,2.78,0.41144444444444445,0.81,99.46
2022-04-12,Assam,140,0,139,1990,4605,3033,7.04,1,36.0,675746,5488,672065,12.79,8.43,0.05527777777777778,0.81,99.46
2022-04-13,Assam,1317,7,1312,16212,3274,626,8.12,0,36.0,677063,5495,673377,9.09,1.74,0.4503333333333333,0.81,99.46
2022-04-14,Assam,1596,21,1589,19958,3183,14,8.0,0,36.0,678659,5516,674966,8.84,0.04,0.5543888888888889,0.81,99.46
2022-04-15,Assam,1417,17,1413,18009,2848,2530,7.87,0,36.0,680076,5533,676379,7.91,7.03,0.50025,0.81,99.46
2022-04-16,Assam,427,5,423,5310,4755,4306,8.04,0,36.0,680503,5538,676802,13.21,11.96,0.1475,0.81,99.46
2022-04-17,Assam,657,7,653,8154,2612,787,8.06,0,36.0,681160,5545,677455,7.26,2.19,0.2265,0.81,99.46
2022-04-18,Assam,1361,10,1357,17068,165,54,7.97,0,36.0,682521,5555,678812,0.46,0.15,0.4741111111111111,0.81,99.46
2022-04-19,Assam,295,0,294,3581,2123,557,8.24,1,36.0,682816,5555,679106,5.9,1.55,0.09947222222222223,0.81,99.46
2022-04-20,Assam,428,4,428,5646,4360,982,7.58,0,36.0,683244,5559,679534,12.11,2.73,0.15683333333333332,0.81,99.46
2022-04-21,Assam,1524,6,1521,19333,3596,718,7.88,0,36.0,684768,5565,681055,9.99,1.99,0.5370277777777778,0.81,99.46
2022-04-22,Assam,585,5,576,7313,3335,2286,8.0,4,36.0,685353,5570,681631,9.26,6.35,0.2031388888888889,0.81,99.46
2022-04-23,Assam,1090,4,1084,14097,2001,1789,7.73,2,36.0,686443,5574,682715,5.56,4.97,0.39158333333333334,0.81,99.46
2022-04-24,Assam,1425,14,1421,17793,4355,3243,8.01,0,36.0,687868,5588,684136,12.1,9.01,0.49425,0.81,99.46
2022-04-25,Assam,1599,19,1597,19861,2316,298,8.05,0,36.0,689467,5607,685733,6.43,0.83,0.5516944444444445,0.81,99.46
2022-04-26,Assam,403,4,395,5314,3788,859,7.58,4,36.0,689870,5611,686128,10.52,2.39,0.1476111111111111,0.81,99.46
2022-04-27,Assam,819,9,815,10116,2836,720,8.1,0,36.0,690689,5620,686943,7.88,2.0,0.281,0.81,99.46
2022-04-28,Assam,966,6,965,12173,4966,3666,7.94,0,36.0,691655,5626,687908,13.79,10.18,0.3381388888888889,0.81,99.46
2022-04-29,Assam,238,2,237,3119,3993,2101,7.63,0,36.0,691893,5628,688145,11.09,5.84,0.08663888888888889,0.81,99.46
2022-04-30,Assam,1449,11,1448,18078,4783,912,8.02,0,36.0,693342,5639,689593,13.29,2.53,0.5021666666666667,0.81,99.46
2022-05-01,Assam,322,3,314,4071,3542,2441,7.91,5,36.0,693664,5642,689907,9.84,6.78,0.11308333333333333,0.81,99.46
2022-05-02,Assam,91,1,91,1460,1320,1199,6.23,0,36.0,693755,5643,689998,3.67,3.33,0.04055555555555555,0.81,99.46
2022-05-03,Assam,624,5,620,7815,2718,270,7.98,0,36.0,694379,5648,690618,7.55,0.75,0.21708333333333332,0.81,99.46
2022-05-04,Assam,753,4,752,9513,3791,456,7.92,0,36.0,695132,5652,691370,10.53,1.27,0.26425,0.81,99.46
2022-05-05,Assam,994,4,986,13013,4915,3738,7.64,4,36.0,696126,5656,692356,13.65,10.38,0.3614722222222222,0.81,99.46
2022-05-06,Assam,218,2,215,2463,384,349,8.85,1,36.0,696344,5658,692571,1.07,0.97,0.06841666666666667,0.81,99.46
2022-05-07,Assam,1010,6,1005,12378,4642,3456,8.16,0,36.0,697354,5664,693576,12.89,9.6,0.3438333333333333,0.81,99.46
2022-05-08,Assam,1580,16,1574,19410,4251,1925,8.14,0,36.0,698934,5680,695150,11.81,5.35,0.5391666666666667,0.81,99.46
2022-05-09,Assam,1512,6,1510,18800,334,31,8.04,0,36.0,700446,5686,696660,0.93,0.09,0.5222222222222223,0.81,99.46
2022-05-10,Assam,513,3,505,6243,3284,382,8.22,5,36.0,700959,5689,697165,9.12,1.06,0.17341666666666666,0.81,99.46
2022-05-11,Assam,610,8,603,7622,4603,2413,8.0,0,36.0,701569,5697,697768,12.79,6.7,0.21172222222222223,0.81,99.46
2022-05-12,Assam,620,9,619,7883,875,835,7.87,0,36.0,702189,5706,698387,2.43,2.32,0.21897222222222223,0.81,99.46
2022-05-13,Assam,161,2,155,2132,630,355,7.55,4,36.0,702350,5708,698542,1.75,0.99,0.059222222222222225,0.81,99.46
2022-05-14,Assam,868,9,866,10772,893,732,8.06,0,36.0,703218,5717,699408,2.48,2.03,0.2992222222222222,0.81,99.46
2022-05-15,Assam,843,11,841,10804,1806,6,7.8,0,36.0,704061,5728,700249,5.02,0.02,0.3001111111111111,0.81,99.46
2022-05-16,Assam,950,3,950,11871,2247,1121,8.0,0,36.0,705011,5731,701199,6.24,3.11,0.32975,0.81,99.46
2022-05-17,Assam,660,5,659,8229,1414,344,8.02,0,36.0,705671,5736,701858,3.93,0.96,0.22858333333333333,0.81,99.46
2022-05-18,Assam,305,4,300,3728,893,434,8.18,1,36.0,705976,5740,702158,2.48,1.21,0.10355555555555555,0.81,99.46
2022-05-19,Assam,76,0,69,1170,1799,410,6.5,7,36.0,706052,5740,702227,5.0,1.14,0.0325,0.81,99.46
2022-05-20,Assam,192,2,185,2414,78,61,7.95,5,36.0,706244,5742,702412,0.22,0.17,0.06705555555555555,0.81,99.46
2022-05-21,Assam,1262,17,1257,16156,1525,1370,7.81,0,36.0,707506,5759,703669,4.24,3.81,0.4487777777777778,0.81,99.46
2022-05-22,Assam,430,6,427,5349,4839,1156,8.04,0,36.0,707936,5765,704096,13.44,3.21,0.14858333333333335,0.81,99.46
2022-05-23,Assam,676,7,667,8352,1359,681,8.09,2,36.0,708612,5772,704763,3.78,1.89,0.232,0.81,99.46
2022-05-24,Assam,1023,7,1021,12417,187,143,8.24,0,36.0,709635,5779,705784,0.52,0.4,0.34491666666666665,0.81,99.46
2022-05-25,Assam,519,4,516,6460,2759,876,8.03,0,36.0,710154,5783,706300,7.66,2.43,0.17944444444444443,0.81,99.46
2022-05-26,Assam,1303,5,1295,16270,3203,638,8.01,3,36.0,711457,5788,707595,8.9,1.77,0.4519444444444444,0.81,99.46
2022-05-27,Assam,948,6,939,11834,4708,1458,8.01,3,36.0,712405,5794,708534,13.08,4.05,0.32872222222222225,0.81,99.46
2022-05-28,Assam,964,6,962,12219,4417,4320,7.89,0,36.0,713369,5800,709496,12.27,12.0,0.33941666666666664,0.81,99.46
2022-05-29,Assam,979,6,971,12850,3723,190,7.62,2,36.0,714348,5806,710467,10.34,0.53,0.35694444444444445,0.81,99.46
2022-05-30,Assam,1233,5,1226,15291,4375,268,8.06,2,36.0,715581,5811,711693,12.15,0.74,0.42475,0.81,99.46
2022-05-31,Assam,955,12,955,12009,1656,507,7.95,0,36.0,716536,5823,712648,4.6,1.41,0.33358333333333334,0.81,99.46
2022-06-01,Assam,852,2,846,10650,1612,564,8.0,4,36.0,717388,5825,713494,4.48,1.57,0.29583333333333334,0.81,99.46
2022-06-02,Assam,808,10,804,9861,217,177,8.19,0,36.0,718196,5835,714298,0.6,0.49,0.27391666666666664,0.81,99.46
2022-06-03,Assam,85,1,76,1196,1125,1081,7.11,8,36.0,718281,5836,714374,3.12,3.0,0.03322222222222222,0.81,99.46
2022-06-04,Assam,781,9,774,9803,2941,578,7.97,0,36.0,719062,5845,715148,8.17,1.61,0.2723055555555556,0.81,99.46
2022-06-05,Assam,838,9,834,10360,486,362,8.09,0,36.0,719900,5854,715982,1.35,1.01,0.2877777777777778,0.81,99.46
2022-06-06,Assam,452,6,452,5117,1184,340,8.83,0,36.0,720352,5860,716434,3.29,0.94,0.1421388888888889,0.81,99.46
2022-06-07,Assam,1522,11,1522,19385,512,169,7.85,0,36.0,721874,5871,717956,1.42,0.47,0.5384722222222222,0.81,99.46
2022-06-08,Assam,1536,16,1534,19452,3697,3465,7.9,0,36.0,723410,5887,719490,10.27,9.62,0.5403333333333333,0.81,99.46
2022-06-09,Assam,163,1,154,1898,1445,1417,8.59,8,36.0,723573,5888,719644,4.01,3.94,0.05272222222222222,0.81,99.46
2022-06-10,Assam,81,0,72,1151,94,87,7.04,9,36.0,723654,5888,719716,0.26,0.24,0.03197222222222222,0.81,99.46
2022-06-11,Assam,634,4,632,8280,2667,2103,7.66,0,36.0,724288,5892,720348,7.41,5.84,0.23,0.81,99.46
2022-06-12,Assam,195,1,189,2407,3905,2887,8.1,5,36.0,724483,5893,720537,10.85,8.02,0.06686111111111111,0.81,99.46
2022-06-13,Assam,1198,7,1193,15004,3187,991,7.98,0,36.0,725681,5900,721730,8.85,2.75,0.4167777777777778,0.81,99.46
2022-06-14,Assam,486,2,480,5802,2187,1904,8.38,4,36.0,726167,5902,722210,6.08,5.29,0.16116666666666668,0.81,99.46
2022-06-15,Assam,473,2,469,6031,3471,1010,7.84,2,36.0,726640,5904,722679,9.64,2.81,0.16752777777777778,0.81,99.45
2022-06-16,Assam,1309,7,1304,16785,4063,3249,7.8,0,36.0,727949,5911,723983,11.29,9.02,0.46625,0.81,99.46
2022-06-17,Assam,944,4,937,12157,3128,3108,7.77,3,36.0,728893,5915,724920,8.69,8.63,0.33769444444444446,0.81,99.45
2022-06-18,Assam,835,9,835,10639,2050,1284,7.85,0,36.0,729728,5924,725755,5.69,3.57,0.2955277777777778,0.81,99.46
2022-06-19,Assam,327,4,320,4176,4678,872,7.83,3,36.0,730055,5928,726075,12.99,2.42,0.116,0.81,99.45
2022-06-20,Assam,248,1,244,2517,4735,1249,9.85,3,36.0,730303,5929,726319,13.15,3.47,0.06991666666666667,0.81,99.45
2022-06-21,Assam,740,4,739,9399,4993,3972,7.87,0,36.0,731043,5933,727058,13.87,11.03,0.26108333333333333,0.81,99.45
2022-06-22,Assam,933,10,928,11272,4140,1508,8.28,0,36.0,731976,5943,727986,11.5,4.19,0.3131111111111111,0.81,99.45
2022-06-23,Assam,1026,15,1018,12878,2410,979,7.97,0,36.0,733002,5958,729004,6.69,2.72,0.3577222222222222,0.81,99.45
2022-06-24,Assam,352,4,349,4100,1894,967,8.59,0,36.0,733354,5962,729353,5.26,2.69,0.11388888888888889,0.81,99.45
2022-06-25,Assam,925,12,921,11667,2267,947,7.93,0,36.0,734279,5974,730274,6.3,2.63,0.32408333333333333,0.81,99.45
2022-06-26,Assam,967,11,961,12210,3877,3045,7.92,0,36.0,735246,5985,731235,10.77,8.46,0.33916666666666667,0.81,99.45
2022-06-27,Assam,436,4,434,5566,3690,1129,7.83,0,36.0,735682,5989,731669,10.25,3.14,0.15461111111111112,0.81,99.45
2022-06-28,Assam,442,5,441,5579,2925,103,7.92,0,36.0,736124,5994,732110,8.12,0.29,0.15497222222222223,0.81,99.45
2022-06-29,Assam,267,0,260,3333,4808,1321,8.01,7,36.0,736391,5994,732370,13.36,3.67,0.09258333333333334,0.81,99.45
2022-06-30,Assam,1125,11,1119,14097,787,44,7.98,0,36.0,737516,6005,733489,2.19,0.12,0.39158333333333334,0.81,99.45
2022-07-01,Assam,1201,6,1193,15135,2344,1197,7.94,2,36.0,738717,6011,734682,6.51,3.32,0.42041666666666666,0.81,99.45
2022-07-02,Assam,43,0,38,613,2087,478,7.01,5,36.0,738760,6011,734720,5.8,1.33,0.017027777777777777,0.81,99.45
2022-07-03,Assam,945,13,944,11485,4228,2019,8.23,0,36.0,739705,6024,735664,11.74,5.61,0.3190277777777778,0.81,99.45
2022-07-04,Assam,1337,5,1333,16657,820,695,8.03,0,36.0,741042,6029,736997,2.28,1.93,0.46269444444444446,0.81,99.45
2022-07-05,Assam,518,3,514,6536,3882,357,7.93,1,36.0,741560,6032,737511,10.78,0.99,0.18155555555555555,0.81,99.45
2022-07-06,Assam,458,2,456,6119,2865,2116,7.48,0,36.0,742018,6034,737967,7.96,5.88,0.16997222222222222,0.81,99.45
2022-07-07,Assam,223,2,218,2704,3366,3087,8.25,3,36.0,742241,6036,738185,9.35,8.58,0.07511111111111111,0.81,99.45
2022-07-08,Assam,1138,6,1138,14001,4367,34,8.13,0,36.0,743379,6042,739323,12.13,0.09,0.3889166666666667,0.81,99.45
2022-07-09,Assam,843,4,841,10501,1502,462,8.03,0,36.0,744222,6046,740164,4.17,1.28,0.2916944444444444,0.81,99.45
2022-07-10,Assam,1547,10,1538,19175,8,4,8.07,0,36.0,745769,6056,741702,0.02,0.01,0.5326388888888889,0.81,99.45
2022-07-11,Assam,291,1,282,3563,3840,574,8.17,8,36.0,746060,6057,741984,10.67,1.59,0.09897222222222223,0.81,99.45
2022-07-12,Assam,1436,19,1435,18140,2446,993,7.92,0,36.0,747496,6076,743419,6.79,2.76,0.5038888888888889,0.81,99.45
2022-07-13,Assam,1557,11,1557,19524,1712,238,7.97,0,36.0,749053,6087,744976,4.76,0.66,0.5423333333333333,0.81,99.46
2022-07-14,Assam,1314,10,1311,16217,1061,217,8.1,0,36.0,750367,6097,746287,2.95,0.6,0.4504722222222222,0.81,99.46
2022-07-15,Assam,865,6,858,11060,3408,968,7.82,1,36.0,751232,6103,747145,9.47,2.69,0.30722222222222223,0.81,99.46
2022-07-16,Assam,1273,7,1268,15486,240,17,8.22,0,36.0,752505,6110,748413,0.67,0.05,0.43016666666666664,0.81,99.46
2022-07-17,Assam,780,3,779,9580,228,177,8.14,0,36.0,753285,6113,749192,0.63,0.49,0.26611111111111113,0.81,99.46
2022-07-18,Assam,18,0,15,517,1804,1129,3.48,3,36.0,753303,6113,749207,5.01,3.14,0.014361111111111111,0.81,99.46
2022-07-19,Assam,1272,12,1265,15593,215,54,8.16,0,36.0,754575,6125,750472,0.6,0.15,0.4331388888888889,0.81,99.46
2022-07-20,Assam,996,5,991,12243,2777,1377,8.14,0,36.0,755571,6130,751463,7.71,3.82,0.34008333333333335,0.81,99.46
2022-07-21,Assam,435,2,426,5703,3462,2275,7.63,7,36.0,756006,6132,751889,9.62,6.32,0.15841666666666668,0.81,99.46
2022-07-22,Assam,1330,11,1321,16172,2747,875,8.22,0,36.0,757336,6143,753210,7.63,2.43,0.44922222222222224,0.81,99.46
2022-07-23,Assam,837,3,829,10421,1547,923,8.03,5,36.0,758173,6146,754039,4.3,2.56,0.28947222222222224,0.81,99.45
2022-07-24,Assam,504,4,498,6760,4541,312,7.46,2,36.0,758677,6150,754537,12.61,0.87,0.18777777777777777,0.81,99.45
2022-07-25,Assam,539,6,538,6911,3511,2177,7.8,0,36.0,759216,6156,755075,9.75,6.05,0.1919722222222222,0.81,99.45
2022-07-26,Assam,1538,18,1530,19281,2935,2652,7.98,0,36.0,760754,6174,756605,8.15,7.37,0.5355833333333333,0.81,99.45
2022-07-27,Assam,1426,8,1420,17639,2796,679,8.08,0,36.0,762180,6182,758025,7.77,1.89,0.4899722222222222,0.81,99.45
2022-07-28,Assam,1253,9,1252,15551,1773,363,8.06,0,36.0,763433,6191,759277,4.92,1.01,0.4319722222222222,0.81,99.46
2022-07-29,Assam,869,5,866,10858,1443,618,8.0,0,36.0,764302,6196,760143,4.01,1.72,0.3016111111111111,0.81,99.46
2022-07-30,Assam,1554,15,1552,19577,1152,1058,7.94,0,36.0,765856,6211,761695,3.2,2.94,0.5438055555555555,0.81,99.46
2022-07-31,Assam,69,0,61,1000,538,447,6.9,8,36.0,765925,6211,761756,1.49,1.24,0.027777777777777776,0.81,99.46
2022-08-01,Assam,1553,9,1550,19671,2215,904,7.89,0,36.0,767478,6220,763306,6.15,2.51,0.5464166666666667,0.81,99.46
2022-08-02,Assam,879,12,874,11120,1157,1064,7.9,0,36.0,768357,6232,764180,3.21,2.96,0.3088888888888889,0.81,99.46
2022-08-03,Assam,1138,7,1138,14108,1581,1509,8.07,0,36.0,769495,6239,765318,4.39,4.19,0.3918888888888889,0.81,99.46
2022-08-04,Assam,269,1,263,3086,1514,765,8.72,5,36.0,769764,6240,765581,4.21,2.12,0.08572222222222223,0.81,99.46
2022-08-05,Assam,204,2,199,2790,1986,145,7.31,3,36.0,769968,6242,765780,5.52,0.4,0.0775,0.81,99.46
2022-08-06,Assam,980,9,972,12080,303,191,8.11,0,36.0,770948,6251,766752,0.84,0.53,0.33555555555555555,0.81,99.46
2022-08-07,Assam,1340,10,1339,16784,3459,444,7.98,0,36.0,772288,6261,768091,9.61,1.23,0.4662222222222222,0.81,99.46
2022-08-08,Assam,114,0,112,1375,1152,22,8.29,2,36.0,772402,6261,768203,3.2,0.06,0.03819444444444445,0.81,99.46
2022-08-09,Assam,1252,8,1248,15772,949,661,7.94,0,36.0,773654,6269,769451,2.64,1.84,0.4381111111111111,0.81,99.46
2022-08-10,Assam,855,10,851,10523,1549,596,8.13,0,36.0,774509,6279,770302,4.3,1.66,0.29230555555555554,0.81,99.46
2022-08-11,Assam,851,5,843,10552,2967,1709,8.06,3,36.0,775360,6284,771145,8.24,4.75,0.2931111111111111,0.81,99.46
2022-08-12,Assam,1084,12,1077,13037,3606,2596,8.31,0,36.0,776444,6296,772222,10.02,7.21,0.3621388888888889,0.81,99.46
2022-08-13,Assam,779,5,775,9913,520,425,7.86,0,36.0,777223,6301,772997,1.44,1.18,0.2753611111111111,0.81,99.46
2022-08-14,Assam,917,13,909,11655,3830,2053,7.87,0,36.0,778140,6314,773906,10.64,5.7,0.32375,0.81,99.46
2022-08-15,Assam,812,9,804,10112,4502,730,8.03,0,36.0,778952,6323,774710,12.51,2.03,0.2808888888888889,0.81,99.46
2022-08-16,Assam,1319,12,1314,16349,3487,2490,8.07,0,36.0,780271,6335,776024,9.69,6.92,0.45413888888888887,0.81,99.46
2022-08-17,Assam,1410,5,1408,17348,862,749,8.13,0,36.0,781681,6340,777432,2.39,2.08,0.48188888888888887,0.81,99.46
2022-08-18,Assam,382,2,377,4571,4425,4370,8.36,3,36.0,782063,6342,777809,12.29,12.14,0.1269722222222222,0.81,99.46
2022-08-19,Assam,1421,6,1421,17722,2146,1886,8.02,0,36.0,783484,6348,779230,5.96,5.24,0.49227777777777776,0.81,99.46
2022-08-20,Assam,1426,10,1424,17855,3600,1577,7.99,0,36.0,784910,6358,780654,10.0,4.38,0.4959722222222222,0.81,99.46
2022-08-21,Assam,407,5,401,5407,2655,1631,7.53,1,36.0,785317,6363,781055,7.38,4.53,0.15019444444444444,0.81,99.46
2022-08-22,Assam,125,0,125,1548,1131,582,8.07,0,36.0,785442,6363,781180,3.14,1.62,0.043,0.81,99.46
2022-08-23,Assam,147,2,145,1834,1009,547,8.02,0,36.0,785589,6365,781325,2.8,1.52,0.050944444444444445,0.81,99.46
2022-08-24,Assam,991,13,989,12244,3210,1263,8.09,0,36.0,786580,6378,782314,8.92,3.51,0.3401111111111111,0.81,99.46
2022-08-25,Assam,1436,8,1431,17824,3477,2934,8.06,0,36.0,788016,6386,783745,9.66,8.15,0.4951111111111111,0.81,99.46
2022-08-26,Assam,266,1,262,3252,953,847,8.18,3,36.0,788282,6387,784007,2.65,2.35,0.09033333333333333,0.81,99.46
2022-08-27,Assam,140,1,137,2194,4864,2835,6.38,2,36.0,788422,6388,784144,13.51,7.88,0.06094444444444445,0.81,99.46
2022-08-28,Assam,1296,6,1296,16180,934,719,8.01,0,36.0,789718,6394,785440,2.59,2.0,0.4494444444444444,0.81,99.46
2022-08-29,Assam,640,2,638,8213,3675,504,7.79,0,36.0,790358,6396,786078,10.21,1.4,0.2281388888888889,0.81,99.46
2022-08-30,Assam,556,6,552,7097,3280,2184,7.83,0,36.0,790914,6402,786630,9.11,6.07,0.1971388888888889,0.81,99.46
2022-08-31,Assam,1012,8,1003,12468,1074,287,8.12,1,36.0,791926,6410,787633,2.98,0.8,0.3463333333333333,0.81,99.46
2022-09-01,Assam,704,7,698,8667,3648,1367,8.12,0,36.0,792630,6417,788331,10.13,3.8,0.24075,0.81,99.46
2022-09-02,Assam,991,14,988,12189,3188,215,8.13,0,36.0,793621,6431,789319,8.86,0.6,0.33858333333333335,0.81,99.46
2022-09-03,Assam,1199,7,1196,14929,3443,239,8.03,0,36.0,794820,6438,790515,9.56,0.66,0.4146944444444444,0.81,99.46
2022-09-04,Assam,1584,22,1582,19815,755,435,7.99,0,36.0,796404,6460,792097,2.1,1.21,0.5504166666666667,0.81,99.46
2022-09-05,Assam,1241,5,1237,15405,3577,11,8.06,0,36.0,797645,6465,793334,9.94,0.03,0.42791666666666667,0.81,99.46
2022-09-06,Assam,708,2,705,8564,2141,434,8.27,1,36.0,798353,6467,794039,5.95,1.21,0.2378888888888889,0.81,99.46
2022-09-07,Assam,1210,13,1204,15336,4331,786,7.89,0,36.0,799563,6480,795243,12.03,2.18,0.426,0.81,99.46
2022-09-08,Assam,1252,5,1252,15823,4827,3709,7.91,0,36.0,800815,6485,796495,13.41,10.3,0.4395277777777778,0.81,99.46
2022-09-09,Assam,157,1,150,2252,1603,1067,6.97,6,36.0,800972,6486,796645,4.45,2.96,0.06255555555555556,0.81,99.46
2022-09-10,Assam,721,7,713,9008,608,543,8.0,1,36.0,801693,6493,797358,1.69,1.51,0.25022222222222223,0.81,99.46
2022-09-11,Assam,220,0,217,2406,3975,1327,9.14,3,36.0,801913,6493,797575,11.04,3.69,0.06683333333333333,0.81,99.46
2022-09-12,Assam,715,3,714,8932,4174,371,8.0,0,36.0,802628,6496,798289,11.59,1.03,0.24811111111111112,0.81,99.46
2022-09-13,Assam,641,2,640,8154,1672,930,7.86,0,36.0,803269,6498,798929,4.64,2.58,0.2265,0.81,99.46
2022-09-14,Assam,238,1,232,3227,4698,1373,7.38,5,36.0,803507,6499,799161,13.05,3.81,0.08963888888888889,0.81,99.46
2022-09-15,Assam,1072,11,1066,13450,2290,1518,7.97,0,36.0,804579,6510,800227,6.36,4.22,0.3736111111111111,0.81,99.46
2022-09-16,Assam,293,3,288,3815,2039,312,7.68,2,36.0,804872,6513,800515,5.66,0.87,0.10597222222222222,0.81,99.46
2022-09-17,Assam,894,11,888,11008,2242,260,8.12,0,36.0,805766,6524,801403,6.23,0.72,0.30577777777777776,0.81,99.46
2022-09-18,Assam,958,8,953,11736,1804,424,8.16,0,36.0,806724,6532,802356,5.01,1.18,0.326,0.81,99.46
2022-09-19,Assam,1006,5,1001,12099,4872,1990,8.31,0,36.0,807730,6537,803357,13.53,5.53,0.33608333333333335,0.81,99.46
2022-09-20,Assam,694,9,688,7907,1871,996,8.78,0,36.0,808424,6546,804045,5.2,2.77,0.21963888888888888,0.81,99.46
2022-09-21,Assam,1440,9,1435,17880,4285,1584,8.05,0,36.0,809864,6555,805480,11.9,4.4,0.49666666666666665,0.81,99.46
2022-09-22,Assam,370,2,369,4597,640,488,8.05,0,36.0,810234,6557,805849,1.78,1.36,0.12769444444444444,0.81,99.46
2022-09-23,Assam,1192,7,1189,15028,912,365,7.93,0,36.0,811426,6564,807038,2.53,1.01,0.41744444444444445,0.81,99.46
2022-09-24,Assam,1360,12,1360,16871,2555,2197,8.06,0,36.0,812786,6576,808398,7.1,6.1,0.4686388888888889,0.81,99.46
2022-09-25,Assam,1482,7,1481,18454,4010,2947,8.03,0,36.0,814268,6583,809879,11.14,8.19,0.5126111111111111,0.81,99.46
2022-09-26,Assam,1258,11,1254,15655,1235,390,8.04,0,36.0,815526,6594,811133,3.43,1.08,0.4348611111111111,0.81,99.46
2022-09-27,Assam,692,6,686,8716,201,28,7.94,0,36.0,816218,6600,811819,0.56,0.08,0.2421111111111111,0.81,99.46
2022-09-28,Assam,720,7,711,8566,1057,821,8.41,2,36.0,816938,6607,812530,2.94,2.28,0.23794444444444443,0.81,99.46
2022-09-29,Assam,218,0,215,2791,1070,677,7.81,3,36.0,817156,6607,812745,2.97,1.88,0.07752777777777778,0.81,99.46
2022-09-30,Assam,459,4,456,5833,498,62,7.87,0,36.0,817615,6611,813201,1.38,0.17,0.16202777777777777,0.81,99.46
2022-10-01,Assam,949,12,949,11257,1733,769,8.43,0,36.0,818564,6623,814150,4.81,2.14,0.31269444444444444,0.81,99.46
2022-10-02,Assam,52,0,50,655,862,347,7.94,2,36.0,818616,6623,814200,2.39,0.96,0.018194444444444444,0.81,99.46
2022-10-03,Assam,1495,7,1488,18815,3034,1772,7.95,0,36.0,820111,6630,815688,8.43,4.92,0.5226388888888889,0.81,99.46
2022-10-04,Assam,560,2,554,6942,2950,1705,8.07,4,36.0,820671,6632,816242,8.19,4.74,0.19283333333333333,0.81,99.46
2022-10-05,Assam,1077,9,1076,13595,1113,552,7.92,0,36.0,821748,6641,817318,3.09,1.53,0.3776388888888889,0.81,99.46
2022-10-06,Assam,1266,15,1265,15463,887,498,8.19,0,36.0,823014,6656,818583,2.46,1.38,0.4295277777777778,0.81,99.46
2022-10-07,Assam,646,3,637,8066,4292,3522,8.01,6,36.0,823660,6659,819220,11.92,9.78,0.22405555555555556,0.81,99.46
2022-10-08,Assam,381,1,375,4857,2724,488,7.84,5,36.0,824041,6660,819595,7.57,1.36,0.13491666666666666,0.81,99.46
2022-10-09,Assam,1120,11,1114,14498,871,262,7.73,0,36.0,825161,6671,820709,2.42,0.73,0.4027222222222222,0.81,99.46
2022-10-10,Assam,769,9,769,9730,2824,741,7.9,0,36.0,825930,6680,821478,7.84,2.06,0.2702777777777778,0.81,99.46
2022-10-11,Assam,279,3,272,3492,1278,1197,7.99,4,36.0,826209,6683,821750,3.55,3.32,0.097,0.81,99.46
2022-10-12,Assam,1069,8,1061,13585,2272,1066,7.87,0,36.0,827278,6691,822811,6.31,2.96,0.3773611111111111,0.81,99.46
2022-10-13,Assam,1307,14,1303,16094,2842,1527,8.12,0,36.0,828585,6705,824114,7.89,4.24,0.44705555555555554,0.81,99.46
2022-10-14,Assam,298,2,293,4115,4375,2243,7.24,3,36.0,828883,6707,824407,12.15,6.23,0.11430555555555555,0.81,99.46
2022-10-15,Assam,981,10,980,12384,601,467,7.92,0,36.0,829864,6717,825387,1.67,1.3,0.344,0.81,99.46
2022-10-16,Assam,1101,8,1098,14219,1874,849,7.74,0,36.0,830965,6725,826485,5.21,2.36,0.3949722222222222,0.81,99.46
2022-10-17,Assam,947,8,945,12102,301,215,7.83,0,36.0,831912,6733,827430,0.84,0.6,0.33616666666666667,0.81,99.46
2022-10-18,Assam,261,2,253,3564,4598,2489,7.32,6,36.0,832173,6735,827683,12.77,6.91,0.099,0.81,99.46
2022-10-19,Assam,360,5,359,4649,4684,1398,7.74,0,36.0,832533,6740,828042,13.01,3.88,0.1291388888888889,0.81,99.46
2022-10-20,Assam,420,2,417,5286,3211,2022,7.95,1,36.0,832953,6742,828459,8.92,5.62,0.14683333333333334,0.81,99.46
2022-10-21,Assam,1401,7,1399,17443,2889,379,8.03,0,36.0,834354,6749,829858,8.02,1.05,0.4845277777777778,0.81,99.46
2022-10-22,Assam,878,6,872,11309,2892,106,7.76,0,36.0,835232,6755,830730,8.03,0.29,0.3141388888888889,0.81,99.46
2022-10-23,Assam,1550,16,1542,19439,3219,35,7.97,0,36.0,836782,6771,832272,8.94,0.1,0.5399722222222222,0.81,99.46
2022-10-24,Assam,635,7,626,8369,4668,4075,7.59,2,36.0,837417,6778,832898,12.97,11.32,0.23247222222222222,0.81,99.46
2022-10-25,Assam,1456,18,1448,17985,3183,1155,8.1,0,36.0,838873,6796,834346,8.84,3.21,0.4995833333333333,0.81,99.46
2022-10-26,Assam,147,2,140,2019,3032,385,7.28,5,36.0,839020,6798,834486,8.42,1.07,0.05608333333333333,0.81,99.46
2022-10-27,Assam,1350,19,1350,17284,3387,2956,7.81,0,36.0,840370,6817,835836,9.41,8.21,0.4801111111111111,0.81,99.46
2022-10-28,Assam,514,6,514,6511,4601,2823,7.89,0,36.0,840884,6823,836350,12.78,7.84,0.1808611111111111,0.81,99.46
2022-10-29,Assam,466,6,462,6023,4853,64,7.74,0,36.0,841350,6829,836812,13.48,0.18,0.16730555555555557,0.81,99.46
2022-10-30,Assam,318,2,315,3889,3929,1395,8.18,1,36.0,841668,6831,837127,10.91,3.88,0.10802777777777778,0.81,99.46
2022-10-31,Assam,843,10,835,10458,165,38,8.06,0,36.0,842511,6841,837962,0.46,0.11,0.2905,0.81,99.46
2022-11-01,Assam,704,10,700,9010,2578,1593,7.81,0,36.0,843215,6851,838662,7.16,4.42,0.25027777777777777,0.81,99.46
2022-11-02,Assam,940,9,940,11811,1552,206,7.96,0,36.0,844155,6860,839602,4.31,0.57,0.32808333333333334,0.81,99.46
2022-11-03,Assam,474,5,465,5769,2761,2063,8.22,4,36.0,844629,6865,840067,7.67,5.73,0.16025,0.81,99.46
2022-11-04,Assam,974,5,973,11932,178,83,8.16,0,36.0,845603,6870,841040,0.49,0.23,0.33144444444444443,0.81,99.46
2022-11-05,Assam,244,3,241,2943,4148,269,8.29,0,36.0,845847,6873,841281,11.52,0.75,0.08175,0.81,99.46
2022-11-06,Assam,411,2,406,5356,3462,2151,7.67,3,36.0,846258,6875,841687,9.62,5.98,0.1487777777777778,0.81,99.46
2022-11-07,Assam,1349,4,1345,17354,1686,1192,7.77,0,36.0,847607,6879,843032,4.68,3.31,0.48205555555555557,0.81,99.46
2022-11-08,Assam,420,1,419,5391,4764,995,7.79,0,36.0,848027,6880,843451,13.23,2.76,0.14975,0.81,99.46
2022-11-09,Assam,1178,6,1173,15249,4743,784,7.73,0,36.0,849205,6886,844624,13.18,2.18,0.4235833333333333,0.81,99.46
2022-11-10,Assam,447,4,438,5451,4320,2453,8.2,5,36.0,849652,6890,845062,12.0,6.81,0.15141666666666667,0.81,99.46
2022-11-11,Assam,355,3,348,4172,1471,939,8.51,4,36.0,850007,6893,845410,4.09,2.61,0.11588888888888889,0.81,99.46
2022-11-12,Assam,1268,6,1265,15983,219,102,7.93,0,36.0,851275,6899,846675,0.61,0.28,0.4439722222222222,0.81,99.46
2022-11-13,Assam,929,8,928,11535,3451,3219,8.05,0,36.0,852204,6907,847603,9.59,8.94,0.3204166666666667,0.81,99.46
2022-11-14,Assam,1293,9,1285,16185,20,18,7.99,0,36.0,853497,6916,848888,0.06,0.05,0.44958333333333333,0.81,99.46
2022-11-15,Assam,842,7,837,10691,4646,4148,7.88,0,36.0,854339,6923,849725,12.91,11.52,0.29697222222222225,0.81,99.46
2022-11-16,Assam,1443,18,1437,18083,3848,3079,7.98,0,36.0,855782,6941,851162,10.69,8.55,0.5023055555555556,0.81,99.46
2022-11-17,Assam,939,6,939,11755,678,406,7.99,0,36.0,856721,6947,852101,1.88,1.13,0.32652777777777775,0.81,99.46
2022-11-18,Assam,303,1,302,3874,1356,242,7.82,0,36.0,857024,6948,852403,3.77,0.67,0.10761111111111112,0.81,99.46
2022-11-19,Assam,43,0,36,742,3338,2482,5.8,7,36.0,857067,6948,852439,9.27,6.89,0.02061111111111111,0.81,99.46
2022-11-20,Assam,1162,12,1159,14603,2057,804,7.96,0,36.0,858229,6960,853598,5.71,2.23,0.4056388888888889,0.81,99.46
2022-11-21,Assam,203,2,203,2356,1384,359,8.62,0,36.0,858432,6962,853801,3.84,1.0,0.06544444444444444,0.81,99.46
2022-11-22,Assam,84,0,80,755,2281,1121,11.13,4,36.0,858516,6962,853881,6.34,3.11,0.020972222222222222,0.81,99.46
2022-11-23,Assam,220,0,217,2744,3254,2653,8.02,3,36.0,858736,6962,854098,9.04,7.37,0.07622222222222222,0.81,99.46
2022-11-24,Assam,289,3,280,2992,1366,45,9.66,6,36.0,859025,6965,854378,3.79,0.12,0.08311111111111111,0.81,99.46
2022-11-25,Assam,946,6,943,11667,4282,2219,8.11,0,36.0,859971,6971,855321,11.89,6.16,0.32408333333333333,0.81,99.46
2022-11-26,Assam,1136,16,1127,14079,4388,551,8.07,0,36.0,861107,6987,856448,12.19,1.53,0.39108333333333334,0.81,99.46
2022-11-27,Assam,1305,6,1296,16393,1815,171,7.96,3,36.0,862412,6993,857744,5.04,0.48,0.4553611111111111,0.81,99.46
2022-11-28,Assam,438,6,430,5727,2392,1229,7.65,2,36.0,862850,6999,858174,6.64,3.41,0.15908333333333333,0.81,99.46
2022-11-29,Assam,67,0,67,988,3856,2635,6.78,0,36.0,862917,6999,858241,10.71,7.32,0.027444444444444445,0.81,99.46
2022-11-30,Assam,1602,15,1595,19955,538,349,8.03,0,36.0,864519,7014,859836,1.49,0.97,0.5543055555555556,0.81,99.46
2022-12-01,Assam,1339,6,1333,16987,2060,492,7.88,0,36.0,865858,7020,861169,5.72,1.37,0.4718611111111111,0.81,99.46
2022-12-02,Assam,49,0,44,549,3907,2731,8.93,5,36.0,865907,7020,861213,10.85,7.59,0.01525,0.81,99.46
2022-12-03,Assam,1076,4,1067,13546,4571,1419,7.94,5,36.0,866983,7024,862280,12.7,3.94,0.37627777777777777,0.81,99.46
2022-12-04,Assam,1334,16,1327,16497,646,319,8.09,0,36.0,868317,7040,863607,1.79,0.89,0.45825,0.81,99.46
2022-12-05,Assam,660,4,656,8229,2999,898,8.02,0,36.0,868977,7044,864263,8.33,2.49,0.22858333333333333,0.81,99.46
2022-12-06,Assam,1164,7,1157,14699,4505,4112,7.92,0,36.0,870141,7051,865420,12.51,11.42,0.40830555555555553,0.81,99.46
2022-12-07,Assam,817,3,811,10099,114,5,8.09,3,36.0,870958,7054,866231,0.32,0.01,0.28052777777777776,0.81,99.46
2022-12-08,Assam,587,2,580,7028,1284,655,8.35,5,36.0,871545,7056,866811,3.57,1.82,0.1952222222222222,0.81,99.46
2022-12-09,Assam,777,11,771,9726,656,32,7.99,0,36.0,872322,7067,867582,1.82,0.09,0.27016666666666667,0.81,99.46
2022-12-10,Assam,735,2,733,8979,3570,2261,8.19,0,36.0,873057,7069,868315,9.92,6.28,0.24941666666666668,0.81,99.46
2022-12-11,Assam,318,2,315,3699,3982,299,8.6,1,36.0,873375,7071,868630,11.06,0.83,0.10275,0.81,99.46
2022-12-12,Assam,186,2,177,2625,3714,1795,7.09,7,36.0,873561,7073,868807,10.32,4.99,0.07291666666666667,0.81,99.46
2022-12-13,Assam,498,5,498,6203,4080,3688,8.03,0,36.0,874059,7078,869305,11.33,10.24,0.17230555555555555,0.81,99.46
2022-12-14,Assam,1336,19,1333,17100,3255,1227,7.81,0,36.0,875395,7097,870638,9.04,3.41,0.475,0.81,99.46
2022-12-15,Assam,332,2,328,4294,231,167,7.73,2,36.0,875727,7099,870966,0.64,0.46,0.11927777777777777,0.81,99.46
2022-12-16,Assam,1140,8,1134,13969,2315,1788,8.16,0,36.0,876867,7107,872100,6.43,4.97,0.3880277777777778,0.81,99.46
2022-12-17,Assam,1562,12,1560,19428,279,82,8.04,0,36.0,878429,7119,873660,0.78,0.23,0.5396666666666666,0.81,99.46
2022-12-18,Assam,576,3,568,7316,3347,1527,7.87,5,36.0,879005,7122,874228,9.3,4.24,0.20322222222222222,0.81,99.46
2022-12-19,Assam,1030,10,1027,12675,690,612,8.13,0,36.0,880035,7132,875255,1.92,1.7,0.35208333333333336,0.81,99.46
2022-12-20,Assam,661,8,660,8525,2286,2146,7.75,0,36.0,880696,7140,875915,6.35,5.96,0.23680555555555555,0.81,99.46
2022-12-21,Assam,386,2,384,4923,2086,664,7.84,0,36.0,881082,7142,876299,5.79,1.84,0.13675,0.81,99.46
2022-12-22,Assam,1503,21,1496,18442,3845,1113,8.15,0,36.0,882585,7163,877795,10.68,3.09,0.5122777777777778,0.81,99.46
2022-12-23,Assam,996,8,989,12506,2389,1927,7.96,0,36.0,883581,7171,878784,6.64,5.35,0.3473888888888889,0.81,99.46
2022-12-24,Assam,1246,10,1246,15626,2992,2089,7.97,0,36.0,884827,7181,880030,8.31,5.8,0.43405555555555553,0.81,99.46
2022-12-25,Assam,1426,19,1424,17529,4071,1179,8.14,0,36.0,886253,7200,881454,11.31,3.28,0.48691666666666666,0.81,99.46
2022-12-26,Assam,239,2,234,3078,455,74,7.76,3,36.0,886492,7202,881688,1.26,0.21,0.0855,0.81,99.46
2022-12-27,Assam,240,3,236,2390,3883,2620,10.04,1,36.0,886732,7205,881924,10.79,7.28,0.06638888888888889,0.81,99.46
2022-12-28,Assam,353,1,344,4386,3240,3139,8.05,8,36.0,887085,7206,882268,9.0,8.72,0.12183333333333334,0.81,99.46
2022-12-29,Assam,161,0,160,2208,2610,2302,7.29,1,36.0,887246,7206,882428,7.25,6.39,0.06133333333333333,0.81,99.46
2022-12-30,Assam,1362,6,1354,16777,3562,1822,8.12,2,36.0,888608,7212,883782,9.89,5.06,0.46602777777777776,0.81,99.46
2022-12-31,Assam,1016,15,1015,12876,2631,490,7.89,0,36.0,889624,7227,884797,7.31,1.36,0.3576666666666667,0.81,99.46
2020-01-01,Bihar,334,5,333,4244,4578,1626,7.87,0,124.8,334,5,333,3.67,1.3,0.034006410256410255,1.5,99.7
2020-01-02,Bihar,1427,16,1423,17997,4269,628,7.93,0,124.8,1761,21,1756,3.42,0.5,0.14420673076923077,1.19,99.72
2020-01-03,Bihar,513,5,513,6482,4298,1440,7.91,0,124.8,2274,26,2269,3.44,1.15,0.051939102564102564,1.14,99.78
2020-01-04,Bihar,221,2,216,2786,1370,892,7.93,3,124.8,2495,28,2485,1.1,0.71,0.022323717948717948,1.12,99.6
2020-01-05,Bihar,207,1,207,2762,3633,3447,7.49,0,124.8,2702,29,2692,2.91,2.76,0.022131410256410255,1.07,99.63
2020-01-06,Bihar,1445,21,1445,18209,3147,1502,7.94,0,124.8,4147,50,4137,2.52,1.2,0.14590544871794872,1.21,99.76
2020-01-07,Bihar,53,0,47,628,4695,216,8.44,6,124.8,4200,50,4184,3.76,0.17,0.005032051282051282,1.19,99.62
2020-01-08,Bihar,516,2,508,6685,3848,3769,7.72,6,124.8,4716,52,4692,3.08,3.02,0.053565705128205125,1.1,99.49
2020-01-09,Bihar,303,1,301,3609,2720,549,8.4,1,124.8,5019,53,4993,2.18,0.44,0.02891826923076923,1.06,99.48
2020-01-10,Bihar,1469,6,1467,18304,2390,1279,8.03,0,124.8,6488,59,6460,1.92,1.02,0.14666666666666667,0.91,99.57
2020-01-11,Bihar,566,2,557,7200,2027,2010,7.86,7,124.8,7054,61,7017,1.62,1.61,0.057692307692307696,0.86,99.48
2020-01-12,Bihar,191,1,184,2163,4608,312,8.83,6,124.8,7245,62,7201,3.69,0.25,0.01733173076923077,0.86,99.39
2020-01-13,Bihar,180,1,173,2294,4459,4128,7.85,6,124.8,7425,63,7374,3.57,3.31,0.018381410256410255,0.85,99.31
2020-01-14,Bihar,1176,12,1172,14331,3966,2528,8.21,0,124.8,8601,75,8546,3.18,2.03,0.11483173076923077,0.87,99.36
2020-01-15,Bihar,1181,10,1177,14890,4570,1674,7.93,0,124.8,9782,85,9723,3.66,1.34,0.11931089743589744,0.87,99.4
2020-01-16,Bihar,1098,10,1097,13625,716,392,8.06,0,124.8,10880,95,10820,0.57,0.31,0.10917467948717949,0.87,99.45
2020-01-17,Bihar,1472,8,1465,18430,4341,766,7.99,0,124.8,12352,103,12285,3.48,0.61,0.14767628205128205,0.83,99.46
2020-01-18,Bihar,1396,12,1396,17002,3490,2556,8.21,0,124.8,13748,115,13681,2.8,2.05,0.13623397435897436,0.84,99.51
2020-01-19,Bihar,194,0,194,2429,1117,1093,7.99,0,124.8,13942,115,13875,0.9,0.88,0.019463141025641027,0.82,99.52
2020-01-20,Bihar,1555,13,1546,19187,4016,317,8.1,0,124.8,15497,128,15421,3.22,0.25,0.15374198717948717,0.83,99.51
2020-01-21,Bihar,139,1,133,1833,1944,395,7.58,5,124.8,15636,129,15554,1.56,0.32,0.0146875,0.83,99.48
2020-01-22,Bihar,765,3,756,9653,3360,1628,7.92,6,124.8,16401,132,16310,2.69,1.3,0.07734775641025642,0.8,99.45
2020-01-23,Bihar,786,4,782,9803,4174,1065,8.02,0,124.8,17187,136,17092,3.34,0.85,0.07854967948717949,0.79,99.45
2020-01-24,Bihar,1004,4,1002,12472,2179,1873,8.05,0,124.8,18191,140,18094,1.75,1.5,0.09993589743589744,0.77,99.47
2020-01-25,Bihar,1477,18,1469,18017,4772,2648,8.2,0,124.8,19668,158,19563,3.82,2.12,0.14436698717948718,0.8,99.47
2020-01-26,Bihar,445,6,442,5695,112,62,7.81,0,124.8,20113,164,20005,0.09,0.05,0.04563301282051282,0.82,99.46
2020-01-27,Bihar,684,5,678,8566,1488,127,7.99,1,124.8,20797,169,20683,1.19,0.1,0.06863782051282051,0.81,99.45
2020-01-28,Bihar,406,5,401,5431,1060,258,7.48,0,124.8,21203,174,21084,0.85,0.21,0.0435176282051282,0.82,99.44
2020-01-29,Bihar,1338,10,1337,16914,2940,2616,7.91,0,124.8,22541,184,22421,2.36,2.1,0.13552884615384617,0.82,99.47
2020-01-30,Bihar,1258,7,1250,15428,2613,1386,8.15,1,124.8,23799,191,23671,2.09,1.11,0.12362179487179487,0.8,99.46
2020-01-31,Bihar,17,0,8,533,3470,149,3.19,9,124.8,23816,191,23679,2.78,0.12,0.004270833333333333,0.8,99.42
2020-02-01,Bihar,395,5,386,4762,593,518,8.29,4,124.8,24211,196,24065,0.48,0.42,0.03815705128205128,0.81,99.4
2020-02-02,Bihar,792,11,789,9783,4061,2260,8.1,0,124.8,25003,207,24854,3.25,1.81,0.07838942307692308,0.83,99.4
2020-02-03,Bihar,1367,12,1361,17297,834,102,7.9,0,124.8,26370,219,26215,0.67,0.08,0.1385977564102564,0.83,99.41
2020-02-04,Bihar,1250,8,1250,15352,240,240,8.14,0,124.8,27620,227,27465,0.19,0.19,0.12301282051282052,0.82,99.44
2020-02-05,Bihar,847,6,839,10665,1785,542,7.94,2,124.8,28467,233,28304,1.43,0.43,0.08545673076923077,0.82,99.43
2020-02-06,Bihar,1447,20,1447,18213,3951,1860,7.94,0,124.8,29914,253,29751,3.17,1.49,0.1459375,0.85,99.46
2020-02-07,Bihar,1110,6,1106,13927,1351,984,7.97,0,124.8,31024,259,30857,1.08,0.79,0.11159455128205129,0.83,99.46
2020-02-08,Bihar,1547,5,1540,19110,2840,554,8.1,2,124.8,32571,264,32397,2.28,0.44,0.153125,0.81,99.47
2020-02-09,Bihar,933,10,933,11838,4327,2030,7.88,0,124.8,33504,274,33330,3.47,1.63,0.09485576923076923,0.82,99.48
2020-02-10,Bihar,834,12,827,10074,4526,2215,8.28,0,124.8,34338,286,34157,3.63,1.77,0.08072115384615385,0.83,99.47
2020-02-11,Bihar,1172,9,1170,14487,3018,263,8.09,0,124.8,35510,295,35327,2.42,0.21,0.11608173076923077,0.83,99.48
2020-02-12,Bihar,500,4,500,5733,48,21,8.72,0,124.8,36010,299,35827,0.04,0.02,0.0459375,0.83,99.49
2020-02-13,Bihar,1559,8,1555,19585,2119,693,7.96,0,124.8,37569,307,37382,1.7,0.56,0.15693108974358974,0.82,99.5
2020-02-14,Bihar,1230,10,1222,15097,1797,1247,8.15,0,124.8,38799,317,38604,1.44,1.0,0.12096955128205128,0.82,99.5
2020-02-15,Bihar,1002,5,996,12718,2212,2090,7.88,1,124.8,39801,322,39600,1.77,1.67,0.10190705128205128,0.81,99.49
2020-02-16,Bihar,610,7,605,7388,2965,533,8.26,0,124.8,40411,329,40205,2.38,0.43,0.05919871794871795,0.81,99.49
2020-02-17,Bihar,519,7,512,6376,290,184,8.14,0,124.8,40930,336,40717,0.23,0.15,0.05108974358974359,0.82,99.48
2020-02-18,Bihar,525,4,517,6628,1990,192,7.92,4,124.8,41455,340,41234,1.59,0.15,0.05310897435897436,0.82,99.47
2020-02-19,Bihar,1415,8,1414,17664,1435,915,8.01,0,124.8,42870,348,42648,1.15,0.73,0.14153846153846153,0.81,99.48
2020-02-20,Bihar,185,1,182,2959,814,105,6.25,2,124.8,43055,349,42830,0.65,0.08,0.023709935897435898,0.81,99.48
2020-02-21,Bihar,1024,9,1024,12912,867,695,7.93,0,124.8,44079,358,43854,0.69,0.56,0.10346153846153847,0.81,99.49
2020-02-22,Bihar,715,2,711,8894,4416,2422,8.04,2,124.8,44794,360,44565,3.54,1.94,0.07126602564102565,0.8,99.49
2020-02-23,Bihar,999,5,997,12259,1152,785,8.15,0,124.8,45793,365,45562,0.92,0.63,0.09822916666666667,0.8,99.5
2020-02-24,Bihar,316,4,316,4020,1336,340,7.86,0,124.8,46109,369,45878,1.07,0.27,0.03221153846153846,0.8,99.5
2020-02-25,Bihar,431,2,423,5211,1896,472,8.27,6,124.8,46540,371,46301,1.52,0.38,0.041754807692307695,0.8,99.49
2020-02-26,Bihar,1274,16,1268,15564,1312,218,8.19,0,124.8,47814,387,47569,1.05,0.17,0.12471153846153846,0.81,99.49
2020-02-27,Bihar,106,1,98,1184,3619,54,8.95,7,124.8,47920,388,47667,2.9,0.04,0.009487179487179488,0.81,99.47
2020-02-28,Bihar,699,10,697,8927,1555,367,7.83,0,124.8,48619,398,48364,1.25,0.29,0.07153044871794872,0.82,99.48
2020-02-29,Bihar,993,13,990,12317,3839,3269,8.06,0,124.8,49612,411,49354,3.08,2.62,0.09869391025641025,0.83,99.48
2020-03-01,Bihar,1599,23,1598,19791,3341,1861,8.08,0,124.8,51211,434,50952,2.68,1.49,0.15858173076923077,0.85,99.49
2020-03-02,Bihar,272,1,269,3169,4156,365,8.58,2,124.8,51483,435,51221,3.33,0.29,0.025392628205128207,0.84,99.49
2020-03-03,Bihar,624,2,616,7708,3724,2173,8.1,6,124.8,52107,437,51837,2.98,1.74,0.06176282051282051,0.84,99.48
2020-03-04,Bihar,302,4,301,4190,2621,1164,7.21,0,124.8,52409,441,52138,2.1,0.93,0.03357371794871795,0.84,99.48
2020-03-05,Bihar,1224,10,1218,15149,487,444,8.08,0,124.8,53633,451,53356,0.39,0.36,0.12138621794871794,0.84,99.48
2020-03-06,Bihar,1491,6,1482,18686,1347,1156,7.98,3,124.8,55124,457,54838,1.08,0.93,0.1497275641025641,0.83,99.48
2020-03-07,Bihar,122,0,120,1930,3450,3363,6.32,2,124.8,55246,457,54958,2.76,2.69,0.01546474358974359,0.83,99.48
2020-03-08,Bihar,364,4,356,4455,46,6,8.17,4,124.8,55610,461,55314,0.04,0.0,0.03569711538461538,0.83,99.47
2020-03-09,Bihar,679,9,670,8182,2529,2334,8.3,0,124.8,56289,470,55984,2.03,1.87,0.06556089743589744,0.83,99.46
2020-03-10,Bihar,846,4,837,10427,3572,1783,8.11,5,124.8,57135,474,56821,2.86,1.43,0.08354967948717949,0.83,99.45
2020-03-11,Bihar,920,6,915,11424,3081,2972,8.05,0,124.8,58055,480,57736,2.47,2.38,0.09153846153846154,0.83,99.45
2020-03-12,Bihar,143,0,143,1626,4899,1611,8.79,0,124.8,58198,480,57879,3.93,1.29,0.013028846153846153,0.82,99.45
2020-03-13,Bihar,1405,20,1404,17800,4756,4313,7.89,0,124.8,59603,500,59283,3.81,3.46,0.14262820512820512,0.84,99.46
2020-03-14,Bihar,263,2,254,3365,3897,143,7.82,7,124.8,59866,502,59537,3.12,0.11,0.026963141025641027,0.84,99.45
2020-03-15,Bihar,588,8,581,7314,3873,1550,8.04,0,124.8,60454,510,60118,3.1,1.24,0.05860576923076923,0.84,99.44
2020-03-16,Bihar,946,7,944,12062,2124,452,7.84,0,124.8,61400,517,61062,1.7,0.36,0.09665064102564103,0.84,99.45
2020-03-17,Bihar,663,6,654,7833,2052,1298,8.46,3,124.8,62063,523,61716,1.64,1.04,0.06276442307692308,0.84,99.44
2020-03-18,Bihar,1570,12,1567,19741,1016,10,7.95,0,124.8,63633,535,63283,0.81,0.01,0.15818108974358974,0.84,99.45
2020-03-19,Bihar,877,8,868,10795,300,48,8.12,1,124.8,64510,543,64151,0.24,0.04,0.08649839743589743,0.84,99.44
2020-03-20,Bihar,1331,4,1330,16559,1763,1733,8.04,0,124.8,65841,547,65481,1.41,1.39,0.13268429487179487,0.83,99.45
2020-03-21,Bihar,580,6,579,7346,1315,1041,7.9,0,124.8,66421,553,66060,1.05,0.83,0.058862179487179485,0.83,99.46
2020-03-22,Bihar,152,1,148,2085,1698,622,7.29,3,124.8,66573,554,66208,1.36,0.5,0.01670673076923077,0.83,99.45
2020-03-23,Bihar,1441,9,1440,17597,1561,613,8.19,0,124.8,68014,563,67648,1.25,0.49,0.14100160256410257,0.83,99.46
2020-03-24,Bihar,832,6,826,10725,4626,3597,7.76,0,124.8,68846,569,68474,3.71,2.88,0.0859375,0.83,99.46
2020-03-25,Bihar,1172,7,1168,14860,4074,1387,7.89,0,124.8,70018,576,69642,3.26,1.11,0.11907051282051281,0.82,99.46
2020-03-26,Bihar,629,3,627,8348,15,15,7.53,0,124.8,70647,579,70269,0.01,0.01,0.06689102564102564,0.82,99.46
2020-03-27,Bihar,1143,10,1137,14336,266,194,7.97,0,124.8,71790,589,71406,0.21,0.16,0.11487179487179487,0.82,99.47
2020-03-28,Bihar,384,2,381,4897,4364,809,7.84,1,124.8,72174,591,71787,3.5,0.65,0.03923878205128205,0.82,99.46
2020-03-29,Bihar,1257,13,1257,15527,4615,4219,8.1,0,124.8,73431,604,73044,3.7,3.38,0.1244150641025641,0.82,99.47
2020-03-30,Bihar,1217,6,1213,15441,1530,250,7.88,0,124.8,74648,610,74257,1.23,0.2,0.12372596153846153,0.82,99.48
2020-03-31,Bihar,1081,7,1080,13637,1557,996,7.93,0,124.8,75729,617,75337,1.25,0.8,0.10927083333333333,0.81,99.48
2020-04-01,Bihar,1525,19,1520,19636,2735,1873,7.77,0,124.8,77254,636,76857,2.19,1.5,0.1573397435897436,0.82,99.49
2020-04-02,Bihar,1103,16,1097,13540,3551,2085,8.15,0,124.8,78357,652,77954,2.85,1.67,0.10849358974358975,0.83,99.49
2020-04-03,Bihar,780,5,773,9816,1189,598,7.95,2,124.8,79137,657,78727,0.95,0.48,0.07865384615384616,0.83,99.48
2020-04-04,Bihar,237,1,235,2740,1188,1133,8.65,1,124.8,79374,658,78962,0.95,0.91,0.021955128205128203,0.83,99.48
2020-04-05,Bihar,1228,5,1220,15112,75,31,8.13,3,124.8,80602,663,80182,0.06,0.02,0.12108974358974359,0.82,99.48
2020-04-06,Bihar,962,10,959,11605,977,640,8.29,0,124.8,81564,673,81141,0.78,0.51,0.09298878205128205,0.83,99.48
2020-04-07,Bihar,1471,10,1470,18605,489,16,7.91,0,124.8,83035,683,82611,0.39,0.01,0.14907852564102564,0.82,99.49
2020-04-08,Bihar,411,2,403,5055,2648,763,8.13,6,124.8,83446,685,83014,2.12,0.61,0.040504807692307694,0.82,99.48
2020-04-09,Bihar,924,8,922,11489,821,714,8.04,0,124.8,84370,693,83936,0.66,0.57,0.09205929487179487,0.82,99.49
2020-04-10,Bihar,1483,20,1481,18360,4593,2952,8.08,0,124.8,85853,713,85417,3.68,2.37,0.14711538461538462,0.83,99.49
2020-04-11,Bihar,292,4,284,3561,4977,1286,8.2,4,124.8,86145,717,85701,3.99,1.03,0.028533653846153847,0.83,99.48
2020-04-12,Bihar,293,3,289,3703,2330,754,7.91,1,124.8,86438,720,85990,1.87,0.6,0.02967147435897436,0.83,99.48
2020-04-13,Bihar,1536,11,1533,19692,1438,674,7.8,0,124.8,87974,731,87523,1.15,0.54,0.15778846153846154,0.83,99.49
2020-04-14,Bihar,1244,9,1244,15428,3728,1913,8.06,0,124.8,89218,740,88767,2.99,1.53,0.12362179487179487,0.83,99.49
2020-04-15,Bihar,534,3,532,6501,1289,9,8.21,0,124.8,89752,743,89299,1.03,0.01,0.052091346153846155,0.83,99.5
2020-04-16,Bihar,1569,16,1561,19442,4419,2558,8.07,0,124.8,91321,759,90860,3.54,2.05,0.15578525641025642,0.83,99.5
2020-04-17,Bihar,595,1,593,7634,335,144,7.79,1,124.8,91916,760,91453,0.27,0.12,0.061169871794871794,0.83,99.5
2020-04-18,Bihar,871,10,862,11272,639,114,7.73,0,124.8,92787,770,92315,0.51,0.09,0.09032051282051282,0.83,99.49
2020-04-19,Bihar,1324,7,1319,16224,4364,3258,8.16,0,124.8,94111,777,93634,3.5,2.61,0.13,0.83,99.49
2020-04-20,Bihar,1183,17,1182,14557,192,178,8.13,0,124.8,95294,794,94816,0.15,0.14,0.1166426282051282,0.83,99.5
2020-04-21,Bihar,1623,18,1622,19661,3088,487,8.25,0,124.8,96917,812,96438,2.47,0.39,0.1575400641025641,0.84,99.51
2020-04-22,Bihar,564,6,558,6897,71,41,8.18,0,124.8,97481,818,96996,0.06,0.03,0.05526442307692308,0.84,99.5
2020-04-23,Bihar,55,0,55,706,1403,133,7.79,0,124.8,97536,818,97051,1.12,0.11,0.005657051282051282,0.84,99.5
2020-04-24,Bihar,234,2,228,3044,4348,635,7.69,4,124.8,97770,820,97279,3.48,0.51,0.024391025641025642,0.84,99.5
2020-04-25,Bihar,142,0,140,2303,2108,1190,6.17,2,124.8,97912,820,97419,1.69,0.95,0.01845352564102564,0.84,99.5
2020-04-26,Bihar,756,9,747,9670,270,118,7.82,0,124.8,98668,829,98166,0.22,0.09,0.07748397435897436,0.84,99.49
2020-04-27,Bihar,194,1,189,2642,2154,268,7.34,4,124.8,98862,830,98355,1.73,0.21,0.021169871794871793,0.84,99.49
2020-04-28,Bihar,69,0,60,945,1023,234,7.3,9,124.8,98931,830,98415,0.82,0.19,0.007572115384615385,0.84,99.48
2020-04-29,Bihar,216,0,212,2810,4688,2532,7.69,4,124.8,99147,830,98627,3.76,2.03,0.02251602564102564,0.84,99.48
2020-04-30,Bihar,873,4,871,10829,1861,1455,8.06,0,124.8,100020,834,99498,1.49,1.17,0.08677083333333334,0.83,99.48
2020-05-01,Bihar,1495,12,1488,18051,4245,2401,8.28,0,124.8,101515,846,100986,3.4,1.92,0.14463942307692307,0.83,99.48
2020-05-02,Bihar,445,4,444,5229,561,273,8.51,0,124.8,101960,850,101430,0.45,0.22,0.04189903846153846,0.83,99.48
2020-05-03,Bihar,428,3,420,5418,2775,346,7.9,5,124.8,102388,853,101850,2.22,0.28,0.04341346153846154,0.83,99.47
2020-05-04,Bihar,1071,12,1067,13178,4540,3320,8.13,0,124.8,103459,865,102917,3.64,2.66,0.10559294871794872,0.84,99.48
2020-05-05,Bihar,571,2,564,7531,4062,1083,7.58,5,124.8,104030,867,103481,3.25,0.87,0.06034455128205128,0.83,99.47
2020-05-06,Bihar,383,3,374,4830,1796,1785,7.93,6,124.8,104413,870,103855,1.44,1.43,0.03870192307692308,0.83,99.47
2020-05-07,Bihar,404,4,395,5007,4963,245,8.07,5,124.8,104817,874,104250,3.98,0.2,0.04012019230769231,0.83,99.46
2020-05-08,Bihar,1190,15,1190,15239,4112,2246,7.81,0,124.8,106007,889,105440,3.29,1.8,0.1221073717948718,0.84,99.47
2020-05-09,Bihar,643,5,635,8184,4617,1492,7.86,3,124.8,106650,894,106075,3.7,1.2,0.06557692307692307,0.84,99.46
2020-05-10,Bihar,1552,19,1546,19263,1096,353,8.06,0,124.8,108202,913,107621,0.88,0.28,0.15435096153846153,0.84,99.46
2020-05-11,Bihar,645,5,644,7514,4989,930,8.58,0,124.8,108847,918,108265,4.0,0.75,0.060208333333333336,0.84,99.47
2020-05-12,Bihar,470,5,463,5923,4463,2886,7.94,2,124.8,109317,923,108728,3.58,2.31,0.0474599358974359,0.84,99.46
2020-05-13,Bihar,1085,9,1083,13294,1904,1164,8.16,0,124.8,110402,932,109811,1.53,0.93,0.1065224358974359,0.84,99.46
2020-05-14,Bihar,320,4,315,4374,2255,1388,7.32,1,124.8,110722,936,110126,1.81,1.11,0.035048076923076925,0.85,99.46
2020-05-15,Bihar,1279,7,1272,15997,3308,1757,8.0,0,124.8,112001,943,111398,2.65,1.41,0.12818108974358974,0.84,99.46
2020-05-16,Bihar,1020,8,1017,12945,1791,800,7.88,0,124.8,113021,951,112415,1.44,0.64,0.10372596153846154,0.84,99.46
2020-05-17,Bihar,1211,10,1204,15351,2125,1048,7.89,0,124.8,114232,961,113619,1.7,0.84,0.12300480769230769,0.84,99.46
2020-05-18,Bihar,629,6,625,7865,4484,473,8.0,0,124.8,114861,967,114244,3.59,0.38,0.06302083333333333,0.84,99.46
2020-05-19,Bihar,349,2,341,4140,4144,792,8.43,6,124.8,115210,969,114585,3.32,0.63,0.03317307692307692,0.84,99.46
2020-05-20,Bihar,1359,7,1351,17098,4013,3613,7.95,1,124.8,116569,976,115936,3.22,2.9,0.13700320512820513,0.84,99.46
2020-05-21,Bihar,1195,17,1189,14838,1509,1072,8.05,0,124.8,117764,993,117125,1.21,0.86,0.11889423076923077,0.84,99.46
2020-05-22,Bihar,327,2,320,4082,2356,1674,8.01,5,124.8,118091,995,117445,1.89,1.34,0.03270833333333333,0.84,99.45
2020-05-23,Bihar,1136,5,1132,14203,4636,3179,8.0,0,124.8,119227,1000,118577,3.71,2.55,0.11380608974358974,0.84,99.45
2020-05-24,Bihar,532,4,528,6594,153,110,8.07,0,124.8,119759,1004,119105,0.12,0.09,0.05283653846153846,0.84,99.45
2020-05-25,Bihar,1410,20,1406,17246,2140,578,8.18,0,124.8,121169,1024,120511,1.71,0.46,0.13818910256410255,0.85,99.46
2020-05-26,Bihar,136,1,130,1474,3763,1674,9.23,5,124.8,121305,1025,120641,3.02,1.34,0.011810897435897435,0.84,99.45
2020-05-27,Bihar,1449,14,1442,17994,4149,2232,8.05,0,124.8,122754,1039,122083,3.32,1.79,0.14418269230769232,0.85,99.45
2020-05-28,Bihar,189,2,187,1894,1497,1225,9.98,0,124.8,122943,1041,122270,1.2,0.98,0.01517628205128205,0.85,99.45
2020-05-29,Bihar,1517,17,1511,18754,2465,46,8.09,0,124.8,124460,1058,123781,1.98,0.04,0.15027243589743589,0.85,99.45
2020-05-30,Bihar,1120,10,1120,14008,2319,676,8.0,0,124.8,125580,1068,124901,1.86,0.54,0.11224358974358975,0.85,99.46
2020-05-31,Bihar,962,11,962,12223,812,806,7.87,0,124.8,126542,1079,125863,0.65,0.65,0.09794070512820513,0.85,99.46
2020-06-01,Bihar,1272,12,1265,15627,1194,214,8.14,0,124.8,127814,1091,127128,0.96,0.17,0.12521634615384616,0.85,99.46
2020-06-02,Bihar,685,5,682,8251,446,163,8.3,0,124.8,128499,1096,127810,0.36,0.13,0.06611378205128206,0.85,99.46
2020-06-03,Bihar,543,3,536,6960,359,211,7.8,4,124.8,129042,1099,128346,0.29,0.17,0.05576923076923077,0.85,99.46
2020-06-04,Bihar,1437,13,1431,17639,619,75,8.15,0,124.8,130479,1112,129777,0.5,0.06,0.14133814102564102,0.85,99.46
2020-06-05,Bihar,1123,14,1121,13791,3383,2041,8.14,0,124.8,131602,1126,130898,2.71,1.64,0.1105048076923077,0.86,99.47
2020-06-06,Bihar,845,3,839,10420,4826,2221,8.11,3,124.8,132447,1129,131737,3.87,1.78,0.08349358974358974,0.85,99.46
2020-06-07,Bihar,428,1,427,5559,4100,2147,7.7,0,124.8,132875,1130,132164,3.29,1.72,0.044543269230769234,0.85,99.46
2020-06-08,Bihar,337,3,331,4446,165,32,7.58,3,124.8,133212,1133,132495,0.13,0.03,0.035625,0.85,99.46
2020-06-09,Bihar,1054,6,1050,13135,32,2,8.02,0,124.8,134266,1139,133545,0.03,0.0,0.10524839743589744,0.85,99.46
2020-06-10,Bihar,1190,9,1182,14831,4289,3930,8.02,0,124.8,135456,1148,134727,3.44,3.15,0.11883814102564103,0.85,99.46
2020-06-11,Bihar,708,10,708,8446,273,270,8.38,0,124.8,136164,1158,135435,0.22,0.22,0.06767628205128205,0.85,99.46
2020-06-12,Bihar,925,3,921,11291,3680,1818,8.19,1,124.8,137089,1161,136356,2.95,1.46,0.09047275641025641,0.85,99.47
2020-06-13,Bihar,1144,9,1140,13693,3523,1192,8.35,0,124.8,138233,1170,137496,2.82,0.96,0.10971955128205128,0.85,99.47
2020-06-14,Bihar,112,1,111,1962,559,291,5.71,0,124.8,138345,1171,137607,0.45,0.23,0.015721153846153847,0.85,99.47
2020-06-15,Bihar,504,4,502,6689,308,219,7.53,0,124.8,138849,1175,138109,0.25,0.18,0.05359775641025641,0.85,99.47
2020-06-16,Bihar,51,0,51,629,4222,1381,8.11,0,124.8,138900,1175,138160,3.38,1.11,0.0050400641025641025,0.85,99.47
2020-06-17,Bihar,890,8,882,11162,3650,512,7.97,0,124.8,139790,1183,139042,2.92,0.41,0.08943910256410256,0.85,99.46
2020-06-18,Bihar,1091,9,1089,14057,2392,222,7.76,0,124.8,140881,1192,140131,1.92,0.18,0.11263621794871795,0.85,99.47
2020-06-19,Bihar,469,6,463,5995,4203,2330,7.82,0,124.8,141350,1198,140594,3.37,1.87,0.04803685897435898,0.85,99.47
2020-06-20,Bihar,466,4,460,5664,1257,175,8.23,2,124.8,141816,1202,141054,1.01,0.14,0.045384615384615384,0.85,99.46
2020-06-21,Bihar,1528,15,1525,19468,3691,225,7.85,0,124.8,143344,1217,142579,2.96,0.18,0.15599358974358973,0.85,99.47
2020-06-22,Bihar,800,4,797,10076,115,30,7.94,0,124.8,144144,1221,143376,0.09,0.02,0.08073717948717948,0.85,99.47
2020-06-23,Bihar,1329,6,1328,17175,3683,1381,7.74,0,124.8,145473,1227,144704,2.95,1.11,0.13762019230769232,0.84,99.47
2020-06-24,Bihar,1215,11,1213,15163,2237,2093,8.01,0,124.8,146688,1238,145917,1.79,1.68,0.12149839743589744,0.84,99.47
2020-06-25,Bihar,887,4,886,11049,2914,762,8.03,0,124.8,147575,1242,146803,2.33,0.61,0.08853365384615385,0.84,99.48
2020-06-26,Bihar,674,6,672,8435,1762,540,7.99,0,124.8,148249,1248,147475,1.41,0.43,0.06758814102564102,0.84,99.48
2020-06-27,Bihar,52,0,49,974,1453,1334,5.34,3,124.8,148301,1248,147524,1.16,1.07,0.007804487179487179,0.84,99.48
2020-06-28,Bihar,1262,15,1254,15762,3115,1885,8.01,0,124.8,149563,1263,148778,2.5,1.51,0.12629807692307693,0.84,99.48
2020-06-29,Bihar,1069,11,1064,12969,491,168,8.24,0,124.8,150632,1274,149842,0.39,0.13,0.10391826923076923,0.85,99.48
2020-06-30,Bihar,838,6,829,10267,993,91,8.16,3,124.8,151470,1280,150671,0.8,0.07,0.0822676282051282,0.85,99.47
2020-07-01,Bihar,1035,11,1031,12981,467,188,7.97,0,124.8,152505,1291,151702,0.37,0.15,0.10401442307692307,0.85,99.47
2020-07-02,Bihar,988,5,986,12123,2047,1002,8.15,0,124.8,153493,1296,152688,1.64,0.8,0.09713942307692308,0.84,99.48
2020-07-03,Bihar,859,12,857,10671,1706,307,8.05,0,124.8,154352,1308,153545,1.37,0.25,0.08550480769230769,0.85,99.48
2020-07-04,Bihar,494,5,486,6036,2055,1039,8.18,3,124.8,154846,1313,154031,1.65,0.83,0.048365384615384616,0.85,99.47
2020-07-05,Bihar,434,1,432,5779,2724,2488,7.51,1,124.8,155280,1314,154463,2.18,1.99,0.04630608974358975,0.85,99.47
2020-07-06,Bihar,335,1,330,4466,3434,1013,7.5,4,124.8,155615,1315,154793,2.75,0.81,0.035785256410256414,0.85,99.47
2020-07-07,Bihar,1510,21,1505,18821,2015,1182,8.02,0,124.8,157125,1336,156298,1.61,0.95,0.15080929487179487,0.85,99.47
2020-07-08,Bihar,896,8,893,11427,1314,147,7.84,0,124.8,158021,1344,157191,1.05,0.12,0.0915625,0.85,99.47
2020-07-09,Bihar,691,7,684,8799,2191,577,7.85,0,124.8,158712,1351,157875,1.76,0.46,0.07050480769230769,0.85,99.47
2020-07-10,Bihar,416,2,407,5362,1702,1096,7.76,7,124.8,159128,1353,158282,1.36,0.88,0.04296474358974359,0.85,99.47
2020-07-11,Bihar,238,2,229,2554,35,26,9.32,7,124.8,159366,1355,158511,0.03,0.02,0.02046474358974359,0.85,99.46
2020-07-12,Bihar,204,1,202,2847,2704,1329,7.17,1,124.8,159570,1356,158713,2.17,1.06,0.0228125,0.85,99.46
2020-07-13,Bihar,145,0,136,1902,1585,1459,7.62,9,124.8,159715,1356,158849,1.27,1.17,0.015240384615384616,0.85,99.46
2020-07-14,Bihar,1053,9,1044,13241,941,755,7.95,0,124.8,160768,1365,159893,0.75,0.6,0.10609775641025641,0.85,99.46
2020-07-15,Bihar,1219,11,1215,15198,3223,530,8.02,0,124.8,161987,1376,161108,2.58,0.42,0.12177884615384615,0.85,99.46
2020-07-16,Bihar,803,6,795,9581,957,230,8.38,2,124.8,162790,1382,161903,0.77,0.18,0.07677083333333333,0.85,99.46
2020-07-17,Bihar,347,2,343,4337,1711,1080,8.0,2,124.8,163137,1384,162246,1.37,0.87,0.03475160256410256,0.85,99.45
2020-07-18,Bihar,1164,14,1163,14143,766,289,8.23,0,124.8,164301,1398,163409,0.61,0.23,0.11332532051282052,0.85,99.46
2020-07-19,Bihar,605,8,603,7673,966,509,7.88,0,124.8,164906,1406,164012,0.77,0.41,0.061482371794871794,0.85,99.46
2020-07-20,Bihar,1351,7,1347,16626,850,638,8.13,0,124.8,166257,1413,165359,0.68,0.51,0.13322115384615385,0.85,99.46
2020-07-21,Bihar,877,4,874,11043,3765,1921,7.94,0,124.8,167134,1417,166233,3.02,1.54,0.08848557692307692,0.85,99.46
2020-07-22,Bihar,1444,15,1443,18195,4642,3205,7.94,0,124.8,168578,1432,167676,3.72,2.57,0.14579326923076924,0.85,99.46
2020-07-23,Bihar,309,3,306,3898,2847,369,7.93,0,124.8,168887,1435,167982,2.28,0.3,0.03123397435897436,0.85,99.46
2020-07-24,Bihar,493,3,487,6026,451,191,8.18,3,124.8,169380,1438,168469,0.36,0.15,0.04828525641025641,0.85,99.46
2020-07-25,Bihar,682,2,681,8736,3343,2432,7.81,0,124.8,170062,1440,169150,2.68,1.95,0.07,0.85,99.46
2020-07-26,Bihar,531,7,525,6819,2791,2052,7.79,0,124.8,170593,1447,169675,2.24,1.64,0.05463942307692308,0.85,99.46
2020-07-27,Bihar,574,7,572,7051,687,32,8.14,0,124.8,171167,1454,170247,0.55,0.03,0.056498397435897435,0.85,99.46
2020-07-28,Bihar,647,6,646,8370,1604,1117,7.73,0,124.8,171814,1460,170893,1.29,0.9,0.06706730769230769,0.85,99.46
2020-07-29,Bihar,1069,15,1063,13671,4404,2122,7.82,0,124.8,172883,1475,171956,3.53,1.7,0.10954326923076924,0.85,99.46
2020-07-30,Bihar,248,3,241,2954,4244,1110,8.4,4,124.8,173131,1478,172197,3.4,0.89,0.023669871794871795,0.85,99.46
2020-07-31,Bihar,1202,8,1200,14691,2020,1886,8.18,0,124.8,174333,1486,173397,1.62,1.51,0.11771634615384616,0.85,99.46
2020-08-01,Bihar,758,7,755,9490,3568,3470,7.99,0,124.8,175091,1493,174152,2.86,2.78,0.07604166666666666,0.85,99.46
2020-08-02,Bihar,285,1,283,4051,2622,978,7.04,1,124.8,175376,1494,174435,2.1,0.78,0.0324599358974359,0.85,99.46
2020-08-03,Bihar,1363,17,1354,17434,1103,599,7.82,0,124.8,176739,1511,175789,0.88,0.48,0.13969551282051282,0.85,99.46
2020-08-04,Bihar,839,10,839,10199,3071,554,8.23,0,124.8,177578,1521,176628,2.46,0.44,0.0817227564102564,0.86,99.47
2020-08-05,Bihar,1381,12,1381,16943,3860,1961,8.15,0,124.8,178959,1533,178009,3.09,1.57,0.13576121794871795,0.86,99.47
2020-08-06,Bihar,275,2,271,3263,4597,3204,8.43,2,124.8,179234,1535,178280,3.68,2.57,0.026145833333333333,0.86,99.47
2020-08-07,Bihar,695,5,694,8482,2692,2104,8.19,0,124.8,179929,1540,178974,2.16,1.69,0.0679647435897436,0.86,99.47
2020-08-08,Bihar,1312,18,1306,16503,683,224,7.95,0,124.8,181241,1558,180280,0.55,0.18,0.13223557692307691,0.86,99.47
2020-08-09,Bihar,13,0,7,567,4290,2598,2.29,6,124.8,181254,1558,180287,3.44,2.08,0.004543269230769231,0.86,99.47
2020-08-10,Bihar,520,6,513,6569,3370,3178,7.92,1,124.8,181774,1564,180800,2.7,2.55,0.05263621794871795,0.86,99.46
2020-08-11,Bihar,1492,15,1490,18385,2666,622,8.12,0,124.8,183266,1579,182290,2.14,0.5,0.14731570512820513,0.86,99.47
2020-08-12,Bihar,575,6,567,6884,781,193,8.35,2,124.8,183841,1585,182857,0.63,0.15,0.05516025641025641,0.86,99.46
2020-08-13,Bihar,1448,6,1441,17866,2761,615,8.1,1,124.8,185289,1591,184298,2.21,0.49,0.14315705128205128,0.86,99.47
2020-08-14,Bihar,1520,11,1516,18837,2691,2582,8.07,0,124.8,186809,1602,185814,2.16,2.07,0.1509375,0.86,99.47
2020-08-15,Bihar,748,7,742,9753,3919,223,7.67,0,124.8,187557,1609,186556,3.14,0.18,0.07814903846153846,0.86,99.47
2020-08-16,Bihar,585,3,580,7357,2046,679,7.95,2,124.8,188142,1612,187136,1.64,0.54,0.058950320512820516,0.86,99.47
2020-08-17,Bihar,280,4,272,3669,2183,992,7.63,4,124.8,188422,1616,187408,1.75,0.79,0.029399038461538463,0.86,99.46
2020-08-18,Bihar,431,3,423,5611,627,260,7.68,5,124.8,188853,1619,187831,0.5,0.21,0.044959935897435896,0.86,99.46
2020-08-19,Bihar,1112,13,1109,13887,928,611,8.01,0,124.8,189965,1632,188940,0.74,0.49,0.11127403846153847,0.86,99.46
2020-08-20,Bihar,1045,8,1045,13112,2517,752,7.97,0,124.8,191010,1640,189985,2.02,0.6,0.10506410256410256,0.86,99.46
2020-08-21,Bihar,923,10,922,11127,2862,1926,8.3,0,124.8,191933,1650,190907,2.29,1.54,0.08915865384615385,0.86,99.47
2020-08-22,Bihar,278,2,269,3582,3762,3674,7.76,7,124.8,192211,1652,191176,3.01,2.94,0.028701923076923076,0.86,99.46
2020-08-23,Bihar,821,6,816,10067,2966,2249,8.16,0,124.8,193032,1658,191992,2.38,1.8,0.0806650641025641,0.86,99.46
2020-08-24,Bihar,1069,10,1067,12937,3006,2808,8.26,0,124.8,194101,1668,193059,2.41,2.25,0.10366185897435898,0.86,99.46
2020-08-25,Bihar,704,9,696,8752,4708,2858,8.04,0,124.8,194805,1677,193755,3.77,2.29,0.07012820512820513,0.86,99.46
2020-08-26,Bihar,478,2,477,6355,1519,788,7.52,0,124.8,195283,1679,194232,1.22,0.63,0.05092147435897436,0.86,99.46
2020-08-27,Bihar,1581,11,1580,19218,2460,1004,8.23,0,124.8,196864,1690,195812,1.97,0.8,0.1539903846153846,0.86,99.47
2020-08-28,Bihar,290,1,284,4084,1410,1168,7.1,5,124.8,197154,1691,196096,1.13,0.94,0.03272435897435898,0.86,99.46
2020-08-29,Bihar,578,3,573,7213,4080,2989,8.01,2,124.8,197732,1694,196669,3.27,2.4,0.05779647435897436,0.86,99.46
2020-08-30,Bihar,708,7,702,8921,4545,1522,7.94,0,124.8,198440,1701,197371,3.64,1.22,0.0714823717948718,0.86,99.46
2020-08-31,Bihar,1358,15,1355,16605,2653,1194,8.18,0,124.8,199798,1716,198726,2.13,0.96,0.13305288461538461,0.86,99.46
2020-09-01,Bihar,1362,17,1360,16749,4621,4069,8.13,0,124.8,201160,1733,200086,3.7,3.26,0.13420673076923076,0.86,99.47
2020-09-02,Bihar,761,8,757,9751,4844,555,7.8,0,124.8,201921,1741,200843,3.88,0.44,0.07813301282051283,0.86,99.47
2020-09-03,Bihar,1400,20,1400,17572,1751,1140,7.97,0,124.8,203321,1761,202243,1.4,0.91,0.14080128205128206,0.87,99.47
2020-09-04,Bihar,1411,7,1406,17339,3532,1914,8.14,0,124.8,204732,1768,203649,2.83,1.53,0.13893429487179487,0.86,99.47
2020-09-05,Bihar,1455,19,1446,18029,2776,2741,8.07,0,124.8,206187,1787,205095,2.22,2.2,0.14446314102564103,0.87,99.47
2020-09-06,Bihar,1246,6,1240,15716,2246,1925,7.93,0,124.8,207433,1793,206335,1.8,1.54,0.12592948717948718,0.86,99.47
2020-09-07,Bihar,280,1,274,3667,3963,3863,7.64,5,124.8,207713,1794,206609,3.18,3.1,0.02938301282051282,0.86,99.47
2020-09-08,Bihar,1247,13,1239,15578,903,595,8.0,0,124.8,208960,1807,207848,0.72,0.48,0.12482371794871795,0.86,99.47
2020-09-09,Bihar,825,8,823,10146,4127,2546,8.13,0,124.8,209785,1815,208671,3.31,2.04,0.08129807692307692,0.87,99.47
2020-09-10,Bihar,303,1,300,3631,1646,478,8.34,2,124.8,210088,1816,208971,1.32,0.38,0.02909455128205128,0.86,99.47
2020-09-11,Bihar,548,1,546,7141,3185,2518,7.67,1,124.8,210636,1817,209517,2.55,2.02,0.05721955128205128,0.86,99.47
2020-09-12,Bihar,1161,5,1161,14492,3415,2967,8.01,0,124.8,211797,1822,210678,2.74,2.38,0.11612179487179487,0.86,99.47
2020-09-13,Bihar,747,3,738,9458,4122,4050,7.9,6,124.8,212544,1825,211416,3.3,3.25,0.07578525641025641,0.86,99.47
2020-09-14,Bihar,1524,10,1515,19282,102,59,7.9,0,124.8,214068,1835,212931,0.08,0.05,0.15450320512820512,0.86,99.47
2020-09-15,Bihar,794,2,787,9803,3007,1929,8.1,5,124.8,214862,1837,213718,2.41,1.55,0.07854967948717949,0.85,99.47
2020-09-16,Bihar,870,3,866,10602,885,101,8.21,1,124.8,215732,1840,214584,0.71,0.08,0.08495192307692308,0.85,99.47
2020-09-17,Bihar,555,2,547,7066,3116,1765,7.85,6,124.8,216287,1842,215131,2.5,1.41,0.05661858974358974,0.85,99.47
2020-09-18,Bihar,695,4,687,9038,175,8,7.69,4,124.8,216982,1846,215818,0.14,0.01,0.07241987179487179,0.85,99.46
2020-09-19,Bihar,429,5,420,5497,498,300,7.8,4,124.8,217411,1851,216238,0.4,0.24,0.04404647435897436,0.85,99.46
2020-09-20,Bihar,406,3,401,5413,3242,2917,7.5,2,124.8,217817,1854,216639,2.6,2.34,0.04337339743589744,0.85,99.46
2020-09-21,Bihar,977,5,974,12443,3224,766,7.85,0,124.8,218794,1859,217613,2.58,0.61,0.09970352564102564,0.85,99.46
2020-09-22,Bihar,1535,19,1528,19270,4625,14,7.97,0,124.8,220329,1878,219141,3.71,0.01,0.1544070512820513,0.85,99.46
2020-09-23,Bihar,1221,8,1221,15504,4586,535,7.88,0,124.8,221550,1886,220362,3.67,0.43,0.12423076923076923,0.85,99.46
2020-09-24,Bihar,1024,9,1019,12887,2923,2221,7.95,0,124.8,222574,1895,221381,2.34,1.78,0.10326121794871795,0.85,99.46
2020-09-25,Bihar,82,0,82,1031,1500,345,7.95,0,124.8,222656,1895,221463,1.2,0.28,0.00826121794871795,0.85,99.46
2020-09-26,Bihar,209,2,200,2619,1509,976,7.98,7,124.8,222865,1897,221663,1.21,0.78,0.020985576923076923,0.85,99.46
2020-09-27,Bihar,991,10,983,12064,1253,937,8.21,0,124.8,223856,1907,222646,1.0,0.75,0.09666666666666666,0.85,99.46
2020-09-28,Bihar,170,2,161,2222,2331,373,7.65,7,124.8,224026,1909,222807,1.87,0.3,0.01780448717948718,0.85,99.46
2020-09-29,Bihar,116,1,114,1200,4441,3592,9.67,1,124.8,224142,1910,222921,3.56,2.88,0.009615384615384616,0.85,99.46
2020-09-30,Bihar,106,1,100,1187,1127,110,8.93,5,124.8,224248,1911,223021,0.9,0.09,0.009511217948717949,0.85,99.45
2020-10-01,Bihar,984,10,979,12189,4676,2795,8.07,0,124.8,225232,1921,224000,3.75,2.24,0.09766826923076923,0.85,99.45
2020-10-02,Bihar,1025,8,1025,12991,2778,1349,7.89,0,124.8,226257,1929,225025,2.23,1.08,0.10409455128205128,0.85,99.46
2020-10-03,Bihar,1225,7,1219,15375,4214,2530,7.97,0,124.8,227482,1936,226244,3.38,2.03,0.12319711538461539,0.85,99.46
2020-10-04,Bihar,1002,6,999,12344,2276,737,8.12,0,124.8,228484,1942,227243,1.82,0.59,0.09891025641025641,0.85,99.46
2020-10-05,Bihar,1031,9,1024,12908,304,225,7.99,0,124.8,229515,1951,228267,0.24,0.18,0.10342948717948718,0.85,99.46
2020-10-06,Bihar,1361,7,1354,16710,2489,1268,8.14,0,124.8,230876,1958,229621,1.99,1.02,0.13389423076923077,0.85,99.46
2020-10-07,Bihar,928,4,928,11543,1939,613,8.04,0,124.8,231804,1962,230549,1.55,0.49,0.09249198717948717,0.85,99.46
2020-10-08,Bihar,558,2,556,7090,1045,125,7.87,0,124.8,232362,1964,231105,0.84,0.1,0.056810897435897435,0.85,99.46
2020-10-09,Bihar,1381,10,1376,17060,374,333,8.09,0,124.8,233743,1974,232481,0.3,0.27,0.13669871794871793,0.84,99.46
2020-10-10,Bihar,679,9,673,8429,885,251,8.06,0,124.8,234422,1983,233154,0.71,0.2,0.0675400641025641,0.85,99.46
2020-10-11,Bihar,527,5,520,6918,788,61,7.62,2,124.8,234949,1988,233674,0.63,0.05,0.05543269230769231,0.85,99.46
2020-10-12,Bihar,1572,11,1572,19327,1661,894,8.13,0,124.8,236521,1999,235246,1.33,0.72,0.15486378205128204,0.85,99.46
2020-10-13,Bihar,1038,4,1032,12986,1071,622,7.99,2,124.8,237559,2003,236278,0.86,0.5,0.10405448717948718,0.84,99.46
2020-10-14,Bihar,267,1,267,3318,1756,849,8.05,0,124.8,237826,2004,236545,1.41,0.68,0.02658653846153846,0.84,99.46
2020-10-15,Bihar,218,2,210,2697,1542,1477,8.08,6,124.8,238044,2006,236755,1.24,1.18,0.021610576923076923,0.84,99.46
2020-10-16,Bihar,1211,15,1204,15149,9,1,7.99,0,124.8,239255,2021,237959,0.01,0.0,0.12138621794871794,0.84,99.46
2020-10-17,Bihar,1123,14,1121,13765,3147,2850,8.16,0,124.8,240378,2035,239080,2.52,2.28,0.11029647435897436,0.85,99.46
2020-10-18,Bihar,990,6,982,12766,3432,2837,7.75,2,124.8,241368,2041,240062,2.75,2.27,0.10229166666666667,0.85,99.46
2020-10-19,Bihar,1156,7,1153,14243,4877,3460,8.12,0,124.8,242524,2048,241215,3.91,2.77,0.11412660256410256,0.84,99.46
2020-10-20,Bihar,713,3,713,9235,2191,1627,7.72,0,124.8,243237,2051,241928,1.76,1.3,0.07399839743589744,0.84,99.46
2020-10-21,Bihar,1427,4,1427,17965,3470,1431,7.94,0,124.8,244664,2055,243355,2.78,1.15,0.1439503205128205,0.84,99.46
2020-10-22,Bihar,70,0,62,539,1226,772,12.99,8,124.8,244734,2055,243417,0.98,0.62,0.004318910256410256,0.84,99.46
2020-10-23,Bihar,1116,6,1110,14050,2184,844,7.94,0,124.8,245850,2061,244527,1.75,0.68,0.11258012820512821,0.84,99.46
2020-10-24,Bihar,1155,6,1154,14354,1561,199,8.05,0,124.8,247005,2067,245681,1.25,0.16,0.11501602564102564,0.84,99.46
2020-10-25,Bihar,799,5,792,9568,216,90,8.35,2,124.8,247804,2072,246473,0.17,0.07,0.07666666666666666,0.84,99.46
2020-10-26,Bihar,994,8,989,12553,3024,1826,7.92,0,124.8,248798,2080,247462,2.42,1.46,0.1005849358974359,0.84,99.46
2020-10-27,Bihar,113,1,112,1220,3896,3102,9.26,0,124.8,248911,2081,247574,3.12,2.49,0.009775641025641026,0.84,99.46
2020-10-28,Bihar,381,3,377,5009,3093,2170,7.61,1,124.8,249292,2084,247951,2.48,1.74,0.040136217948717946,0.84,99.46
2020-10-29,Bihar,46,0,39,1143,2835,2693,4.02,7,124.8,249338,2084,247990,2.27,2.16,0.009158653846153846,0.84,99.46
2020-10-30,Bihar,1439,8,1436,18211,88,70,7.9,0,124.8,250777,2092,249426,0.07,0.06,0.14592147435897435,0.83,99.46
2020-10-31,Bihar,790,8,784,10234,1547,1149,7.72,0,124.8,251567,2100,250210,1.24,0.92,0.08200320512820512,0.83,99.46
2020-11-01,Bihar,894,12,889,11419,3231,677,7.83,0,124.8,252461,2112,251099,2.59,0.54,0.09149839743589744,0.84,99.46
2020-11-02,Bihar,795,9,789,10493,2009,1504,7.58,0,124.8,253256,2121,251888,1.61,1.21,0.08407852564102564,0.84,99.46
2020-11-03,Bihar,1312,5,1311,16514,4228,1106,7.94,0,124.8,254568,2126,253199,3.39,0.89,0.13232371794871794,0.84,99.46
2020-11-04,Bihar,146,0,144,1690,2736,325,8.64,2,124.8,254714,2126,253343,2.19,0.26,0.013541666666666667,0.83,99.46
2020-11-05,Bihar,1438,13,1435,18291,2456,449,7.86,0,124.8,256152,2139,254778,1.97,0.36,0.1465625,0.84,99.46
2020-11-06,Bihar,1633,23,1633,19804,3073,1138,8.25,0,124.8,257785,2162,256411,2.46,0.91,0.15868589743589745,0.84,99.47
2020-11-07,Bihar,520,4,512,6055,1839,445,8.59,4,124.8,258305,2166,256923,1.47,0.36,0.048517628205128206,0.84,99.46
2020-11-08,Bihar,771,6,764,10273,1213,706,7.51,1,124.8,259076,2172,257687,0.97,0.57,0.08231570512820513,0.84,99.46
2020-11-09,Bihar,430,1,426,5006,1752,1655,8.59,3,124.8,259506,2173,258113,1.4,1.33,0.04011217948717949,0.84,99.46
2020-11-10,Bihar,374,3,368,4594,3690,3469,8.14,3,124.8,259880,2176,258481,2.96,2.78,0.03681089743589744,0.84,99.46
2020-11-11,Bihar,350,1,346,4528,1861,1131,7.73,3,124.8,260230,2177,258827,1.49,0.91,0.03628205128205128,0.84,99.46
2020-11-12,Bihar,1372,4,1365,17225,3928,3142,7.97,3,124.8,261602,2181,260192,3.15,2.52,0.13802083333333334,0.83,99.46
2020-11-13,Bihar,1308,5,1304,16189,776,131,8.08,0,124.8,262910,2186,261496,0.62,0.1,0.1297195512820513,0.83,99.46
2020-11-14,Bihar,955,12,952,11968,1519,396,7.98,0,124.8,263865,2198,262448,1.22,0.32,0.09589743589743589,0.83,99.46
2020-11-15,Bihar,322,3,318,3859,3185,31,8.34,1,124.8,264187,2201,262766,2.55,0.02,0.030921474358974358,0.83,99.46
2020-11-16,Bihar,181,2,180,2670,835,268,6.78,0,124.8,264368,2203,262946,0.67,0.21,0.02139423076923077,0.83,99.46
2020-11-17,Bihar,180,1,173,2137,545,289,8.42,6,124.8,264548,2204,263119,0.44,0.23,0.017123397435897435,0.83,99.46
2020-11-18,Bihar,442,2,436,5339,4422,2768,8.28,4,124.8,264990,2206,263555,3.54,2.22,0.04278044871794872,0.83,99.46
2020-11-19,Bihar,1302,11,1295,16085,2828,1809,8.09,0,124.8,266292,2217,264850,2.27,1.45,0.12888621794871793,0.83,99.46
2020-11-20,Bihar,881,7,878,10562,4156,3455,8.34,0,124.8,267173,2224,265728,3.33,2.77,0.08463141025641026,0.83,99.46
2020-11-21,Bihar,683,8,675,8688,1934,661,7.86,0,124.8,267856,2232,266403,1.55,0.53,0.06961538461538462,0.83,99.46
2020-11-22,Bihar,659,6,650,8553,1993,235,7.7,3,124.8,268515,2238,267053,1.6,0.19,0.06853365384615384,0.83,99.46
2020-11-23,Bihar,1478,14,1471,18314,4814,2646,8.07,0,124.8,269993,2252,268524,3.86,2.12,0.14674679487179487,0.83,99.46
2020-11-24,Bihar,348,4,345,4317,3164,2411,8.06,0,124.8,270341,2256,268869,2.54,1.93,0.03459134615384615,0.83,99.46
2020-11-25,Bihar,268,1,259,3112,128,108,8.61,8,124.8,270609,2257,269128,0.1,0.09,0.024935897435897435,0.83,99.45
2020-11-26,Bihar,1352,11,1352,17068,457,327,7.92,0,124.8,271961,2268,270480,0.37,0.26,0.13676282051282052,0.83,99.46
2020-11-27,Bihar,724,3,722,9393,4358,1307,7.71,0,124.8,272685,2271,271202,3.49,1.05,0.07526442307692308,0.83,99.46
2020-11-28,Bihar,250,1,243,3264,1943,1076,7.66,6,124.8,272935,2272,271445,1.56,0.86,0.026153846153846153,0.83,99.45
2020-11-29,Bihar,1253,15,1245,16185,1705,1499,7.74,0,124.8,274188,2287,272690,1.37,1.2,0.1296875,0.83,99.45
2020-11-30,Bihar,350,1,342,4867,4974,4778,7.19,7,124.8,274538,2288,273032,3.99,3.83,0.03899839743589743,0.83,99.45
2020-12-01,Bihar,1039,14,1036,13424,3309,2866,7.74,0,124.8,275577,2302,274068,2.65,2.3,0.10756410256410256,0.84,99.45
2020-12-02,Bihar,713,5,705,9143,593,446,7.8,3,124.8,276290,2307,274773,0.48,0.36,0.07326121794871795,0.83,99.45
2020-12-03,Bihar,1176,12,1168,14705,971,433,8.0,0,124.8,277466,2319,275941,0.78,0.35,0.11782852564102564,0.84,99.45
2020-12-04,Bihar,1484,12,1483,18549,1388,288,8.0,0,124.8,278950,2331,277424,1.11,0.23,0.14862980769230769,0.84,99.45
2020-12-05,Bihar,381,2,379,5030,1165,369,7.57,0,124.8,279331,2333,277803,0.93,0.3,0.04030448717948718,0.84,99.45
2020-12-06,Bihar,148,0,145,1859,4600,566,7.96,3,124.8,279479,2333,277948,3.69,0.45,0.014895833333333334,0.83,99.45
2020-12-07,Bihar,282,3,273,3227,3359,1198,8.74,6,124.8,279761,2336,278221,2.69,0.96,0.025857371794871794,0.83,99.45
2020-12-08,Bihar,692,7,690,8456,3169,1459,8.18,0,124.8,280453,2343,278911,2.54,1.17,0.06775641025641026,0.84,99.45
2020-12-09,Bihar,1338,12,1330,16807,2413,1184,7.96,0,124.8,281791,2355,280241,1.93,0.95,0.13467147435897436,0.84,99.45
2020-12-10,Bihar,1073,6,1072,13378,3056,2138,8.02,0,124.8,282864,2361,281313,2.45,1.71,0.10719551282051282,0.83,99.45
2020-12-11,Bihar,1206,3,1198,14835,1036,579,8.13,5,124.8,284070,2364,282511,0.83,0.46,0.1188701923076923,0.83,99.45
2020-12-12,Bihar,1066,13,1058,13526,4240,1071,7.88,0,124.8,285136,2377,283569,3.4,0.86,0.10838141025641025,0.83,99.45
2020-12-13,Bihar,610,8,606,7681,2690,668,7.94,0,124.8,285746,2385,284175,2.16,0.54,0.06154647435897436,0.83,99.45
2020-12-14,Bihar,405,5,396,5046,4325,1516,8.03,4,124.8,286151,2390,284571,3.47,1.21,0.04043269230769231,0.84,99.45
2020-12-15,Bihar,1572,22,1565,19764,51,17,7.95,0,124.8,287723,2412,286136,0.04,0.01,0.1583653846153846,0.84,99.45
2020-12-16,Bihar,318,1,313,3680,3174,1151,8.64,4,124.8,288041,2413,286449,2.54,0.92,0.029487179487179487,0.84,99.45
2020-12-17,Bihar,636,6,632,7672,2578,495,8.29,0,124.8,288677,2419,287081,2.07,0.4,0.061474358974358975,0.84,99.45
2020-12-18,Bihar,674,4,666,8451,2315,308,7.98,4,124.8,289351,2423,287747,1.85,0.25,0.06771634615384615,0.84,99.45
2020-12-19,Bihar,171,2,169,2050,522,286,8.34,0,124.8,289522,2425,287916,0.42,0.23,0.016426282051282052,0.84,99.45
2020-12-20,Bihar,647,6,642,8364,1383,848,7.74,0,124.8,290169,2431,288558,1.11,0.68,0.06701923076923078,0.84,99.44
2020-12-21,Bihar,1094,15,1085,13778,2113,1664,7.94,0,124.8,291263,2446,289643,1.69,1.33,0.11040064102564102,0.84,99.44
2020-12-22,Bihar,583,8,577,7250,2018,834,8.04,0,124.8,291846,2454,290220,1.62,0.67,0.05809294871794872,0.84,99.44
2020-12-23,Bihar,676,5,676,8668,4215,255,7.8,0,124.8,292522,2459,290896,3.38,0.2,0.06945512820512821,0.84,99.44
2020-12-24,Bihar,812,2,804,9876,3304,482,8.22,6,124.8,293334,2461,291700,2.65,0.39,0.07913461538461539,0.84,99.44
2020-12-25,Bihar,1064,9,1058,13095,1441,360,8.13,0,124.8,294398,2470,292758,1.15,0.29,0.10492788461538462,0.84,99.44
2020-12-26,Bihar,1340,5,1334,16245,3275,2178,8.25,1,124.8,295738,2475,294092,2.62,1.75,0.13016826923076924,0.84,99.44
2020-12-27,Bihar,1348,18,1346,17061,3783,2217,7.9,0,124.8,297086,2493,295438,3.03,1.78,0.13670673076923076,0.84,99.45
2020-12-28,Bihar,1567,9,1565,19878,3894,442,7.88,0,124.8,298653,2502,297003,3.12,0.35,0.15927884615384616,0.84,99.45
2020-12-29,Bihar,1381,6,1381,17356,4075,4069,7.96,0,124.8,300034,2508,298384,3.27,3.26,0.13907051282051283,0.84,99.45
2020-12-30,Bihar,909,11,900,11460,1524,1113,7.93,0,124.8,300943,2519,299284,1.22,0.89,0.09182692307692308,0.84,99.45
2020-12-31,Bihar,1007,13,998,12463,1327,656,8.08,0,124.8,301950,2532,300282,1.06,0.53,0.09986378205128205,0.84,99.45
2021-01-01,Bihar,1132,6,1127,13521,3840,1321,8.37,0,124.8,303082,2538,301409,3.08,1.06,0.10834134615384615,0.84,99.45
2021-01-02,Bihar,1249,8,1247,15996,2633,2239,7.81,0,124.8,304331,2546,302656,2.11,1.79,0.12817307692307692,0.84,99.45
2021-01-03,Bihar,836,4,833,10149,3361,947,8.24,0,124.8,305167,2550,303489,2.69,0.76,0.08132211538461538,0.84,99.45
2021-01-04,Bihar,478,4,472,6260,1714,538,7.64,2,124.8,305645,2554,303961,1.37,0.43,0.05016025641025641,0.84,99.45
2021-01-05,Bihar,946,7,939,11849,3236,2979,7.98,0,124.8,306591,2561,304900,2.59,2.39,0.09494391025641026,0.84,99.45
2021-01-06,Bihar,638,6,630,8392,1491,1440,7.6,2,124.8,307229,2567,305530,1.19,1.15,0.06724358974358974,0.84,99.45
2021-01-07,Bihar,1595,15,1586,19426,1211,566,8.21,0,124.8,308824,2582,307116,0.97,0.45,0.1556570512820513,0.84,99.45
2021-01-08,Bihar,1187,7,1184,14428,3518,2287,8.23,0,124.8,310011,2589,308300,2.82,1.83,0.11560897435897435,0.84,99.45
2021-01-09,Bihar,312,1,312,4508,3597,2848,6.92,0,124.8,310323,2590,308612,2.88,2.28,0.03612179487179487,0.83,99.45
2021-01-10,Bihar,790,6,785,9884,4806,2386,7.99,0,124.8,311113,2596,309397,3.85,1.91,0.07919871794871795,0.83,99.45
2021-01-11,Bihar,475,6,471,6443,955,392,7.37,0,124.8,311588,2602,309868,0.77,0.31,0.051626602564102564,0.84,99.45
2021-01-12,Bihar,903,8,900,11217,4454,524,8.05,0,124.8,312491,2610,310768,3.57,0.42,0.08987980769230769,0.84,99.45
2021-01-13,Bihar,83,0,74,1006,303,182,8.25,9,124.8,312574,2610,310842,0.24,0.15,0.008060897435897435,0.84,99.45
2021-01-14,Bihar,369,4,360,4625,3335,2825,7.98,5,124.8,312943,2614,311202,2.67,2.26,0.03705929487179487,0.84,99.44
2021-01-15,Bihar,709,8,701,8621,4120,795,8.22,0,124.8,313652,2622,311903,3.3,0.64,0.06907852564102564,0.84,99.44
2021-01-16,Bihar,588,2,583,7278,1615,1091,8.08,3,124.8,314240,2624,312486,1.29,0.87,0.05831730769230769,0.84,99.44
2021-01-17,Bihar,986,11,986,12257,2926,2607,8.04,0,124.8,315226,2635,313472,2.34,2.09,0.09821314102564102,0.84,99.44
2021-01-18,Bihar,507,7,505,6557,2379,975,7.73,0,124.8,315733,2642,313977,1.91,0.78,0.0525400641025641,0.84,99.44
2021-01-19,Bihar,1054,11,1048,13380,1131,452,7.88,0,124.8,316787,2653,315025,0.91,0.36,0.10721153846153846,0.84,99.44
2021-01-20,Bihar,1421,20,1419,18061,105,18,7.87,0,124.8,318208,2673,316444,0.08,0.01,0.14471955128205127,0.84,99.45
2021-01-21,Bihar,1213,14,1208,15498,4994,3037,7.83,0,124.8,319421,2687,317652,4.0,2.43,0.12418269230769231,0.84,99.45
2021-01-22,Bihar,1098,16,1093,13598,3100,2139,8.07,0,124.8,320519,2703,318745,2.48,1.71,0.10895833333333334,0.84,99.45
2021-01-23,Bihar,626,6,625,7471,2858,1273,8.38,0,124.8,321145,2709,319370,2.29,1.02,0.05986378205128205,0.84,99.45
2021-01-24,Bihar,592,3,584,7443,4564,1756,7.95,5,124.8,321737,2712,319954,3.66,1.41,0.059639423076923076,0.84,99.45
2021-01-25,Bihar,906,8,906,10702,2566,1814,8.47,0,124.8,322643,2720,320860,2.06,1.45,0.08575320512820513,0.84,99.45
2021-01-26,Bihar,324,1,321,4076,2563,834,7.95,2,124.8,322967,2721,321181,2.05,0.67,0.03266025641025641,0.84,99.45
2021-01-27,Bihar,726,7,718,9062,4773,1396,8.01,1,124.8,323693,2728,321899,3.82,1.12,0.07261217948717949,0.84,99.45
2021-01-28,Bihar,1418,11,1410,17870,3251,2686,7.94,0,124.8,325111,2739,323309,2.6,2.15,0.14318910256410255,0.84,99.45
2021-01-29,Bihar,1396,20,1388,17754,2013,777,7.86,0,124.8,326507,2759,324697,1.61,0.62,0.14225961538461537,0.85,99.45
2021-01-30,Bihar,1235,4,1227,15821,515,54,7.81,4,124.8,327742,2763,325924,0.41,0.04,0.12677083333333333,0.84,99.45
2021-01-31,Bihar,1616,11,1611,19949,3404,0,8.1,0,124.8,329358,2774,327535,2.73,0.0,0.15984775641025642,0.84,99.45
2021-02-01,Bihar,524,3,519,6544,3789,3612,8.01,2,124.8,329882,2777,328054,3.04,2.89,0.05243589743589744,0.84,99.45
2021-02-02,Bihar,1562,22,1557,19444,341,100,8.03,0,124.8,331444,2799,329611,0.27,0.08,0.15580128205128205,0.84,99.45
2021-02-03,Bihar,500,4,492,5592,2903,2704,8.94,4,124.8,331944,2803,330103,2.33,2.17,0.044807692307692305,0.84,99.45
2021-02-04,Bihar,575,8,571,7046,744,204,8.16,0,124.8,332519,2811,330674,0.6,0.16,0.05645833333333333,0.85,99.45
2021-02-05,Bihar,1244,18,1242,15507,2709,1587,8.02,0,124.8,333763,2829,331916,2.17,1.27,0.12425480769230769,0.85,99.45
2021-02-06,Bihar,1269,12,1263,15413,173,53,8.23,0,124.8,335032,2841,333179,0.14,0.04,0.12350160256410256,0.85,99.45
2021-02-07,Bihar,690,8,686,8465,438,205,8.15,0,124.8,335722,2849,333865,0.35,0.16,0.06782852564102564,0.85,99.45
2021-02-08,Bihar,574,5,574,7052,3100,119,8.14,0,124.8,336296,2854,334439,2.48,0.1,0.056506410256410254,0.85,99.45
2021-02-09,Bihar,483,2,474,5897,278,165,8.19,7,124.8,336779,2856,334913,0.22,0.13,0.04725160256410257,0.85,99.45
2021-02-10,Bihar,1480,6,1474,18479,2661,1615,8.01,0,124.8,338259,2862,336387,2.13,1.29,0.14806891025641025,0.85,99.45
2021-02-11,Bihar,1516,7,1514,18865,659,152,8.04,0,124.8,339775,2869,337901,0.53,0.12,0.15116185897435896,0.84,99.45
2021-02-12,Bihar,347,1,340,4060,4261,3306,8.55,6,124.8,340122,2870,338241,3.41,2.65,0.032532051282051284,0.84,99.45
2021-02-13,Bihar,1380,15,1375,17123,3960,152,8.06,0,124.8,341502,2885,339616,3.17,0.12,0.13720352564102564,0.84,99.45
2021-02-14,Bihar,167,0,166,1702,647,90,9.81,1,124.8,341669,2885,339782,0.52,0.07,0.013637820512820514,0.84,99.45
2021-02-15,Bihar,437,1,431,5815,3622,1132,7.52,5,124.8,342106,2886,340213,2.9,0.91,0.04659455128205128,0.84,99.45
2021-02-16,Bihar,1570,8,1561,19497,4311,3803,8.05,1,124.8,343676,2894,341774,3.45,3.05,0.15622596153846155,0.84,99.45
2021-02-17,Bihar,117,0,112,1599,1763,1397,7.32,5,124.8,343793,2894,341886,1.41,1.12,0.0128125,0.84,99.45
2021-02-18,Bihar,352,5,346,4311,3191,1075,8.17,1,124.8,344145,2899,342232,2.56,0.86,0.03454326923076923,0.84,99.44
2021-02-19,Bihar,1422,8,1421,18095,177,90,7.86,0,124.8,345567,2907,343653,0.14,0.07,0.1449919871794872,0.84,99.45
2021-02-20,Bihar,344,1,339,4517,4514,1711,7.62,4,124.8,345911,2908,343992,3.62,1.37,0.03619391025641026,0.84,99.45
2021-02-21,Bihar,1427,6,1425,17869,4172,2356,7.99,0,124.8,347338,2914,345417,3.34,1.89,0.14318108974358976,0.84,99.45
2021-02-22,Bihar,960,3,952,12112,1613,835,7.93,5,124.8,348298,2917,346369,1.29,0.67,0.09705128205128205,0.84,99.45
2021-02-23,Bihar,1489,19,1481,18524,3573,3183,8.04,0,124.8,349787,2936,347850,2.86,2.55,0.14842948717948717,0.84,99.45
2021-02-24,Bihar,509,5,507,6469,139,29,7.87,0,124.8,350296,2941,348357,0.11,0.02,0.051834935897435895,0.84,99.45
2021-02-25,Bihar,1474,13,1467,18071,2769,2432,8.16,0,124.8,351770,2954,349824,2.22,1.95,0.14479967948717948,0.84,99.45
2021-02-26,Bihar,1365,4,1357,16750,465,67,8.15,4,124.8,353135,2958,351181,0.37,0.05,0.13421474358974358,0.84,99.45
2021-02-27,Bihar,465,2,461,5683,2417,820,8.18,2,124.8,353600,2960,351642,1.94,0.66,0.045536858974358975,0.84,99.45
2021-02-28,Bihar,454,4,450,5650,2199,302,8.04,0,124.8,354054,2964,352092,1.76,0.24,0.045272435897435896,0.84,99.45
2021-03-01,Bihar,178,0,169,2142,2698,386,8.31,9,124.8,354232,2964,352261,2.16,0.31,0.017163461538461537,0.84,99.44
2021-03-02,Bihar,60,0,52,1010,567,50,5.94,8,124.8,354292,2964,352313,0.45,0.04,0.008092948717948719,0.84,99.44
2021-03-03,Bihar,114,0,107,1247,4139,2267,9.14,7,124.8,354406,2964,352420,3.32,1.82,0.00999198717948718,0.84,99.44
2021-03-04,Bihar,140,0,138,1226,3972,1162,11.42,2,124.8,354546,2964,352558,3.18,0.93,0.009823717948717949,0.84,99.44
2021-03-05,Bihar,249,1,249,3509,3360,1958,7.1,0,124.8,354795,2965,352807,2.69,1.57,0.028116987179487178,0.84,99.44
2021-03-06,Bihar,766,7,761,9566,4962,1513,8.01,0,124.8,355561,2972,353568,3.98,1.21,0.07665064102564102,0.84,99.44
2021-03-07,Bihar,1038,6,1033,12874,1548,12,8.06,0,124.8,356599,2978,354601,1.24,0.01,0.10315705128205128,0.84,99.44
2021-03-08,Bihar,1371,17,1364,17234,1307,39,7.96,0,124.8,357970,2995,355965,1.05,0.03,0.13809294871794872,0.84,99.44
2021-03-09,Bihar,1260,6,1254,15803,2089,804,7.97,0,124.8,359230,3001,357219,1.67,0.64,0.12662660256410257,0.84,99.44
2021-03-10,Bihar,1531,18,1525,19252,4087,2785,7.95,0,124.8,360761,3019,358744,3.27,2.23,0.1542628205128205,0.84,99.44
2021-03-11,Bihar,675,2,674,8089,4227,3067,8.34,0,124.8,361436,3021,359418,3.39,2.46,0.06481570512820513,0.84,99.44
2021-03-12,Bihar,1293,13,1293,16295,2308,689,7.93,0,124.8,362729,3034,360711,1.85,0.55,0.13056891025641026,0.84,99.44
2021-03-13,Bihar,1155,7,1149,14267,239,165,8.1,0,124.8,363884,3041,361860,0.19,0.13,0.11431891025641025,0.84,99.44
2021-03-14,Bihar,705,8,702,8896,276,183,7.92,0,124.8,364589,3049,362562,0.22,0.15,0.07128205128205128,0.84,99.44
2021-03-15,Bihar,343,3,342,4185,3152,2027,8.2,0,124.8,364932,3052,362904,2.53,1.62,0.033533653846153845,0.84,99.44
2021-03-16,Bihar,812,9,811,10194,4702,3019,7.97,0,124.8,365744,3061,363715,3.77,2.42,0.0816826923076923,0.84,99.45
2021-03-17,Bihar,1321,7,1316,16650,997,900,7.93,0,124.8,367065,3068,365031,0.8,0.72,0.13341346153846154,0.84,99.45
2021-03-18,Bihar,440,4,432,5431,2452,2119,8.1,4,124.8,367505,3072,365463,1.96,1.7,0.0435176282051282,0.84,99.44
2021-03-19,Bihar,374,4,372,4782,3653,3270,7.82,0,124.8,367879,3076,365835,2.93,2.62,0.03831730769230769,0.84,99.44
2021-03-20,Bihar,192,2,188,2263,3185,516,8.48,2,124.8,368071,3078,366023,2.55,0.41,0.01813301282051282,0.84,99.44
2021-03-21,Bihar,51,0,45,678,2268,1420,7.52,6,124.8,368122,3078,366068,1.82,1.14,0.005432692307692308,0.84,99.44
2021-03-22,Bihar,381,4,376,4930,2602,773,7.73,1,124.8,368503,3082,366444,2.08,0.62,0.03950320512820513,0.84,99.44
2021-03-23,Bihar,88,1,80,1005,3718,1938,8.76,7,124.8,368591,3083,366524,2.98,1.55,0.008052884615384615,0.84,99.44
2021-03-24,Bihar,1106,12,1103,14161,1148,1140,7.81,0,124.8,369697,3095,367627,0.92,0.91,0.11346955128205129,0.84,99.44
2021-03-25,Bihar,871,4,867,10724,7,3,8.12,0,124.8,370568,3099,368494,0.01,0.0,0.08592948717948717,0.84,99.44
2021-03-26,Bihar,1215,13,1215,15123,124,12,8.03,0,124.8,371783,3112,369709,0.1,0.01,0.12117788461538462,0.84,99.44
2021-03-27,Bihar,575,2,566,7368,1937,978,7.8,7,124.8,372358,3114,370275,1.55,0.78,0.05903846153846154,0.84,99.44
2021-03-28,Bihar,672,8,670,8491,674,307,7.91,0,124.8,373030,3122,370945,0.54,0.25,0.06803685897435897,0.84,99.44
2021-03-29,Bihar,399,3,394,5058,525,396,7.89,2,124.8,373429,3125,371339,0.42,0.32,0.04052884615384615,0.84,99.44
2021-03-30,Bihar,318,3,315,3850,3315,1530,8.26,0,124.8,373747,3128,371654,2.66,1.23,0.030849358974358976,0.84,99.44
2021-03-31,Bihar,342,4,337,4334,4722,3681,7.89,1,124.8,374089,3132,371991,3.78,2.95,0.034727564102564105,0.84,99.44
2021-04-01,Bihar,360,4,360,4127,4085,1417,8.72,0,124.8,374449,3136,372351,3.27,1.14,0.033068910256410254,0.84,99.44
2021-04-02,Bihar,809,3,802,10261,2271,785,7.88,4,124.8,375258,3139,373153,1.82,0.63,0.08221955128205129,0.84,99.44
2021-04-03,Bihar,1149,14,1146,14021,4701,124,8.19,0,124.8,376407,3153,374299,3.77,0.1,0.1123477564102564,0.84,99.44
2021-04-04,Bihar,1456,19,1449,18162,1276,1116,8.02,0,124.8,377863,3172,375748,1.02,0.89,0.14552884615384615,0.84,99.44
2021-04-05,Bihar,1315,18,1312,16015,3591,328,8.21,0,124.8,379178,3190,377060,2.88,0.26,0.1283253205128205,0.84,99.44
2021-04-06,Bihar,716,4,710,9171,1432,572,7.81,2,124.8,379894,3194,377770,1.15,0.46,0.07348557692307692,0.84,99.44
2021-04-07,Bihar,860,2,859,10103,2398,1971,8.51,0,124.8,380754,3196,378629,1.92,1.58,0.08095352564102565,0.84,99.44
2021-04-08,Bihar,1568,10,1562,19335,2190,1856,8.11,0,124.8,382322,3206,380191,1.75,1.49,0.15492788461538462,0.84,99.44
2021-04-09,Bihar,505,3,498,6015,4169,2027,8.4,4,124.8,382827,3209,380689,3.34,1.62,0.04819711538461539,0.84,99.44
2021-04-10,Bihar,457,4,454,6007,4055,765,7.61,0,124.8,383284,3213,381143,3.25,0.61,0.04813301282051282,0.84,99.44
2021-04-11,Bihar,1332,16,1328,16796,2945,2641,7.93,0,124.8,384616,3229,382471,2.36,2.12,0.13458333333333333,0.84,99.44
2021-04-12,Bihar,185,0,184,2520,485,131,7.34,1,124.8,384801,3229,382655,0.39,0.1,0.020192307692307693,0.84,99.44
2021-04-13,Bihar,829,12,823,9852,4826,987,8.41,0,124.8,385630,3241,383478,3.87,0.79,0.07894230769230769,0.84,99.44
2021-04-14,Bihar,264,3,264,3115,4564,2239,8.48,0,124.8,385894,3244,383742,3.66,1.79,0.0249599358974359,0.84,99.44
2021-04-15,Bihar,893,8,892,10756,4072,3092,8.3,0,124.8,386787,3252,384634,3.26,2.48,0.08618589743589744,0.84,99.44
2021-04-16,Bihar,1598,6,1592,19985,3029,884,8.0,0,124.8,388385,3258,386226,2.43,0.71,0.16013621794871793,0.84,99.44
2021-04-17,Bihar,202,2,198,2565,3663,1694,7.88,2,124.8,388587,3260,386424,2.94,1.36,0.020552884615384615,0.84,99.44
2021-04-18,Bihar,1144,8,1138,14201,93,17,8.06,0,124.8,389731,3268,387562,0.07,0.01,0.1137900641025641,0.84,99.44
2021-04-19,Bihar,1454,4,1449,18169,1113,941,8.0,1,124.8,391185,3272,389011,0.89,0.75,0.1455849358974359,0.84,99.44
2021-04-20,Bihar,1548,14,1548,19600,4766,1654,7.9,0,124.8,392733,3286,390559,3.82,1.33,0.15705128205128205,0.84,99.45
2021-04-21,Bihar,65,0,63,928,3532,1924,7.0,2,124.8,392798,3286,390622,2.83,1.54,0.007435897435897436,0.84,99.45
2021-04-22,Bihar,808,6,806,10269,3511,3450,7.87,0,124.8,393606,3292,391428,2.81,2.76,0.08228365384615384,0.84,99.45
2021-04-23,Bihar,1552,17,1549,19664,2569,543,7.89,0,124.8,395158,3309,392977,2.06,0.44,0.15756410256410255,0.84,99.45
2021-04-24,Bihar,1488,21,1480,18703,2030,275,7.96,0,124.8,396646,3330,394457,1.63,0.22,0.14986378205128206,0.84,99.45
2021-04-25,Bihar,115,1,108,1375,3552,29,8.36,6,124.8,396761,3331,394565,2.85,0.02,0.011017628205128206,0.84,99.45
2021-04-26,Bihar,901,3,900,11315,1396,131,7.96,0,124.8,397662,3334,395465,1.12,0.1,0.0906650641025641,0.84,99.45
2021-04-27,Bihar,720,10,716,8563,2102,665,8.41,0,124.8,398382,3344,396181,1.68,0.53,0.06861378205128205,0.84,99.45
2021-04-28,Bihar,132,0,124,1637,319,163,8.06,8,124.8,398514,3344,396305,0.26,0.13,0.013116987179487179,0.84,99.45
2021-04-29,Bihar,1163,8,1163,14422,881,112,8.06,0,124.8,399677,3352,397468,0.71,0.09,0.11556089743589744,0.84,99.45
2021-04-30,Bihar,455,3,452,5023,3234,2486,9.06,0,124.8,400132,3355,397920,2.59,1.99,0.040248397435897434,0.84,99.45
2021-05-01,Bihar,1184,11,1178,14987,3231,1967,7.9,0,124.8,401316,3366,399098,2.59,1.58,0.12008814102564103,0.84,99.45
2021-05-02,Bihar,742,6,740,8781,867,421,8.45,0,124.8,402058,3372,399838,0.69,0.34,0.07036057692307693,0.84,99.45
2021-05-03,Bihar,1147,8,1147,14494,4178,2893,7.91,0,124.8,403205,3380,400985,3.35,2.32,0.11613782051282051,0.84,99.45
2021-05-04,Bihar,1302,9,1293,15893,2147,783,8.19,0,124.8,404507,3389,402278,1.72,0.63,0.12734775641025642,0.84,99.45
2021-05-05,Bihar,1572,15,1564,19449,2426,180,8.08,0,124.8,406079,3404,403842,1.94,0.14,0.15584134615384615,0.84,99.45
2021-05-06,Bihar,606,2,601,7813,1941,436,7.76,3,124.8,406685,3406,404443,1.56,0.35,0.06260416666666667,0.84,99.45
2021-05-07,Bihar,1006,11,1003,12322,3440,1421,8.16,0,124.8,407691,3417,405446,2.76,1.14,0.09873397435897435,0.84,99.45
2021-05-08,Bihar,277,2,269,3563,1098,529,7.77,6,124.8,407968,3419,405715,0.88,0.42,0.028549679487179486,0.84,99.45
2021-05-09,Bihar,538,3,530,6913,99,91,7.78,5,124.8,408506,3422,406245,0.08,0.07,0.055392628205128205,0.84,99.45
2021-05-10,Bihar,149,1,147,1953,379,225,7.63,1,124.8,408655,3423,406392,0.3,0.18,0.01564903846153846,0.84,99.45
2021-05-11,Bihar,155,1,154,2273,3816,25,6.82,0,124.8,408810,3424,406546,3.06,0.02,0.018213141025641026,0.84,99.45
2021-05-12,Bihar,268,3,259,3255,2768,771,8.23,6,124.8,409078,3427,406805,2.22,0.62,0.02608173076923077,0.84,99.44
2021-05-13,Bihar,561,2,558,7191,424,229,7.8,1,124.8,409639,3429,407363,0.34,0.18,0.05762019230769231,0.84,99.44
2021-05-14,Bihar,833,7,833,10614,150,69,7.85,0,124.8,410472,3436,408196,0.12,0.06,0.08504807692307692,0.84,99.45
2021-05-15,Bihar,297,1,293,3893,4413,273,7.63,3,124.8,410769,3437,408489,3.54,0.22,0.031193910256410256,0.84,99.44
2021-05-16,Bihar,414,5,411,5051,1993,470,8.2,0,124.8,411183,3442,408900,1.6,0.38,0.04047275641025641,0.84,99.44
2021-05-17,Bihar,788,10,788,9803,946,506,8.04,0,124.8,411971,3452,409688,0.76,0.41,0.07854967948717949,0.84,99.45
2021-05-18,Bihar,535,4,531,6661,3692,2593,8.03,0,124.8,412506,3456,410219,2.96,2.08,0.05337339743589744,0.84,99.45
2021-05-19,Bihar,578,3,578,7359,701,429,7.85,0,124.8,413084,3459,410797,0.56,0.34,0.058966346153846154,0.84,99.45
2021-05-20,Bihar,811,6,806,9818,4236,3668,8.26,0,124.8,413895,3465,411603,3.39,2.94,0.0786698717948718,0.84,99.45
2021-05-21,Bihar,1001,7,993,12595,1234,370,7.95,1,124.8,414896,3472,412596,0.99,0.3,0.10092147435897436,0.84,99.45
2021-05-22,Bihar,1219,7,1210,15072,142,57,8.09,2,124.8,416115,3479,413806,0.11,0.05,0.12076923076923077,0.84,99.45
2021-05-23,Bihar,215,2,211,2794,1234,1172,7.7,2,124.8,416330,3481,414017,0.99,0.94,0.022387820512820514,0.84,99.44
2021-05-24,Bihar,1459,6,1452,18303,4504,2317,7.97,1,124.8,417789,3487,415469,3.61,1.86,0.14665865384615384,0.83,99.44
2021-05-25,Bihar,1528,17,1528,19103,4141,3426,8.0,0,124.8,419317,3504,416997,3.32,2.75,0.15306891025641026,0.84,99.45
2021-05-26,Bihar,486,7,486,6706,3831,1035,7.25,0,124.8,419803,3511,417483,3.07,0.83,0.05373397435897436,0.84,99.45
2021-05-27,Bihar,571,2,564,6994,3118,1228,8.16,5,124.8,420374,3513,418047,2.5,0.98,0.05604166666666666,0.84,99.45
2021-05-28,Bihar,900,12,899,10528,1766,794,8.55,0,124.8,421274,3525,418946,1.42,0.64,0.08435897435897435,0.84,99.45
2021-05-29,Bihar,1431,7,1431,18344,351,278,7.8,0,124.8,422705,3532,420377,0.28,0.22,0.1469871794871795,0.84,99.45
2021-05-30,Bihar,539,7,537,6514,2562,2172,8.27,0,124.8,423244,3539,420914,2.05,1.74,0.052195512820512824,0.84,99.45
2021-05-31,Bihar,1278,12,1269,16072,4244,4240,7.95,0,124.8,424522,3551,422183,3.4,3.4,0.12878205128205128,0.84,99.45
2021-06-01,Bihar,1012,13,1007,12729,2205,52,7.95,0,124.8,425534,3564,423190,1.77,0.04,0.10199519230769231,0.84,99.45
2021-06-02,Bihar,397,1,394,5219,4536,3922,7.61,2,124.8,425931,3565,423584,3.63,3.14,0.041818910256410255,0.84,99.45
2021-06-03,Bihar,1219,16,1219,15513,1646,410,7.86,0,124.8,427150,3581,424803,1.32,0.33,0.12430288461538462,0.84,99.45
2021-06-04,Bihar,353,1,345,4057,4477,2716,8.7,7,124.8,427503,3582,425148,3.59,2.18,0.03250801282051282,0.84,99.45
2021-06-05,Bihar,1432,7,1424,17772,1042,397,8.06,1,124.8,428935,3589,426572,0.83,0.32,0.14240384615384616,0.84,99.45
2021-06-06,Bihar,1110,11,1107,14094,81,67,7.88,0,124.8,430045,3600,427679,0.06,0.05,0.1129326923076923,0.84,99.45
2021-06-07,Bihar,1405,4,1405,16994,1724,549,8.27,0,124.8,431450,3604,429084,1.38,0.44,0.1361698717948718,0.84,99.45
2021-06-08,Bihar,172,1,168,2392,3951,2647,7.19,3,124.8,431622,3605,429252,3.17,2.12,0.019166666666666665,0.84,99.45
2021-06-09,Bihar,668,9,663,8433,922,810,7.92,0,124.8,432290,3614,429915,0.74,0.65,0.06757211538461538,0.84,99.45
2021-06-10,Bihar,763,3,756,10190,2865,1375,7.49,4,124.8,433053,3617,430671,2.3,1.1,0.08165064102564103,0.84,99.45
2021-06-11,Bihar,1436,19,1429,18157,2322,126,7.91,0,124.8,434489,3636,432100,1.86,0.1,0.14548878205128205,0.84,99.45
2021-06-12,Bihar,358,4,353,3975,871,499,9.01,1,124.8,434847,3640,432453,0.7,0.4,0.031850961538461536,0.84,99.45
2021-06-13,Bihar,1355,18,1347,16824,3422,2006,8.05,0,124.8,436202,3658,433800,2.74,1.61,0.1348076923076923,0.84,99.45
2021-06-14,Bihar,597,8,590,7592,3538,2340,7.86,0,124.8,436799,3666,434390,2.83,1.88,0.060833333333333336,0.84,99.45
2021-06-15,Bihar,502,7,499,6532,2988,1158,7.69,0,124.8,437301,3673,434889,2.39,0.93,0.05233974358974359,0.84,99.45
2021-06-16,Bihar,702,5,693,8387,2516,599,8.37,4,124.8,438003,3678,435582,2.02,0.48,0.06720352564102564,0.84,99.45
2021-06-17,Bihar,1596,15,1595,19608,3537,1452,8.14,0,124.8,439599,3693,437177,2.83,1.16,0.15711538461538463,0.84,99.45
2021-06-18,Bihar,937,12,932,11928,623,373,7.86,0,124.8,440536,3705,438109,0.5,0.3,0.09557692307692307,0.84,99.45
2021-06-19,Bihar,779,9,779,9760,3686,1416,7.98,0,124.8,441315,3714,438888,2.95,1.13,0.0782051282051282,0.84,99.45
2021-06-20,Bihar,615,8,606,7824,4175,3411,7.86,1,124.8,441930,3722,439494,3.35,2.73,0.06269230769230769,0.84,99.45
2021-06-21,Bihar,480,1,472,5763,2765,196,8.33,7,124.8,442410,3723,439966,2.22,0.16,0.046177884615384614,0.84,99.45
2021-06-22,Bihar,1585,20,1583,19959,2003,922,7.94,0,124.8,443995,3743,441549,1.6,0.74,0.15992788461538462,0.84,99.45
2021-06-23,Bihar,697,3,692,8589,3762,1055,8.12,2,124.8,444692,3746,442241,3.01,0.85,0.06882211538461538,0.84,99.45
2021-06-24,Bihar,729,8,721,8964,1439,1244,8.13,0,124.8,445421,3754,442962,1.15,1.0,0.07182692307692308,0.84,99.45
2021-06-25,Bihar,366,3,359,4510,2344,282,8.12,4,124.8,445787,3757,443321,1.88,0.23,0.036137820512820516,0.84,99.45
2021-06-26,Bihar,1327,10,1323,17300,2554,390,7.67,0,124.8,447114,3767,444644,2.05,0.31,0.13862179487179488,0.84,99.45
2021-06-27,Bihar,1381,18,1376,16886,453,368,8.18,0,124.8,448495,3785,446020,0.36,0.29,0.13530448717948718,0.84,99.45
2021-06-28,Bihar,684,3,684,8326,1835,1016,8.22,0,124.8,449179,3788,446704,1.47,0.81,0.0667147435897436,0.84,99.45
2021-06-29,Bihar,78,0,71,1050,4738,4007,7.43,7,124.8,449257,3788,446775,3.8,3.21,0.008413461538461538,0.84,99.45
2021-06-30,Bihar,122,1,114,1700,3997,950,7.18,7,124.8,449379,3789,446889,3.2,0.76,0.013621794871794872,0.84,99.45
2021-07-01,Bihar,1584,11,1583,19517,1878,1556,8.12,0,124.8,450963,3800,448472,1.5,1.25,0.15638621794871796,0.84,99.45
2021-07-02,Bihar,73,0,64,694,1048,938,10.52,9,124.8,451036,3800,448536,0.84,0.75,0.005560897435897436,0.84,99.45
2021-07-03,Bihar,157,1,156,2226,4700,976,7.05,0,124.8,451193,3801,448692,3.77,0.78,0.017836538461538463,0.84,99.45
2021-07-04,Bihar,921,9,913,11335,3328,76,8.13,0,124.8,452114,3810,449605,2.67,0.06,0.09082532051282051,0.84,99.45
2021-07-05,Bihar,239,2,238,3401,820,103,7.03,0,124.8,452353,3812,449843,0.66,0.08,0.027251602564102563,0.84,99.45
2021-07-06,Bihar,686,6,686,8798,2796,738,7.8,0,124.8,453039,3818,450529,2.24,0.59,0.07049679487179487,0.84,99.45
2021-07-07,Bihar,836,11,833,10939,3421,1845,7.64,0,124.8,453875,3829,451362,2.74,1.48,0.08765224358974359,0.84,99.45
2021-07-08,Bihar,934,3,927,11671,1771,1752,8.0,4,124.8,454809,3832,452289,1.42,1.4,0.09351762820512821,0.84,99.45
2021-07-09,Bihar,1429,15,1426,17937,2668,92,7.97,0,124.8,456238,3847,453715,2.14,0.07,0.14372596153846154,0.84,99.45
2021-07-10,Bihar,480,6,478,5912,4149,3355,8.12,0,124.8,456718,3853,454193,3.32,2.69,0.047371794871794874,0.84,99.45
2021-07-11,Bihar,1468,4,1460,18266,651,155,8.04,4,124.8,458186,3857,455653,0.52,0.12,0.1463621794871795,0.84,99.45
2021-07-12,Bihar,416,4,412,5146,4986,2654,8.08,0,124.8,458602,3861,456065,4.0,2.13,0.04123397435897436,0.84,99.45
2021-07-13,Bihar,712,7,703,8969,3944,1740,7.94,2,124.8,459314,3868,456768,3.16,1.39,0.07186698717948718,0.84,99.45
2021-07-14,Bihar,765,8,764,9827,376,9,7.78,0,124.8,460079,3876,457532,0.3,0.01,0.07874198717948717,0.84,99.45
2021-07-15,Bihar,571,2,564,7446,121,100,7.67,5,124.8,460650,3878,458096,0.1,0.08,0.05966346153846154,0.84,99.45
2021-07-16,Bihar,1271,6,1269,16448,2202,1216,7.73,0,124.8,461921,3884,459365,1.76,0.97,0.1317948717948718,0.84,99.45
2021-07-17,Bihar,1473,19,1473,18526,4241,1156,7.95,0,124.8,463394,3903,460838,3.4,0.93,0.14844551282051283,0.84,99.45
2021-07-18,Bihar,1571,7,1570,19834,4083,3946,7.92,0,124.8,464965,3910,462408,3.27,3.16,0.15892628205128206,0.84,99.45
2021-07-19,Bihar,1502,18,1500,18993,417,392,7.91,0,124.8,466467,3928,463908,0.33,0.31,0.1521875,0.84,99.45
2021-07-20,Bihar,1381,13,1381,17195,827,63,8.03,0,124.8,467848,3941,465289,0.66,0.05,0.13778044871794873,0.84,99.45
2021-07-21,Bihar,477,3,473,5961,4669,4367,8.0,1,124.8,468325,3944,465762,3.74,3.5,0.04776442307692308,0.84,99.45
2021-07-22,Bihar,949,8,942,11619,2149,419,8.17,0,124.8,469274,3952,466704,1.72,0.34,0.09310096153846154,0.84,99.45
2021-07-23,Bihar,580,7,578,6746,4569,277,8.6,0,124.8,469854,3959,467282,3.66,0.22,0.05405448717948718,0.84,99.45
2021-07-24,Bihar,1594,8,1594,19764,1856,915,8.07,0,124.8,471448,3967,468876,1.49,0.73,0.1583653846153846,0.84,99.45
2021-07-25,Bihar,1384,15,1376,17376,373,135,7.97,0,124.8,472832,3982,470252,0.3,0.11,0.13923076923076924,0.84,99.45
2021-07-26,Bihar,423,3,421,5810,1196,850,7.28,0,124.8,473255,3985,470673,0.96,0.68,0.04655448717948718,0.84,99.45
2021-07-27,Bihar,1508,11,1504,18878,723,625,7.99,0,124.8,474763,3996,472177,0.58,0.5,0.15126602564102565,0.84,99.46
2021-07-28,Bihar,1263,17,1261,15699,4052,3017,8.05,0,124.8,476026,4013,473438,3.25,2.42,0.12579326923076922,0.84,99.46
2021-07-29,Bihar,1507,12,1505,19102,4058,315,7.89,0,124.8,477533,4025,474943,3.25,0.25,0.15306089743589743,0.84,99.46
2021-07-30,Bihar,257,0,252,3218,3721,1808,7.99,5,124.8,477790,4025,475195,2.98,1.45,0.02578525641025641,0.84,99.46
2021-07-31,Bihar,610,6,609,7744,1747,1333,7.88,0,124.8,478400,4031,475804,1.4,1.07,0.062051282051282054,0.84,99.46
2021-08-01,Bihar,335,1,329,4270,2510,1638,7.85,5,124.8,478735,4032,476133,2.01,1.31,0.03421474358974359,0.84,99.46
2021-08-02,Bihar,616,5,611,7622,4588,1846,8.08,0,124.8,479351,4037,476744,3.68,1.48,0.06107371794871795,0.84,99.46
2021-08-03,Bihar,1555,17,1547,19766,2495,2368,7.87,0,124.8,480906,4054,478291,2.0,1.9,0.15838141025641025,0.84,99.46
2021-08-04,Bihar,920,10,919,11522,4984,1779,7.98,0,124.8,481826,4064,479210,3.99,1.43,0.09232371794871795,0.84,99.46
2021-08-05,Bihar,459,3,450,5696,1942,887,8.06,6,124.8,482285,4067,479660,1.56,0.71,0.045641025641025644,0.84,99.46
2021-08-06,Bihar,1260,17,1251,16045,2671,1442,7.85,0,124.8,483545,4084,480911,2.14,1.16,0.12856570512820512,0.84,99.46
2021-08-07,Bihar,1191,4,1187,14719,845,745,8.09,0,124.8,484736,4088,482098,0.68,0.6,0.11794070512820513,0.84,99.46
2021-08-08,Bihar,1256,11,1256,15465,4025,3556,8.12,0,124.8,485992,4099,483354,3.23,2.85,0.12391826923076923,0.84,99.46
2021-08-09,Bihar,872,7,867,10855,4593,703,8.03,0,124.8,486864,4106,484221,3.68,0.56,0.08697916666666666,0.84,99.46
2021-08-10,Bihar,1349,19,1345,17226,4699,595,7.83,0,124.8,488213,4125,485566,3.77,0.48,0.13802884615384614,0.84,99.46
2021-08-11,Bihar,1369,13,1364,16983,1788,1261,8.06,0,124.8,489582,4138,486930,1.43,1.01,0.13608173076923077,0.85,99.46
2021-08-12,Bihar,1505,11,1503,18540,786,21,8.12,0,124.8,491087,4149,488433,0.63,0.02,0.1485576923076923,0.84,99.46
2021-08-13,Bihar,248,1,244,2824,1792,183,8.78,3,124.8,491335,4150,488677,1.44,0.15,0.02262820512820513,0.84,99.46
2021-08-14,Bihar,195,2,186,2356,4774,325,8.28,7,124.8,491530,4152,488863,3.83,0.26,0.01887820512820513,0.84,99.46
2021-08-15,Bihar,317,2,315,3945,2094,174,8.04,0,124.8,491847,4154,489178,1.68,0.14,0.03161057692307692,0.84,99.46
2021-08-16,Bihar,167,1,160,2343,1617,1571,7.13,6,124.8,492014,4155,489338,1.3,1.26,0.01877403846153846,0.84,99.46
2021-08-17,Bihar,1155,14,1150,14476,2219,1040,7.98,0,124.8,493169,4169,490488,1.78,0.83,0.11599358974358974,0.85,99.46
2021-08-18,Bihar,438,2,433,5391,1116,1010,8.12,3,124.8,493607,4171,490921,0.89,0.81,0.04319711538461538,0.85,99.46
2021-08-19,Bihar,1539,12,1533,19162,449,4,8.03,0,124.8,495146,4183,492454,0.36,0.0,0.15354166666666666,0.84,99.46
2021-08-20,Bihar,265,2,257,3684,1171,876,7.19,6,124.8,495411,4185,492711,0.94,0.7,0.02951923076923077,0.84,99.45
2021-08-21,Bihar,797,9,792,10065,3054,2041,7.92,0,124.8,496208,4194,493503,2.45,1.64,0.08064903846153847,0.85,99.45
2021-08-22,Bihar,541,1,534,6771,3520,3406,7.99,6,124.8,496749,4195,494037,2.82,2.73,0.05425480769230769,0.84,99.45
2021-08-23,Bihar,1170,15,1170,14520,630,487,8.06,0,124.8,497919,4210,495207,0.5,0.39,0.11634615384615385,0.85,99.46
2021-08-24,Bihar,746,3,737,9742,2855,2277,7.66,6,124.8,498665,4213,495944,2.29,1.82,0.07806089743589743,0.84,99.45
2021-08-25,Bihar,1007,7,1003,12371,622,609,8.14,0,124.8,499672,4220,496947,0.5,0.49,0.09912660256410256,0.84,99.45
2021-08-26,Bihar,101,1,99,1178,3182,2383,8.57,1,124.8,499773,4221,497046,2.55,1.91,0.009439102564102565,0.84,99.45
2021-08-27,Bihar,72,1,68,1301,3582,1711,5.53,3,124.8,499845,4222,497114,2.87,1.37,0.010424679487179487,0.84,99.45
2021-08-28,Bihar,906,5,903,10966,1228,864,8.26,0,124.8,500751,4227,498017,0.98,0.69,0.08786858974358974,0.84,99.45
2021-08-29,Bihar,124,1,117,1466,419,364,8.46,6,124.8,500875,4228,498134,0.34,0.29,0.011746794871794872,0.84,99.45
2021-08-30,Bihar,317,2,313,3727,1256,863,8.51,2,124.8,501192,4230,498447,1.01,0.69,0.02986378205128205,0.84,99.45
2021-08-31,Bihar,657,6,656,8128,137,17,8.08,0,124.8,501849,4236,499103,0.11,0.01,0.06512820512820512,0.84,99.45
2021-09-01,Bihar,640,5,632,7752,4299,129,8.26,3,124.8,502489,4241,499735,3.44,0.1,0.062115384615384614,0.84,99.45
2021-09-02,Bihar,581,2,576,7205,3595,1456,8.06,3,124.8,503070,4243,500311,2.88,1.17,0.0577323717948718,0.84,99.45
2021-09-03,Bihar,29,0,22,546,2409,514,5.31,7,124.8,503099,4243,500333,1.93,0.41,0.004375,0.84,99.45
2021-09-04,Bihar,91,0,89,737,3796,2102,12.35,2,124.8,503190,4243,500422,3.04,1.68,0.005905448717948718,0.84,99.45
2021-09-05,Bihar,384,4,381,5284,4828,3124,7.27,0,124.8,503574,4247,500803,3.87,2.5,0.042339743589743586,0.84,99.45
2021-09-06,Bihar,93,1,90,1372,3381,2275,6.78,2,124.8,503667,4248,500893,2.71,1.82,0.010993589743589743,0.84,99.45
2021-09-07,Bihar,1219,5,1216,15365,748,483,7.93,0,124.8,504886,4253,502109,0.6,0.39,0.12311698717948719,0.84,99.45
2021-09-08,Bihar,1016,5,1009,12473,3375,1214,8.15,2,124.8,505902,4258,503118,2.7,0.97,0.09994391025641025,0.84,99.45
2021-09-09,Bihar,993,5,985,12601,2767,1806,7.88,3,124.8,506895,4263,504103,2.22,1.45,0.10096955128205128,0.84,99.45
2021-09-10,Bihar,457,2,453,5581,3532,2107,8.19,2,124.8,507352,4265,504556,2.83,1.69,0.04471955128205128,0.84,99.45
2021-09-11,Bihar,87,0,79,1379,4996,1797,6.31,8,124.8,507439,4265,504635,4.0,1.44,0.011049679487179487,0.84,99.45
2021-09-12,Bihar,1341,10,1335,16665,2179,2171,8.05,0,124.8,508780,4275,505970,1.75,1.74,0.13353365384615384,0.84,99.45
2021-09-13,Bihar,328,2,321,3499,2043,379,9.37,5,124.8,509108,4277,506291,1.64,0.3,0.028036858974358973,0.84,99.45
2021-09-14,Bihar,357,3,354,4586,4162,490,7.78,0,124.8,509465,4280,506645,3.33,0.39,0.03674679487179487,0.84,99.45
2021-09-15,Bihar,1367,14,1362,17052,286,166,8.02,0,124.8,510832,4294,508007,0.23,0.13,0.13663461538461538,0.84,99.45
2021-09-16,Bihar,114,0,111,1530,1774,110,7.45,3,124.8,510946,4294,508118,1.42,0.09,0.012259615384615384,0.84,99.45
2021-09-17,Bihar,978,14,975,11981,2916,2362,8.16,0,124.8,511924,4308,509093,2.34,1.89,0.09600160256410256,0.84,99.45
2021-09-18,Bihar,1526,18,1519,18766,4259,1595,8.13,0,124.8,513450,4326,510612,3.41,1.28,0.15036858974358974,0.84,99.45
2021-09-19,Bihar,384,2,383,4982,2572,510,7.71,0,124.8,513834,4328,510995,2.06,0.41,0.039919871794871796,0.84,99.45
2021-09-20,Bihar,1376,17,1368,17801,2829,1652,7.73,0,124.8,515210,4345,512363,2.27,1.32,0.14263621794871795,0.84,99.45
2021-09-21,Bihar,1134,9,1130,14402,3983,1190,7.87,0,124.8,516344,4354,513493,3.19,0.95,0.11540064102564103,0.84,99.45
2021-09-22,Bihar,913,8,909,11462,2053,426,7.97,0,124.8,517257,4362,514402,1.65,0.34,0.09184294871794872,0.84,99.45
2021-09-23,Bihar,1270,8,1261,15929,3358,1947,7.97,1,124.8,518527,4370,515663,2.69,1.56,0.12763621794871796,0.84,99.45
2021-09-24,Bihar,1087,11,1080,13746,559,56,7.91,0,124.8,519614,4381,516743,0.45,0.04,0.11014423076923077,0.84,99.45
2021-09-25,Bihar,131,0,129,1243,1568,508,10.54,2,124.8,519745,4381,516872,1.26,0.41,0.009959935897435898,0.84,99.45
2021-09-26,Bihar,641,7,641,7735,3025,1375,8.29,0,124.8,520386,4388,517513,2.42,1.1,0.06197916666666667,0.84,99.45
2021-09-27,Bihar,1477,16,1471,18849,1691,1563,7.84,0,124.8,521863,4404,518984,1.35,1.25,0.15103365384615386,0.84,99.45
2021-09-28,Bihar,1465,8,1459,18504,4579,716,7.92,0,124.8,523328,4412,520443,3.67,0.57,0.14826923076923076,0.84,99.45
2021-09-29,Bihar,1462,19,1453,18334,1748,432,7.97,0,124.8,524790,4431,521896,1.4,0.35,0.14690705128205128,0.84,99.45
2021-09-30,Bihar,1061,4,1059,13371,262,151,7.94,0,124.8,525851,4435,522955,0.21,0.12,0.10713942307692308,0.84,99.45
2021-10-01,Bihar,1579,7,1575,19652,774,489,8.03,0,124.8,527430,4442,524530,0.62,0.39,0.15746794871794872,0.84,99.45
2021-10-02,Bihar,661,4,656,8251,4198,977,8.01,1,124.8,528091,4446,525186,3.36,0.78,0.06611378205128206,0.84,99.45
2021-10-03,Bihar,392,5,389,4496,1245,691,8.72,0,124.8,528483,4451,525575,1.0,0.55,0.03602564102564103,0.84,99.45
2021-10-04,Bihar,997,7,994,12633,2778,1297,7.89,0,124.8,529480,4458,526569,2.23,1.04,0.10122596153846154,0.84,99.45
2021-10-05,Bihar,707,4,705,8837,1746,16,8.0,0,124.8,530187,4462,527274,1.4,0.01,0.07080929487179487,0.84,99.45
2021-10-06,Bihar,744,6,744,9269,3509,1265,8.03,0,124.8,530931,4468,528018,2.81,1.01,0.07427083333333333,0.84,99.45
2021-10-07,Bihar,1537,18,1530,19294,3134,2305,7.97,0,124.8,532468,4486,529548,2.51,1.85,0.15459935897435897,0.84,99.45
2021-10-08,Bihar,1013,9,1005,12372,1919,897,8.19,0,124.8,533481,4495,530553,1.54,0.72,0.09913461538461539,0.84,99.45
2021-10-09,Bihar,239,2,236,2536,1796,1398,9.42,1,124.8,533720,4497,530789,1.44,1.12,0.02032051282051282,0.84,99.45
2021-10-10,Bihar,746,2,738,8863,1892,516,8.42,6,124.8,534466,4499,531527,1.52,0.41,0.0710176282051282,0.84,99.45
2021-10-11,Bihar,1428,19,1427,18071,2299,2096,7.9,0,124.8,535894,4518,532954,1.84,1.68,0.14479967948717948,0.84,99.45
2021-10-12,Bihar,792,5,784,9748,2480,1006,8.12,3,124.8,536686,4523,533738,1.99,0.81,0.07810897435897436,0.84,99.45
2021-10-13,Bihar,1380,7,1372,17037,3751,1717,8.1,1,124.8,538066,4530,535110,3.01,1.38,0.13651442307692307,0.84,99.45
2021-10-14,Bihar,945,7,943,12020,369,42,7.86,0,124.8,539011,4537,536053,0.3,0.03,0.09631410256410257,0.84,99.45
2021-10-15,Bihar,1591,21,1583,19339,975,774,8.23,0,124.8,540602,4558,537636,0.78,0.62,0.1549599358974359,0.84,99.45
2021-10-16,Bihar,135,0,132,2285,3519,1488,5.91,3,124.8,540737,4558,537768,2.82,1.19,0.018309294871794873,0.84,99.45
2021-10-17,Bihar,382,3,377,5028,4939,3404,7.6,2,124.8,541119,4561,538145,3.96,2.73,0.04028846153846154,0.84,99.45
2021-10-18,Bihar,108,0,105,1268,2492,252,8.52,3,124.8,541227,4561,538250,2.0,0.2,0.01016025641025641,0.84,99.45
2021-10-19,Bihar,240,0,238,2811,1318,352,8.54,2,124.8,541467,4561,538488,1.06,0.28,0.02252403846153846,0.84,99.45
2021-10-20,Bihar,1513,19,1505,18427,1773,337,8.21,0,124.8,542980,4580,539993,1.42,0.27,0.14765224358974358,0.84,99.45
2021-10-21,Bihar,10,0,8,533,2796,2619,1.88,2,124.8,542990,4580,540001,2.24,2.1,0.004270833333333333,0.84,99.45
2021-10-22,Bihar,1183,10,1178,14724,3578,2501,8.03,0,124.8,544173,4590,541179,2.87,2.0,0.11798076923076924,0.84,99.45
2021-10-23,Bihar,1511,10,1505,18588,4189,655,8.13,0,124.8,545684,4600,542684,3.36,0.52,0.14894230769230768,0.84,99.45
2021-10-24,Bihar,1092,10,1085,13588,3163,2343,8.04,0,124.8,546776,4610,543769,2.53,1.88,0.10887820512820513,0.84,99.45
2021-10-25,Bihar,626,8,618,7882,555,541,7.94,0,124.8,547402,4618,544387,0.44,0.43,0.06315705128205128,0.84,99.45
2021-10-26,Bihar,230,1,223,2707,3957,1617,8.5,6,124.8,547632,4619,544610,3.17,1.3,0.021690705128205128,0.84,99.45
2021-10-27,Bihar,74,0,67,1007,2828,1269,7.35,7,124.8,547706,4619,544677,2.27,1.02,0.008068910256410256,0.84,99.45
2021-10-28,Bihar,1294,5,1294,16310,3521,1725,7.93,0,124.8,549000,4624,545971,2.82,1.38,0.13068910256410257,0.84,99.45
2021-10-29,Bihar,1499,18,1495,18850,2242,2155,7.95,0,124.8,550499,4642,547466,1.8,1.73,0.15104166666666666,0.84,99.45
2021-10-30,Bihar,1410,9,1410,17439,980,108,8.09,0,124.8,551909,4651,548876,0.79,0.09,0.13973557692307692,0.84,99.45
2021-10-31,Bihar,679,5,675,8107,3781,272,8.38,0,124.8,552588,4656,549551,3.03,0.22,0.0649599358974359,0.84,99.45
2021-11-01,Bihar,987,11,985,12770,2590,687,7.73,0,124.8,553575,4667,550536,2.08,0.55,0.10232371794871795,0.84,99.45
2021-11-02,Bihar,1175,4,1175,14083,1485,1415,8.34,0,124.8,554750,4671,551711,1.19,1.13,0.11284455128205129,0.84,99.45
2021-11-03,Bihar,1197,14,1188,14585,1966,1154,8.21,0,124.8,555947,4685,552899,1.58,0.92,0.11686698717948718,0.84,99.45
2021-11-04,Bihar,1432,14,1430,18023,662,36,7.95,0,124.8,557379,4699,554329,0.53,0.03,0.1444150641025641,0.84,99.45
2021-11-05,Bihar,1504,6,1499,18915,2823,2206,7.95,0,124.8,558883,4705,555828,2.26,1.77,0.1515625,0.84,99.45
2021-11-06,Bihar,993,3,993,12100,2789,1740,8.21,0,124.8,559876,4708,556821,2.23,1.39,0.09695512820512821,0.84,99.45
2021-11-07,Bihar,97,1,96,1525,820,59,6.36,0,124.8,559973,4709,556917,0.66,0.05,0.012219551282051282,0.84,99.45
2021-11-08,Bihar,1036,13,1035,13011,4489,3918,7.96,0,124.8,561009,4722,557952,3.6,3.14,0.10425480769230769,0.84,99.46
2021-11-09,Bihar,903,3,903,11608,4932,3559,7.78,0,124.8,561912,4725,558855,3.95,2.85,0.09301282051282052,0.84,99.46
2021-11-10,Bihar,197,1,196,2496,453,234,7.89,0,124.8,562109,4726,559051,0.36,0.19,0.02,0.84,99.46
2021-11-11,Bihar,172,2,170,2310,4418,331,7.45,0,124.8,562281,4728,559221,3.54,0.27,0.018509615384615385,0.84,99.46
2021-11-12,Bihar,264,1,257,2835,4879,2541,9.31,6,124.8,562545,4729,559478,3.91,2.04,0.022716346153846153,0.84,99.45
2021-11-13,Bihar,119,0,119,1555,2320,940,7.65,0,124.8,562664,4729,559597,1.86,0.75,0.012459935897435898,0.84,99.45
2021-11-14,Bihar,75,0,71,1135,1283,643,6.61,4,124.8,562739,4729,559668,1.03,0.52,0.009094551282051283,0.84,99.45
2021-11-15,Bihar,105,1,99,1490,178,67,7.05,5,124.8,562844,4730,559767,0.14,0.05,0.011939102564102563,0.84,99.45
2021-11-16,Bihar,1183,16,1183,15241,4968,3710,7.76,0,124.8,564027,4746,560950,3.98,2.97,0.12212339743589744,0.84,99.45
2021-11-17,Bihar,1220,17,1219,15540,64,25,7.85,0,124.8,565247,4763,562169,0.05,0.02,0.12451923076923077,0.84,99.46
2021-11-18,Bihar,1414,4,1408,17810,375,135,7.94,2,124.8,566661,4767,563577,0.3,0.11,0.14270833333333333,0.84,99.46
2021-11-19,Bihar,236,0,228,2643,145,36,8.93,8,124.8,566897,4767,563805,0.12,0.03,0.021177884615384616,0.84,99.45
2021-11-20,Bihar,1063,13,1061,13709,1514,590,7.75,0,124.8,567960,4780,564866,1.21,0.47,0.10984775641025642,0.84,99.46
2021-11-21,Bihar,69,0,67,1109,3133,2637,6.22,2,124.8,568029,4780,564933,2.51,2.11,0.008886217948717948,0.84,99.45
2021-11-22,Bihar,1506,15,1497,18677,235,97,8.06,0,124.8,569535,4795,566430,0.19,0.08,0.14965544871794872,0.84,99.45
2021-11-23,Bihar,473,5,468,6093,1307,875,7.76,0,124.8,570008,4800,566898,1.05,0.7,0.04882211538461539,0.84,99.45
2021-11-24,Bihar,1384,13,1376,18061,1066,1063,7.66,0,124.8,571392,4813,568274,0.85,0.85,0.14471955128205127,0.84,99.45
2021-11-25,Bihar,924,6,917,11818,3433,511,7.82,1,124.8,572316,4819,569191,2.75,0.41,0.09469551282051282,0.84,99.45
2021-11-26,Bihar,1127,13,1119,13995,1061,323,8.05,0,124.8,573443,4832,570310,0.85,0.26,0.11213942307692308,0.84,99.45
2021-11-27,Bihar,575,2,572,7228,951,571,7.96,1,124.8,574018,4834,570882,0.76,0.46,0.057916666666666665,0.84,99.45
2021-11-28,Bihar,541,3,537,6744,2568,2477,8.02,1,124.8,574559,4837,571419,2.06,1.98,0.054038461538461535,0.84,99.45
2021-11-29,Bihar,1428,6,1423,17541,2933,1473,8.14,0,124.8,575987,4843,572842,2.35,1.18,0.14055288461538462,0.84,99.45
2021-11-30,Bihar,899,6,890,11464,4809,2722,7.84,3,124.8,576886,4849,573732,3.85,2.18,0.09185897435897436,0.84,99.45
2021-12-01,Bihar,88,1,87,1273,129,63,6.91,0,124.8,576974,4850,573819,0.1,0.05,0.010200320512820512,0.84,99.45
2021-12-02,Bihar,1461,21,1460,18112,76,25,8.07,0,124.8,578435,4871,575279,0.06,0.02,0.14512820512820512,0.84,99.45
2021-12-03,Bihar,540,4,537,6830,906,70,7.91,0,124.8,578975,4875,575816,0.73,0.06,0.0547275641025641,0.84,99.45
2021-12-04,Bihar,767,3,761,9578,2041,399,8.01,3,124.8,579742,4878,576577,1.64,0.32,0.07674679487179487,0.84,99.45
2021-12-05,Bihar,1408,15,1405,17847,199,175,7.89,0,124.8,581150,4893,577982,0.16,0.14,0.1430048076923077,0.84,99.45
2021-12-06,Bihar,1246,3,1239,15621,4027,132,7.98,4,124.8,582396,4896,579221,3.23,0.11,0.12516826923076924,0.84,99.45
2021-12-07,Bihar,1221,13,1218,15343,3110,4,7.96,0,124.8,583617,4909,580439,2.49,0.0,0.12294070512820512,0.84,99.46
2021-12-08,Bihar,36,0,32,676,4500,192,5.33,4,124.8,583653,4909,580471,3.61,0.15,0.005416666666666667,0.84,99.45
2021-12-09,Bihar,1349,15,1345,16998,3076,1200,7.94,0,124.8,585002,4924,581816,2.46,0.96,0.13620192307692308,0.84,99.46
2021-12-10,Bihar,1209,13,1208,15123,3173,1116,7.99,0,124.8,586211,4937,583024,2.54,0.89,0.12117788461538462,0.84,99.46
2021-12-11,Bihar,794,5,791,9987,2732,1840,7.95,0,124.8,587005,4942,583815,2.19,1.47,0.08002403846153847,0.84,99.46
2021-12-12,Bihar,1136,8,1129,14317,4725,1859,7.93,0,124.8,588141,4950,584944,3.79,1.49,0.11471955128205129,0.84,99.46
2021-12-13,Bihar,424,3,422,5060,2594,658,8.38,0,124.8,588565,4953,585366,2.08,0.53,0.0405448717948718,0.84,99.46
2021-12-14,Bihar,1520,11,1511,18671,892,142,8.14,0,124.8,590085,4964,586877,0.71,0.11,0.1496073717948718,0.84,99.46
2021-12-15,Bihar,1617,7,1616,19638,2850,1680,8.23,0,124.8,591702,4971,588493,2.28,1.35,0.15735576923076924,0.84,99.46
2021-12-16,Bihar,99,0,93,1612,2269,1019,6.14,6,124.8,591801,4971,588586,1.82,0.82,0.012916666666666667,0.84,99.46
2021-12-17,Bihar,427,4,427,5118,4248,1204,8.34,0,124.8,592228,4975,589013,3.4,0.96,0.04100961538461539,0.84,99.46
2021-12-18,Bihar,123,0,114,1468,762,761,8.38,9,124.8,592351,4975,589127,0.61,0.61,0.011762820512820512,0.84,99.46
2021-12-19,Bihar,1334,13,1333,16504,2504,1577,8.08,0,124.8,593685,4988,590460,2.01,1.26,0.13224358974358974,0.84,99.46
2021-12-20,Bihar,172,1,164,2734,529,201,6.29,7,124.8,593857,4989,590624,0.42,0.16,0.021907051282051282,0.84,99.46
2021-12-21,Bihar,479,2,470,5134,2114,347,9.33,7,124.8,594336,4991,591094,1.69,0.28,0.041137820512820514,0.84,99.45
2021-12-22,Bihar,1084,4,1080,13420,2839,2700,8.08,0,124.8,595420,4995,592174,2.27,2.16,0.10753205128205129,0.84,99.45
2021-12-23,Bihar,690,2,690,8378,1613,1426,8.24,0,124.8,596110,4997,592864,1.29,1.14,0.06713141025641026,0.84,99.46
2021-12-24,Bihar,538,4,538,6439,2942,1786,8.36,0,124.8,596648,5001,593402,2.36,1.43,0.05159455128205128,0.84,99.46
2021-12-25,Bihar,390,1,386,4710,1561,237,8.28,3,124.8,597038,5002,593788,1.25,0.19,0.03774038461538461,0.84,99.46
2021-12-26,Bihar,116,1,113,1257,4281,4130,9.23,2,124.8,597154,5003,593901,3.43,3.31,0.010072115384615384,0.84,99.46
2021-12-27,Bihar,1051,5,1047,13002,1184,819,8.08,0,124.8,598205,5008,594948,0.95,0.66,0.10418269230769231,0.84,99.46
2021-12-28,Bihar,58,0,56,759,1488,730,7.64,2,124.8,598263,5008,595004,1.19,0.58,0.006081730769230769,0.84,99.46
2021-12-29,Bihar,1430,19,1422,17764,748,705,8.05,0,124.8,599693,5027,596426,0.6,0.56,0.14233974358974358,0.84,99.46
2021-12-30,Bihar,940,13,932,11647,3757,2901,8.07,0,124.8,600633,5040,597358,3.01,2.32,0.09332532051282051,0.84,99.45
2021-12-31,Bihar,171,2,170,2269,3297,1310,7.54,0,124.8,600804,5042,597528,2.64,1.05,0.018181089743589743,0.84,99.45
2022-01-01,Bihar,484,4,477,5958,2130,702,8.12,3,124.8,601288,5046,598005,1.71,0.56,0.047740384615384615,0.84,99.45
2022-01-02,Bihar,858,11,853,10683,1753,826,8.03,0,124.8,602146,5057,598858,1.4,0.66,0.08560096153846154,0.84,99.45
2022-01-03,Bihar,139,1,133,1502,4371,637,9.25,5,124.8,602285,5058,598991,3.5,0.51,0.01203525641025641,0.84,99.45
2022-01-04,Bihar,335,1,332,4298,429,370,7.79,2,124.8,602620,5059,599323,0.34,0.3,0.03443910256410256,0.84,99.45
2022-01-05,Bihar,1195,4,1191,14583,2561,154,8.19,0,124.8,603815,5063,600514,2.05,0.12,0.11685096153846154,0.84,99.45
2022-01-06,Bihar,1538,10,1534,19321,2696,769,7.96,0,124.8,605353,5073,602048,2.16,0.62,0.15481570512820514,0.84,99.45
2022-01-07,Bihar,1059,12,1055,13209,3462,2752,8.02,0,124.8,606412,5085,603103,2.77,2.21,0.10584134615384615,0.84,99.45
2022-01-08,Bihar,1362,19,1360,16674,228,21,8.17,0,124.8,607774,5104,604463,0.18,0.02,0.13360576923076922,0.84,99.46
2022-01-09,Bihar,138,1,130,1253,650,614,11.01,7,124.8,607912,5105,604593,0.52,0.49,0.010040064102564103,0.84,99.45
2022-01-10,Bihar,1151,9,1149,14077,2779,2417,8.18,0,124.8,609063,5114,605742,2.23,1.94,0.11279647435897436,0.84,99.45
2022-01-11,Bihar,435,5,432,5429,2089,551,8.01,0,124.8,609498,5119,606174,1.67,0.44,0.043501602564102564,0.84,99.45
2022-01-12,Bihar,790,9,781,9634,2089,14,8.2,0,124.8,610288,5128,606955,1.67,0.01,0.07719551282051282,0.84,99.45
2022-01-13,Bihar,979,5,977,11953,4168,1145,8.19,0,124.8,611267,5133,607932,3.34,0.92,0.09577724358974359,0.84,99.45
2022-01-14,Bihar,1055,6,1050,12926,2579,2352,8.16,0,124.8,612322,5139,608982,2.07,1.88,0.10357371794871795,0.84,99.45
2022-01-15,Bihar,1588,10,1588,19879,3031,2173,7.99,0,124.8,613910,5149,610570,2.43,1.74,0.15928685897435899,0.84,99.46
2022-01-16,Bihar,1048,7,1042,13217,3429,2261,7.93,0,124.8,614958,5156,611612,2.75,1.81,0.10590544871794871,0.84,99.46
2022-01-17,Bihar,369,4,362,4398,3393,840,8.39,3,124.8,615327,5160,611974,2.72,0.67,0.03524038461538462,0.84,99.46
2022-01-18,Bihar,1194,12,1187,14588,4392,1271,8.18,0,124.8,616521,5172,613161,3.52,1.02,0.11689102564102564,0.84,99.46
2022-01-19,Bihar,159,0,157,1648,98,89,9.65,2,124.8,616680,5172,613318,0.08,0.07,0.013205128205128204,0.84,99.45
2022-01-20,Bihar,61,0,57,717,1247,1060,8.51,4,124.8,616741,5172,613375,1.0,0.85,0.005745192307692308,0.84,99.45
2022-01-21,Bihar,795,6,789,9866,4225,3626,8.06,0,124.8,617536,5178,614164,3.39,2.91,0.07905448717948718,0.84,99.45
2022-01-22,Bihar,1608,8,1605,19953,3185,2919,8.06,0,124.8,619144,5186,615769,2.55,2.34,0.1598798076923077,0.84,99.45
2022-01-23,Bihar,865,8,858,11021,3008,823,7.85,0,124.8,620009,5194,616627,2.41,0.66,0.08830929487179487,0.84,99.45
2022-01-24,Bihar,631,6,626,7756,2081,693,8.14,0,124.8,620640,5200,617253,1.67,0.56,0.0621474358974359,0.84,99.45
2022-01-25,Bihar,128,1,128,1549,1286,885,8.26,0,124.8,620768,5201,617381,1.03,0.71,0.012411858974358975,0.84,99.45
2022-01-26,Bihar,839,7,831,11059,3784,2897,7.59,1,124.8,621607,5208,618212,3.03,2.32,0.08861378205128205,0.84,99.45
2022-01-27,Bihar,1319,15,1315,16416,3081,828,8.03,0,124.8,622926,5223,619527,2.47,0.66,0.13153846153846155,0.84,99.45
2022-01-28,Bihar,563,7,556,7129,963,737,7.9,0,124.8,623489,5230,620083,0.77,0.59,0.057123397435897436,0.84,99.45
2022-01-29,Bihar,1000,14,995,12451,2560,1786,8.03,0,124.8,624489,5244,621078,2.05,1.43,0.0997676282051282,0.84,99.45
2022-01-30,Bihar,998,14,994,12261,1804,736,8.14,0,124.8,625487,5258,622072,1.45,0.59,0.09824519230769231,0.84,99.45
2022-01-31,Bihar,770,5,763,9575,1399,1106,8.04,2,124.8,626257,5263,622835,1.12,0.89,0.07672275641025642,0.84,99.45
2022-02-01,Bihar,1008,3,1004,12470,4599,1449,8.08,1,124.8,627265,5266,623839,3.69,1.16,0.0999198717948718,0.84,99.45
2022-02-02,Bihar,1301,15,1292,16025,3610,2976,8.12,0,124.8,628566,5281,625131,2.89,2.38,0.1284054487179487,0.84,99.45
2022-02-03,Bihar,761,10,758,9208,2731,2452,8.26,0,124.8,629327,5291,625889,2.19,1.96,0.07378205128205129,0.84,99.45
2022-02-04,Bihar,852,6,849,11151,706,154,7.64,0,124.8,630179,5297,626738,0.57,0.12,0.08935096153846153,0.84,99.45
2022-02-05,Bihar,1470,16,1462,18381,2596,274,8.0,0,124.8,631649,5313,628200,2.08,0.22,0.14728365384615386,0.84,99.45
2022-02-06,Bihar,860,4,856,10717,769,193,8.02,0,124.8,632509,5317,629056,0.62,0.15,0.08587339743589743,0.84,99.45
2022-02-07,Bihar,1500,22,1492,18814,1679,804,7.97,0,124.8,634009,5339,630548,1.35,0.64,0.15075320512820511,0.84,99.45
2022-02-08,Bihar,1498,15,1489,19081,1049,217,7.85,0,124.8,635507,5354,632037,0.84,0.17,0.1528926282051282,0.84,99.45
2022-02-09,Bihar,237,1,234,3393,1156,920,6.98,2,124.8,635744,5355,632271,0.93,0.74,0.0271875,0.84,99.45
2022-02-10,Bihar,153,0,145,1655,4704,900,9.24,8,124.8,635897,5355,632416,3.77,0.72,0.013261217948717948,0.84,99.45
2022-02-11,Bihar,966,9,965,12022,2263,1221,8.04,0,124.8,636863,5364,633381,1.81,0.98,0.09633012820512821,0.84,99.45
2022-02-12,Bihar,1107,6,1102,13914,86,28,7.96,0,124.8,637970,5370,634483,0.07,0.02,0.11149038461538462,0.84,99.45
2022-02-13,Bihar,81,0,79,586,1264,1172,13.82,2,124.8,638051,5370,634562,1.01,0.94,0.004695512820512821,0.84,99.45
2022-02-14,Bihar,940,4,935,11772,3667,1556,7.99,1,124.8,638991,5374,635497,2.94,1.25,0.09432692307692307,0.84,99.45
2022-02-15,Bihar,723,10,717,9070,3854,3615,7.97,0,124.8,639714,5384,636214,3.09,2.9,0.07267628205128206,0.84,99.45
2022-02-16,Bihar,8,0,0,526,3588,326,1.52,8,124.8,639722,5384,636214,2.88,0.26,0.00421474358974359,0.84,99.45
2022-02-17,Bihar,1544,7,1542,19290,2905,1543,8.0,0,124.8,641266,5391,637756,2.33,1.24,0.1545673076923077,0.84,99.45
2022-02-18,Bihar,1034,13,1027,12771,549,137,8.1,0,124.8,642300,5404,638783,0.44,0.11,0.10233173076923077,0.84,99.45
2022-02-19,Bihar,1285,14,1278,15805,2100,573,8.13,0,124.8,643585,5418,640061,1.68,0.46,0.1266426282051282,0.84,99.45
2022-02-20,Bihar,1189,17,1187,14668,628,160,8.11,0,124.8,644774,5435,641248,0.5,0.13,0.11753205128205128,0.84,99.45
2022-02-21,Bihar,1321,11,1321,16512,35,7,8.0,0,124.8,646095,5446,642569,0.03,0.01,0.13230769230769232,0.84,99.45
2022-02-22,Bihar,1114,8,1107,13921,4671,4211,8.0,0,124.8,647209,5454,643676,3.74,3.37,0.11154647435897436,0.84,99.45
2022-02-23,Bihar,419,5,414,4899,3624,72,8.55,0,124.8,647628,5459,644090,2.9,0.06,0.03925480769230769,0.84,99.45
2022-02-24,Bihar,1303,7,1297,16779,3872,1292,7.77,0,124.8,648931,5466,645387,3.1,1.04,0.13444711538461537,0.84,99.45
2022-02-25,Bihar,1137,13,1137,14182,686,62,8.02,0,124.8,650068,5479,646524,0.55,0.05,0.11363782051282051,0.84,99.45
2022-02-26,Bihar,482,4,475,5441,4784,4241,8.86,3,124.8,650550,5483,646999,3.83,3.4,0.043597756410256414,0.84,99.45
2022-02-27,Bihar,259,3,257,3458,1684,845,7.49,0,124.8,650809,5486,647256,1.35,0.68,0.027708333333333335,0.84,99.45
2022-02-28,Bihar,542,1,541,7084,4896,4887,7.65,0,124.8,651351,5487,647797,3.92,3.92,0.056762820512820514,0.84,99.45
2022-03-01,Bihar,516,1,512,6555,3764,2684,7.87,3,124.8,651867,5488,648309,3.02,2.15,0.05252403846153846,0.84,99.45
2022-03-02,Bihar,744,7,737,9143,4470,3373,8.14,0,124.8,652611,5495,649046,3.58,2.7,0.07326121794871795,0.84,99.45
2022-03-03,Bihar,311,1,304,3686,144,64,8.44,6,124.8,652922,5496,649350,0.12,0.05,0.02953525641025641,0.84,99.45
2022-03-04,Bihar,94,0,94,1263,2894,1149,7.44,0,124.8,653016,5496,649444,2.32,0.92,0.010120192307692307,0.84,99.45
2022-03-05,Bihar,936,8,928,11168,4032,2492,8.38,0,124.8,653952,5504,650372,3.23,2.0,0.08948717948717949,0.84,99.45
2022-03-06,Bihar,86,0,83,1255,2398,500,6.85,3,124.8,654038,5504,650455,1.92,0.4,0.010056089743589744,0.84,99.45
2022-03-07,Bihar,1495,17,1486,18818,1325,75,7.94,0,124.8,655533,5521,651941,1.06,0.06,0.15078525641025642,0.84,99.45
2022-03-08,Bihar,1268,11,1268,15614,4737,2353,8.12,0,124.8,656801,5532,653209,3.8,1.89,0.12511217948717948,0.84,99.45
2022-03-09,Bihar,1081,14,1077,13309,165,114,8.12,0,124.8,657882,5546,654286,0.13,0.09,0.10664262820512821,0.84,99.45
2022-03-10,Bihar,1326,17,1322,16146,1124,223,8.21,0,124.8,659208,5563,655608,0.9,0.18,0.129375,0.84,99.45
2022-03-11,Bihar,527,7,525,6327,1932,1048,8.33,0,124.8,659735,5570,656133,1.55,0.84,0.05069711538461538,0.84,99.45
2022-03-12,Bihar,1532,17,1532,19356,2802,280,7.91,0,124.8,661267,5587,657665,2.25,0.22,0.15509615384615386,0.84,99.46
2022-03-13,Bihar,1406,9,1398,16924,3392,1166,8.31,0,124.8,662673,5596,659063,2.72,0.93,0.13560897435897437,0.84,99.46
2022-03-14,Bihar,1306,7,1297,16536,756,227,7.9,2,124.8,663979,5603,660360,0.61,0.18,0.1325,0.84,99.45
2022-03-15,Bihar,61,0,53,515,3302,55,11.84,8,124.8,664040,5603,660413,2.65,0.04,0.004126602564102564,0.84,99.45
2022-03-16,Bihar,365,1,360,4383,4717,4650,8.33,4,124.8,664405,5604,660773,3.78,3.73,0.03512019230769231,0.84,99.45
2022-03-17,Bihar,20,0,12,537,282,15,3.72,8,124.8,664425,5604,660785,0.23,0.01,0.0043028846153846155,0.84,99.45
2022-03-18,Bihar,708,2,701,8646,1307,87,8.19,5,124.8,665133,5606,661486,1.05,0.07,0.06927884615384615,0.84,99.45
2022-03-19,Bihar,1201,11,1197,15324,4585,1816,7.84,0,124.8,666334,5617,662683,3.67,1.46,0.12278846153846154,0.84,99.45
2022-03-20,Bihar,138,0,130,1707,4968,524,8.08,8,124.8,666472,5617,662813,3.98,0.42,0.013677884615384616,0.84,99.45
2022-03-21,Bihar,1468,14,1466,18470,1728,515,7.95,0,124.8,667940,5631,664279,1.38,0.41,0.14799679487179487,0.84,99.45
2022-03-22,Bihar,614,7,606,7525,2336,1986,8.16,1,124.8,668554,5638,664885,1.87,1.59,0.06029647435897436,0.84,99.45
2022-03-23,Bihar,1475,14,1469,18390,1117,440,8.02,0,124.8,670029,5652,666354,0.9,0.35,0.14735576923076923,0.84,99.45
2022-03-24,Bihar,504,5,498,6520,3259,2251,7.73,1,124.8,670533,5657,666852,2.61,1.8,0.052243589743589745,0.84,99.45
2022-03-25,Bihar,1521,15,1513,18767,868,350,8.1,0,124.8,672054,5672,668365,0.7,0.28,0.15037660256410257,0.84,99.45
2022-03-26,Bihar,133,0,126,1472,431,64,9.04,7,124.8,672187,5672,668491,0.35,0.05,0.011794871794871795,0.84,99.45
2022-03-27,Bihar,1078,6,1073,13392,3974,1863,8.05,0,124.8,673265,5678,669564,3.18,1.49,0.10730769230769231,0.84,99.45
2022-03-28,Bihar,1200,3,1193,15025,836,703,7.99,4,124.8,674465,5681,670757,0.67,0.56,0.12039262820512821,0.84,99.45
2022-03-29,Bihar,944,12,944,11874,4941,3818,7.95,0,124.8,675409,5693,671701,3.96,3.06,0.09514423076923077,0.84,99.45
2022-03-30,Bihar,1004,9,997,12056,4966,959,8.33,0,124.8,676413,5702,672698,3.98,0.77,0.0966025641025641,0.84,99.45
2022-03-31,Bihar,770,3,767,9550,3159,24,8.06,0,124.8,677183,5705,673465,2.53,0.02,0.0765224358974359,0.84,99.45
2022-04-01,Bihar,249,2,245,3226,3985,1040,7.72,2,124.8,677432,5707,673710,3.19,0.83,0.025849358974358975,0.84,99.45
2022-04-02,Bihar,786,3,777,9557,3162,803,8.22,6,124.8,678218,5710,674487,2.53,0.64,0.07657852564102564,0.84,99.45
2022-04-03,Bihar,1136,8,1131,14335,1379,10,7.92,0,124.8,679354,5718,675618,1.1,0.01,0.11486378205128205,0.84,99.45
2022-04-04,Bihar,1506,13,1498,19420,2453,1047,7.75,0,124.8,680860,5731,677116,1.97,0.84,0.15560897435897436,0.84,99.45
2022-04-05,Bihar,1099,7,1092,14290,3349,88,7.69,0,124.8,681959,5738,678208,2.68,0.07,0.11450320512820512,0.84,99.45
2022-04-06,Bihar,718,2,718,9191,3841,573,7.81,0,124.8,682677,5740,678926,3.08,0.46,0.07364583333333333,0.84,99.45
2022-04-07,Bihar,508,6,504,6074,613,274,8.36,0,124.8,683185,5746,679430,0.49,0.22,0.0486698717948718,0.84,99.45
2022-04-08,Bihar,1031,8,1030,13483,1093,1008,7.65,0,124.8,684216,5754,680460,0.88,0.81,0.10803685897435897,0.84,99.45
2022-04-09,Bihar,363,1,363,4675,2629,816,7.76,0,124.8,684579,5755,680823,2.11,0.65,0.037459935897435896,0.84,99.45
2022-04-10,Bihar,1268,11,1261,15649,4776,3006,8.1,0,124.8,685847,5766,682084,3.83,2.41,0.1253926282051282,0.84,99.45
2022-04-11,Bihar,1221,5,1212,15307,1048,820,7.98,4,124.8,687068,5771,683296,0.84,0.66,0.1226522435897436,0.84,99.45
2022-04-12,Bihar,271,1,267,3076,2914,2903,8.81,3,124.8,687339,5772,683563,2.33,2.33,0.0246474358974359,0.84,99.45
2022-04-13,Bihar,1526,7,1520,19060,2204,313,8.01,0,124.8,688865,5779,685083,1.77,0.25,0.152724358974359,0.84,99.45
2022-04-14,Bihar,344,2,343,4317,579,511,7.97,0,124.8,689209,5781,685426,0.46,0.41,0.03459134615384615,0.84,99.45
2022-04-15,Bihar,478,6,474,5991,3688,3090,7.98,0,124.8,689687,5787,685900,2.96,2.48,0.048004807692307694,0.84,99.45
2022-04-16,Bihar,706,7,700,9301,4827,651,7.59,0,124.8,690393,5794,686600,3.87,0.52,0.0745272435897436,0.84,99.45
2022-04-17,Bihar,1267,9,1264,15416,445,266,8.22,0,124.8,691660,5803,687864,0.36,0.21,0.12352564102564102,0.84,99.45
2022-04-18,Bihar,660,8,654,8292,4937,338,7.96,0,124.8,692320,5811,688518,3.96,0.27,0.06644230769230769,0.84,99.45
2022-04-19,Bihar,481,2,475,6106,935,402,7.88,4,124.8,692801,5813,688993,0.75,0.32,0.04892628205128205,0.84,99.45
2022-04-20,Bihar,1434,14,1425,17945,2144,569,7.99,0,124.8,694235,5827,690418,1.72,0.46,0.1437900641025641,0.84,99.45
2022-04-21,Bihar,200,2,194,2477,4240,3252,8.07,4,124.8,694435,5829,690612,3.4,2.61,0.01984775641025641,0.84,99.45
2022-04-22,Bihar,1548,5,1544,19099,3758,3542,8.11,0,124.8,695983,5834,692156,3.01,2.84,0.15303685897435898,0.84,99.45
2022-04-23,Bihar,1010,8,1007,12544,4893,1846,8.05,0,124.8,696993,5842,693163,3.92,1.48,0.10051282051282051,0.84,99.45
2022-04-24,Bihar,1021,15,1021,12454,1007,86,8.2,0,124.8,698014,5857,694184,0.81,0.07,0.09979166666666667,0.84,99.45
2022-04-25,Bihar,1551,20,1543,19109,3156,996,8.12,0,124.8,699565,5877,695727,2.53,0.8,0.15311698717948719,0.84,99.45
2022-04-26,Bihar,411,2,409,5264,1769,1215,7.81,0,124.8,699976,5879,696136,1.42,0.97,0.04217948717948718,0.84,99.45
2022-04-27,Bihar,781,5,772,9236,1250,822,8.46,4,124.8,700757,5884,696908,1.0,0.66,0.07400641025641026,0.84,99.45
2022-04-28,Bihar,820,8,812,10246,2694,2656,8.0,0,124.8,701577,5892,697720,2.16,2.13,0.08209935897435898,0.84,99.45
2022-04-29,Bihar,341,1,338,4282,4260,1656,7.96,2,124.8,701918,5893,698058,3.41,1.33,0.034310897435897436,0.84,99.45
2022-04-30,Bihar,1194,14,1187,15163,4210,2501,7.87,0,124.8,703112,5907,699245,3.37,2.0,0.12149839743589744,0.84,99.45
2022-05-01,Bihar,219,3,219,2881,2716,2224,7.6,0,124.8,703331,5910,699464,2.18,1.78,0.023084935897435897,0.84,99.45
2022-05-02,Bihar,849,5,847,10187,1597,520,8.33,0,124.8,704180,5915,700311,1.28,0.42,0.08162660256410256,0.84,99.45
2022-05-03,Bihar,529,5,525,6322,1357,684,8.37,0,124.8,704709,5920,700836,1.09,0.55,0.05065705128205128,0.84,99.45
2022-05-04,Bihar,663,5,657,7930,3054,1567,8.36,1,124.8,705372,5925,701493,2.45,1.26,0.06354166666666666,0.84,99.45
2022-05-05,Bihar,1336,14,1331,16619,2870,997,8.04,0,124.8,706708,5939,702824,2.3,0.8,0.1331650641025641,0.84,99.45
2022-05-06,Bihar,823,11,815,10040,4560,1273,8.2,0,124.8,707531,5950,703639,3.65,1.02,0.08044871794871795,0.84,99.45
2022-05-07,Bihar,1557,21,1550,19526,308,85,7.97,0,124.8,709088,5971,705189,0.25,0.07,0.15645833333333334,0.84,99.45
2022-05-08,Bihar,460,3,460,5513,3993,2441,8.34,0,124.8,709548,5974,705649,3.2,1.96,0.044174679487179486,0.84,99.45
2022-05-09,Bihar,157,0,153,2050,3131,1375,7.66,4,124.8,709705,5974,705802,2.51,1.1,0.016426282051282052,0.84,99.45
2022-05-10,Bihar,704,9,698,8881,3231,2396,7.93,0,124.8,710409,5983,706500,2.59,1.92,0.07116185897435898,0.84,99.45
2022-05-11,Bihar,942,4,939,11614,2724,702,8.11,0,124.8,711351,5987,707439,2.18,0.56,0.09306089743589743,0.84,99.45
2022-05-12,Bihar,1456,10,1448,18573,1622,399,7.84,0,124.8,712807,5997,708887,1.3,0.32,0.14882211538461537,0.84,99.45
2022-05-13,Bihar,477,6,474,6124,2945,43,7.79,0,124.8,713284,6003,709361,2.36,0.03,0.04907051282051282,0.84,99.45
2022-05-14,Bihar,1079,5,1073,13258,1895,513,8.14,1,124.8,714363,6008,710434,1.52,0.41,0.10623397435897436,0.84,99.45
2022-05-15,Bihar,969,3,960,11954,2705,1129,8.11,6,124.8,715332,6011,711394,2.17,0.9,0.09578525641025641,0.84,99.45
2022-05-16,Bihar,1379,8,1373,17620,2370,268,7.83,0,124.8,716711,6019,712767,1.9,0.21,0.14118589743589743,0.84,99.45
2022-05-17,Bihar,886,5,883,10631,3455,1176,8.33,0,124.8,717597,6024,713650,2.77,0.94,0.08518429487179487,0.84,99.45
2022-05-18,Bihar,1561,4,1559,19941,879,772,7.83,0,124.8,719158,6028,715209,0.7,0.62,0.15978365384615384,0.84,99.45
2022-05-19,Bihar,875,11,866,10968,724,301,7.98,0,124.8,720033,6039,716075,0.58,0.24,0.08788461538461538,0.84,99.45
2022-05-20,Bihar,857,8,855,10684,3071,184,8.02,0,124.8,720890,6047,716930,2.46,0.15,0.08560897435897435,0.84,99.45
2022-05-21,Bihar,459,2,453,5619,4973,2793,8.17,4,124.8,721349,6049,717383,3.98,2.24,0.04502403846153846,0.84,99.45
2022-05-22,Bihar,1219,3,1213,15530,1880,1447,7.85,3,124.8,722568,6052,718596,1.51,1.16,0.12443910256410257,0.84,99.45
2022-05-23,Bihar,746,3,744,9542,4050,2474,7.82,0,124.8,723314,6055,719340,3.25,1.98,0.07645833333333334,0.84,99.45
2022-05-24,Bihar,1512,18,1510,18815,958,69,8.04,0,124.8,724826,6073,720850,0.77,0.06,0.15076121794871794,0.84,99.45
2022-05-25,Bihar,451,4,449,5662,925,544,7.97,0,124.8,725277,6077,721299,0.74,0.44,0.045368589743589746,0.84,99.45
2022-05-26,Bihar,356,4,354,4281,1257,76,8.32,0,124.8,725633,6081,721653,1.01,0.06,0.03430288461538462,0.84,99.45
2022-05-27,Bihar,1060,9,1060,13250,2642,2498,8.0,0,124.8,726693,6090,722713,2.12,2.0,0.10616987179487179,0.84,99.45
2022-05-28,Bihar,1201,16,1195,15268,1872,961,7.87,0,124.8,727894,6106,723908,1.5,0.77,0.12233974358974359,0.84,99.45
2022-05-29,Bihar,356,2,350,4405,1101,78,8.08,4,124.8,728250,6108,724258,0.88,0.06,0.03529647435897436,0.84,99.45
2022-05-30,Bihar,209,2,208,2523,2054,871,8.28,0,124.8,728459,6110,724466,1.65,0.7,0.020216346153846154,0.84,99.45
2022-05-31,Bihar,350,4,342,4636,872,455,7.55,4,124.8,728809,6114,724808,0.7,0.36,0.037147435897435896,0.84,99.45
2022-06-01,Bihar,457,2,451,6116,2286,989,7.47,4,124.8,729266,6116,725259,1.83,0.79,0.049006410256410254,0.84,99.45
2022-06-02,Bihar,1110,6,1105,13897,681,447,7.99,0,124.8,730376,6122,726364,0.55,0.36,0.11135416666666667,0.84,99.45
2022-06-03,Bihar,52,0,45,747,1717,114,6.96,7,124.8,730428,6122,726409,1.38,0.09,0.005985576923076923,0.84,99.45
2022-06-04,Bihar,569,4,566,6973,937,251,8.16,0,124.8,730997,6126,726975,0.75,0.2,0.055873397435897434,0.84,99.45
2022-06-05,Bihar,473,1,467,5747,2783,2526,8.23,5,124.8,731470,6127,727442,2.23,2.02,0.04604967948717949,0.84,99.45
2022-06-06,Bihar,943,8,934,11445,3356,281,8.24,1,124.8,732413,6135,728376,2.69,0.23,0.09170673076923076,0.84,99.45
2022-06-07,Bihar,168,1,160,1716,1028,160,9.79,7,124.8,732581,6136,728536,0.82,0.13,0.01375,0.84,99.45
2022-06-08,Bihar,239,1,236,3329,4416,2720,7.18,2,124.8,732820,6137,728772,3.54,2.18,0.026674679487179487,0.84,99.45
2022-06-09,Bihar,1394,4,1391,17610,2351,80,7.92,0,124.8,734214,6141,730163,1.88,0.06,0.14110576923076923,0.84,99.45
2022-06-10,Bihar,1458,6,1452,18378,2835,462,7.93,0,124.8,735672,6147,731615,2.27,0.37,0.14725961538461538,0.84,99.45
2022-06-11,Bihar,965,11,957,12051,4999,2671,8.01,0,124.8,736637,6158,732572,4.01,2.14,0.0965625,0.84,99.45
2022-06-12,Bihar,600,7,600,7210,4084,3881,8.32,0,124.8,737237,6165,733172,3.27,3.11,0.0577724358974359,0.84,99.45
2022-06-13,Bihar,515,5,506,6092,3151,2815,8.45,4,124.8,737752,6170,733678,2.52,2.26,0.04881410256410256,0.84,99.45
2022-06-14,Bihar,562,3,557,6563,2324,832,8.56,2,124.8,738314,6173,734235,1.86,0.67,0.05258814102564103,0.84,99.45
2022-06-15,Bihar,802,6,795,10084,4902,1716,7.95,1,124.8,739116,6179,735030,3.93,1.38,0.08080128205128205,0.84,99.45
2022-06-16,Bihar,1310,10,1308,16117,2034,1845,8.13,0,124.8,740426,6189,736338,1.63,1.48,0.1291426282051282,0.84,99.45
2022-06-17,Bihar,758,3,757,9202,4677,707,8.24,0,124.8,741184,6192,737095,3.75,0.57,0.07373397435897436,0.84,99.45
2022-06-18,Bihar,1326,9,1317,16574,3876,2384,8.0,0,124.8,742510,6201,738412,3.11,1.91,0.13280448717948717,0.84,99.45
2022-06-19,Bihar,1376,16,1376,17000,731,318,8.09,0,124.8,743886,6217,739788,0.59,0.25,0.1362179487179487,0.84,99.45
2022-06-20,Bihar,1383,10,1382,16627,4953,884,8.32,0,124.8,745269,6227,741170,3.97,0.71,0.13322916666666668,0.84,99.45
2022-06-21,Bihar,1338,18,1338,16464,1092,197,8.13,0,124.8,746607,6245,742508,0.88,0.16,0.13192307692307692,0.84,99.45
2022-06-22,Bihar,962,12,953,11992,3585,702,8.02,0,124.8,747569,6257,743461,2.87,0.56,0.09608974358974359,0.84,99.45
2022-06-23,Bihar,675,9,670,8265,2935,2363,8.17,0,124.8,748244,6266,744131,2.35,1.89,0.06622596153846154,0.84,99.45
2022-06-24,Bihar,1138,4,1137,13885,2768,1120,8.2,0,124.8,749382,6270,745268,2.22,0.9,0.11125801282051281,0.84,99.45
2022-06-25,Bihar,970,6,968,11904,3947,3517,8.15,0,124.8,750352,6276,746236,3.16,2.82,0.09538461538461539,0.84,99.45
2022-06-26,Bihar,425,6,420,5341,814,291,7.96,0,124.8,750777,6282,746656,0.65,0.23,0.04279647435897436,0.84,99.45
2022-06-27,Bihar,152,1,145,2019,4262,1861,7.53,6,124.8,750929,6283,746801,3.42,1.49,0.016177884615384615,0.84,99.45
2022-06-28,Bihar,917,12,917,11513,2429,805,7.96,0,124.8,751846,6295,747718,1.95,0.65,0.09225160256410256,0.84,99.45
2022-06-29,Bihar,998,10,993,12507,337,326,7.98,0,124.8,752844,6305,748711,0.27,0.26,0.10021634615384616,0.84,99.45
2022-06-30,Bihar,967,4,959,12273,3873,3138,7.88,4,124.8,753811,6309,749670,3.1,2.51,0.09834134615384615,0.84,99.45
2022-07-01,Bihar,1587,5,1578,19648,4122,81,8.08,4,124.8,755398,6314,751248,3.3,0.06,0.15743589743589745,0.84,99.45
2022-07-02,Bihar,499,7,495,6420,1219,1078,7.77,0,124.8,755897,6321,751743,0.98,0.86,0.05144230769230769,0.84,99.45
2022-07-03,Bihar,1044,4,1035,13161,3431,801,7.93,5,124.8,756941,6325,752778,2.75,0.64,0.10545673076923077,0.84,99.45
2022-07-04,Bihar,1081,8,1080,13356,4796,1223,8.09,0,124.8,758022,6333,753858,3.84,0.98,0.10701923076923077,0.84,99.45
2022-07-05,Bihar,148,1,143,2073,1254,326,7.14,4,124.8,758170,6334,754001,1.0,0.26,0.016610576923076922,0.84,99.45
2022-07-06,Bihar,107,0,98,1119,2553,1907,9.56,9,124.8,758277,6334,754099,2.05,1.53,0.008966346153846155,0.84,99.45
2022-07-07,Bihar,703,7,697,8926,4657,512,7.88,0,124.8,758980,6341,754796,3.73,0.41,0.0715224358974359,0.84,99.45
2022-07-08,Bihar,837,4,834,10533,1244,910,7.95,0,124.8,759817,6345,755630,1.0,0.73,0.08439903846153846,0.84,99.45
2022-07-09,Bihar,1311,8,1306,16414,2858,1517,7.99,0,124.8,761128,6353,756936,2.29,1.22,0.1315224358974359,0.83,99.45
2022-07-10,Bihar,1491,7,1485,18088,3913,2690,8.24,0,124.8,762619,6360,758421,3.14,2.16,0.14493589743589744,0.83,99.45
2022-07-11,Bihar,1484,14,1482,18710,1790,1223,7.93,0,124.8,764103,6374,759903,1.43,0.98,0.1499198717948718,0.83,99.45
2022-07-12,Bihar,179,2,172,2307,4532,60,7.76,5,124.8,764282,6376,760075,3.63,0.05,0.018485576923076924,0.83,99.45
2022-07-13,Bihar,89,1,86,1757,704,304,5.07,2,124.8,764371,6377,760161,0.56,0.24,0.01407852564102564,0.83,99.45
2022-07-14,Bihar,302,4,298,4039,3509,2210,7.48,0,124.8,764673,6381,760459,2.81,1.77,0.03236378205128205,0.83,99.45
2022-07-15,Bihar,733,9,727,9267,4759,2435,7.91,0,124.8,765406,6390,761186,3.81,1.95,0.07425480769230769,0.83,99.45
2022-07-16,Bihar,1028,5,1019,12983,771,419,7.92,4,124.8,766434,6395,762205,0.62,0.34,0.10403044871794871,0.83,99.45
2022-07-17,Bihar,1320,15,1313,16695,2024,1271,7.91,0,124.8,767754,6410,763518,1.62,1.02,0.13377403846153846,0.83,99.45
2022-07-18,Bihar,947,12,942,12223,821,797,7.75,0,124.8,768701,6422,764460,0.66,0.64,0.09794070512820513,0.84,99.45
2022-07-19,Bihar,785,6,780,9560,2382,491,8.21,0,124.8,769486,6428,765240,1.91,0.39,0.07660256410256411,0.84,99.45
2022-07-20,Bihar,839,5,830,10122,1754,1169,8.29,4,124.8,770325,6433,766070,1.41,0.94,0.08110576923076923,0.84,99.45
2022-07-21,Bihar,997,10,991,12300,2086,1110,8.11,0,124.8,771322,6443,767061,1.67,0.89,0.0985576923076923,0.84,99.45
2022-07-22,Bihar,438,3,433,5533,4447,3292,7.92,2,124.8,771760,6446,767494,3.56,2.64,0.044334935897435895,0.84,99.45
2022-07-23,Bihar,1547,16,1543,19257,2426,424,8.03,0,124.8,773307,6462,769037,1.94,0.34,0.1543028846153846,0.84,99.45
2022-07-24,Bihar,1448,9,1443,18056,4549,3191,8.02,0,124.8,774755,6471,770480,3.65,2.56,0.14467948717948717,0.84,99.45
2022-07-25,Bihar,339,1,331,4133,3117,1495,8.2,7,124.8,775094,6472,770811,2.5,1.2,0.03311698717948718,0.83,99.45
2022-07-26,Bihar,361,5,353,4268,4710,2364,8.46,3,124.8,775455,6477,771164,3.77,1.89,0.03419871794871795,0.84,99.45
2022-07-27,Bihar,536,7,532,7055,1164,727,7.6,0,124.8,775991,6484,771696,0.93,0.58,0.05653044871794872,0.84,99.45
2022-07-28,Bihar,535,4,535,6718,251,98,7.96,0,124.8,776526,6488,772231,0.2,0.08,0.053830128205128204,0.84,99.45
2022-07-29,Bihar,631,7,622,8181,2713,1175,7.71,2,124.8,777157,6495,772853,2.17,0.94,0.06555288461538461,0.84,99.45
2022-07-30,Bihar,753,10,752,9265,104,17,8.13,0,124.8,777910,6505,773605,0.08,0.01,0.07423878205128205,0.84,99.45
2022-07-31,Bihar,1233,4,1232,15102,2271,995,8.16,0,124.8,779143,6509,774837,1.82,0.8,0.12100961538461538,0.84,99.45
2022-08-01,Bihar,1342,4,1342,16710,2333,1534,8.03,0,124.8,780485,6513,776179,1.87,1.23,0.13389423076923077,0.83,99.45
2022-08-02,Bihar,112,1,104,1144,757,168,9.79,7,124.8,780597,6514,776283,0.61,0.13,0.009166666666666667,0.83,99.45
2022-08-03,Bihar,1219,16,1210,14916,209,159,8.17,0,124.8,781816,6530,777493,0.17,0.13,0.11951923076923077,0.84,99.45
2022-08-04,Bihar,260,1,251,3565,2672,1837,7.29,8,124.8,782076,6531,777744,2.14,1.47,0.028565705128205127,0.84,99.45
2022-08-05,Bihar,1091,10,1085,13077,3030,873,8.34,0,124.8,783167,6541,778829,2.43,0.7,0.10478365384615385,0.84,99.45
2022-08-06,Bihar,1545,15,1545,19594,1280,186,7.89,0,124.8,784712,6556,780374,1.03,0.15,0.15700320512820512,0.84,99.45
2022-08-07,Bihar,511,5,502,6693,224,71,7.63,4,124.8,785223,6561,780876,0.18,0.06,0.05362980769230769,0.84,99.45
2022-08-08,Bihar,215,1,209,3121,1259,800,6.89,5,124.8,785438,6562,781085,1.01,0.64,0.02500801282051282,0.84,99.45
2022-08-09,Bihar,1408,7,1408,17631,2400,1903,7.99,0,124.8,786846,6569,782493,1.92,1.52,0.14127403846153846,0.83,99.45
2022-08-10,Bihar,1376,18,1371,17351,4393,3235,7.93,0,124.8,788222,6587,783864,3.52,2.59,0.13903044871794873,0.84,99.45
2022-08-11,Bihar,757,3,749,9496,4285,2029,7.97,5,124.8,788979,6590,784613,3.43,1.63,0.07608974358974359,0.84,99.45
2022-08-12,Bihar,75,1,74,1196,2584,1209,6.27,0,124.8,789054,6591,784687,2.07,0.97,0.009583333333333333,0.84,99.45
2022-08-13,Bihar,330,1,323,3977,1923,301,8.3,6,124.8,789384,6592,785010,1.54,0.24,0.03186698717948718,0.84,99.45
2022-08-14,Bihar,871,12,866,10807,369,9,8.06,0,124.8,790255,6604,785876,0.3,0.01,0.08659455128205128,0.84,99.45
2022-08-15,Bihar,670,3,667,8281,2763,589,8.09,0,124.8,790925,6607,786543,2.21,0.47,0.06635416666666667,0.84,99.45
2022-08-16,Bihar,632,8,624,7587,2738,321,8.33,0,124.8,791557,6615,787167,2.19,0.26,0.060793269230769234,0.84,99.45
2022-08-17,Bihar,727,4,719,9252,4127,970,7.86,4,124.8,792284,6619,787886,3.31,0.78,0.07413461538461538,0.84,99.44
2022-08-18,Bihar,545,4,538,6743,1961,380,8.08,3,124.8,792829,6623,788424,1.57,0.3,0.054030448717948716,0.84,99.44
2022-08-19,Bihar,741,5,741,9095,3113,238,8.15,0,124.8,793570,6628,789165,2.49,0.19,0.07287660256410257,0.84,99.44
2022-08-20,Bihar,574,3,565,7232,321,187,7.94,6,124.8,794144,6631,789730,0.26,0.15,0.05794871794871795,0.83,99.44
2022-08-21,Bihar,704,5,696,8837,4250,1612,7.97,3,124.8,794848,6636,790426,3.41,1.29,0.07080929487179487,0.83,99.44
2022-08-22,Bihar,1347,8,1342,16732,3660,1683,8.05,0,124.8,796195,6644,791768,2.93,1.35,0.13407051282051283,0.83,99.44
2022-08-23,Bihar,960,9,952,12011,2253,380,7.99,0,124.8,797155,6653,792720,1.81,0.3,0.09624198717948718,0.83,99.44
2022-08-24,Bihar,1405,13,1402,17656,525,231,7.96,0,124.8,798560,6666,794122,0.42,0.19,0.14147435897435898,0.83,99.44
2022-08-25,Bihar,222,1,221,2515,4530,1808,8.83,0,124.8,798782,6667,794343,3.63,1.45,0.02015224358974359,0.83,99.44
2022-08-26,Bihar,817,2,815,9925,437,28,8.23,0,124.8,799599,6669,795158,0.35,0.02,0.07952724358974358,0.83,99.44
2022-08-27,Bihar,576,5,568,7438,2495,1819,7.74,3,124.8,800175,6674,795726,2.0,1.46,0.059599358974358974,0.83,99.44
2022-08-28,Bihar,447,5,442,6208,2441,1531,7.2,0,124.8,800622,6679,796168,1.96,1.23,0.04974358974358974,0.83,99.44
2022-08-29,Bihar,24,0,16,879,850,556,2.73,8,124.8,800646,6679,796184,0.68,0.45,0.0070432692307692306,0.83,99.44
2022-08-30,Bihar,620,3,616,7736,491,343,8.01,1,124.8,801266,6682,796800,0.39,0.27,0.06198717948717949,0.83,99.44
2022-08-31,Bihar,729,10,728,8838,2380,2117,8.25,0,124.8,801995,6692,797528,1.91,1.7,0.0708173076923077,0.83,99.44
2022-09-01,Bihar,425,1,418,5459,208,81,7.79,6,124.8,802420,6693,797946,0.17,0.06,0.04374198717948718,0.83,99.44
2022-09-02,Bihar,993,7,984,12260,4165,3484,8.1,2,124.8,803413,6700,798930,3.34,2.79,0.09823717948717949,0.83,99.44
2022-09-03,Bihar,1396,8,1395,17504,3415,912,7.98,0,124.8,804809,6708,800325,2.74,0.73,0.14025641025641025,0.83,99.44
2022-09-04,Bihar,627,3,624,8046,1096,182,7.79,0,124.8,805436,6711,800949,0.88,0.15,0.06447115384615384,0.83,99.44
2022-09-05,Bihar,1010,6,1006,12833,878,182,7.87,0,124.8,806446,6717,801955,0.7,0.15,0.10282852564102564,0.83,99.44
2022-09-06,Bihar,706,8,704,8592,2538,907,8.22,0,124.8,807152,6725,802659,2.03,0.73,0.06884615384615385,0.83,99.44
2022-09-07,Bihar,1356,13,1347,16748,392,230,8.1,0,124.8,808508,6738,804006,0.31,0.18,0.13419871794871796,0.83,99.44
2022-09-08,Bihar,446,5,439,5785,3270,2305,7.71,2,124.8,808954,6743,804445,2.62,1.85,0.04635416666666667,0.83,99.44
2022-09-09,Bihar,365,3,363,4278,4513,3438,8.53,0,124.8,809319,6746,804808,3.62,2.75,0.03427884615384615,0.83,99.44
2022-09-10,Bihar,413,1,410,5326,2674,118,7.75,2,124.8,809732,6747,805218,2.14,0.09,0.04267628205128205,0.83,99.44
2022-09-11,Bihar,397,4,397,4703,3425,577,8.44,0,124.8,810129,6751,805615,2.74,0.46,0.03768429487179487,0.83,99.44
2022-09-12,Bihar,505,6,502,6158,1070,477,8.2,0,124.8,810634,6757,806117,0.86,0.38,0.04934294871794872,0.83,99.44
2022-09-13,Bihar,965,12,965,12366,3566,2495,7.8,0,124.8,811599,6769,807082,2.86,2.0,0.09908653846153846,0.83,99.44
2022-09-14,Bihar,1491,9,1489,18504,1492,40,8.06,0,124.8,813090,6778,808571,1.2,0.03,0.14826923076923076,0.83,99.44
2022-09-15,Bihar,1552,6,1543,19525,1070,198,7.95,3,124.8,814642,6784,810114,0.86,0.16,0.1564503205128205,0.83,99.44
2022-09-16,Bihar,1127,4,1119,13838,287,122,8.14,4,124.8,815769,6788,811233,0.23,0.1,0.11088141025641025,0.83,99.44
2022-09-17,Bihar,1011,12,1009,12448,427,308,8.12,0,124.8,816780,6800,812242,0.34,0.25,0.09974358974358974,0.83,99.44
2022-09-18,Bihar,99,0,91,913,3292,1166,10.84,8,124.8,816879,6800,812333,2.64,0.93,0.007315705128205128,0.83,99.44
2022-09-19,Bihar,1490,4,1490,18992,4487,729,7.85,0,124.8,818369,6804,813823,3.6,0.58,0.15217948717948718,0.83,99.44
2022-09-20,Bihar,416,1,410,5091,3953,3198,8.17,5,124.8,818785,6805,814233,3.17,2.56,0.04079326923076923,0.83,99.44
2022-09-21,Bihar,1000,7,998,12868,828,597,7.77,0,124.8,819785,6812,815231,0.66,0.48,0.10310897435897436,0.83,99.44
2022-09-22,Bihar,967,5,963,12466,2687,985,7.76,0,124.8,820752,6817,816194,2.15,0.79,0.09988782051282051,0.83,99.44
2022-09-23,Bihar,436,5,431,5546,2805,116,7.86,0,124.8,821188,6822,816625,2.25,0.09,0.044439102564102564,0.83,99.44
2022-09-24,Bihar,29,0,20,667,1704,842,4.35,9,124.8,821217,6822,816645,1.37,0.67,0.005344551282051282,0.83,99.44
2022-09-25,Bihar,975,6,967,12634,3659,713,7.72,2,124.8,822192,6828,817612,2.93,0.57,0.10123397435897435,0.83,99.44
2022-09-26,Bihar,1307,17,1302,16400,3524,2245,7.97,0,124.8,823499,6845,818914,2.82,1.8,0.13141025641025642,0.83,99.44
2022-09-27,Bihar,736,8,731,9136,2789,2323,8.06,0,124.8,824235,6853,819645,2.23,1.86,0.0732051282051282,0.83,99.44
2022-09-28,Bihar,1551,20,1545,19474,4465,3819,7.96,0,124.8,825786,6873,821190,3.58,3.06,0.15604166666666666,0.83,99.44
2022-09-29,Bihar,638,8,632,7927,828,89,8.05,0,124.8,826424,6881,821822,0.66,0.07,0.0635176282051282,0.83,99.44
2022-09-30,Bihar,1118,6,1114,13894,27,14,8.05,0,124.8,827542,6887,822936,0.02,0.01,0.1113301282051282,0.83,99.44
2022-10-01,Bihar,1419,11,1412,17823,572,222,7.96,0,124.8,828961,6898,824348,0.46,0.18,0.1428125,0.83,99.44
2022-10-02,Bihar,1370,8,1369,17118,835,686,8.0,0,124.8,830331,6906,825717,0.67,0.55,0.13716346153846154,0.83,99.44
2022-10-03,Bihar,138,1,135,1878,3751,1426,7.35,2,124.8,830469,6907,825852,3.01,1.14,0.015048076923076923,0.83,99.44
2022-10-04,Bihar,1282,15,1275,15745,2676,633,8.14,0,124.8,831751,6922,827127,2.14,0.51,0.12616185897435897,0.83,99.44
2022-10-05,Bihar,312,2,306,4013,1547,723,7.77,4,124.8,832063,6924,827433,1.24,0.58,0.03215544871794872,0.83,99.44
2022-10-06,Bihar,79,0,72,1261,1756,1439,6.26,7,124.8,832142,6924,827505,1.41,1.15,0.010104166666666666,0.83,99.44
2022-10-07,Bihar,834,5,830,10552,1634,1474,7.9,0,124.8,832976,6929,828335,1.31,1.18,0.08455128205128205,0.83,99.44
2022-10-08,Bihar,1547,4,1544,19489,2960,2470,7.94,0,124.8,834523,6933,829879,2.37,1.98,0.15616185897435897,0.83,99.44
2022-10-09,Bihar,273,3,269,3555,464,369,7.68,1,124.8,834796,6936,830148,0.37,0.3,0.028485576923076922,0.83,99.44
2022-10-10,Bihar,371,4,369,4583,4100,1110,8.1,0,124.8,835167,6940,830517,3.29,0.89,0.03672275641025641,0.83,99.44
2022-10-11,Bihar,720,10,714,9027,798,482,7.98,0,124.8,835887,6950,831231,0.64,0.39,0.07233173076923077,0.83,99.44
2022-10-12,Bihar,976,7,969,11871,1666,736,8.22,0,124.8,836863,6957,832200,1.33,0.59,0.09512019230769231,0.83,99.44
2022-10-13,Bihar,68,0,68,996,4117,3911,6.83,0,124.8,836931,6957,832268,3.3,3.13,0.00798076923076923,0.83,99.44
2022-10-14,Bihar,283,2,275,3538,246,10,8.0,6,124.8,837214,6959,832543,0.2,0.01,0.028349358974358974,0.83,99.44
2022-10-15,Bihar,1379,11,1373,17094,1112,628,8.07,0,124.8,838593,6970,833916,0.89,0.5,0.13697115384615385,0.83,99.44
2022-10-16,Bihar,609,3,602,7495,2984,872,8.13,4,124.8,839202,6973,834518,2.39,0.7,0.060056089743589745,0.83,99.44
2022-10-17,Bihar,406,2,398,5113,1196,1147,7.94,6,124.8,839608,6975,834916,0.96,0.92,0.040969551282051285,0.83,99.44
2022-10-18,Bihar,396,5,390,4724,3379,2714,8.38,1,124.8,840004,6980,835306,2.71,2.17,0.0378525641025641,0.83,99.44
2022-10-19,Bihar,40,0,38,735,2503,1469,5.44,2,124.8,840044,6980,835344,2.01,1.18,0.005889423076923077,0.83,99.44
2022-10-20,Bihar,1032,7,1024,12874,3090,1905,8.02,1,124.8,841076,6987,836368,2.48,1.53,0.10315705128205128,0.83,99.44
2022-10-21,Bihar,473,5,471,6337,3114,596,7.46,0,124.8,841549,6992,836839,2.5,0.48,0.05077724358974359,0.83,99.44
2022-10-22,Bihar,1144,4,1143,14103,4361,1184,8.11,0,124.8,842693,6996,837982,3.49,0.95,0.1130048076923077,0.83,99.44
2022-10-23,Bihar,1183,8,1177,14659,1586,584,8.07,0,124.8,843876,7004,839159,1.27,0.47,0.11745993589743589,0.83,99.44
2022-10-24,Bihar,806,6,803,10104,3322,1819,7.98,0,124.8,844682,7010,839962,2.66,1.46,0.08096153846153846,0.83,99.44
2022-10-25,Bihar,1556,12,1555,19342,901,901,8.04,0,124.8,846238,7022,841517,0.72,0.72,0.15498397435897435,0.83,99.44
2022-10-26,Bihar,1123,9,1115,13941,4088,1785,8.06,0,124.8,847361,7031,842632,3.28,1.43,0.11170673076923077,0.83,99.44
2022-10-27,Bihar,571,1,562,7535,4512,4280,7.58,8,124.8,847932,7032,843194,3.62,3.43,0.060376602564102565,0.83,99.44
2022-10-28,Bihar,1351,18,1348,17088,1251,1238,7.91,0,124.8,849283,7050,844542,1.0,0.99,0.13692307692307693,0.83,99.44
2022-10-29,Bihar,1548,10,1548,18907,1339,653,8.19,0,124.8,850831,7060,846090,1.07,0.52,0.15149839743589744,0.83,99.44
2022-10-30,Bihar,938,3,932,12211,1726,869,7.68,3,124.8,851769,7063,847022,1.38,0.7,0.09784455128205129,0.83,99.44
2022-10-31,Bihar,913,8,907,11582,3110,1685,7.88,0,124.8,852682,7071,847929,2.49,1.35,0.09280448717948718,0.83,99.44
2022-11-01,Bihar,1047,8,1044,13284,4996,2938,7.88,0,124.8,853729,7079,848973,4.0,2.35,0.1064423076923077,0.83,99.44
2022-11-02,Bihar,127,1,118,1500,141,14,8.47,8,124.8,853856,7080,849091,0.11,0.01,0.01201923076923077,0.83,99.44
2022-11-03,Bihar,1581,23,1572,19673,1278,306,8.04,0,124.8,855437,7103,850663,1.02,0.25,0.15763621794871796,0.83,99.44
2022-11-04,Bihar,1142,9,1134,14040,3715,2524,8.13,0,124.8,856579,7112,851797,2.98,2.02,0.1125,0.83,99.44
2022-11-05,Bihar,1099,3,1094,13699,1143,923,8.02,2,124.8,857678,7115,852891,0.92,0.74,0.10976762820512821,0.83,99.44
2022-11-06,Bihar,537,1,532,6479,4439,2009,8.29,4,124.8,858215,7116,853423,3.56,1.61,0.0519150641025641,0.83,99.44
2022-11-07,Bihar,874,2,867,11160,3559,3238,7.83,5,124.8,859089,7118,854290,2.85,2.59,0.08942307692307692,0.83,99.44
2022-11-08,Bihar,154,0,150,1818,3686,2577,8.47,4,124.8,859243,7118,854440,2.95,2.06,0.014567307692307692,0.83,99.44
2022-11-09,Bihar,86,1,86,1815,2105,1102,4.74,0,124.8,859329,7119,854526,1.69,0.88,0.014543269230769231,0.83,99.44
2022-11-10,Bihar,1423,20,1418,17704,4790,52,8.04,0,124.8,860752,7139,855944,3.84,0.04,0.14185897435897435,0.83,99.44
2022-11-11,Bihar,1309,16,1303,15636,3343,393,8.37,0,124.8,862061,7155,857247,2.68,0.31,0.12528846153846154,0.83,99.44
2022-11-12,Bihar,138,1,132,2075,212,212,6.65,5,124.8,862199,7156,857379,0.17,0.17,0.016626602564102564,0.83,99.44
2022-11-13,Bihar,621,7,615,7705,2031,113,8.06,0,124.8,862820,7163,857994,1.63,0.09,0.061738782051282054,0.83,99.44
2022-11-14,Bihar,882,8,875,10851,1947,202,8.13,0,124.8,863702,7171,858869,1.56,0.16,0.08694711538461539,0.83,99.44
2022-11-15,Bihar,244,3,243,2908,374,130,8.39,0,124.8,863946,7174,859112,0.3,0.1,0.02330128205128205,0.83,99.44
2022-11-16,Bihar,319,3,313,4106,2975,1264,7.77,3,124.8,864265,7177,859425,2.38,1.01,0.032900641025641025,0.83,99.44
2022-11-17,Bihar,1148,15,1148,14126,3621,1847,8.13,0,124.8,865413,7192,860573,2.9,1.48,0.11318910256410257,0.83,99.44
2022-11-18,Bihar,988,10,979,12547,4171,1042,7.87,0,124.8,866401,7202,861552,3.34,0.83,0.10053685897435898,0.83,99.44
2022-11-19,Bihar,445,6,436,5449,470,143,8.17,3,124.8,866846,7208,861988,0.38,0.11,0.04366185897435897,0.83,99.44
2022-11-20,Bihar,625,3,623,7759,3977,3611,8.06,0,124.8,867471,7211,862611,3.19,2.89,0.06217147435897436,0.83,99.44
2022-11-21,Bihar,607,8,605,7586,615,124,8.0,0,124.8,868078,7219,863216,0.49,0.1,0.06078525641025641,0.83,99.44
2022-11-22,Bihar,1224,15,1216,15599,1854,1586,7.85,0,124.8,869302,7234,864432,1.49,1.27,0.12499198717948717,0.83,99.44
2022-11-23,Bihar,241,2,234,3073,1442,0,7.84,5,124.8,869543,7236,864666,1.16,0.0,0.024623397435897434,0.83,99.44
2022-11-24,Bihar,951,6,942,12166,2819,112,7.82,3,124.8,870494,7242,865608,2.26,0.09,0.09748397435897437,0.83,99.44
2022-11-25,Bihar,702,3,694,8585,165,159,8.18,5,124.8,871196,7245,866302,0.13,0.13,0.06879006410256411,0.83,99.44
2022-11-26,Bihar,271,0,269,3581,46,21,7.57,2,124.8,871467,7245,866571,0.04,0.02,0.028693910256410257,0.83,99.44
2022-11-27,Bihar,157,1,155,2036,235,111,7.71,1,124.8,871624,7246,866726,0.19,0.09,0.016314102564102564,0.83,99.44
2022-11-28,Bihar,1321,17,1314,16426,30,15,8.04,0,124.8,872945,7263,868040,0.02,0.01,0.13161858974358975,0.83,99.44
2022-11-29,Bihar,340,2,331,3518,1953,1836,9.66,7,124.8,873285,7265,868371,1.56,1.47,0.028189102564102564,0.83,99.44
2022-11-30,Bihar,123,1,114,1414,4765,1482,8.7,8,124.8,873408,7266,868485,3.82,1.19,0.011330128205128204,0.83,99.44
2022-12-01,Bihar,1306,7,1300,16820,268,69,7.76,0,124.8,874714,7273,869785,0.21,0.06,0.13477564102564102,0.83,99.44
2022-12-02,Bihar,233,1,224,3079,2667,469,7.57,8,124.8,874947,7274,870009,2.14,0.38,0.02467147435897436,0.83,99.44
2022-12-03,Bihar,1527,11,1520,19206,2254,851,7.95,0,124.8,876474,7285,871529,1.81,0.68,0.15389423076923076,0.83,99.44
2022-12-04,Bihar,1078,5,1070,13342,1480,150,8.08,3,124.8,877552,7290,872599,1.19,0.12,0.10690705128205129,0.83,99.44
2022-12-05,Bihar,1287,3,1286,15954,1836,37,8.07,0,124.8,878839,7293,873885,1.47,0.03,0.12783653846153847,0.83,99.44
2022-12-06,Bihar,748,6,745,9553,4029,1292,7.83,0,124.8,879587,7299,874630,3.23,1.04,0.07654647435897435,0.83,99.44
2022-12-07,Bihar,1333,10,1332,16431,3587,2413,8.11,0,124.8,880920,7309,875962,2.87,1.93,0.13165865384615386,0.83,99.44
2022-12-08,Bihar,1154,17,1154,14658,257,170,7.87,0,124.8,882074,7326,877116,0.21,0.14,0.11745192307692308,0.83,99.44
2022-12-09,Bihar,1217,3,1208,14663,2524,2310,8.3,6,124.8,883291,7329,878324,2.02,1.85,0.11749198717948718,0.83,99.44
2022-12-10,Bihar,1125,12,1125,13503,4684,3244,8.33,0,124.8,884416,7341,879449,3.75,2.6,0.10819711538461538,0.83,99.44
2022-12-11,Bihar,604,4,599,7477,1511,384,8.08,1,124.8,885020,7345,880048,1.21,0.31,0.059911858974358974,0.83,99.44
2022-12-12,Bihar,800,5,797,9842,3602,600,8.13,0,124.8,885820,7350,880845,2.89,0.48,0.07886217948717948,0.83,99.44
2022-12-13,Bihar,746,3,737,9513,4652,1942,7.84,6,124.8,886566,7353,881582,3.73,1.56,0.07622596153846153,0.83,99.44
2022-12-14,Bihar,1152,12,1151,14317,4820,4382,8.05,0,124.8,887718,7365,882733,3.86,3.51,0.11471955128205129,0.83,99.44
2022-12-15,Bihar,1258,4,1252,15687,3660,3270,8.02,2,124.8,888976,7369,883985,2.93,2.62,0.1256971153846154,0.83,99.44
2022-12-16,Bihar,838,9,835,10706,559,449,7.83,0,124.8,889814,7378,884820,0.45,0.36,0.08578525641025642,0.83,99.44
2022-12-17,Bihar,1466,9,1464,18882,1050,159,7.76,0,124.8,891280,7387,886284,0.84,0.13,0.15129807692307692,0.83,99.44
2022-12-18,Bihar,1366,5,1359,16945,617,90,8.06,2,124.8,892646,7392,887643,0.49,0.07,0.13577724358974358,0.83,99.44
2022-12-19,Bihar,1162,11,1162,14683,235,115,7.91,0,124.8,893808,7403,888805,0.19,0.09,0.11765224358974359,0.83,99.44
2022-12-20,Bihar,386,4,386,4465,3910,2085,8.65,0,124.8,894194,7407,889191,3.13,1.67,0.03577724358974359,0.83,99.44
2022-12-21,Bihar,182,2,181,2379,3877,1881,7.65,0,124.8,894376,7409,889372,3.11,1.51,0.0190625,0.83,99.44
2022-12-22,Bihar,155,2,147,1620,222,203,9.57,6,124.8,894531,7411,889519,0.18,0.16,0.012980769230769231,0.83,99.44
2022-12-23,Bihar,511,4,508,6325,1923,1205,8.08,0,124.8,895042,7415,890027,1.54,0.97,0.050681089743589744,0.83,99.44
2022-12-24,Bihar,47,0,46,742,2430,161,6.33,1,124.8,895089,7415,890073,1.95,0.13,0.005945512820512821,0.83,99.44
2022-12-25,Bihar,449,5,441,5523,89,55,8.13,3,124.8,895538,7420,890514,0.07,0.04,0.04425480769230769,0.83,99.44
2022-12-26,Bihar,1439,19,1436,17842,4913,929,8.07,0,124.8,896977,7439,891950,3.94,0.74,0.1429647435897436,0.83,99.44
2022-12-27,Bihar,1305,19,1305,16499,1798,285,7.91,0,124.8,898282,7458,893255,1.44,0.23,0.13220352564102564,0.83,99.44
2022-12-28,Bihar,680,6,672,8365,2594,945,8.13,2,124.8,898962,7464,893927,2.08,0.76,0.06702724358974359,0.83,99.44
2022-12-29,Bihar,491,2,485,6185,4788,3691,7.94,4,124.8,899453,7466,894412,3.84,2.96,0.04955929487179487,0.83,99.44
2022-12-30,Bihar,207,1,198,2804,1206,390,7.38,8,124.8,899660,7467,894610,0.97,0.31,0.02246794871794872,0.83,99.44
2022-12-31,Bihar,1267,18,1259,15448,3092,2630,8.2,0,124.8,900927,7485,895869,2.48,2.11,0.12378205128205128,0.83,99.44
2020-01-01,Chhattisgarh,443,2,442,5125,4208,3107,8.64,0,32.7,443,2,442,12.87,9.5,0.15672782874617736,0.45,99.77
2020-01-02,Chhattisgarh,543,4,538,6835,4862,3205,7.94,1,32.7,986,6,980,14.87,9.8,0.20902140672782873,0.61,99.39
2020-01-03,Chhattisgarh,1011,9,1009,13076,3283,3059,7.73,0,32.7,1997,15,1989,10.04,9.35,0.39987767584097855,0.75,99.6
2020-01-04,Chhattisgarh,630,6,624,8299,2671,647,7.59,0,32.7,2627,21,2613,8.17,1.98,0.25379204892966356,0.8,99.47
2020-01-05,Chhattisgarh,976,7,970,12151,627,504,8.03,0,32.7,3603,28,3583,1.92,1.54,0.37159021406727827,0.78,99.44
2020-01-06,Chhattisgarh,1136,4,1135,14566,1390,849,7.8,0,32.7,4739,32,4718,4.25,2.6,0.44544342507645257,0.68,99.56
2020-01-07,Chhattisgarh,759,9,758,9358,3847,2909,8.11,0,32.7,5498,41,5476,11.76,8.9,0.286177370030581,0.75,99.6
2020-01-08,Chhattisgarh,1242,4,1238,15796,2764,279,7.86,0,32.7,6740,45,6714,8.45,0.85,0.4830581039755351,0.67,99.61
2020-01-09,Chhattisgarh,530,7,522,6333,1730,1227,8.37,1,32.7,7270,52,7236,5.29,3.75,0.19366972477064218,0.72,99.53
2020-01-10,Chhattisgarh,1423,5,1422,17730,2557,543,8.03,0,32.7,8693,57,8658,7.82,1.66,0.5422018348623853,0.66,99.6
2020-01-11,Chhattisgarh,417,2,410,4710,418,23,8.85,5,32.7,9110,59,9068,1.28,0.07,0.1440366972477064,0.65,99.54
2020-01-12,Chhattisgarh,1553,6,1546,19080,882,157,8.14,1,32.7,10663,65,10614,2.7,0.48,0.58348623853211,0.61,99.54
2020-01-13,Chhattisgarh,867,12,866,10688,729,117,8.11,0,32.7,11530,77,11480,2.23,0.36,0.32685015290519875,0.67,99.57
2020-01-14,Chhattisgarh,638,2,631,8061,1424,1152,7.91,5,32.7,12168,79,12111,4.35,3.52,0.2465137614678899,0.65,99.53
2020-01-15,Chhattisgarh,638,9,638,8005,415,386,7.97,0,32.7,12806,88,12749,1.27,1.18,0.24480122324159018,0.69,99.55
2020-01-16,Chhattisgarh,536,5,530,6801,832,682,7.88,1,32.7,13342,93,13279,2.54,2.09,0.20798165137614677,0.7,99.53
2020-01-17,Chhattisgarh,1542,17,1536,19140,2777,1593,8.06,0,32.7,14884,110,14815,8.49,4.87,0.5853211009174312,0.74,99.54
2020-01-18,Chhattisgarh,568,6,560,7062,681,592,8.04,2,32.7,15452,116,15375,2.08,1.81,0.21596330275229356,0.75,99.5
2020-01-19,Chhattisgarh,363,1,358,4558,4359,683,7.96,4,32.7,15815,117,15733,13.33,2.09,0.13938837920489294,0.74,99.48
2020-01-20,Chhattisgarh,518,5,510,6564,3114,2437,7.89,3,32.7,16333,122,16243,9.52,7.45,0.2007339449541284,0.75,99.45
2020-01-21,Chhattisgarh,856,3,850,10963,2343,1631,7.81,3,32.7,17189,125,17093,7.17,4.99,0.33525993883792043,0.73,99.44
2020-01-22,Chhattisgarh,1024,9,1022,12872,4651,668,7.96,0,32.7,18213,134,18115,14.22,2.04,0.3936391437308868,0.74,99.46
2020-01-23,Chhattisgarh,650,9,644,8063,1689,403,8.06,0,32.7,18863,143,18759,5.17,1.23,0.24657492354740057,0.76,99.45
2020-01-24,Chhattisgarh,1511,20,1510,18473,3079,2118,8.18,0,32.7,20374,163,20269,9.42,6.48,0.5649235474006116,0.8,99.48
2020-01-25,Chhattisgarh,699,5,697,8973,3,2,7.79,0,32.7,21073,168,20966,0.01,0.01,0.2744036697247706,0.8,99.49
2020-01-26,Chhattisgarh,1289,14,1281,16185,4810,3937,7.96,0,32.7,22362,182,22247,14.71,12.04,0.4949541284403669,0.81,99.49
2020-01-27,Chhattisgarh,935,12,932,12036,1385,904,7.77,0,32.7,23297,194,23179,4.24,2.76,0.3680733944954128,0.83,99.49
2020-01-28,Chhattisgarh,1489,12,1481,18350,1688,1491,8.11,0,32.7,24786,206,24660,5.16,4.56,0.5611620795107033,0.83,99.49
2020-01-29,Chhattisgarh,50,0,41,573,3844,847,8.73,9,32.7,24836,206,24701,11.76,2.59,0.017522935779816513,0.83,99.46
2020-01-30,Chhattisgarh,210,2,202,2587,1620,233,8.12,6,32.7,25046,208,24903,4.95,0.71,0.07911314984709479,0.83,99.43
2020-01-31,Chhattisgarh,804,8,804,10349,2608,1006,7.77,0,32.7,25850,216,25707,7.98,3.08,0.3164831804281345,0.84,99.45
2020-02-01,Chhattisgarh,1180,4,1179,14601,332,92,8.08,0,32.7,27030,220,26886,1.02,0.28,0.44651376146788985,0.81,99.47
2020-02-02,Chhattisgarh,507,1,502,6038,1064,14,8.4,4,32.7,27537,221,27388,3.25,0.04,0.18464831804281343,0.8,99.46
2020-02-03,Chhattisgarh,697,3,693,8092,3956,124,8.61,1,32.7,28234,224,28081,12.1,0.38,0.24746177370030578,0.79,99.46
2020-02-04,Chhattisgarh,875,2,869,11030,2095,1740,7.93,4,32.7,29109,226,28950,6.41,5.32,0.337308868501529,0.78,99.45
2020-02-05,Chhattisgarh,776,10,769,9668,424,396,8.03,0,32.7,29885,236,29719,1.3,1.21,0.29565749235474004,0.79,99.44
2020-02-06,Chhattisgarh,423,1,420,5432,2321,1548,7.79,2,32.7,30308,237,30139,7.1,4.73,0.16611620795107032,0.78,99.44
2020-02-07,Chhattisgarh,94,1,91,1267,3018,2975,7.42,2,32.7,30402,238,30230,9.23,9.1,0.038746177370030575,0.78,99.43
2020-02-08,Chhattisgarh,1154,14,1148,14940,4982,3823,7.72,0,32.7,31556,252,31378,15.24,11.69,0.4568807339449541,0.8,99.44
2020-02-09,Chhattisgarh,979,9,972,12278,2292,351,7.97,0,32.7,32535,261,32350,7.01,1.07,0.3754740061162079,0.8,99.43
2020-02-10,Chhattisgarh,1232,12,1225,15582,3503,590,7.91,0,32.7,33767,273,33575,10.71,1.8,0.4765137614678899,0.81,99.43
2020-02-11,Chhattisgarh,1545,19,1541,19796,4803,3911,7.8,0,32.7,35312,292,35116,14.69,11.96,0.6053822629969419,0.83,99.44
2020-02-12,Chhattisgarh,1505,5,1501,18347,2031,637,8.2,0,32.7,36817,297,36617,6.21,1.95,0.5610703363914372,0.81,99.46
2020-02-13,Chhattisgarh,849,8,845,10654,936,306,7.97,0,32.7,37666,305,37462,2.86,0.94,0.32581039755351676,0.81,99.46
2020-02-14,Chhattisgarh,1496,4,1490,18872,749,578,7.93,2,32.7,39162,309,38952,2.29,1.77,0.5771253822629969,0.79,99.46
2020-02-15,Chhattisgarh,1216,12,1212,15391,4145,1017,7.9,0,32.7,40378,321,40164,12.68,3.11,0.47067278287461767,0.79,99.47
2020-02-16,Chhattisgarh,1024,3,1016,12488,1759,515,8.2,5,32.7,41402,324,41180,5.38,1.57,0.3818960244648318,0.78,99.46
2020-02-17,Chhattisgarh,1039,10,1035,12819,4452,257,8.11,0,32.7,42441,334,42215,13.61,0.79,0.39201834862385315,0.79,99.47
2020-02-18,Chhattisgarh,414,3,412,5329,567,80,7.77,0,32.7,42855,337,42627,1.73,0.24,0.1629663608562691,0.79,99.47
2020-02-19,Chhattisgarh,1283,4,1274,15840,2963,119,8.1,5,32.7,44138,341,43901,9.06,0.36,0.4844036697247706,0.77,99.46
2020-02-20,Chhattisgarh,1063,14,1057,13443,701,400,7.91,0,32.7,45201,355,44958,2.14,1.22,0.4111009174311926,0.79,99.46
2020-02-21,Chhattisgarh,201,1,201,3038,3707,2879,6.62,0,32.7,45402,356,45159,11.34,8.8,0.0929051987767584,0.78,99.46
2020-02-22,Chhattisgarh,879,11,876,10772,1919,351,8.16,0,32.7,46281,367,46035,5.87,1.07,0.3294189602446483,0.79,99.47
2020-02-23,Chhattisgarh,332,1,328,3941,2089,1402,8.42,3,32.7,46613,368,46363,6.39,4.29,0.12051987767584096,0.79,99.46
2020-02-24,Chhattisgarh,923,12,914,11534,4181,3717,8.0,0,32.7,47536,380,47277,12.79,11.37,0.35272171253822626,0.8,99.46
2020-02-25,Chhattisgarh,282,2,281,3696,617,107,7.63,0,32.7,47818,382,47558,1.89,0.33,0.1130275229357798,0.8,99.46
2020-02-26,Chhattisgarh,1573,13,1569,19428,2950,1441,8.1,0,32.7,49391,395,49127,9.02,4.41,0.5941284403669724,0.8,99.47
2020-02-27,Chhattisgarh,510,4,504,5808,4634,143,8.78,2,32.7,49901,399,49631,14.17,0.44,0.17761467889908256,0.8,99.46
2020-02-28,Chhattisgarh,1219,9,1213,15339,1811,1684,7.95,0,32.7,51120,408,50844,5.54,5.15,0.4690825688073394,0.8,99.46
2020-02-29,Chhattisgarh,307,3,303,3827,4167,2234,8.02,1,32.7,51427,411,51147,12.74,6.83,0.11703363914373087,0.8,99.46
2020-03-01,Chhattisgarh,648,6,644,8274,2018,1435,7.83,0,32.7,52075,417,51791,6.17,4.39,0.2530275229357798,0.8,99.45
2020-03-02,Chhattisgarh,1271,6,1264,16292,2930,2439,7.8,1,32.7,53346,423,53055,8.96,7.46,0.4982262996941895,0.79,99.45
2020-03-03,Chhattisgarh,706,9,697,8592,1896,1173,8.22,0,32.7,54052,432,53752,5.8,3.59,0.26275229357798163,0.8,99.44
2020-03-04,Chhattisgarh,1379,16,1378,17308,4567,845,7.97,0,32.7,55431,448,55130,13.97,2.58,0.5292966360856268,0.81,99.46
2020-03-05,Chhattisgarh,1356,15,1355,16936,366,348,8.01,0,32.7,56787,463,56485,1.12,1.06,0.517920489296636,0.82,99.47
2020-03-06,Chhattisgarh,596,8,590,7110,1979,135,8.38,0,32.7,57383,471,57075,6.05,0.41,0.21743119266055044,0.82,99.46
2020-03-07,Chhattisgarh,688,4,686,8690,4687,3094,7.92,0,32.7,58071,475,57761,14.33,9.46,0.2657492354740061,0.82,99.47
2020-03-08,Chhattisgarh,1344,6,1335,16879,2216,1393,7.96,3,32.7,59415,481,59096,6.78,4.26,0.516177370030581,0.81,99.46
2020-03-09,Chhattisgarh,510,5,503,6441,3582,666,7.92,2,32.7,59925,486,59599,10.95,2.04,0.19697247706422016,0.81,99.46
2020-03-10,Chhattisgarh,663,7,663,8515,4529,458,7.79,0,32.7,60588,493,60262,13.85,1.4,0.26039755351681954,0.81,99.46
2020-03-11,Chhattisgarh,1478,5,1474,18550,4897,3232,7.97,0,32.7,62066,498,61736,14.98,9.88,0.5672782874617737,0.8,99.47
2020-03-12,Chhattisgarh,1535,5,1535,19301,1844,807,7.95,0,32.7,63601,503,63271,5.64,2.47,0.5902446483180428,0.79,99.48
2020-03-13,Chhattisgarh,137,1,128,1076,1721,334,12.73,8,32.7,63738,504,63399,5.26,1.02,0.032905198776758404,0.79,99.47
2020-03-14,Chhattisgarh,1294,14,1294,16243,4000,3324,7.97,0,32.7,65032,518,64693,12.23,10.17,0.4967278287461773,0.8,99.48
2020-03-15,Chhattisgarh,1294,18,1287,15816,2412,1897,8.18,0,32.7,66326,536,65980,7.38,5.8,0.48366972477064213,0.81,99.48
2020-03-16,Chhattisgarh,1405,18,1400,17674,4431,3771,7.95,0,32.7,67731,554,67380,13.55,11.53,0.5404892966360856,0.82,99.48
2020-03-17,Chhattisgarh,520,2,516,6781,2198,767,7.67,2,32.7,68251,556,67896,6.72,2.35,0.20737003058103973,0.81,99.48
2020-03-18,Chhattisgarh,707,3,700,9159,2887,2656,7.72,4,32.7,68958,559,68596,8.83,8.12,0.28009174311926605,0.81,99.48
2020-03-19,Chhattisgarh,95,1,95,1476,169,160,6.44,0,32.7,69053,560,68691,0.52,0.49,0.045137614678899075,0.81,99.48
2020-03-20,Chhattisgarh,1130,9,1125,14186,3416,381,7.97,0,32.7,70183,569,69816,10.45,1.17,0.4338226299694189,0.81,99.48
2020-03-21,Chhattisgarh,712,5,709,8806,1831,1501,8.09,0,32.7,70895,574,70525,5.6,4.59,0.2692966360856269,0.81,99.48
2020-03-22,Chhattisgarh,1082,14,1075,13466,1488,826,8.04,0,32.7,71977,588,71600,4.55,2.53,0.4118042813455657,0.82,99.48
2020-03-23,Chhattisgarh,301,2,293,3746,4245,1412,8.04,6,32.7,72278,590,71893,12.98,4.32,0.11455657492354739,0.82,99.47
2020-03-24,Chhattisgarh,1411,11,1404,17548,4276,550,8.04,0,32.7,73689,601,73297,13.08,1.68,0.5366360856269112,0.82,99.47
2020-03-25,Chhattisgarh,692,10,686,8678,470,400,7.97,0,32.7,74381,611,73983,1.44,1.22,0.26538226299694184,0.82,99.46
2020-03-26,Chhattisgarh,307,4,300,3684,4805,1484,8.33,3,32.7,74688,615,74283,14.69,4.54,0.11266055045871558,0.82,99.46
2020-03-27,Chhattisgarh,1318,11,1311,16661,827,522,7.91,0,32.7,76006,626,75594,2.53,1.6,0.5095107033639144,0.82,99.46
2020-03-28,Chhattisgarh,234,1,230,2644,4835,93,8.85,3,32.7,76240,627,75824,14.79,0.28,0.08085626911314983,0.82,99.45
2020-03-29,Chhattisgarh,1180,6,1176,14751,2842,1461,8.0,0,32.7,77420,633,77000,8.69,4.47,0.4511009174311926,0.82,99.46
2020-03-30,Chhattisgarh,1128,7,1125,13957,3275,713,8.08,0,32.7,78548,640,78125,10.02,2.18,0.4268195718654434,0.81,99.46
2020-03-31,Chhattisgarh,952,3,949,11475,2608,1116,8.3,0,32.7,79500,643,79074,7.98,3.41,0.3509174311926605,0.81,99.46
2020-04-01,Chhattisgarh,286,3,278,3954,734,720,7.23,5,32.7,79786,646,79352,2.24,2.2,0.12091743119266053,0.81,99.46
2020-04-02,Chhattisgarh,1366,13,1363,16991,4511,1992,8.04,0,32.7,81152,659,80715,13.8,6.09,0.5196024464831803,0.81,99.46
2020-04-03,Chhattisgarh,453,6,452,5623,3964,3769,8.06,0,32.7,81605,665,81167,12.12,11.53,0.1719571865443425,0.81,99.46
2020-04-04,Chhattisgarh,1272,15,1268,16024,1345,483,7.94,0,32.7,82877,680,82435,4.11,1.48,0.4900305810397553,0.82,99.47
2020-04-05,Chhattisgarh,558,3,557,6902,3862,3383,8.08,0,32.7,83435,683,82992,11.81,10.35,0.2110703363914373,0.82,99.47
2020-04-06,Chhattisgarh,510,4,504,6126,3404,3375,8.33,2,32.7,83945,687,83496,10.41,10.32,0.18733944954128437,0.82,99.47
2020-04-07,Chhattisgarh,932,10,931,11771,47,44,7.92,0,32.7,84877,697,84427,0.14,0.13,0.3599694189602446,0.82,99.47
2020-04-08,Chhattisgarh,1250,6,1249,15363,317,135,8.14,0,32.7,86127,703,85676,0.97,0.41,0.4698165137614678,0.82,99.48
2020-04-09,Chhattisgarh,395,2,391,4798,1463,906,8.23,2,32.7,86522,705,86067,4.47,2.77,0.14672782874617735,0.81,99.47
2020-04-10,Chhattisgarh,145,1,141,1961,2183,1244,7.39,3,32.7,86667,706,86208,6.68,3.8,0.059969418960244644,0.81,99.47
2020-04-11,Chhattisgarh,870,7,861,10642,723,58,8.18,2,32.7,87537,713,87069,2.21,0.18,0.3254434250764526,0.81,99.47
2020-04-12,Chhattisgarh,988,14,982,12302,3925,3408,8.03,0,32.7,88525,727,88051,12.0,10.42,0.37620795107033633,0.82,99.46
2020-04-13,Chhattisgarh,308,3,299,3388,761,716,9.09,6,32.7,88833,730,88350,2.33,2.19,0.10360856269113149,0.82,99.46
2020-04-14,Chhattisgarh,1543,6,1543,19019,2458,1172,8.11,0,32.7,90376,736,89893,7.52,3.58,0.5816207951070336,0.81,99.47
2020-04-15,Chhattisgarh,531,1,529,6992,2873,2396,7.59,1,32.7,90907,737,90422,8.79,7.33,0.21382262996941895,0.81,99.47
2020-04-16,Chhattisgarh,993,10,989,12323,4204,2232,8.06,0,32.7,91900,747,91411,12.86,6.83,0.37685015290519874,0.81,99.47
2020-04-17,Chhattisgarh,1304,4,1301,16287,1225,678,8.01,0,32.7,93204,751,92712,3.75,2.07,0.49807339449541277,0.81,99.47
2020-04-18,Chhattisgarh,914,12,908,11624,4172,4028,7.86,0,32.7,94118,763,93620,12.76,12.32,0.3554740061162079,0.81,99.47
2020-04-19,Chhattisgarh,1036,12,1029,12895,4169,2828,8.03,0,32.7,95154,775,94649,12.75,8.65,0.3943425076452599,0.81,99.47
2020-04-20,Chhattisgarh,1225,12,1224,15507,2804,1689,7.9,0,32.7,96379,787,95873,8.57,5.17,0.47422018348623846,0.82,99.47
2020-04-21,Chhattisgarh,1297,16,1297,15724,4059,2417,8.25,0,32.7,97676,803,97170,12.41,7.39,0.48085626911314977,0.82,99.48
2020-04-22,Chhattisgarh,355,2,347,4634,3037,1516,7.66,6,32.7,98031,805,97517,9.29,4.64,0.14171253822629967,0.82,99.48
2020-04-23,Chhattisgarh,752,2,752,9437,2228,1986,7.97,0,32.7,98783,807,98269,6.81,6.07,0.2885932721712538,0.82,99.48
2020-04-24,Chhattisgarh,625,2,620,8138,1637,1187,7.68,3,32.7,99408,809,98889,5.01,3.63,0.24886850152905196,0.81,99.48
2020-04-25,Chhattisgarh,1159,14,1152,14616,1418,449,7.93,0,32.7,100567,823,100041,4.34,1.37,0.4469724770642201,0.82,99.48
2020-04-26,Chhattisgarh,1324,14,1320,16270,172,79,8.14,0,32.7,101891,837,101361,0.53,0.24,0.49755351681957183,0.82,99.48
2020-04-27,Chhattisgarh,1388,16,1385,17067,2415,1826,8.13,0,32.7,103279,853,102746,7.39,5.58,0.5219266055045871,0.83,99.48
2020-04-28,Chhattisgarh,995,8,986,12363,3262,1962,8.05,1,32.7,104274,861,103732,9.98,6.0,0.3780733944954128,0.83,99.48
2020-04-29,Chhattisgarh,212,2,203,2404,4332,2387,8.82,7,32.7,104486,863,103935,13.25,7.3,0.07351681957186544,0.83,99.47
2020-04-30,Chhattisgarh,236,2,233,3000,640,217,7.87,1,32.7,104722,865,104168,1.96,0.66,0.09174311926605504,0.83,99.47
2020-05-01,Chhattisgarh,1053,6,1044,12996,999,180,8.1,3,32.7,105775,871,105212,3.06,0.55,0.39743119266055044,0.82,99.47
2020-05-02,Chhattisgarh,1344,8,1340,17332,3079,2228,7.75,0,32.7,107119,879,106552,9.42,6.81,0.5300305810397553,0.82,99.47
2020-05-03,Chhattisgarh,669,4,665,8448,4599,3169,7.92,0,32.7,107788,883,107217,14.06,9.69,0.258348623853211,0.82,99.47
2020-05-04,Chhattisgarh,1153,11,1146,14349,1955,990,8.04,0,32.7,108941,894,108363,5.98,3.03,0.43880733944954126,0.82,99.47
2020-05-05,Chhattisgarh,1603,6,1601,19719,1202,1188,8.13,0,32.7,110544,900,109964,3.68,3.63,0.6030275229357798,0.81,99.48
2020-05-06,Chhattisgarh,248,0,239,3502,3843,2927,7.08,9,32.7,110792,900,110203,11.75,8.95,0.10709480122324158,0.81,99.47
2020-05-07,Chhattisgarh,454,2,447,5611,2159,1497,8.09,5,32.7,111246,902,110650,6.6,4.58,0.17159021406727826,0.81,99.46
2020-05-08,Chhattisgarh,1219,4,1215,15013,4239,3530,8.12,0,32.7,112465,906,111865,12.96,10.8,0.4591131498470947,0.81,99.47
2020-05-09,Chhattisgarh,734,10,731,9106,995,497,8.06,0,32.7,113199,916,112596,3.04,1.52,0.2784709480122324,0.81,99.47
2020-05-10,Chhattisgarh,1013,3,1005,12709,1223,690,7.97,5,32.7,114212,919,113601,3.74,2.11,0.38865443425076446,0.8,99.47
2020-05-11,Chhattisgarh,138,1,134,1760,2333,689,7.84,3,32.7,114350,920,113735,7.13,2.11,0.05382262996941895,0.8,99.46
2020-05-12,Chhattisgarh,1538,7,1530,19005,2375,375,8.09,1,32.7,115888,927,115265,7.26,1.15,0.5811926605504586,0.8,99.46
2020-05-13,Chhattisgarh,78,0,71,1026,928,393,7.6,7,32.7,115966,927,115336,2.84,1.2,0.031376146788990825,0.8,99.46
2020-05-14,Chhattisgarh,1236,14,1229,15188,1467,1025,8.14,0,32.7,117202,941,116565,4.49,3.13,0.4644648318042813,0.8,99.46
2020-05-15,Chhattisgarh,1526,5,1526,19126,3279,2861,7.98,0,32.7,118728,946,118091,10.03,8.75,0.5848929663608562,0.8,99.46
2020-05-16,Chhattisgarh,237,1,234,2654,959,279,8.93,2,32.7,118965,947,118325,2.93,0.85,0.08116207951070335,0.8,99.46
2020-05-17,Chhattisgarh,271,1,269,3374,2418,95,8.03,1,32.7,119236,948,118594,7.39,0.29,0.10318042813455656,0.8,99.46
2020-05-18,Chhattisgarh,844,3,835,10890,2336,1894,7.75,6,32.7,120080,951,119429,7.14,5.79,0.33302752293577975,0.79,99.46
2020-05-19,Chhattisgarh,1131,6,1124,14191,3771,3159,7.97,1,32.7,121211,957,120553,11.53,9.66,0.43397553516819565,0.79,99.46
2020-05-20,Chhattisgarh,594,5,587,7446,1592,295,7.98,2,32.7,121805,962,121140,4.87,0.9,0.2277064220183486,0.79,99.45
2020-05-21,Chhattisgarh,1378,4,1369,17556,4889,4694,7.85,5,32.7,123183,966,122509,14.95,14.35,0.5368807339449541,0.78,99.45
2020-05-22,Chhattisgarh,1536,14,1534,19431,3959,662,7.9,0,32.7,124719,980,124043,12.11,2.02,0.5942201834862385,0.79,99.46
2020-05-23,Chhattisgarh,1009,7,1002,12515,1551,433,8.06,0,32.7,125728,987,125045,4.74,1.32,0.38272171253822623,0.79,99.46
2020-05-24,Chhattisgarh,1314,11,1314,16168,851,67,8.13,0,32.7,127042,998,126359,2.6,0.2,0.49443425076452596,0.79,99.46
2020-05-25,Chhattisgarh,99,0,90,1193,2637,1536,8.3,9,32.7,127141,998,126449,8.06,4.7,0.03648318042813455,0.78,99.46
2020-05-26,Chhattisgarh,686,3,686,8389,4454,2815,8.18,0,32.7,127827,1001,127135,13.62,8.61,0.25654434250764524,0.78,99.46
2020-05-27,Chhattisgarh,1094,7,1089,13474,4330,657,8.12,0,32.7,128921,1008,128224,13.24,2.01,0.4120489296636085,0.78,99.46
2020-05-28,Chhattisgarh,661,7,660,8610,763,567,7.68,0,32.7,129582,1015,128884,2.33,1.73,0.26330275229357797,0.78,99.46
2020-05-29,Chhattisgarh,518,2,518,6752,3268,2816,7.67,0,32.7,130100,1017,129402,9.99,8.61,0.20648318042813454,0.78,99.46
2020-05-30,Chhattisgarh,412,3,408,5016,1627,4,8.21,1,32.7,130512,1020,129810,4.98,0.01,0.15339449541284403,0.78,99.46
2020-05-31,Chhattisgarh,1528,10,1525,19259,770,67,7.93,0,32.7,132040,1030,131335,2.35,0.2,0.588960244648318,0.78,99.47
2020-06-01,Chhattisgarh,791,6,783,9811,4340,2206,8.06,2,32.7,132831,1036,132118,13.27,6.75,0.30003058103975533,0.78,99.46
2020-06-02,Chhattisgarh,646,4,646,7914,1862,1602,8.16,0,32.7,133477,1040,132764,5.69,4.9,0.24201834862385319,0.78,99.47
2020-06-03,Chhattisgarh,684,5,684,8419,4325,2267,8.12,0,32.7,134161,1045,133448,13.23,6.93,0.25746177370030576,0.78,99.47
2020-06-04,Chhattisgarh,94,0,91,1586,3950,1273,5.93,3,32.7,134255,1045,133539,12.08,3.89,0.04850152905198776,0.78,99.47
2020-06-05,Chhattisgarh,637,6,629,7741,3896,547,8.23,2,32.7,134892,1051,134168,11.91,1.67,0.23672782874617734,0.78,99.46
2020-06-06,Chhattisgarh,1302,12,1300,16510,2991,2764,7.89,0,32.7,136194,1063,135468,9.15,8.45,0.5048929663608562,0.78,99.47
2020-06-07,Chhattisgarh,775,5,769,9732,1391,849,7.96,1,32.7,136969,1068,136237,4.25,2.6,0.29761467889908255,0.78,99.47
2020-06-08,Chhattisgarh,1110,13,1108,13933,4725,273,7.97,0,32.7,138079,1081,137345,14.45,0.83,0.42608562691131496,0.78,99.47
2020-06-09,Chhattisgarh,1448,9,1440,18322,4728,1174,7.9,0,32.7,139527,1090,138785,14.46,3.59,0.5603058103975534,0.78,99.47
2020-06-10,Chhattisgarh,1127,11,1122,14111,413,186,7.99,0,32.7,140654,1101,139907,1.26,0.57,0.43152905198776753,0.78,99.47
2020-06-11,Chhattisgarh,654,9,648,8234,1776,106,7.94,0,32.7,141308,1110,140555,5.43,0.32,0.2518042813455657,0.79,99.47
2020-06-12,Chhattisgarh,309,2,304,4013,3370,1116,7.7,3,32.7,141617,1112,140859,10.31,3.41,0.12272171253822628,0.79,99.46
2020-06-13,Chhattisgarh,1447,8,1442,17960,685,213,8.06,0,32.7,143064,1120,142301,2.09,0.65,0.5492354740061162,0.78,99.47
2020-06-14,Chhattisgarh,681,3,673,8539,4236,2213,7.98,5,32.7,143745,1123,142974,12.95,6.77,0.26113149847094796,0.78,99.46
2020-06-15,Chhattisgarh,569,5,569,6604,4835,4105,8.62,0,32.7,144314,1128,143543,14.79,12.55,0.2019571865443425,0.78,99.47
2020-06-16,Chhattisgarh,1529,9,1526,19442,2097,885,7.86,0,32.7,145843,1137,145069,6.41,2.71,0.5945565749235473,0.78,99.47
2020-06-17,Chhattisgarh,903,9,894,11416,2536,1407,7.91,0,32.7,146746,1146,145963,7.76,4.3,0.34911314984709474,0.78,99.47
2020-06-18,Chhattisgarh,1406,7,1399,17435,2515,1981,8.06,0,32.7,148152,1153,147362,7.69,6.06,0.5331804281345565,0.78,99.47
2020-06-19,Chhattisgarh,1478,5,1473,18563,638,173,7.96,0,32.7,149630,1158,148835,1.95,0.53,0.5676758409785932,0.77,99.47
2020-06-20,Chhattisgarh,1062,14,1053,13027,198,58,8.15,0,32.7,150692,1172,149888,0.61,0.18,0.3983792048929663,0.78,99.47
2020-06-21,Chhattisgarh,301,4,301,3833,1546,768,7.85,0,32.7,150993,1176,150189,4.73,2.35,0.11721712538226299,0.78,99.47
2020-06-22,Chhattisgarh,832,10,826,10311,1487,1455,8.07,0,32.7,151825,1186,151015,4.55,4.45,0.31532110091743115,0.78,99.47
2020-06-23,Chhattisgarh,1012,12,1009,13050,2843,181,7.75,0,32.7,152837,1198,152024,8.69,0.55,0.3990825688073394,0.78,99.47
2020-06-24,Chhattisgarh,1535,8,1529,18567,9,7,8.27,0,32.7,154372,1206,153553,0.03,0.02,0.5677981651376146,0.78,99.47
2020-06-25,Chhattisgarh,159,0,156,2065,4315,4014,7.7,3,32.7,154531,1206,153709,13.2,12.28,0.06314984709480122,0.78,99.47
2020-06-26,Chhattisgarh,486,6,483,5508,3867,1590,8.82,0,32.7,155017,1212,154192,11.83,4.86,0.16844036697247705,0.78,99.47
2020-06-27,Chhattisgarh,1221,16,1213,15063,4001,818,8.11,0,32.7,156238,1228,155405,12.24,2.5,0.4606422018348623,0.79,99.47
2020-06-28,Chhattisgarh,485,4,481,6284,2909,1475,7.72,0,32.7,156723,1232,155886,8.9,4.51,0.19217125382262995,0.79,99.47
2020-06-29,Chhattisgarh,744,8,736,9272,2448,1407,8.02,0,32.7,157467,1240,156622,7.49,4.3,0.28354740061162076,0.79,99.46
2020-06-30,Chhattisgarh,863,5,858,10405,3705,1064,8.29,0,32.7,158330,1245,157480,11.33,3.25,0.3181957186544342,0.79,99.46
2020-07-01,Chhattisgarh,100,0,97,1143,4420,411,8.75,3,32.7,158430,1245,157577,13.52,1.26,0.034954128440366966,0.79,99.46
2020-07-02,Chhattisgarh,431,2,426,5348,3686,3042,8.06,3,32.7,158861,1247,158003,11.27,9.3,0.16354740061162076,0.78,99.46
2020-07-03,Chhattisgarh,1075,6,1071,13352,2985,12,8.05,0,32.7,159936,1253,159074,9.13,0.04,0.40831804281345563,0.78,99.46
2020-07-04,Chhattisgarh,817,11,810,10388,716,672,7.86,0,32.7,160753,1264,159884,2.19,2.06,0.31767584097859325,0.79,99.46
2020-07-05,Chhattisgarh,850,12,850,10723,3797,2364,7.93,0,32.7,161603,1276,160734,11.61,7.23,0.32792048929663603,0.79,99.46
2020-07-06,Chhattisgarh,800,11,799,10252,2471,961,7.8,0,32.7,162403,1287,161533,7.56,2.94,0.3135168195718654,0.79,99.46
2020-07-07,Chhattisgarh,493,7,487,6245,720,503,7.89,0,32.7,162896,1294,162020,2.2,1.54,0.19097859327217123,0.79,99.46
2020-07-08,Chhattisgarh,768,3,761,9703,4285,106,7.92,4,32.7,163664,1297,162781,13.1,0.32,0.2967278287461773,0.79,99.46
2020-07-09,Chhattisgarh,845,7,843,10219,4118,555,8.27,0,32.7,164509,1304,163624,12.59,1.7,0.3125076452599388,0.79,99.46
2020-07-10,Chhattisgarh,943,5,935,12295,2708,2046,7.67,3,32.7,165452,1309,164559,8.28,6.26,0.3759938837920489,0.79,99.46
2020-07-11,Chhattisgarh,572,3,563,6876,3340,944,8.32,6,32.7,166024,1312,165122,10.21,2.89,0.21027522935779813,0.79,99.46
2020-07-12,Chhattisgarh,1185,7,1178,14892,4310,1148,7.96,0,32.7,167209,1319,166300,13.18,3.51,0.4554128440366972,0.79,99.46
2020-07-13,Chhattisgarh,1495,21,1486,18459,2284,87,8.1,0,32.7,168704,1340,167786,6.98,0.27,0.5644954128440366,0.79,99.46
2020-07-14,Chhattisgarh,1482,5,1474,18749,4856,3998,7.9,3,32.7,170186,1345,169260,14.85,12.23,0.5733639143730886,0.79,99.46
2020-07-15,Chhattisgarh,1519,10,1515,19329,4011,3804,7.86,0,32.7,171705,1355,170775,12.27,11.63,0.5911009174311926,0.79,99.46
2020-07-16,Chhattisgarh,888,4,884,10810,3578,3534,8.21,0,32.7,172593,1359,171659,10.94,10.81,0.33058103975535164,0.79,99.46
2020-07-17,Chhattisgarh,373,3,372,4968,1167,127,7.51,0,32.7,172966,1362,172031,3.57,0.39,0.15192660550458714,0.79,99.46
2020-07-18,Chhattisgarh,1337,5,1337,16855,3355,1641,7.93,0,32.7,174303,1367,173368,10.26,5.02,0.5154434250764526,0.78,99.46
2020-07-19,Chhattisgarh,510,5,503,6602,4786,1172,7.72,2,32.7,174813,1372,173871,14.64,3.58,0.2018960244648318,0.78,99.46
2020-07-20,Chhattisgarh,409,4,400,4965,2083,923,8.24,5,32.7,175222,1376,174271,6.37,2.82,0.1518348623853211,0.79,99.46
2020-07-21,Chhattisgarh,1148,16,1141,13987,4947,626,8.21,0,32.7,176370,1392,175412,15.13,1.91,0.4277370030581039,0.79,99.46
2020-07-22,Chhattisgarh,355,1,350,4988,2703,479,7.12,4,32.7,176725,1393,175762,8.27,1.46,0.15253822629969419,0.79,99.46
2020-07-23,Chhattisgarh,1283,13,1278,16037,1333,477,8.0,0,32.7,178008,1406,177040,4.08,1.46,0.49042813455657486,0.79,99.46
2020-07-24,Chhattisgarh,323,3,321,4344,1528,169,7.44,0,32.7,178331,1409,177361,4.67,0.52,0.1328440366972477,0.79,99.46
2020-07-25,Chhattisgarh,336,4,336,4181,2960,933,8.04,0,32.7,178667,1413,177697,9.05,2.85,0.12785932721712537,0.79,99.46
2020-07-26,Chhattisgarh,978,11,970,12476,727,447,7.84,0,32.7,179645,1424,178667,2.22,1.37,0.38152905198776754,0.79,99.46
2020-07-27,Chhattisgarh,761,10,754,9504,4770,1901,8.01,0,32.7,180406,1434,179421,14.59,5.81,0.29064220183486233,0.79,99.45
2020-07-28,Chhattisgarh,249,2,243,3333,862,633,7.47,4,32.7,180655,1436,179664,2.64,1.94,0.10192660550458714,0.79,99.45
2020-07-29,Chhattisgarh,1382,8,1381,17324,943,843,7.98,0,32.7,182037,1444,181045,2.88,2.58,0.5297859327217125,0.79,99.46
2020-07-30,Chhattisgarh,788,7,782,9764,2777,774,8.07,0,32.7,182825,1451,181827,8.49,2.37,0.2985932721712538,0.79,99.45
2020-07-31,Chhattisgarh,1265,6,1262,15905,3232,1940,7.95,0,32.7,184090,1457,183089,9.88,5.93,0.48639143730886847,0.79,99.46
2020-08-01,Chhattisgarh,1472,4,1464,18296,1043,96,8.05,4,32.7,185562,1461,184553,3.19,0.29,0.5595107033639143,0.79,99.46
2020-08-02,Chhattisgarh,722,5,720,9297,3328,2301,7.77,0,32.7,186284,1466,185273,10.18,7.04,0.28431192660550453,0.79,99.46
2020-08-03,Chhattisgarh,1054,14,1045,13647,2354,1991,7.72,0,32.7,187338,1480,186318,7.2,6.09,0.4173394495412844,0.79,99.46
2020-08-04,Chhattisgarh,375,2,373,4938,1847,1327,7.59,0,32.7,187713,1482,186691,5.65,4.06,0.1510091743119266,0.79,99.46
2020-08-05,Chhattisgarh,1549,10,1541,19089,3303,1536,8.11,0,32.7,189262,1492,188232,10.1,4.7,0.5837614678899082,0.79,99.46
2020-08-06,Chhattisgarh,172,0,163,2376,3359,3023,7.24,9,32.7,189434,1492,188395,10.27,9.24,0.07266055045871558,0.79,99.45
2020-08-07,Chhattisgarh,540,5,538,6718,1226,1164,8.04,0,32.7,189974,1497,188933,3.75,3.56,0.20544342507645258,0.79,99.45
2020-08-08,Chhattisgarh,369,3,367,4662,1011,397,7.92,0,32.7,190343,1500,189300,3.09,1.21,0.14256880733944952,0.79,99.45
2020-08-09,Chhattisgarh,1495,16,1492,18867,45,32,7.92,0,32.7,191838,1516,190792,0.14,0.1,0.5769724770642202,0.79,99.45
2020-08-10,Chhattisgarh,198,2,197,2804,1588,1375,7.06,0,32.7,192036,1518,190989,4.86,4.2,0.0857492354740061,0.79,99.45
2020-08-11,Chhattisgarh,437,2,429,5487,4613,471,7.96,6,32.7,192473,1520,191418,14.11,1.44,0.16779816513761467,0.79,99.45
2020-08-12,Chhattisgarh,833,7,824,10232,4317,2769,8.14,2,32.7,193306,1527,192242,13.2,8.47,0.3129051987767584,0.79,99.45
2020-08-13,Chhattisgarh,1548,18,1546,18868,4691,1556,8.2,0,32.7,194854,1545,193788,14.35,4.76,0.5770030581039755,0.79,99.45
2020-08-14,Chhattisgarh,1289,17,1289,15900,2119,1676,8.11,0,32.7,196143,1562,195077,6.48,5.13,0.4862385321100917,0.8,99.46
2020-08-15,Chhattisgarh,1425,14,1417,17919,1174,45,7.95,0,32.7,197568,1576,196494,3.59,0.14,0.5479816513761467,0.8,99.46
2020-08-16,Chhattisgarh,542,6,542,7098,4226,4151,7.64,0,32.7,198110,1582,197036,12.92,12.69,0.2170642201834862,0.8,99.46
2020-08-17,Chhattisgarh,322,3,317,4131,3275,205,7.79,2,32.7,198432,1585,197353,10.02,0.63,0.12633027522935777,0.8,99.46
2020-08-18,Chhattisgarh,828,10,824,10331,2199,264,8.01,0,32.7,199260,1595,198177,6.72,0.81,0.31593272171253817,0.8,99.46
2020-08-19,Chhattisgarh,186,2,179,2216,2529,1002,8.39,5,32.7,199446,1597,198356,7.73,3.06,0.06776758409785932,0.8,99.45
2020-08-20,Chhattisgarh,1464,12,1456,18399,3637,936,7.96,0,32.7,200910,1609,199812,11.12,2.86,0.5626605504587155,0.8,99.45
2020-08-21,Chhattisgarh,1253,13,1249,15703,753,427,7.98,0,32.7,202163,1622,201061,2.3,1.31,0.4802140672782874,0.8,99.45
2020-08-22,Chhattisgarh,512,6,506,6324,1415,1140,8.1,0,32.7,202675,1628,201567,4.33,3.49,0.193394495412844,0.8,99.45
2020-08-23,Chhattisgarh,89,1,89,1546,2042,1947,5.76,0,32.7,202764,1629,201656,6.24,5.95,0.0472782874617737,0.8,99.45
2020-08-24,Chhattisgarh,1099,12,1090,13920,250,199,7.9,0,32.7,203863,1641,202746,0.76,0.61,0.4256880733944954,0.8,99.45
2020-08-25,Chhattisgarh,819,5,815,10452,3143,1184,7.84,0,32.7,204682,1646,203561,9.61,3.62,0.31963302752293576,0.8,99.45
2020-08-26,Chhattisgarh,484,5,483,6206,4440,619,7.8,0,32.7,205166,1651,204044,13.58,1.89,0.1897859327217125,0.8,99.45
2020-08-27,Chhattisgarh,172,1,170,1978,4501,622,8.7,1,32.7,205338,1652,204214,13.76,1.9,0.06048929663608562,0.8,99.45
2020-08-28,Chhattisgarh,602,5,601,7502,1132,161,8.02,0,32.7,205940,1657,204815,3.46,0.49,0.22941896024464828,0.8,99.45
2020-08-29,Chhattisgarh,713,4,709,8963,234,51,7.95,0,32.7,206653,1661,205524,0.72,0.16,0.2740978593272171,0.8,99.45
2020-08-30,Chhattisgarh,1515,22,1508,18431,3235,994,8.22,0,32.7,208168,1683,207032,9.89,3.04,0.5636391437308867,0.81,99.45
2020-08-31,Chhattisgarh,1245,4,1238,15932,2241,1973,7.81,3,32.7,209413,1687,208270,6.85,6.03,0.4872171253822629,0.81,99.45
2020-09-01,Chhattisgarh,295,3,288,3494,1974,393,8.44,4,32.7,209708,1690,208558,6.04,1.2,0.10685015290519877,0.81,99.45
2020-09-02,Chhattisgarh,811,4,808,10018,1186,690,8.1,0,32.7,210519,1694,209366,3.63,2.11,0.30636085626911314,0.8,99.45
2020-09-03,Chhattisgarh,580,3,573,7501,1632,56,7.73,4,32.7,211099,1697,209939,4.99,0.17,0.22938837920489294,0.8,99.45
2020-09-04,Chhattisgarh,412,3,408,5160,3052,2212,7.98,1,32.7,211511,1700,210347,9.33,6.76,0.15779816513761466,0.8,99.45
2020-09-05,Chhattisgarh,804,4,796,9822,4082,3336,8.19,4,32.7,212315,1704,211143,12.48,10.2,0.3003669724770642,0.8,99.45
2020-09-06,Chhattisgarh,356,5,348,4511,2561,958,7.89,3,32.7,212671,1709,211491,7.83,2.93,0.13795107033639142,0.8,99.45
2020-09-07,Chhattisgarh,779,8,770,10099,196,41,7.71,1,32.7,213450,1717,212261,0.6,0.13,0.3088379204892966,0.8,99.44
2020-09-08,Chhattisgarh,520,5,520,6664,4896,115,7.8,0,32.7,213970,1722,212781,14.97,0.35,0.20379204892966357,0.8,99.44
2020-09-09,Chhattisgarh,571,6,568,7275,97,12,7.85,0,32.7,214541,1728,213349,0.3,0.04,0.22247706422018346,0.81,99.44
2020-09-10,Chhattisgarh,130,1,129,1407,1911,1,9.24,0,32.7,214671,1729,213478,5.84,0.0,0.04302752293577981,0.81,99.44
2020-09-11,Chhattisgarh,1042,13,1036,12698,2326,1870,8.21,0,32.7,215713,1742,214514,7.11,5.72,0.3883180428134556,0.81,99.44
2020-09-12,Chhattisgarh,593,8,592,7049,898,62,8.41,0,32.7,216306,1750,215106,2.75,0.19,0.21556574923547397,0.81,99.45
2020-09-13,Chhattisgarh,253,1,245,2837,1239,659,8.92,7,32.7,216559,1751,215351,3.79,2.02,0.08675840978593272,0.81,99.44
2020-09-14,Chhattisgarh,1029,12,1022,12800,1822,1352,8.04,0,32.7,217588,1763,216373,5.57,4.13,0.3914373088685015,0.81,99.44
2020-09-15,Chhattisgarh,1545,6,1539,19737,2508,328,7.83,0,32.7,219133,1769,217912,7.67,1.0,0.6035779816513761,0.81,99.44
2020-09-16,Chhattisgarh,322,4,318,3979,2994,1243,8.09,0,32.7,219455,1773,218230,9.16,3.8,0.12168195718654433,0.81,99.44
2020-09-17,Chhattisgarh,1416,15,1416,17677,3482,36,8.01,0,32.7,220871,1788,219646,10.65,0.11,0.5405810397553517,0.81,99.45
2020-09-18,Chhattisgarh,652,8,650,8266,2906,139,7.89,0,32.7,221523,1796,220296,8.89,0.43,0.25278287461773696,0.81,99.45
2020-09-19,Chhattisgarh,819,9,819,10287,331,289,7.96,0,32.7,222342,1805,221115,1.01,0.88,0.3145871559633027,0.81,99.45
2020-09-20,Chhattisgarh,1456,12,1450,18552,1432,1426,7.85,0,32.7,223798,1817,222565,4.38,4.36,0.5673394495412843,0.81,99.45
2020-09-21,Chhattisgarh,805,4,799,10352,4869,2224,7.78,2,32.7,224603,1821,223364,14.89,6.8,0.3165749235474006,0.81,99.45
2020-09-22,Chhattisgarh,95,0,87,1613,1215,139,5.89,8,32.7,224698,1821,223451,3.72,0.43,0.04932721712538226,0.81,99.45
2020-09-23,Chhattisgarh,678,3,670,8275,3694,2406,8.19,5,32.7,225376,1824,224121,11.3,7.36,0.25305810397553513,0.81,99.44
2020-09-24,Chhattisgarh,1117,14,1113,14512,2596,1323,7.7,0,32.7,226493,1838,225234,7.94,4.05,0.44379204892966356,0.81,99.44
2020-09-25,Chhattisgarh,799,2,796,9894,653,274,8.08,1,32.7,227292,1840,226030,2.0,0.84,0.3025688073394495,0.81,99.44
2020-09-26,Chhattisgarh,1173,16,1172,14579,264,248,8.05,0,32.7,228465,1856,227202,0.81,0.76,0.4458409785932721,0.81,99.45
2020-09-27,Chhattisgarh,654,7,648,7725,1254,926,8.47,0,32.7,229119,1863,227850,3.83,2.83,0.23623853211009171,0.81,99.45
2020-09-28,Chhattisgarh,699,6,695,9208,4591,3794,7.59,0,32.7,229818,1869,228545,14.04,11.6,0.28159021406727824,0.81,99.45
2020-09-29,Chhattisgarh,286,2,284,3905,3409,111,7.32,0,32.7,230104,1871,228829,10.43,0.34,0.1194189602446483,0.81,99.45
2020-09-30,Chhattisgarh,732,8,731,9211,3671,801,7.95,0,32.7,230836,1879,229560,11.23,2.45,0.2816819571865443,0.81,99.45
2020-10-01,Chhattisgarh,994,12,993,12124,3860,3182,8.2,0,32.7,231830,1891,230553,11.8,9.73,0.37076452599388376,0.82,99.45
2020-10-02,Chhattisgarh,609,5,600,7603,127,15,8.01,4,32.7,232439,1896,231153,0.39,0.05,0.2325076452599388,0.82,99.45
2020-10-03,Chhattisgarh,459,6,457,5740,1296,884,8.0,0,32.7,232898,1902,231610,3.96,2.7,0.17553516819571863,0.82,99.45
2020-10-04,Chhattisgarh,1579,11,1576,19810,2626,58,7.97,0,32.7,234477,1913,233186,8.03,0.18,0.6058103975535167,0.82,99.45
2020-10-05,Chhattisgarh,336,2,334,4345,3590,150,7.73,0,32.7,234813,1915,233520,10.98,0.46,0.13287461773700304,0.82,99.45
2020-10-06,Chhattisgarh,265,2,259,3043,4915,266,8.71,4,32.7,235078,1917,233779,15.03,0.81,0.09305810397553516,0.82,99.45
2020-10-07,Chhattisgarh,461,2,453,5576,2689,2333,8.27,6,32.7,235539,1919,234232,8.22,7.13,0.17051987767584095,0.81,99.45
2020-10-08,Chhattisgarh,567,4,567,7240,346,87,7.83,0,32.7,236106,1923,234799,1.06,0.27,0.22140672782874615,0.81,99.45
2020-10-09,Chhattisgarh,394,1,385,4655,954,612,8.46,8,32.7,236500,1924,235184,2.92,1.87,0.14235474006116206,0.81,99.44
2020-10-10,Chhattisgarh,1279,7,1275,15599,4697,3307,8.2,0,32.7,237779,1931,236459,14.36,10.11,0.4770336391437308,0.81,99.44
2020-10-11,Chhattisgarh,1046,8,1039,13303,742,228,7.86,0,32.7,238825,1939,237498,2.27,0.7,0.4068195718654434,0.81,99.44
2020-10-12,Chhattisgarh,242,1,237,2924,4737,3430,8.28,4,32.7,239067,1940,237735,14.49,10.49,0.08941896024464831,0.81,99.44
2020-10-13,Chhattisgarh,1600,10,1597,19772,661,199,8.09,0,32.7,240667,1950,239332,2.02,0.61,0.6046483180428134,0.81,99.45
2020-10-14,Chhattisgarh,302,2,294,3679,3282,128,8.21,6,32.7,240969,1952,239626,10.04,0.39,0.11250764525993882,0.81,99.44
2020-10-15,Chhattisgarh,1601,20,1596,19906,4585,1294,8.04,0,32.7,242570,1972,241222,14.02,3.96,0.6087461773700306,0.81,99.44
2020-10-16,Chhattisgarh,24,0,18,505,4234,725,4.75,6,32.7,242594,1972,241240,12.95,2.22,0.015443425076452598,0.81,99.44
2020-10-17,Chhattisgarh,935,4,931,12171,1295,690,7.68,0,32.7,243529,1976,242171,3.96,2.11,0.3722018348623853,0.81,99.44
2020-10-18,Chhattisgarh,81,1,81,853,4040,2159,9.5,0,32.7,243610,1977,242252,12.35,6.6,0.026085626911314982,0.81,99.44
2020-10-19,Chhattisgarh,1381,9,1380,16887,3401,1441,8.18,0,32.7,244991,1986,243632,10.4,4.41,0.5164220183486238,0.81,99.45
2020-10-20,Chhattisgarh,744,7,744,9304,498,22,8.0,0,32.7,245735,1993,244376,1.52,0.07,0.284525993883792,0.81,99.45
2020-10-21,Chhattisgarh,656,4,655,8064,3841,487,8.13,0,32.7,246391,1997,245031,11.75,1.49,0.24660550458715594,0.81,99.45
2020-10-22,Chhattisgarh,564,6,556,6706,184,77,8.41,2,32.7,246955,2003,245587,0.56,0.24,0.20507645259938836,0.81,99.45
2020-10-23,Chhattisgarh,164,0,156,2313,3967,3815,7.09,8,32.7,247119,2003,245743,12.13,11.67,0.07073394495412844,0.81,99.44
2020-10-24,Chhattisgarh,1248,17,1246,15474,1290,298,8.07,0,32.7,248367,2020,246989,3.94,0.91,0.47321100917431186,0.81,99.45
2020-10-25,Chhattisgarh,626,5,620,8175,4142,4040,7.66,1,32.7,248993,2025,247609,12.67,12.35,0.24999999999999997,0.81,99.44
2020-10-26,Chhattisgarh,1189,10,1188,14946,4500,3139,7.96,0,32.7,250182,2035,248797,13.76,9.6,0.4570642201834862,0.81,99.45
2020-10-27,Chhattisgarh,999,9,990,12370,2401,1470,8.08,0,32.7,251181,2044,249787,7.34,4.5,0.37828746177370026,0.81,99.45
2020-10-28,Chhattisgarh,369,1,368,4477,649,503,8.24,0,32.7,251550,2045,250155,1.98,1.54,0.13691131498470946,0.81,99.45
2020-10-29,Chhattisgarh,876,6,869,11025,1563,456,7.95,1,32.7,252426,2051,251024,4.78,1.39,0.33715596330275227,0.81,99.44
2020-10-30,Chhattisgarh,142,1,140,2278,2472,284,6.23,1,32.7,252568,2052,251164,7.56,0.87,0.06966360856269112,0.81,99.44
2020-10-31,Chhattisgarh,332,1,326,4163,1050,300,7.98,5,32.7,252900,2053,251490,3.21,0.92,0.12730886850152903,0.81,99.44
2020-11-01,Chhattisgarh,1416,19,1408,17815,2623,909,7.95,0,32.7,254316,2072,252898,8.02,2.78,0.5448012232415902,0.81,99.44
2020-11-02,Chhattisgarh,1365,6,1359,17477,1985,1205,7.81,0,32.7,255681,2078,254257,6.07,3.69,0.5344648318042813,0.81,99.44
2020-11-03,Chhattisgarh,1243,9,1239,15931,1193,1016,7.8,0,32.7,256924,2087,255496,3.65,3.11,0.4871865443425076,0.81,99.44
2020-11-04,Chhattisgarh,453,4,447,5368,1606,1415,8.44,2,32.7,257377,2091,255943,4.91,4.33,0.1641590214067278,0.81,99.44
2020-11-05,Chhattisgarh,924,6,924,11254,4235,3781,8.21,0,32.7,258301,2097,256867,12.95,11.56,0.34415902140672777,0.81,99.44
2020-11-06,Chhattisgarh,621,4,613,7620,4435,1737,8.15,4,32.7,258922,2101,257480,13.56,5.31,0.2330275229357798,0.81,99.44
2020-11-07,Chhattisgarh,1295,5,1291,15954,2679,605,8.12,0,32.7,260217,2106,258771,8.19,1.85,0.48788990825688067,0.81,99.44
2020-11-08,Chhattisgarh,105,0,105,1279,3589,1242,8.21,0,32.7,260322,2106,258876,10.98,3.8,0.0391131498470948,0.81,99.44
2020-11-09,Chhattisgarh,54,0,49,762,3920,2610,7.09,5,32.7,260376,2106,258925,11.99,7.98,0.023302752293577977,0.81,99.44
2020-11-10,Chhattisgarh,977,6,976,12095,4900,1383,8.08,0,32.7,261353,2112,259901,14.98,4.23,0.3698776758409785,0.81,99.44
2020-11-11,Chhattisgarh,891,7,886,11454,2187,769,7.78,0,32.7,262244,2119,260787,6.69,2.35,0.35027522935779815,0.81,99.44
2020-11-12,Chhattisgarh,210,1,206,2652,2140,479,7.92,3,32.7,262454,2120,260993,6.54,1.46,0.08110091743119265,0.81,99.44
2020-11-13,Chhattisgarh,430,2,429,5060,2106,112,8.5,0,32.7,262884,2122,261422,6.44,0.34,0.1547400611620795,0.81,99.44
2020-11-14,Chhattisgarh,505,4,504,6250,2751,2046,8.08,0,32.7,263389,2126,261926,8.41,6.26,0.19113149847094799,0.81,99.44
2020-11-15,Chhattisgarh,516,5,514,6397,4297,558,8.07,0,32.7,263905,2131,262440,13.14,1.71,0.1956269113149847,0.81,99.44
2020-11-16,Chhattisgarh,1004,4,1001,12160,3022,661,8.26,0,32.7,264909,2135,263441,9.24,2.02,0.37186544342507644,0.81,99.45
2020-11-17,Chhattisgarh,807,6,803,9935,1084,271,8.12,0,32.7,265716,2141,264244,3.31,0.83,0.30382262996941894,0.81,99.45
2020-11-18,Chhattisgarh,1370,15,1365,16780,4033,3586,8.16,0,32.7,267086,2156,265609,12.33,10.97,0.5131498470948012,0.81,99.45
2020-11-19,Chhattisgarh,633,8,624,7861,2257,1429,8.05,1,32.7,267719,2164,266233,6.9,4.37,0.24039755351681955,0.81,99.44
2020-11-20,Chhattisgarh,764,2,763,9369,387,380,8.15,0,32.7,268483,2166,266996,1.18,1.16,0.28651376146788987,0.81,99.45
2020-11-21,Chhattisgarh,776,10,773,9723,3280,1703,7.98,0,32.7,269259,2176,267769,10.03,5.21,0.2973394495412844,0.81,99.45
2020-11-22,Chhattisgarh,1551,17,1544,19517,655,18,7.95,0,32.7,270810,2193,269313,2.0,0.06,0.5968501529051987,0.81,99.45
2020-11-23,Chhattisgarh,1491,6,1490,18482,2848,902,8.07,0,32.7,272301,2199,270803,8.71,2.76,0.5651987767584097,0.81,99.45
2020-11-24,Chhattisgarh,1034,11,1033,13059,2658,1898,7.92,0,32.7,273335,2210,271836,8.13,5.8,0.39935779816513756,0.81,99.45
2020-11-25,Chhattisgarh,873,9,864,11203,1606,1016,7.79,0,32.7,274208,2219,272700,4.91,3.11,0.34259938837920484,0.81,99.45
2020-11-26,Chhattisgarh,629,2,626,8166,555,338,7.7,1,32.7,274837,2221,273326,1.7,1.03,0.2497247706422018,0.81,99.45
2020-11-27,Chhattisgarh,120,1,116,1355,1118,957,8.86,3,32.7,274957,2222,273442,3.42,2.93,0.04143730886850153,0.81,99.45
2020-11-28,Chhattisgarh,1129,5,1122,13659,564,233,8.27,2,32.7,276086,2227,274564,1.72,0.71,0.41770642201834857,0.81,99.45
2020-11-29,Chhattisgarh,409,4,407,5686,3997,2356,7.19,0,32.7,276495,2231,274971,12.22,7.2,0.17388379204892965,0.81,99.45
2020-11-30,Chhattisgarh,779,7,773,9891,3347,1559,7.88,0,32.7,277274,2238,275744,10.24,4.77,0.30247706422018344,0.81,99.45
2020-12-01,Chhattisgarh,476,4,476,5816,2991,1763,8.18,0,32.7,277750,2242,276220,9.15,5.39,0.17785932721712536,0.81,99.45
2020-12-02,Chhattisgarh,745,9,736,9419,3173,3035,7.91,0,32.7,278495,2251,276956,9.7,9.28,0.28804281345565746,0.81,99.45
2020-12-03,Chhattisgarh,1482,16,1476,18493,2506,851,8.01,0,32.7,279977,2267,278432,7.66,2.6,0.5655351681957186,0.81,99.45
2020-12-04,Chhattisgarh,1595,21,1593,19893,2018,589,8.02,0,32.7,281572,2288,280025,6.17,1.8,0.608348623853211,0.81,99.45
2020-12-05,Chhattisgarh,1195,11,1193,14985,3097,229,7.97,0,32.7,282767,2299,281218,9.47,0.7,0.4582568807339449,0.81,99.45
2020-12-06,Chhattisgarh,439,4,435,5467,3438,1373,8.03,0,32.7,283206,2303,281653,10.51,4.2,0.16718654434250763,0.81,99.45
2020-12-07,Chhattisgarh,695,5,687,8853,387,384,7.85,3,32.7,283901,2308,282340,1.18,1.17,0.2707339449541284,0.81,99.45
2020-12-08,Chhattisgarh,272,3,272,3691,1011,46,7.37,0,32.7,284173,2311,282612,3.09,0.14,0.11287461773700304,0.81,99.45
2020-12-09,Chhattisgarh,924,9,916,12171,1582,434,7.59,0,32.7,285097,2320,283528,4.84,1.33,0.3722018348623853,0.81,99.45
2020-12-10,Chhattisgarh,1150,7,1144,14333,654,156,8.02,0,32.7,286247,2327,284672,2.0,0.48,0.4383180428134556,0.81,99.45
2020-12-11,Chhattisgarh,1230,16,1228,15417,4726,2076,7.98,0,32.7,287477,2343,285900,14.45,6.35,0.47146788990825683,0.82,99.45
2020-12-12,Chhattisgarh,1330,5,1325,16817,2842,1985,7.91,0,32.7,288807,2348,287225,8.69,6.07,0.5142813455657492,0.81,99.45
2020-12-13,Chhattisgarh,359,4,359,4706,1758,1331,7.63,0,32.7,289166,2352,287584,5.38,4.07,0.143914373088685,0.81,99.45
2020-12-14,Chhattisgarh,814,7,813,10503,683,484,7.75,0,32.7,289980,2359,288397,2.09,1.48,0.3211926605504587,0.81,99.45
2020-12-15,Chhattisgarh,863,3,856,10592,2704,1988,8.15,4,32.7,290843,2362,289253,8.27,6.08,0.323914373088685,0.81,99.45
2020-12-16,Chhattisgarh,1090,12,1089,13575,2242,2104,8.03,0,32.7,291933,2374,290342,6.86,6.43,0.41513761467889904,0.81,99.46
2020-12-17,Chhattisgarh,746,11,738,9455,3141,571,7.89,0,32.7,292679,2385,291080,9.61,1.75,0.28914373088685014,0.81,99.45
2020-12-18,Chhattisgarh,1224,13,1224,15271,694,571,8.02,0,32.7,293903,2398,292304,2.12,1.75,0.46700305810397547,0.82,99.46
2020-12-19,Chhattisgarh,812,2,807,10194,306,287,7.97,3,32.7,294715,2400,293111,0.94,0.88,0.311743119266055,0.81,99.46
2020-12-20,Chhattisgarh,783,2,775,9716,1810,1293,8.06,6,32.7,295498,2402,293886,5.54,3.95,0.2971253822629969,0.81,99.45
2020-12-21,Chhattisgarh,1061,7,1061,13025,1361,240,8.15,0,32.7,296559,2409,294947,4.16,0.73,0.3983180428134556,0.81,99.46
2020-12-22,Chhattisgarh,145,0,136,1948,1933,1031,7.44,9,32.7,296704,2409,295083,5.91,3.15,0.05957186544342507,0.81,99.45
2020-12-23,Chhattisgarh,374,2,366,4658,1912,1113,8.03,6,32.7,297078,2411,295449,5.85,3.4,0.14244648318042813,0.81,99.45
2020-12-24,Chhattisgarh,304,1,296,3791,516,163,8.02,7,32.7,297382,2412,295745,1.58,0.5,0.11593272171253821,0.81,99.45
2020-12-25,Chhattisgarh,234,3,231,3134,4711,50,7.47,0,32.7,297616,2415,295976,14.41,0.15,0.09584097859327216,0.81,99.45
2020-12-26,Chhattisgarh,1041,5,1032,12690,2334,104,8.2,4,32.7,298657,2420,297008,7.14,0.32,0.3880733944954128,0.81,99.45
2020-12-27,Chhattisgarh,984,11,978,12030,4521,1497,8.18,0,32.7,299641,2431,297986,13.83,4.58,0.36788990825688067,0.81,99.45
2020-12-28,Chhattisgarh,1183,15,1175,14518,3188,3137,8.15,0,32.7,300824,2446,299161,9.75,9.59,0.44397553516819566,0.81,99.45
2020-12-29,Chhattisgarh,1223,11,1215,15249,4480,1301,8.02,0,32.7,302047,2457,300376,13.7,3.98,0.46633027522935777,0.81,99.45
2020-12-30,Chhattisgarh,1115,12,1106,13985,632,219,7.97,0,32.7,303162,2469,301482,1.93,0.67,0.42767584097859324,0.81,99.45
2020-12-31,Chhattisgarh,987,3,985,11788,2182,1112,8.37,0,32.7,304149,2472,302467,6.67,3.4,0.3604892966360856,0.81,99.45
2021-01-01,Chhattisgarh,36,0,33,591,2430,1219,6.09,3,32.7,304185,2472,302500,7.43,3.73,0.018073394495412842,0.81,99.45
2021-01-02,Chhattisgarh,1527,22,1518,19022,3142,62,8.03,0,32.7,305712,2494,304018,9.61,0.19,0.5817125382262996,0.82,99.45
2021-01-03,Chhattisgarh,1529,21,1523,19024,788,537,8.04,0,32.7,307241,2515,305541,2.41,1.64,0.5817737003058103,0.82,99.45
2021-01-04,Chhattisgarh,358,4,350,4175,3444,1323,8.57,4,32.7,307599,2519,305891,10.53,4.05,0.12767584097859325,0.82,99.44
2021-01-05,Chhattisgarh,1399,9,1391,17803,1987,1739,7.86,0,32.7,308998,2528,307282,6.08,5.32,0.5444342507645259,0.82,99.44
2021-01-06,Chhattisgarh,81,0,74,1230,1313,121,6.59,7,32.7,309079,2528,307356,4.02,0.37,0.037614678899082564,0.82,99.44
2021-01-07,Chhattisgarh,631,4,631,8456,3170,655,7.46,0,32.7,309710,2532,307987,9.69,2.0,0.2585932721712538,0.82,99.44
2021-01-08,Chhattisgarh,132,1,132,1950,1763,328,6.77,0,32.7,309842,2533,308119,5.39,1.0,0.059633027522935776,0.82,99.44
2021-01-09,Chhattisgarh,670,10,663,8435,651,289,7.94,0,32.7,310512,2543,308782,1.99,0.88,0.2579510703363914,0.82,99.44
2021-01-10,Chhattisgarh,536,4,533,6731,4471,76,7.96,0,32.7,311048,2547,309315,13.67,0.23,0.20584097859327216,0.82,99.44
2021-01-11,Chhattisgarh,1283,5,1278,16037,2723,707,8.0,0,32.7,312331,2552,310593,8.33,2.16,0.49042813455657486,0.82,99.44
2021-01-12,Chhattisgarh,173,0,164,2389,1619,564,7.24,9,32.7,312504,2552,310757,4.95,1.72,0.07305810397553517,0.82,99.44
2021-01-13,Chhattisgarh,516,4,514,6670,3653,1839,7.74,0,32.7,313020,2556,311271,11.17,5.62,0.2039755351681957,0.82,99.44
2021-01-14,Chhattisgarh,898,4,895,11422,3085,2181,7.86,0,32.7,313918,2560,312166,9.43,6.67,0.3492966360856269,0.82,99.44
2021-01-15,Chhattisgarh,1435,14,1428,18111,4607,2882,7.92,0,32.7,315353,2574,313594,14.09,8.81,0.5538532110091743,0.82,99.44
2021-01-16,Chhattisgarh,743,4,739,9633,402,138,7.71,0,32.7,316096,2578,314333,1.23,0.42,0.2945871559633027,0.82,99.44
2021-01-17,Chhattisgarh,1304,7,1299,16581,3353,527,7.86,0,32.7,317400,2585,315632,10.25,1.61,0.5070642201834862,0.81,99.44
2021-01-18,Chhattisgarh,67,0,65,545,1940,1775,12.29,2,32.7,317467,2585,315697,5.93,5.43,0.016666666666666666,0.81,99.44
2021-01-19,Chhattisgarh,1392,5,1385,17339,861,309,8.03,2,32.7,318859,2590,317082,2.63,0.94,0.5302446483180427,0.81,99.44
2021-01-20,Chhattisgarh,82,0,73,925,1493,719,8.86,9,32.7,318941,2590,317155,4.57,2.2,0.0282874617737003,0.81,99.44
2021-01-21,Chhattisgarh,581,8,573,7278,2900,1636,7.98,0,32.7,319522,2598,317728,8.87,5.0,0.2225688073394495,0.81,99.44
2021-01-22,Chhattisgarh,487,5,479,6412,3848,846,7.6,3,32.7,320009,2603,318207,11.77,2.59,0.19608562691131495,0.81,99.44
2021-01-23,Chhattisgarh,286,2,283,3398,1018,1018,8.42,1,32.7,320295,2605,318490,3.11,3.11,0.10391437308868501,0.81,99.44
2021-01-24,Chhattisgarh,346,1,337,4343,322,206,7.97,8,32.7,320641,2606,318827,0.98,0.63,0.13281345565749234,0.81,99.43
2021-01-25,Chhattisgarh,471,1,468,5649,3334,1056,8.34,2,32.7,321112,2607,319295,10.2,3.23,0.17275229357798164,0.81,99.43
2021-01-26,Chhattisgarh,1177,7,1171,14783,2333,1483,7.96,0,32.7,322289,2614,320466,7.13,4.54,0.4520795107033639,0.81,99.43
2021-01-27,Chhattisgarh,1080,3,1071,13334,2365,2039,8.1,6,32.7,323369,2617,321537,7.23,6.24,0.4077675840978593,0.81,99.43
2021-01-28,Chhattisgarh,1059,14,1059,13001,4868,2843,8.15,0,32.7,324428,2631,322596,14.89,8.69,0.3975840978593272,0.81,99.44
2021-01-29,Chhattisgarh,1197,8,1194,14724,3787,2390,8.13,0,32.7,325625,2639,323790,11.58,7.31,0.4502752293577981,0.81,99.44
2021-01-30,Chhattisgarh,1520,19,1511,19187,2967,2470,7.92,0,32.7,327145,2658,325301,9.07,7.55,0.5867584097859326,0.81,99.44
2021-01-31,Chhattisgarh,789,8,789,10464,3771,1431,7.54,0,32.7,327934,2666,326090,11.53,4.38,0.31999999999999995,0.81,99.44
2021-02-01,Chhattisgarh,1267,12,1258,16164,3058,1123,7.84,0,32.7,329201,2678,327348,9.35,3.43,0.49431192660550455,0.81,99.44
2021-02-02,Chhattisgarh,1290,10,1281,16187,1649,1596,7.97,0,32.7,330491,2688,328629,5.04,4.88,0.49501529051987764,0.81,99.44
2021-02-03,Chhattisgarh,54,0,54,754,391,280,7.16,0,32.7,330545,2688,328683,1.2,0.86,0.023058103975535166,0.81,99.44
2021-02-04,Chhattisgarh,833,6,832,10972,593,519,7.59,0,32.7,331378,2694,329515,1.81,1.59,0.3355351681957186,0.81,99.44
2021-02-05,Chhattisgarh,757,2,755,9442,4792,1776,8.02,0,32.7,332135,2696,330270,14.65,5.43,0.28874617737003055,0.81,99.44
2021-02-06,Chhattisgarh,92,0,85,883,4828,728,10.42,7,32.7,332227,2696,330355,14.76,2.23,0.027003058103975533,0.81,99.44
2021-02-07,Chhattisgarh,1267,3,1260,15965,1788,519,7.94,4,32.7,333494,2699,331615,5.47,1.59,0.48822629969418957,0.81,99.44
2021-02-08,Chhattisgarh,1489,9,1482,18872,4081,801,7.89,0,32.7,334983,2708,333097,12.48,2.45,0.5771253822629969,0.81,99.44
2021-02-09,Chhattisgarh,223,2,218,2481,2610,431,8.99,3,32.7,335206,2710,333315,7.98,1.32,0.07587155963302751,0.81,99.44
2021-02-10,Chhattisgarh,426,5,420,5563,1766,939,7.66,1,32.7,335632,2715,333735,5.4,2.87,0.1701223241590214,0.81,99.43
2021-02-11,Chhattisgarh,1054,6,1048,12829,705,175,8.22,0,32.7,336686,2721,334783,2.16,0.54,0.39232415902140666,0.81,99.43
2021-02-12,Chhattisgarh,514,5,514,5859,1770,463,8.77,0,32.7,337200,2726,335297,5.41,1.42,0.1791743119266055,0.81,99.44
2021-02-13,Chhattisgarh,1377,13,1370,17393,3505,1383,7.92,0,32.7,338577,2739,336667,10.72,4.23,0.5318960244648318,0.81,99.44
2021-02-14,Chhattisgarh,155,1,148,2332,4140,2311,6.65,6,32.7,338732,2740,336815,12.66,7.07,0.07131498470948011,0.81,99.43
2021-02-15,Chhattisgarh,1325,14,1317,16804,4234,2532,7.89,0,32.7,340057,2754,338132,12.95,7.74,0.5138837920489296,0.81,99.43
2021-02-16,Chhattisgarh,84,0,84,1161,1072,249,7.24,0,32.7,340141,2754,338216,3.28,0.76,0.0355045871559633,0.81,99.43
2021-02-17,Chhattisgarh,654,4,650,7961,4347,54,8.22,0,32.7,340795,2758,338866,13.29,0.17,0.2434556574923547,0.81,99.43
2021-02-18,Chhattisgarh,260,3,251,3284,4065,156,7.92,6,32.7,341055,2761,339117,12.43,0.48,0.10042813455657491,0.81,99.43
2021-02-19,Chhattisgarh,235,2,231,2955,1601,926,7.95,2,32.7,341290,2763,339348,4.9,2.83,0.09036697247706421,0.81,99.43
2021-02-20,Chhattisgarh,1560,8,1553,19553,3792,577,7.98,0,32.7,342850,2771,340901,11.6,1.76,0.5979510703363914,0.81,99.43
2021-02-21,Chhattisgarh,1097,3,1088,13110,2377,1246,8.37,6,32.7,343947,2774,341989,7.27,3.81,0.4009174311926605,0.81,99.43
2021-02-22,Chhattisgarh,870,2,865,11186,2081,947,7.78,3,32.7,344817,2776,342854,6.36,2.9,0.3420795107033639,0.81,99.43
2021-02-23,Chhattisgarh,1198,4,1192,14804,4631,3454,8.09,2,32.7,346015,2780,344046,14.16,10.56,0.45272171253822624,0.8,99.43
2021-02-24,Chhattisgarh,605,5,600,7949,4959,3138,7.61,0,32.7,346620,2785,344646,15.17,9.6,0.2430886850152905,0.8,99.43
2021-02-25,Chhattisgarh,255,1,252,3396,3795,3772,7.51,2,32.7,346875,2786,344898,11.61,11.54,0.1038532110091743,0.8,99.43
2021-02-26,Chhattisgarh,1571,19,1566,19953,3384,2855,7.87,0,32.7,348446,2805,346464,10.35,8.73,0.610183486238532,0.81,99.43
2021-02-27,Chhattisgarh,289,1,288,4021,1796,685,7.19,0,32.7,348735,2806,346752,5.49,2.09,0.1229663608562691,0.8,99.43
2021-02-28,Chhattisgarh,757,11,754,9674,3438,137,7.83,0,32.7,349492,2817,347506,10.51,0.42,0.29584097859327213,0.81,99.43
2021-03-01,Chhattisgarh,1288,12,1279,16028,4823,4684,8.04,0,32.7,350780,2829,348785,14.75,14.32,0.4901529051987767,0.81,99.43
2021-03-02,Chhattisgarh,488,5,486,5743,665,121,8.5,0,32.7,351268,2834,349271,2.03,0.37,0.1756269113149847,0.81,99.43
2021-03-03,Chhattisgarh,989,11,987,12348,4524,2241,8.01,0,32.7,352257,2845,350258,13.83,6.85,0.3776146788990825,0.81,99.43
2021-03-04,Chhattisgarh,486,2,482,5996,2982,1000,8.11,2,32.7,352743,2847,350740,9.12,3.06,0.18336391437308866,0.81,99.43
2021-03-05,Chhattisgarh,510,3,505,6669,1883,832,7.65,2,32.7,353253,2850,351245,5.76,2.54,0.20394495412844035,0.81,99.43
2021-03-06,Chhattisgarh,788,10,788,9935,349,161,7.93,0,32.7,354041,2860,352033,1.07,0.49,0.30382262996941894,0.81,99.43
2021-03-07,Chhattisgarh,1516,12,1512,19230,2397,1058,7.88,0,32.7,355557,2872,353545,7.33,3.24,0.5880733944954127,0.81,99.43
2021-03-08,Chhattisgarh,760,4,758,8952,1867,1514,8.49,0,32.7,356317,2876,354303,5.71,4.63,0.27376146788990824,0.81,99.43
2021-03-09,Chhattisgarh,931,13,926,11673,3323,2204,7.98,0,32.7,357248,2889,355229,10.16,6.74,0.35697247706422014,0.81,99.43
2021-03-10,Chhattisgarh,901,2,896,11397,4583,3372,7.91,3,32.7,358149,2891,356125,14.02,10.31,0.34853211009174306,0.81,99.43
2021-03-11,Chhattisgarh,818,9,809,10151,3078,475,8.06,0,32.7,358967,2900,356934,9.41,1.45,0.31042813455657486,0.81,99.43
2021-03-12,Chhattisgarh,678,4,677,8285,1624,245,8.18,0,32.7,359645,2904,357611,4.97,0.75,0.25336391437308864,0.81,99.43
2021-03-13,Chhattisgarh,1037,7,1037,13149,2614,1683,7.89,0,32.7,360682,2911,358648,7.99,5.15,0.40211009174311924,0.81,99.44
2021-03-14,Chhattisgarh,1233,5,1229,15700,2206,1402,7.85,0,32.7,361915,2916,359877,6.75,4.29,0.48012232415902134,0.81,99.44
2021-03-15,Chhattisgarh,38,0,35,729,3042,2076,5.21,3,32.7,361953,2916,359912,9.3,6.35,0.022293577981651373,0.81,99.44
2021-03-16,Chhattisgarh,722,4,718,8711,2309,1276,8.29,0,32.7,362675,2920,360630,7.06,3.9,0.2663914373088685,0.81,99.44
2021-03-17,Chhattisgarh,389,2,387,4895,1299,1153,7.95,0,32.7,363064,2922,361017,3.97,3.53,0.14969418960244646,0.8,99.44
2021-03-18,Chhattisgarh,356,4,356,4172,1449,392,8.53,0,32.7,363420,2926,361373,4.43,1.2,0.1275840978593272,0.81,99.44
2021-03-19,Chhattisgarh,360,4,357,4521,3316,1556,7.96,0,32.7,363780,2930,361730,10.14,4.76,0.13825688073394493,0.81,99.44
2021-03-20,Chhattisgarh,609,6,609,7917,4062,472,7.69,0,32.7,364389,2936,362339,12.42,1.44,0.24211009174311923,0.81,99.44
2021-03-21,Chhattisgarh,185,2,185,2338,1800,192,7.91,0,32.7,364574,2938,362524,5.5,0.59,0.07149847094801222,0.81,99.44
2021-03-22,Chhattisgarh,889,3,884,10523,1722,393,8.45,2,32.7,365463,2941,363408,5.27,1.2,0.3218042813455657,0.8,99.44
2021-03-23,Chhattisgarh,1458,15,1454,18424,3509,770,7.91,0,32.7,366921,2956,364862,10.73,2.35,0.5634250764525993,0.81,99.44
2021-03-24,Chhattisgarh,1617,9,1611,19870,4301,92,8.14,0,32.7,368538,2965,366473,13.15,0.28,0.6076452599388379,0.8,99.44
2021-03-25,Chhattisgarh,222,2,213,2999,2703,2464,7.4,7,32.7,368760,2967,366686,8.27,7.54,0.09171253822629968,0.8,99.44
2021-03-26,Chhattisgarh,271,3,267,3532,1864,1550,7.67,1,32.7,369031,2970,366953,5.7,4.74,0.10801223241590213,0.8,99.44
2021-03-27,Chhattisgarh,393,5,392,5192,1132,280,7.57,0,32.7,369424,2975,367345,3.46,0.86,0.15877675840978592,0.81,99.44
2021-03-28,Chhattisgarh,946,8,940,12188,2359,1565,7.76,0,32.7,370370,2983,368285,7.21,4.79,0.3727217125382263,0.81,99.44
2021-03-29,Chhattisgarh,707,8,699,8798,3525,2308,8.04,0,32.7,371077,2991,368984,10.78,7.06,0.26905198776758404,0.81,99.44
2021-03-30,Chhattisgarh,821,10,820,10221,3151,1447,8.03,0,32.7,371898,3001,369804,9.64,4.43,0.31256880733944953,0.81,99.44
2021-03-31,Chhattisgarh,347,4,345,4381,4010,113,7.92,0,32.7,372245,3005,370149,12.26,0.35,0.13397553516819571,0.81,99.44
2021-04-01,Chhattisgarh,279,3,271,3796,2351,638,7.35,5,32.7,372524,3008,370420,7.19,1.95,0.11608562691131497,0.81,99.44
2021-04-02,Chhattisgarh,433,3,427,5457,2254,444,7.93,3,32.7,372957,3011,370847,6.89,1.36,0.16688073394495412,0.81,99.43
2021-04-03,Chhattisgarh,550,6,542,6806,226,202,8.08,2,32.7,373507,3017,371389,0.69,0.62,0.20813455657492352,0.81,99.43
2021-04-04,Chhattisgarh,640,8,635,8126,1145,634,7.88,0,32.7,374147,3025,372024,3.5,1.94,0.24850152905198775,0.81,99.43
2021-04-05,Chhattisgarh,1611,23,1608,19835,3112,2298,8.12,0,32.7,375758,3048,373632,9.52,7.03,0.6065749235474005,0.81,99.43
2021-04-06,Chhattisgarh,249,1,249,2858,3355,1208,8.71,0,32.7,376007,3049,373881,10.26,3.69,0.0874006116207951,0.81,99.43
2021-04-07,Chhattisgarh,675,5,670,8594,1120,578,7.85,0,32.7,376682,3054,374551,3.43,1.77,0.2628134556574923,0.81,99.43
2021-04-08,Chhattisgarh,716,6,708,8922,207,171,8.03,2,32.7,377398,3060,375259,0.63,0.52,0.27284403669724766,0.81,99.43
2021-04-09,Chhattisgarh,1228,13,1224,15432,786,510,7.96,0,32.7,378626,3073,376483,2.4,1.56,0.4719266055045871,0.81,99.43
2021-04-10,Chhattisgarh,50,0,47,741,62,49,6.75,3,32.7,378676,3073,376530,0.19,0.15,0.022660550458715595,0.81,99.43
2021-04-11,Chhattisgarh,1540,6,1539,19269,2050,1246,7.99,0,32.7,380216,3079,378069,6.27,3.81,0.5892660550458715,0.81,99.44
2021-04-12,Chhattisgarh,209,2,208,2326,3144,360,8.99,0,32.7,380425,3081,378277,9.61,1.1,0.071131498470948,0.81,99.44
2021-04-13,Chhattisgarh,1066,5,1062,12869,2771,1668,8.28,0,32.7,381491,3086,379339,8.47,5.1,0.39354740061162075,0.81,99.44
2021-04-14,Chhattisgarh,943,13,940,12373,1641,1130,7.62,0,32.7,382434,3099,380279,5.02,3.46,0.37837920489296634,0.81,99.44
2021-04-15,Chhattisgarh,1178,10,1176,14567,3710,514,8.09,0,32.7,383612,3109,381455,11.35,1.57,0.4454740061162079,0.81,99.44
2021-04-16,Chhattisgarh,148,1,147,1866,832,343,7.93,0,32.7,383760,3110,381602,2.54,1.05,0.05706422018348623,0.81,99.44
2021-04-17,Chhattisgarh,661,8,660,8214,3415,2805,8.05,0,32.7,384421,3118,382262,10.44,8.58,0.2511926605504587,0.81,99.44
2021-04-18,Chhattisgarh,1320,18,1317,16561,237,229,7.97,0,32.7,385741,3136,383579,0.72,0.7,0.5064525993883792,0.81,99.44
2021-04-19,Chhattisgarh,1306,14,1301,16143,2870,1490,8.09,0,32.7,387047,3150,384880,8.78,4.56,0.49366972477064214,0.81,99.44
2021-04-20,Chhattisgarh,856,11,849,10520,4151,975,8.14,0,32.7,387903,3161,385729,12.69,2.98,0.32171253822629964,0.81,99.44
2021-04-21,Chhattisgarh,1249,9,1246,15860,386,279,7.88,0,32.7,389152,3170,386975,1.18,0.85,0.48501529051987763,0.81,99.44
2021-04-22,Chhattisgarh,1352,11,1350,16830,376,118,8.03,0,32.7,390504,3181,388325,1.15,0.36,0.5146788990825687,0.81,99.44
2021-04-23,Chhattisgarh,510,2,503,6062,1298,896,8.41,5,32.7,391014,3183,388828,3.97,2.74,0.18538226299694188,0.81,99.44
2021-04-24,Chhattisgarh,458,2,458,5775,2642,2431,7.93,0,32.7,391472,3185,389286,8.08,7.43,0.17660550458715593,0.81,99.44
2021-04-25,Chhattisgarh,878,12,870,11060,4654,2090,7.94,0,32.7,392350,3197,390156,14.23,6.39,0.33822629969418955,0.81,99.44
2021-04-26,Chhattisgarh,62,0,61,957,3543,1520,6.48,1,32.7,392412,3197,390217,10.83,4.65,0.029266055045871556,0.81,99.44
2021-04-27,Chhattisgarh,703,5,694,8884,1722,157,7.91,4,32.7,393115,3202,390911,5.27,0.48,0.2716819571865443,0.81,99.44
2021-04-28,Chhattisgarh,1148,14,1146,14339,1059,139,8.01,0,32.7,394263,3216,392057,3.24,0.43,0.4385015290519877,0.82,99.44
2021-04-29,Chhattisgarh,75,0,72,660,3773,1401,11.36,3,32.7,394338,3216,392129,11.54,4.28,0.020183486238532108,0.82,99.44
2021-04-30,Chhattisgarh,622,5,613,7626,3713,213,8.16,4,32.7,394960,3221,392742,11.35,0.65,0.2332110091743119,0.82,99.44
2021-05-01,Chhattisgarh,550,3,545,6766,2505,2083,8.13,2,32.7,395510,3224,393287,7.66,6.37,0.20691131498470947,0.82,99.44
2021-05-02,Chhattisgarh,864,11,859,10283,1322,693,8.4,0,32.7,396374,3235,394146,4.04,2.12,0.3144648318042813,0.82,99.44
2021-05-03,Chhattisgarh,1397,12,1393,17630,2534,1303,7.92,0,32.7,397771,3247,395539,7.75,3.98,0.5391437308868501,0.82,99.44
2021-05-04,Chhattisgarh,349,4,346,4474,4019,3188,7.8,0,32.7,398120,3251,395885,12.29,9.75,0.1368195718654434,0.82,99.44
2021-05-05,Chhattisgarh,1346,18,1339,16751,210,149,8.04,0,32.7,399466,3269,397224,0.64,0.46,0.5122629969418959,0.82,99.44
2021-05-06,Chhattisgarh,1474,11,1470,18976,2343,1976,7.77,0,32.7,400940,3280,398694,7.17,6.04,0.5803058103975535,0.82,99.44
2021-05-07,Chhattisgarh,1289,12,1286,16435,4398,163,7.84,0,32.7,402229,3292,399980,13.45,0.5,0.5025993883792048,0.82,99.44
2021-05-08,Chhattisgarh,850,5,844,10895,284,277,7.8,1,32.7,403079,3297,400824,0.87,0.85,0.33318042813455656,0.82,99.44
2021-05-09,Chhattisgarh,1524,18,1519,19199,1248,543,7.94,0,32.7,404603,3315,402343,3.82,1.66,0.5871253822629968,0.82,99.44
2021-05-10,Chhattisgarh,44,0,42,1038,3948,62,4.24,2,32.7,404647,3315,402385,12.07,0.19,0.03174311926605504,0.82,99.44
2021-05-11,Chhattisgarh,279,3,279,3416,22,19,8.17,0,32.7,404926,3318,402664,0.07,0.06,0.10446483180428133,0.82,99.44
2021-05-12,Chhattisgarh,713,6,711,8522,227,200,8.37,0,32.7,405639,3324,403375,0.69,0.61,0.260611620795107,0.82,99.44
2021-05-13,Chhattisgarh,1551,22,1549,19440,3093,1920,7.98,0,32.7,407190,3346,404924,9.46,5.87,0.5944954128440366,0.82,99.44
2021-05-14,Chhattisgarh,1621,14,1614,19939,4277,1936,8.13,0,32.7,408811,3360,406538,13.08,5.92,0.6097553516819572,0.82,99.44
2021-05-15,Chhattisgarh,739,3,736,9226,1525,1446,8.01,0,32.7,409550,3363,407274,4.66,4.42,0.2821406727828746,0.82,99.44
2021-05-16,Chhattisgarh,1543,10,1538,19455,3368,466,7.93,0,32.7,411093,3373,408812,10.3,1.43,0.5949541284403669,0.82,99.45
2021-05-17,Chhattisgarh,284,3,284,3470,2169,1861,8.18,0,32.7,411377,3376,409096,6.63,5.69,0.10611620795107032,0.82,99.45
2021-05-18,Chhattisgarh,835,2,832,10630,1007,666,7.86,1,32.7,412212,3378,409928,3.08,2.04,0.32507645259938833,0.82,99.45
2021-05-19,Chhattisgarh,158,1,155,2025,1736,761,7.8,2,32.7,412370,3379,410083,5.31,2.33,0.061926605504587146,0.82,99.45
2021-05-20,Chhattisgarh,250,1,242,2762,3453,2323,9.05,7,32.7,412620,3380,410325,10.56,7.1,0.08446483180428134,0.82,99.44
2021-05-21,Chhattisgarh,126,0,118,1887,4055,1599,6.68,8,32.7,412746,3380,410443,12.4,4.89,0.057706422018348615,0.82,99.44
2021-05-22,Chhattisgarh,1162,13,1155,14258,982,184,8.15,0,32.7,413908,3393,411598,3.0,0.56,0.43602446483180424,0.82,99.44
2021-05-23,Chhattisgarh,22,0,22,774,2157,1843,2.84,0,32.7,413930,3393,411620,6.6,5.64,0.0236697247706422,0.82,99.44
2021-05-24,Chhattisgarh,92,1,84,1202,2141,174,7.65,7,32.7,414022,3394,411704,6.55,0.53,0.03675840978593272,0.82,99.44
2021-05-25,Chhattisgarh,1306,6,1299,16710,3979,186,7.82,1,32.7,415328,3400,413003,12.17,0.57,0.5110091743119265,0.82,99.44
2021-05-26,Chhattisgarh,794,5,785,10040,1064,663,7.91,4,32.7,416122,3405,413788,3.25,2.03,0.30703363914373083,0.82,99.44
2021-05-27,Chhattisgarh,1395,5,1393,17340,1579,418,8.04,0,32.7,417517,3410,415181,4.83,1.28,0.5302752293577981,0.82,99.44
2021-05-28,Chhattisgarh,268,2,264,3597,4874,4560,7.45,2,32.7,417785,3412,415445,14.91,13.94,0.10999999999999999,0.82,99.44
2021-05-29,Chhattisgarh,1501,10,1499,18310,1493,370,8.2,0,32.7,419286,3422,416944,4.57,1.13,0.5599388379204893,0.82,99.44
2021-05-30,Chhattisgarh,1477,9,1475,18359,400,219,8.05,0,32.7,420763,3431,418419,1.22,0.67,0.5614373088685015,0.82,99.44
2021-05-31,Chhattisgarh,675,5,669,8556,1104,837,7.89,1,32.7,421438,3436,419088,3.38,2.56,0.26165137614678896,0.82,99.44
2021-06-01,Chhattisgarh,846,10,843,10678,4765,3122,7.92,0,32.7,422284,3446,419931,14.57,9.55,0.32654434250764525,0.82,99.44
2021-06-02,Chhattisgarh,1046,8,1039,12991,315,213,8.05,0,32.7,423330,3454,420970,0.96,0.65,0.3972782874617737,0.82,99.44
2021-06-03,Chhattisgarh,631,8,629,7974,3548,2347,7.91,0,32.7,423961,3462,421599,10.85,7.18,0.2438532110091743,0.82,99.44
2021-06-04,Chhattisgarh,1304,14,1303,16391,2680,1225,7.96,0,32.7,425265,3476,422902,8.2,3.75,0.5012538226299693,0.82,99.44
2021-06-05,Chhattisgarh,1525,22,1525,18986,4927,857,8.03,0,32.7,426790,3498,424427,15.07,2.62,0.580611620795107,0.82,99.45
2021-06-06,Chhattisgarh,1401,4,1400,17363,1131,549,8.07,0,32.7,428191,3502,425827,3.46,1.68,0.5309785932721712,0.82,99.45
2021-06-07,Chhattisgarh,1441,21,1439,17925,1631,1070,8.04,0,32.7,429632,3523,427266,4.99,3.27,0.5481651376146789,0.82,99.45
2021-06-08,Chhattisgarh,1233,17,1226,15629,955,4,7.89,0,32.7,430865,3540,428492,2.92,0.01,0.4779510703363914,0.82,99.45
2021-06-09,Chhattisgarh,1179,7,1173,14865,1184,227,7.93,0,32.7,432044,3547,429665,3.62,0.69,0.4545871559633027,0.82,99.45
2021-06-10,Chhattisgarh,1406,13,1404,17870,673,536,7.87,0,32.7,433450,3560,431069,2.06,1.64,0.5464831804281345,0.82,99.45
2021-06-11,Chhattisgarh,963,11,961,11880,436,2,8.11,0,32.7,434413,3571,432030,1.33,0.01,0.36330275229357795,0.82,99.45
2021-06-12,Chhattisgarh,1168,17,1168,13815,450,220,8.45,0,32.7,435581,3588,433198,1.38,0.67,0.42247706422018344,0.82,99.45
2021-06-13,Chhattisgarh,161,1,158,2134,492,259,7.54,2,32.7,435742,3589,433356,1.5,0.79,0.06525993883792049,0.82,99.45
2021-06-14,Chhattisgarh,213,1,208,2577,4842,3064,8.27,4,32.7,435955,3590,433564,14.81,9.37,0.07880733944954127,0.82,99.45
2021-06-15,Chhattisgarh,703,7,698,8914,4159,355,7.89,0,32.7,436658,3597,434262,12.72,1.09,0.2725993883792049,0.82,99.45
2021-06-16,Chhattisgarh,254,2,252,3130,3854,1257,8.12,0,32.7,436912,3599,434514,11.79,3.84,0.09571865443425075,0.82,99.45
2021-06-17,Chhattisgarh,376,2,368,4671,981,436,8.05,6,32.7,437288,3601,434882,3.0,1.33,0.14284403669724768,0.82,99.45
2021-06-18,Chhattisgarh,176,1,175,2266,1277,839,7.77,0,32.7,437464,3602,435057,3.91,2.57,0.0692966360856269,0.82,99.45
2021-06-19,Chhattisgarh,1453,13,1447,18094,4301,305,8.03,0,32.7,438917,3615,436504,13.15,0.93,0.5533333333333332,0.82,99.45
2021-06-20,Chhattisgarh,810,2,806,10366,1051,681,7.81,2,32.7,439727,3617,437310,3.21,2.08,0.3170030581039755,0.82,99.45
2021-06-21,Chhattisgarh,862,12,861,10893,1802,980,7.91,0,32.7,440589,3629,438171,5.51,3.0,0.3331192660550458,0.82,99.45
2021-06-22,Chhattisgarh,1573,15,1567,19889,2430,1030,7.91,0,32.7,442162,3644,439738,7.43,3.15,0.6082262996941895,0.82,99.45
2021-06-23,Chhattisgarh,910,10,906,11370,2655,1770,8.0,0,32.7,443072,3654,440644,8.12,5.41,0.34770642201834856,0.82,99.45
2021-06-24,Chhattisgarh,1388,9,1388,17841,840,277,7.78,0,32.7,444460,3663,442032,2.57,0.85,0.5455963302752292,0.82,99.45
2021-06-25,Chhattisgarh,1271,12,1269,15304,2360,1490,8.31,0,32.7,445731,3675,443301,7.22,4.56,0.46801223241590206,0.82,99.45
2021-06-26,Chhattisgarh,1073,14,1070,13323,2067,1884,8.05,0,32.7,446804,3689,444371,6.32,5.76,0.4074311926605504,0.83,99.46
2021-06-27,Chhattisgarh,395,5,389,4793,387,224,8.24,1,32.7,447199,3694,444760,1.18,0.69,0.1465749235474006,0.83,99.45
2021-06-28,Chhattisgarh,933,4,925,11887,3080,2685,7.85,4,32.7,448132,3698,445685,9.42,8.21,0.3635168195718654,0.83,99.45
2021-06-29,Chhattisgarh,170,1,167,1689,4544,2695,10.07,2,32.7,448302,3699,445852,13.9,8.24,0.05165137614678898,0.83,99.45
2021-06-30,Chhattisgarh,964,6,963,12567,276,261,7.67,0,32.7,449266,3705,446815,0.84,0.8,0.38431192660550456,0.82,99.45
2021-07-01,Chhattisgarh,1031,7,1029,12631,3449,2392,8.16,0,32.7,450297,3712,447844,10.55,7.31,0.3862691131498471,0.82,99.46
2021-07-02,Chhattisgarh,890,9,889,10722,1977,643,8.3,0,32.7,451187,3721,448733,6.05,1.97,0.3278899082568807,0.82,99.46
2021-07-03,Chhattisgarh,1571,17,1570,19399,3586,3335,8.1,0,32.7,452758,3738,450303,10.97,10.2,0.5932415902140672,0.83,99.46
2021-07-04,Chhattisgarh,1156,10,1155,14318,1718,1007,8.07,0,32.7,453914,3748,451458,5.25,3.08,0.43785932721712534,0.83,99.46
2021-07-05,Chhattisgarh,337,1,336,3970,2383,409,8.49,0,32.7,454251,3749,451794,7.29,1.25,0.12140672782874616,0.83,99.46
2021-07-06,Chhattisgarh,1068,11,1063,13055,3825,1887,8.18,0,32.7,455319,3760,452857,11.7,5.77,0.39923547400611614,0.83,99.46
2021-07-07,Chhattisgarh,1382,8,1375,17352,1754,1158,7.96,0,32.7,456701,3768,454232,5.36,3.54,0.5306422018348623,0.83,99.46
2021-07-08,Chhattisgarh,1491,17,1485,18836,3491,2119,7.92,0,32.7,458192,3785,455717,10.68,6.48,0.5760244648318043,0.83,99.46
2021-07-09,Chhattisgarh,1053,5,1044,13361,95,29,7.88,4,32.7,459245,3790,456761,0.29,0.09,0.4085932721712538,0.83,99.46
2021-07-10,Chhattisgarh,1255,5,1252,15389,4552,2486,8.16,0,32.7,460500,3795,458013,13.92,7.6,0.470611620795107,0.82,99.46
2021-07-11,Chhattisgarh,1443,18,1438,17584,719,544,8.21,0,32.7,461943,3813,459451,2.2,1.66,0.5377370030581039,0.83,99.46
2021-07-12,Chhattisgarh,98,1,90,1266,997,138,7.74,7,32.7,462041,3814,459541,3.05,0.42,0.03871559633027522,0.83,99.46
2021-07-13,Chhattisgarh,1222,11,1220,15428,1300,455,7.92,0,32.7,463263,3825,460761,3.98,1.39,0.4718042813455657,0.83,99.46
2021-07-14,Chhattisgarh,634,3,629,7966,2848,1405,7.96,2,32.7,463897,3828,461390,8.71,4.3,0.24360856269113146,0.83,99.46
2021-07-15,Chhattisgarh,216,2,211,2685,4326,88,8.04,3,32.7,464113,3830,461601,13.23,0.27,0.08211009174311926,0.83,99.46
2021-07-16,Chhattisgarh,916,2,909,11546,4393,56,7.93,5,32.7,465029,3832,462510,13.43,0.17,0.3530886850152905,0.82,99.46
2021-07-17,Chhattisgarh,1437,21,1433,17629,2873,59,8.15,0,32.7,466466,3853,463943,8.79,0.18,0.5391131498470947,0.83,99.46
2021-07-18,Chhattisgarh,1553,11,1546,19690,3922,2438,7.89,0,32.7,468019,3864,465489,11.99,7.46,0.6021406727828745,0.83,99.46
2021-07-19,Chhattisgarh,1299,16,1292,16216,2067,2006,8.01,0,32.7,469318,3880,466781,6.32,6.13,0.4959021406727828,0.83,99.46
2021-07-20,Chhattisgarh,568,3,565,7790,1295,221,7.29,0,32.7,469886,3883,467346,3.96,0.68,0.23822629969418957,0.83,99.46
2021-07-21,Chhattisgarh,1291,13,1286,16044,2388,1587,8.05,0,32.7,471177,3896,468632,7.3,4.85,0.49064220183486235,0.83,99.46
2021-07-22,Chhattisgarh,841,4,834,10278,653,585,8.18,3,32.7,472018,3900,469466,2.0,1.79,0.31431192660550455,0.83,99.46
2021-07-23,Chhattisgarh,208,2,201,2170,2752,2452,9.59,5,32.7,472226,3902,469667,8.42,7.5,0.06636085626911314,0.83,99.46
2021-07-24,Chhattisgarh,1444,4,1437,17936,869,630,8.05,3,32.7,473670,3906,471104,2.66,1.93,0.5485015290519877,0.82,99.46
2021-07-25,Chhattisgarh,1371,11,1366,17015,15,11,8.06,0,32.7,475041,3917,472470,0.05,0.03,0.5203363914373088,0.82,99.46
2021-07-26,Chhattisgarh,1092,10,1089,13585,1554,1336,8.04,0,32.7,476133,3927,473559,4.75,4.09,0.41544342507645254,0.82,99.46
2021-07-27,Chhattisgarh,1332,15,1328,17032,1869,1837,7.82,0,32.7,477465,3942,474887,5.72,5.62,0.5208562691131498,0.83,99.46
2021-07-28,Chhattisgarh,81,1,73,972,1920,1825,8.33,7,32.7,477546,3943,474960,5.87,5.58,0.02972477064220183,0.83,99.46
2021-07-29,Chhattisgarh,954,13,953,11548,4965,3652,8.26,0,32.7,478500,3956,475913,15.18,11.17,0.3531498470948012,0.83,99.46
2021-07-30,Chhattisgarh,82,0,80,751,2395,595,10.92,2,32.7,478582,3956,475993,7.32,1.82,0.02296636085626911,0.83,99.46
2021-07-31,Chhattisgarh,1086,6,1086,13324,4639,2441,8.15,0,32.7,479668,3962,477079,14.19,7.46,0.4074617737003058,0.83,99.46
2021-08-01,Chhattisgarh,810,4,807,10417,1446,568,7.78,0,32.7,480478,3966,477886,4.42,1.74,0.31856269113149843,0.83,99.46
2021-08-02,Chhattisgarh,118,1,115,1478,2714,139,7.98,2,32.7,480596,3967,478001,8.3,0.43,0.04519877675840978,0.83,99.46
2021-08-03,Chhattisgarh,725,3,723,9025,1037,821,8.03,0,32.7,481321,3970,478724,3.17,2.51,0.2759938837920489,0.82,99.46
2021-08-04,Chhattisgarh,1087,11,1087,13541,3907,2736,8.03,0,32.7,482408,3981,479811,11.95,8.37,0.4140978593272171,0.83,99.46
2021-08-05,Chhattisgarh,335,1,327,4369,884,656,7.67,7,32.7,482743,3982,480138,2.7,2.01,0.13360856269113147,0.82,99.46
2021-08-06,Chhattisgarh,610,5,608,7990,3960,1559,7.63,0,32.7,483353,3987,480746,12.11,4.77,0.24434250764525992,0.82,99.46
2021-08-07,Chhattisgarh,555,1,555,7186,4593,2831,7.72,0,32.7,483908,3988,481301,14.05,8.66,0.21975535168195717,0.82,99.46
2021-08-08,Chhattisgarh,467,6,464,5818,4898,3988,8.03,0,32.7,484375,3994,481765,14.98,12.2,0.17792048929663606,0.82,99.46
2021-08-09,Chhattisgarh,598,6,596,7467,4750,155,8.01,0,32.7,484973,4000,482361,14.53,0.47,0.22834862385321097,0.82,99.46
2021-08-10,Chhattisgarh,924,12,915,11610,1471,547,7.96,0,32.7,485897,4012,483276,4.5,1.67,0.35504587155963296,0.83,99.46
2021-08-11,Chhattisgarh,331,3,324,4517,867,550,7.33,4,32.7,486228,4015,483600,2.65,1.68,0.13813455657492354,0.83,99.46
2021-08-12,Chhattisgarh,803,8,798,10516,1341,428,7.64,0,32.7,487031,4023,484398,4.1,1.31,0.3215902140672782,0.83,99.46
2021-08-13,Chhattisgarh,412,2,405,4756,2642,1621,8.66,5,32.7,487443,4025,484803,8.08,4.96,0.14544342507645258,0.83,99.46
2021-08-14,Chhattisgarh,445,5,437,5050,4929,235,8.81,3,32.7,487888,4030,485240,15.07,0.72,0.15443425076452597,0.83,99.46
2021-08-15,Chhattisgarh,963,9,954,11962,2560,690,8.05,0,32.7,488851,4039,486194,7.83,2.11,0.3658103975535168,0.83,99.46
2021-08-16,Chhattisgarh,1437,18,1432,17651,2541,1078,8.14,0,32.7,490288,4057,487626,7.77,3.3,0.5397859327217125,0.83,99.46
2021-08-17,Chhattisgarh,308,3,307,3881,4491,449,7.94,0,32.7,490596,4060,487933,13.73,1.37,0.11868501529051986,0.83,99.46
2021-08-18,Chhattisgarh,1114,11,1113,14097,4626,244,7.9,0,32.7,491710,4071,489046,14.15,0.75,0.4311009174311926,0.83,99.46
2021-08-19,Chhattisgarh,1366,4,1366,17038,2992,2293,8.02,0,32.7,493076,4075,490412,9.15,7.01,0.5210397553516819,0.83,99.46
2021-08-20,Chhattisgarh,1463,13,1456,18256,3418,1391,8.01,0,32.7,494539,4088,491868,10.45,4.25,0.5582874617737003,0.83,99.46
2021-08-21,Chhattisgarh,343,1,334,3831,2996,1287,8.95,8,32.7,494882,4089,492202,9.16,3.94,0.11715596330275228,0.83,99.46
2021-08-22,Chhattisgarh,252,1,251,3094,3460,2849,8.14,0,32.7,495134,4090,492453,10.58,8.71,0.09461773700305809,0.83,99.46
2021-08-23,Chhattisgarh,384,1,384,4851,235,66,7.92,0,32.7,495518,4091,492837,0.72,0.2,0.148348623853211,0.83,99.46
2021-08-24,Chhattisgarh,781,8,781,9708,371,18,8.04,0,32.7,496299,4099,493618,1.13,0.06,0.29688073394495407,0.83,99.46
2021-08-25,Chhattisgarh,1021,9,1014,12797,390,340,7.98,0,32.7,497320,4108,494632,1.19,1.04,0.3913455657492354,0.83,99.46
2021-08-26,Chhattisgarh,98,1,95,1284,1404,652,7.63,2,32.7,497418,4109,494727,4.29,1.99,0.03926605504587156,0.83,99.46
2021-08-27,Chhattisgarh,1378,17,1371,17471,3090,1820,7.89,0,32.7,498796,4126,496098,9.45,5.57,0.5342813455657491,0.83,99.46
2021-08-28,Chhattisgarh,330,3,327,4075,3826,2002,8.1,0,32.7,499126,4129,496425,11.7,6.12,0.12461773700305809,0.83,99.46
2021-08-29,Chhattisgarh,1180,8,1171,14784,3249,973,7.98,1,32.7,500306,4137,497596,9.94,2.98,0.4521100917431192,0.83,99.46
2021-08-30,Chhattisgarh,284,2,277,3738,2510,1276,7.6,5,32.7,500590,4139,497873,7.68,3.9,0.11431192660550457,0.83,99.46
2021-08-31,Chhattisgarh,1011,7,1006,13285,2880,1007,7.61,0,32.7,501601,4146,498879,8.81,3.08,0.40626911314984704,0.83,99.46
2021-09-01,Chhattisgarh,1215,9,1213,15034,470,1,8.08,0,32.7,502816,4155,500092,1.44,0.0,0.45975535168195714,0.83,99.46
2021-09-02,Chhattisgarh,1472,21,1464,18286,3220,1129,8.05,0,32.7,504288,4176,501556,9.85,3.45,0.5592048929663608,0.83,99.46
2021-09-03,Chhattisgarh,1605,21,1603,19801,3776,3671,8.11,0,32.7,505893,4197,503159,11.55,11.23,0.6055351681957186,0.83,99.46
2021-09-04,Chhattisgarh,1008,3,1002,12827,3026,2548,7.86,3,32.7,506901,4200,504161,9.25,7.79,0.392262996941896,0.83,99.46
2021-09-05,Chhattisgarh,1078,15,1073,13021,506,210,8.28,0,32.7,507979,4215,505234,1.55,0.64,0.3981957186544342,0.83,99.46
2021-09-06,Chhattisgarh,686,2,677,8643,982,325,7.94,7,32.7,508665,4217,505911,3.0,0.99,0.26431192660550457,0.83,99.46
2021-09-07,Chhattisgarh,1357,19,1357,16902,4263,7,8.03,0,32.7,510022,4236,507268,13.04,0.02,0.516880733944954,0.83,99.46
2021-09-08,Chhattisgarh,1357,7,1350,16791,233,122,8.08,0,32.7,511379,4243,508618,0.71,0.37,0.5134862385321101,0.83,99.46
2021-09-09,Chhattisgarh,118,0,118,1805,1182,921,6.54,0,32.7,511497,4243,508736,3.61,2.82,0.05519877675840978,0.83,99.46
2021-09-10,Chhattisgarh,989,7,987,12156,3825,1386,8.14,0,32.7,512486,4250,509723,11.7,4.24,0.371743119266055,0.83,99.46
2021-09-11,Chhattisgarh,1467,17,1462,18610,2190,1054,7.88,0,32.7,513953,4267,511185,6.7,3.22,0.5691131498470947,0.83,99.46
2021-09-12,Chhattisgarh,1234,17,1228,15121,4428,2862,8.16,0,32.7,515187,4284,512413,13.54,8.75,0.46241590214067274,0.83,99.46
2021-09-13,Chhattisgarh,1144,3,1144,14732,4020,1494,7.77,0,32.7,516331,4287,513557,12.29,4.57,0.45051987767584095,0.83,99.46
2021-09-14,Chhattisgarh,1450,17,1443,17933,3104,2917,8.09,0,32.7,517781,4304,515000,9.49,8.92,0.5484097859327216,0.83,99.46
2021-09-15,Chhattisgarh,1442,10,1439,18035,4410,2410,8.0,0,32.7,519223,4314,516439,13.49,7.37,0.5515290519877675,0.83,99.46
2021-09-16,Chhattisgarh,1024,4,1019,12603,2140,287,8.13,1,32.7,520247,4318,517458,6.54,0.88,0.3854128440366972,0.83,99.46
2021-09-17,Chhattisgarh,1340,13,1338,16900,1191,167,7.93,0,32.7,521587,4331,518796,3.64,0.51,0.5168195718654434,0.83,99.46
2021-09-18,Chhattisgarh,787,6,778,10139,3296,3058,7.76,3,32.7,522374,4337,519574,10.08,9.35,0.3100611620795107,0.83,99.46
2021-09-19,Chhattisgarh,853,11,850,10890,51,49,7.83,0,32.7,523227,4348,520424,0.16,0.15,0.33302752293577975,0.83,99.46
2021-09-20,Chhattisgarh,642,3,634,8029,606,390,8.0,5,32.7,523869,4351,521058,1.85,1.19,0.24553516819571863,0.83,99.46
2021-09-21,Chhattisgarh,1387,5,1380,17625,3563,870,7.87,2,32.7,525256,4356,522438,10.9,2.66,0.5389908256880733,0.83,99.46
2021-09-22,Chhattisgarh,1219,9,1217,15346,2524,1782,7.94,0,32.7,526475,4365,523655,7.72,5.45,0.4692966360856269,0.83,99.46
2021-09-23,Chhattisgarh,1211,4,1208,15097,267,24,8.02,0,32.7,527686,4369,524863,0.82,0.07,0.4616819571865443,0.83,99.47
2021-09-24,Chhattisgarh,51,0,44,690,4617,1135,7.39,7,32.7,527737,4369,524907,14.12,3.47,0.021100917431192658,0.83,99.46
2021-09-25,Chhattisgarh,299,4,295,3559,299,71,8.4,0,32.7,528036,4373,525202,0.91,0.22,0.10883792048929662,0.83,99.46
2021-09-26,Chhattisgarh,1554,16,1553,19596,4205,1840,7.93,0,32.7,529590,4389,526755,12.86,5.63,0.5992660550458715,0.83,99.46
2021-09-27,Chhattisgarh,767,9,760,9284,3484,3293,8.26,0,32.7,530357,4398,527515,10.65,10.07,0.283914373088685,0.83,99.46
2021-09-28,Chhattisgarh,1022,6,1014,12591,2827,1532,8.12,2,32.7,531379,4404,528529,8.65,4.69,0.385045871559633,0.83,99.46
2021-09-29,Chhattisgarh,1225,18,1219,15255,3714,2776,8.03,0,32.7,532604,4422,529748,11.36,8.49,0.46651376146788986,0.83,99.46
2021-09-30,Chhattisgarh,522,5,514,6907,3074,1177,7.56,3,32.7,533126,4427,530262,9.4,3.6,0.21122324159021405,0.83,99.46
2021-10-01,Chhattisgarh,956,6,956,11787,669,76,8.11,0,32.7,534082,4433,531218,2.05,0.23,0.36045871559633025,0.83,99.46
2021-10-02,Chhattisgarh,770,8,762,9648,1444,160,7.98,0,32.7,534852,4441,531980,4.42,0.49,0.29504587155963297,0.83,99.46
2021-10-03,Chhattisgarh,1349,16,1349,16861,4005,3446,8.0,0,32.7,536201,4457,533329,12.25,10.54,0.5156269113149846,0.83,99.46
2021-10-04,Chhattisgarh,156,0,149,1699,1554,659,9.18,7,32.7,536357,4457,533478,4.75,2.02,0.051957186544342504,0.83,99.46
2021-10-05,Chhattisgarh,356,2,352,4118,2844,1403,8.64,2,32.7,536713,4459,533830,8.7,4.29,0.12593272171253822,0.83,99.46
2021-10-06,Chhattisgarh,1045,11,1040,13150,4507,2267,7.95,0,32.7,537758,4470,534870,13.78,6.93,0.4021406727828746,0.83,99.46
2021-10-07,Chhattisgarh,587,3,586,7171,629,390,8.19,0,32.7,538345,4473,535456,1.92,1.19,0.21929663608562688,0.83,99.46
2021-10-08,Chhattisgarh,459,5,450,5555,3896,381,8.26,4,32.7,538804,4478,535906,11.91,1.17,0.16987767584097857,0.83,99.46
2021-10-09,Chhattisgarh,861,7,853,10939,4439,2383,7.87,1,32.7,539665,4485,536759,13.57,7.29,0.334525993883792,0.83,99.46
2021-10-10,Chhattisgarh,845,6,842,11215,1987,1476,7.53,0,32.7,540510,4491,537601,6.08,4.51,0.3429663608562691,0.83,99.46
2021-10-11,Chhattisgarh,251,3,246,2986,2327,705,8.41,2,32.7,540761,4494,537847,7.12,2.16,0.09131498470948012,0.83,99.46
2021-10-12,Chhattisgarh,1557,17,1555,19420,289,6,8.02,0,32.7,542318,4511,539402,0.88,0.02,0.5938837920489296,0.83,99.46
2021-10-13,Chhattisgarh,1082,6,1082,13805,1979,1099,7.84,0,32.7,543400,4517,540484,6.05,3.36,0.42217125382262993,0.83,99.46
2021-10-14,Chhattisgarh,1620,16,1613,19945,1634,151,8.12,0,32.7,545020,4533,542097,5.0,0.46,0.6099388379204892,0.83,99.46
2021-10-15,Chhattisgarh,1041,9,1038,13004,4126,1374,8.01,0,32.7,546061,4542,543135,12.62,4.2,0.3976758409785932,0.83,99.46
2021-10-16,Chhattisgarh,102,0,97,1309,2631,1226,7.79,5,32.7,546163,4542,543232,8.05,3.75,0.04003058103975535,0.83,99.46
2021-10-17,Chhattisgarh,412,2,405,5141,1176,993,8.01,5,32.7,546575,4544,543637,3.6,3.04,0.15721712538226298,0.83,99.46
2021-10-18,Chhattisgarh,1309,14,1302,16151,4841,1288,8.1,0,32.7,547884,4558,544939,14.8,3.94,0.49391437308868497,0.83,99.46
2021-10-19,Chhattisgarh,709,5,708,9016,1332,664,7.86,0,32.7,548593,4563,545647,4.07,2.03,0.27571865443425075,0.83,99.46
2021-10-20,Chhattisgarh,406,1,405,4954,1386,526,8.2,0,32.7,548999,4564,546052,4.24,1.61,0.15149847094801222,0.83,99.46
2021-10-21,Chhattisgarh,704,7,697,8882,4154,311,7.93,0,32.7,549703,4571,546749,12.7,0.95,0.27162079510703363,0.83,99.46
2021-10-22,Chhattisgarh,413,6,413,5294,2862,96,7.8,0,32.7,550116,4577,547162,8.75,0.29,0.16189602446483178,0.83,99.46
2021-10-23,Chhattisgarh,330,3,321,3603,575,198,9.16,6,32.7,550446,4580,547483,1.76,0.61,0.1101834862385321,0.83,99.46
2021-10-24,Chhattisgarh,1017,14,1009,12759,1195,36,7.97,0,32.7,551463,4594,548492,3.65,0.11,0.39018348623853205,0.83,99.46
2021-10-25,Chhattisgarh,1049,4,1047,12722,3421,933,8.25,0,32.7,552512,4598,549539,10.46,2.85,0.38905198776758404,0.83,99.46
2021-10-26,Chhattisgarh,1481,9,1477,18702,4054,1187,7.92,0,32.7,553993,4607,551016,12.4,3.63,0.5719266055045871,0.83,99.46
2021-10-27,Chhattisgarh,155,1,148,1936,4960,4264,8.01,6,32.7,554148,4608,551164,15.17,13.04,0.05920489296636085,0.83,99.46
2021-10-28,Chhattisgarh,719,2,712,9040,2697,554,7.95,5,32.7,554867,4610,551876,8.25,1.69,0.2764525993883792,0.83,99.46
2021-10-29,Chhattisgarh,366,3,362,3933,1392,419,9.31,1,32.7,555233,4613,552238,4.26,1.28,0.12027522935779815,0.83,99.46
2021-10-30,Chhattisgarh,704,2,703,8630,467,405,8.16,0,32.7,555937,4615,552941,1.43,1.24,0.263914373088685,0.83,99.46
2021-10-31,Chhattisgarh,40,0,38,652,4597,2948,6.13,2,32.7,555977,4615,552979,14.06,9.02,0.019938837920489293,0.83,99.46
2021-11-01,Chhattisgarh,238,3,230,2614,3014,627,9.1,5,32.7,556215,4618,553209,9.22,1.92,0.07993883792048928,0.83,99.46
2021-11-02,Chhattisgarh,241,1,238,2928,2770,2617,8.23,2,32.7,556456,4619,553447,8.47,8.0,0.08954128440366972,0.83,99.46
2021-11-03,Chhattisgarh,1150,15,1150,14755,2714,979,7.79,0,32.7,557606,4634,554597,8.3,2.99,0.45122324159021404,0.83,99.46
2021-11-04,Chhattisgarh,471,6,464,6267,2332,1902,7.52,1,32.7,558077,4640,555061,7.13,5.82,0.19165137614678898,0.83,99.46
2021-11-05,Chhattisgarh,459,3,457,5944,1267,571,7.72,0,32.7,558536,4643,555518,3.87,1.75,0.1817737003058104,0.83,99.46
2021-11-06,Chhattisgarh,1187,9,1185,14542,1880,711,8.16,0,32.7,559723,4652,556703,5.75,2.17,0.4447094801223241,0.83,99.46
2021-11-07,Chhattisgarh,578,7,571,7480,1951,1248,7.73,0,32.7,560301,4659,557274,5.97,3.82,0.22874617737003056,0.83,99.46
2021-11-08,Chhattisgarh,172,1,166,2878,72,68,5.98,5,32.7,560473,4660,557440,0.22,0.21,0.08801223241590213,0.83,99.46
2021-11-09,Chhattisgarh,677,8,675,8881,4029,3357,7.62,0,32.7,561150,4668,558115,12.32,10.27,0.27159021406727823,0.83,99.46
2021-11-10,Chhattisgarh,1576,15,1576,19688,4550,1017,8.0,0,32.7,562726,4683,559691,13.91,3.11,0.6020795107033639,0.83,99.46
2021-11-11,Chhattisgarh,1378,4,1378,17403,1882,1860,7.92,0,32.7,564104,4687,561069,5.76,5.69,0.5322018348623853,0.83,99.46
2021-11-12,Chhattisgarh,314,3,310,3646,4006,3207,8.61,1,32.7,564418,4690,561379,12.25,9.81,0.11149847094801223,0.83,99.46
2021-11-13,Chhattisgarh,1465,13,1461,18169,4336,1618,8.06,0,32.7,565883,4703,562840,13.26,4.95,0.5556269113149847,0.83,99.46
2021-11-14,Chhattisgarh,916,8,912,11608,2433,200,7.89,0,32.7,566799,4711,563752,7.44,0.61,0.3549847094801223,0.83,99.46
2021-11-15,Chhattisgarh,1248,17,1242,15793,4963,3876,7.9,0,32.7,568047,4728,564994,15.18,11.85,0.48296636085626904,0.83,99.46
2021-11-16,Chhattisgarh,988,5,987,12614,1557,1368,7.83,0,32.7,569035,4733,565981,4.76,4.18,0.3857492354740061,0.83,99.46
2021-11-17,Chhattisgarh,1408,14,1400,18062,3977,3290,7.8,0,32.7,570443,4747,567381,12.16,10.06,0.552354740061162,0.83,99.46
2021-11-18,Chhattisgarh,634,3,633,7692,2631,54,8.24,0,32.7,571077,4750,568014,8.05,0.17,0.23522935779816512,0.83,99.46
2021-11-19,Chhattisgarh,1200,12,1199,15122,3453,2683,7.94,0,32.7,572277,4762,569213,10.56,8.2,0.4624464831804281,0.83,99.46
2021-11-20,Chhattisgarh,1444,17,1440,18283,4354,617,7.9,0,32.7,573721,4779,570653,13.31,1.89,0.5591131498470947,0.83,99.47
2021-11-21,Chhattisgarh,1564,9,1557,19596,946,252,7.98,0,32.7,575285,4788,572210,2.89,0.77,0.5992660550458715,0.83,99.47
2021-11-22,Chhattisgarh,521,3,520,6550,3287,2616,7.95,0,32.7,575806,4791,572730,10.05,8.0,0.2003058103975535,0.83,99.47
2021-11-23,Chhattisgarh,294,2,294,3790,3477,1161,7.76,0,32.7,576100,4793,573024,10.63,3.55,0.11590214067278286,0.83,99.47
2021-11-24,Chhattisgarh,905,4,904,11069,1988,1438,8.18,0,32.7,577005,4797,573928,6.08,4.4,0.3385015290519877,0.83,99.47
2021-11-25,Chhattisgarh,1480,15,1471,18313,2857,2855,8.08,0,32.7,578485,4812,575399,8.74,8.73,0.5600305810397553,0.83,99.47
2021-11-26,Chhattisgarh,996,14,987,12382,1279,688,8.04,0,32.7,579481,4826,576386,3.91,2.1,0.3786544342507645,0.83,99.47
2021-11-27,Chhattisgarh,374,5,372,4781,1137,760,7.82,0,32.7,579855,4831,576758,3.48,2.32,0.14620795107033638,0.83,99.47
2021-11-28,Chhattisgarh,503,7,499,6144,4861,1228,8.19,0,32.7,580358,4838,577257,14.87,3.76,0.1878899082568807,0.83,99.47
2021-11-29,Chhattisgarh,315,1,306,4343,2364,48,7.25,8,32.7,580673,4839,577563,7.23,0.15,0.13281345565749234,0.83,99.46
2021-11-30,Chhattisgarh,1477,17,1471,18700,3259,110,7.9,0,32.7,582150,4856,579034,9.97,0.34,0.5718654434250764,0.83,99.46
2021-12-01,Chhattisgarh,1627,6,1623,19667,3745,3190,8.27,0,32.7,583777,4862,580657,11.45,9.76,0.6014373088685014,0.83,99.47
2021-12-02,Chhattisgarh,1098,5,1098,13377,4275,3584,8.21,0,32.7,584875,4867,581755,13.07,10.96,0.4090825688073394,0.83,99.47
2021-12-03,Chhattisgarh,778,7,776,9806,117,113,7.93,0,32.7,585653,4874,582531,0.36,0.35,0.2998776758409786,0.83,99.47
2021-12-04,Chhattisgarh,155,1,150,2139,3717,3527,7.25,4,32.7,585808,4875,582681,11.37,10.79,0.06541284403669724,0.83,99.47
2021-12-05,Chhattisgarh,386,2,386,4898,929,730,7.88,0,32.7,586194,4877,583067,2.84,2.23,0.14978593272171253,0.83,99.47
2021-12-06,Chhattisgarh,1367,7,1362,17181,1232,718,7.96,0,32.7,587561,4884,584429,3.77,2.2,0.5254128440366972,0.83,99.47
2021-12-07,Chhattisgarh,1260,16,1254,16024,4219,3710,7.86,0,32.7,588821,4900,585683,12.9,11.35,0.4900305810397553,0.83,99.47
2021-12-08,Chhattisgarh,1202,13,1202,15456,3645,1617,7.78,0,32.7,590023,4913,586885,11.15,4.94,0.4726605504587155,0.83,99.47
2021-12-09,Chhattisgarh,204,2,199,2802,2687,1589,7.28,3,32.7,590227,4915,587084,8.22,4.86,0.0856880733944954,0.83,99.47
2021-12-10,Chhattisgarh,769,3,761,9294,4863,3306,8.27,5,32.7,590996,4918,587845,14.87,10.11,0.2842201834862385,0.83,99.47
2021-12-11,Chhattisgarh,575,3,575,7413,4028,2399,7.76,0,32.7,591571,4921,588420,12.32,7.34,0.226697247706422,0.83,99.47
2021-12-12,Chhattisgarh,1310,16,1304,15763,4670,2215,8.31,0,32.7,592881,4937,589724,14.28,6.77,0.4820489296636085,0.83,99.47
2021-12-13,Chhattisgarh,740,2,735,9796,4320,3633,7.55,3,32.7,593621,4939,590459,13.21,11.11,0.29957186544342507,0.83,99.47
2021-12-14,Chhattisgarh,1472,12,1468,18456,861,265,7.98,0,32.7,595093,4951,591927,2.63,0.81,0.5644036697247706,0.83,99.47
2021-12-15,Chhattisgarh,1488,19,1484,18590,865,843,8.0,0,32.7,596581,4970,593411,2.65,2.58,0.5685015290519877,0.83,99.47
2021-12-16,Chhattisgarh,848,9,847,10846,575,559,7.82,0,32.7,597429,4979,594258,1.76,1.71,0.3316819571865443,0.83,99.47
2021-12-17,Chhattisgarh,1092,12,1091,13577,240,213,8.04,0,32.7,598521,4991,595349,0.73,0.65,0.4151987767584097,0.83,99.47
2021-12-18,Chhattisgarh,1165,13,1161,14153,648,406,8.23,0,32.7,599686,5004,596510,1.98,1.24,0.4328134556574923,0.83,99.47
2021-12-19,Chhattisgarh,187,1,187,2587,1873,1312,7.23,0,32.7,599873,5005,596697,5.73,4.01,0.07911314984709479,0.83,99.47
2021-12-20,Chhattisgarh,1314,12,1307,16615,879,219,7.91,0,32.7,601187,5017,598004,2.69,0.67,0.5081039755351682,0.83,99.47
2021-12-21,Chhattisgarh,234,1,230,2984,1882,693,7.84,3,32.7,601421,5018,598234,5.76,2.12,0.09125382262996941,0.83,99.47
2021-12-22,Chhattisgarh,1387,11,1379,17305,4289,4210,8.02,0,32.7,602808,5029,599613,13.12,12.87,0.5292048929663608,0.83,99.47
2021-12-23,Chhattisgarh,803,4,802,10038,2098,1619,8.0,0,32.7,603611,5033,600415,6.42,4.95,0.30697247706422015,0.83,99.47
2021-12-24,Chhattisgarh,778,4,778,9624,268,80,8.08,0,32.7,604389,5037,601193,0.82,0.24,0.29431192660550454,0.83,99.47
2021-12-25,Chhattisgarh,570,7,564,6933,1797,1764,8.22,0,32.7,604959,5044,601757,5.5,5.39,0.2120183486238532,0.83,99.47
2021-12-26,Chhattisgarh,271,2,267,3035,4049,2116,8.93,2,32.7,605230,5046,602024,12.38,6.47,0.09281345565749234,0.83,99.47
2021-12-27,Chhattisgarh,1390,13,1386,17226,2145,511,8.07,0,32.7,606620,5059,603410,6.56,1.56,0.526788990825688,0.83,99.47
2021-12-28,Chhattisgarh,929,5,926,11727,2170,1999,7.92,0,32.7,607549,5064,604336,6.64,6.11,0.35862385321100915,0.83,99.47
2021-12-29,Chhattisgarh,94,1,93,980,280,54,9.59,0,32.7,607643,5065,604429,0.86,0.17,0.029969418960244645,0.83,99.47
2021-12-30,Chhattisgarh,1206,5,1201,15004,3,1,8.04,0,32.7,608849,5070,605630,0.01,0.0,0.45883792048929656,0.83,99.47
2021-12-31,Chhattisgarh,717,6,714,9048,3844,903,7.92,0,32.7,609566,5076,606344,11.76,2.76,0.276697247706422,0.83,99.47
2022-01-01,Chhattisgarh,374,2,368,4147,1445,967,9.02,4,32.7,609940,5078,606712,4.42,2.96,0.1268195718654434,0.83,99.47
2022-01-02,Chhattisgarh,545,4,543,6560,705,580,8.31,0,32.7,610485,5082,607255,2.16,1.77,0.200611620795107,0.83,99.47
2022-01-03,Chhattisgarh,146,1,142,1553,2938,2307,9.4,3,32.7,610631,5083,607397,8.98,7.06,0.04749235474006116,0.83,99.47
2022-01-04,Chhattisgarh,1020,14,1016,12757,3283,973,8.0,0,32.7,611651,5097,608413,10.04,2.98,0.39012232415902137,0.83,99.47
2022-01-05,Chhattisgarh,1077,6,1073,13352,3305,3134,8.07,0,32.7,612728,5103,609486,10.11,9.58,0.40831804281345563,0.83,99.47
2022-01-06,Chhattisgarh,314,3,310,4032,1331,885,7.79,1,32.7,613042,5106,609796,4.07,2.71,0.12330275229357797,0.83,99.47
2022-01-07,Chhattisgarh,1409,19,1407,17182,3383,765,8.2,0,32.7,614451,5125,611203,10.35,2.34,0.5254434250764526,0.83,99.47
2022-01-08,Chhattisgarh,337,2,331,4216,2722,916,7.99,4,32.7,614788,5127,611534,8.32,2.8,0.12892966360856267,0.83,99.47
2022-01-09,Chhattisgarh,695,5,695,8857,2276,2192,7.85,0,32.7,615483,5132,612229,6.96,6.7,0.2708562691131498,0.83,99.47
2022-01-10,Chhattisgarh,1090,4,1087,13502,296,40,8.07,0,32.7,616573,5136,613316,0.91,0.12,0.41290519877675835,0.83,99.47
2022-01-11,Chhattisgarh,1411,8,1409,17506,2432,750,8.06,0,32.7,617984,5144,614725,7.44,2.29,0.5353516819571865,0.83,99.47
2022-01-12,Chhattisgarh,1175,9,1172,14707,3874,1269,7.99,0,32.7,619159,5153,615897,11.85,3.88,0.4497553516819571,0.83,99.47
2022-01-13,Chhattisgarh,193,2,190,2416,3613,3173,7.99,1,32.7,619352,5155,616087,11.05,9.7,0.07388379204892966,0.83,99.47
2022-01-14,Chhattisgarh,627,4,621,7699,876,452,8.14,2,32.7,619979,5159,616708,2.68,1.38,0.23544342507645258,0.83,99.47
2022-01-15,Chhattisgarh,1118,9,1115,13825,4471,4102,8.09,0,32.7,621097,5168,617823,13.67,12.54,0.42278287461773695,0.83,99.47
2022-01-16,Chhattisgarh,1376,9,1373,17321,2985,2876,7.94,0,32.7,622473,5177,619196,9.13,8.8,0.5296941896024464,0.83,99.47
2022-01-17,Chhattisgarh,236,1,236,2502,240,146,9.43,0,32.7,622709,5178,619432,0.73,0.45,0.0765137614678899,0.83,99.47
2022-01-18,Chhattisgarh,1065,6,1060,13786,3101,1353,7.73,0,32.7,623774,5184,620492,9.48,4.14,0.42159021406727826,0.83,99.47
2022-01-19,Chhattisgarh,527,5,527,6908,4440,2747,7.63,0,32.7,624301,5189,621019,13.58,8.4,0.2112538226299694,0.83,99.47
2022-01-20,Chhattisgarh,206,2,205,3027,3876,2398,6.81,0,32.7,624507,5191,621224,11.85,7.33,0.09256880733944953,0.83,99.47
2022-01-21,Chhattisgarh,929,12,920,11465,2993,395,8.1,0,32.7,625436,5203,622144,9.15,1.21,0.350611620795107,0.83,99.47
2022-01-22,Chhattisgarh,1431,17,1422,17963,1034,230,7.97,0,32.7,626867,5220,623566,3.16,0.7,0.5493272171253822,0.83,99.47
2022-01-23,Chhattisgarh,885,8,883,11360,2923,1206,7.79,0,32.7,627752,5228,624449,8.94,3.69,0.34740061162079505,0.83,99.47
2022-01-24,Chhattisgarh,912,3,904,11195,900,635,8.15,5,32.7,628664,5231,625353,2.75,1.94,0.34235474006116207,0.83,99.47
2022-01-25,Chhattisgarh,1517,14,1514,18414,1682,3,8.24,0,32.7,630181,5245,626867,5.14,0.01,0.5631192660550458,0.83,99.47
2022-01-26,Chhattisgarh,576,8,574,7018,4168,1691,8.21,0,32.7,630757,5253,627441,12.75,5.17,0.21461773700305808,0.83,99.47
2022-01-27,Chhattisgarh,638,6,633,7820,4462,766,8.16,0,32.7,631395,5259,628074,13.65,2.34,0.23914373088685012,0.83,99.47
2022-01-28,Chhattisgarh,1547,7,1545,19299,1223,816,8.02,0,32.7,632942,5266,629619,3.74,2.5,0.590183486238532,0.83,99.47
2022-01-29,Chhattisgarh,510,6,501,6333,3336,1083,8.05,3,32.7,633452,5272,630120,10.2,3.31,0.19366972477064218,0.83,99.47
2022-01-30,Chhattisgarh,314,2,307,4308,2178,777,7.29,5,32.7,633766,5274,630427,6.66,2.38,0.13174311926605503,0.83,99.47
2022-01-31,Chhattisgarh,691,2,690,8919,363,235,7.75,0,32.7,634457,5276,631117,1.11,0.72,0.27275229357798164,0.83,99.47
2022-02-01,Chhattisgarh,142,1,138,2320,4772,1189,6.12,3,32.7,634599,5277,631255,14.59,3.64,0.0709480122324159,0.83,99.47
2022-02-02,Chhattisgarh,1036,12,1030,12707,2015,1505,8.15,0,32.7,635635,5289,632285,6.16,4.6,0.3885932721712538,0.83,99.47
2022-02-03,Chhattisgarh,1173,8,1173,14498,3094,1210,8.09,0,32.7,636808,5297,633458,9.46,3.7,0.44336391437308864,0.83,99.47
2022-02-04,Chhattisgarh,191,1,182,2322,4524,3545,8.23,8,32.7,636999,5298,633640,13.83,10.84,0.0710091743119266,0.83,99.47
2022-02-05,Chhattisgarh,691,5,683,8475,1612,49,8.15,3,32.7,637690,5303,634323,4.93,0.15,0.25917431192660545,0.83,99.47
2022-02-06,Chhattisgarh,1103,5,1103,13274,1317,1159,8.31,0,32.7,638793,5308,635426,4.03,3.54,0.4059327217125382,0.83,99.47
2022-02-07,Chhattisgarh,757,6,750,9809,3415,3316,7.72,1,32.7,639550,5314,636176,10.44,10.14,0.2999694189602446,0.83,99.47
2022-02-08,Chhattisgarh,674,5,674,8421,4224,2787,8.0,0,32.7,640224,5319,636850,12.92,8.52,0.2575229357798165,0.83,99.47
2022-02-09,Chhattisgarh,620,7,613,8049,2041,917,7.7,0,32.7,640844,5326,637463,6.24,2.8,0.24614678899082565,0.83,99.47
2022-02-10,Chhattisgarh,1434,4,1432,17885,4716,4187,8.02,0,32.7,642278,5330,638895,14.42,12.8,0.5469418960244647,0.83,99.47
2022-02-11,Chhattisgarh,860,8,854,10645,1572,1118,8.08,0,32.7,643138,5338,639749,4.81,3.42,0.3255351681957186,0.83,99.47
2022-02-12,Chhattisgarh,1034,9,1027,12594,4491,2571,8.21,0,32.7,644172,5347,640776,13.73,7.86,0.38513761467889907,0.83,99.47
2022-02-13,Chhattisgarh,1208,14,1204,15044,4613,3372,8.03,0,32.7,645380,5361,641980,14.11,10.31,0.46006116207951064,0.83,99.47
2022-02-14,Chhattisgarh,1231,17,1226,15509,3660,3144,7.94,0,32.7,646611,5378,643206,11.19,9.61,0.4742813455657492,0.83,99.47
2022-02-15,Chhattisgarh,1491,8,1490,18832,4780,1090,7.92,0,32.7,648102,5386,644696,14.62,3.33,0.5759021406727828,0.83,99.47
2022-02-16,Chhattisgarh,645,5,644,8155,379,12,7.91,0,32.7,648747,5391,645340,1.16,0.04,0.24938837920489293,0.83,99.47
2022-02-17,Chhattisgarh,190,2,182,2410,2142,1594,7.88,6,32.7,648937,5393,645522,6.55,4.87,0.07370030581039755,0.83,99.47
2022-02-18,Chhattisgarh,768,10,765,9772,2768,57,7.86,0,32.7,649705,5403,646287,8.46,0.17,0.2988379204892966,0.83,99.47
2022-02-19,Chhattisgarh,1388,19,1380,17384,1238,1042,7.98,0,32.7,651093,5422,647667,3.79,3.19,0.5316207951070335,0.83,99.47
2022-02-20,Chhattisgarh,1211,17,1202,15352,4686,4308,7.89,0,32.7,652304,5439,648869,14.33,13.17,0.469480122324159,0.83,99.47
2022-02-21,Chhattisgarh,226,1,225,2684,150,0,8.42,0,32.7,652530,5440,649094,0.46,0.0,0.0820795107033639,0.83,99.47
2022-02-22,Chhattisgarh,1463,15,1462,18259,4926,206,8.01,0,32.7,653993,5455,650556,15.06,0.63,0.5583792048929663,0.83,99.47
2022-02-23,Chhattisgarh,990,11,982,12472,3688,1244,7.94,0,32.7,654983,5466,651538,11.28,3.8,0.38140672782874613,0.83,99.47
2022-02-24,Chhattisgarh,1051,9,1045,13315,1814,665,7.89,0,32.7,656034,5475,652583,5.55,2.03,0.4071865443425076,0.83,99.47
2022-02-25,Chhattisgarh,651,7,650,8000,2776,451,8.14,0,32.7,656685,5482,653233,8.49,1.38,0.24464831804281342,0.83,99.47
2022-02-26,Chhattisgarh,997,14,992,12348,440,245,8.07,0,32.7,657682,5496,654225,1.35,0.75,0.3776146788990825,0.84,99.47
2022-02-27,Chhattisgarh,876,6,868,10827,3181,3095,8.09,2,32.7,658558,5502,655093,9.73,9.46,0.33110091743119263,0.84,99.47
2022-02-28,Chhattisgarh,723,3,715,9148,3820,3064,7.9,5,32.7,659281,5505,655808,11.68,9.37,0.27975535168195714,0.84,99.47
2022-03-01,Chhattisgarh,975,6,966,11772,2722,2622,8.28,3,32.7,660256,5511,656774,8.32,8.02,0.36,0.83,99.47
2022-03-02,Chhattisgarh,1263,17,1260,15613,1738,1041,8.09,0,32.7,661519,5528,658034,5.31,3.18,0.47746177370030574,0.84,99.47
2022-03-03,Chhattisgarh,722,5,718,9499,1152,742,7.6,0,32.7,662241,5533,658752,3.52,2.27,0.2904892966360856,0.84,99.47
2022-03-04,Chhattisgarh,293,1,293,3785,98,92,7.74,0,32.7,662534,5534,659045,0.3,0.28,0.1157492354740061,0.84,99.47
2022-03-05,Chhattisgarh,1476,12,1469,18601,4550,882,7.94,0,32.7,664010,5546,660514,13.91,2.7,0.5688379204892966,0.84,99.47
2022-03-06,Chhattisgarh,57,0,55,652,4022,2568,8.74,2,32.7,664067,5546,660569,12.3,7.85,0.019938837920489293,0.84,99.47
2022-03-07,Chhattisgarh,1423,10,1414,17706,2088,1392,8.04,0,32.7,665490,5556,661983,6.39,4.26,0.5414678899082568,0.83,99.47
2022-03-08,Chhattisgarh,1551,11,1544,18952,911,27,8.18,0,32.7,667041,5567,663527,2.79,0.08,0.579571865443425,0.83,99.47
2022-03-09,Chhattisgarh,1052,13,1043,13420,3534,2724,7.84,0,32.7,668093,5580,664570,10.81,8.33,0.4103975535168195,0.84,99.47
2022-03-10,Chhattisgarh,1090,14,1087,13314,1959,1476,8.19,0,32.7,669183,5594,665657,5.99,4.51,0.4071559633027522,0.84,99.47
2022-03-11,Chhattisgarh,441,5,438,5719,3983,2378,7.71,0,32.7,669624,5599,666095,12.18,7.27,0.17489296636085624,0.84,99.47
2022-03-12,Chhattisgarh,1350,11,1342,16841,1945,1058,8.02,0,32.7,670974,5610,667437,5.95,3.24,0.5150152905198776,0.84,99.47
2022-03-13,Chhattisgarh,1388,8,1385,17143,4623,841,8.1,0,32.7,672362,5618,668822,14.14,2.57,0.5242507645259938,0.84,99.47
2022-03-14,Chhattisgarh,228,2,225,2261,4624,2212,10.08,1,32.7,672590,5620,669047,14.14,6.76,0.06914373088685015,0.84,99.47
2022-03-15,Chhattisgarh,770,6,762,9550,3317,207,8.06,2,32.7,673360,5626,669809,10.14,0.63,0.2920489296636085,0.84,99.47
2022-03-16,Chhattisgarh,410,5,406,5101,1931,578,8.04,0,32.7,673770,5631,670215,5.91,1.77,0.1559938837920489,0.84,99.47
2022-03-17,Chhattisgarh,1397,18,1395,17405,4324,356,8.03,0,32.7,675167,5649,671610,13.22,1.09,0.5322629969418959,0.84,99.47
2022-03-18,Chhattisgarh,513,1,511,5863,2143,190,8.75,1,32.7,675680,5650,672121,6.55,0.58,0.1792966360856269,0.84,99.47
2022-03-19,Chhattisgarh,129,0,123,1700,2624,288,7.59,6,32.7,675809,5650,672244,8.02,0.88,0.05198776758409785,0.84,99.47
2022-03-20,Chhattisgarh,1401,20,1401,17552,2013,1416,7.98,0,32.7,677210,5670,673645,6.16,4.33,0.5367584097859327,0.84,99.47
2022-03-21,Chhattisgarh,336,2,330,4118,2099,2081,8.16,4,32.7,677546,5672,673975,6.42,6.36,0.12593272171253822,0.84,99.47
2022-03-22,Chhattisgarh,1426,18,1418,17656,3725,1293,8.08,0,32.7,678972,5690,675393,11.39,3.95,0.5399388379204892,0.84,99.47
2022-03-23,Chhattisgarh,1090,12,1082,13311,4454,1199,8.19,0,32.7,680062,5702,676475,13.62,3.67,0.4070642201834862,0.84,99.47
2022-03-24,Chhattisgarh,1474,17,1465,18443,3685,3006,7.99,0,32.7,681536,5719,677940,11.27,9.19,0.564006116207951,0.84,99.47
2022-03-25,Chhattisgarh,491,6,484,5924,3789,887,8.29,1,32.7,682027,5725,678424,11.59,2.71,0.18116207951070334,0.84,99.47
2022-03-26,Chhattisgarh,39,0,32,520,1693,37,7.5,7,32.7,682066,5725,678456,5.18,0.11,0.015902140672782873,0.84,99.47
2022-03-27,Chhattisgarh,1528,17,1526,19123,1004,765,7.99,0,32.7,683594,5742,679982,3.07,2.34,0.5848012232415901,0.84,99.47
2022-03-28,Chhattisgarh,652,9,646,8470,2196,1154,7.7,0,32.7,684246,5751,680628,6.72,3.53,0.2590214067278287,0.84,99.47
2022-03-29,Chhattisgarh,169,0,161,2271,3480,1082,7.44,8,32.7,684415,5751,680789,10.64,3.31,0.06944954128440366,0.84,99.47
2022-03-30,Chhattisgarh,1436,19,1431,17437,646,522,8.24,0,32.7,685851,5770,682220,1.98,1.6,0.5332415902140673,0.84,99.47
2022-03-31,Chhattisgarh,265,3,257,3493,1242,172,7.59,5,32.7,686116,5773,682477,3.8,0.53,0.10681957186544341,0.84,99.47
2022-04-01,Chhattisgarh,282,1,273,3149,1559,166,8.96,8,32.7,686398,5774,682750,4.77,0.51,0.09629969418960244,0.84,99.47
2022-04-02,Chhattisgarh,903,8,901,11616,1147,111,7.77,0,32.7,687301,5782,683651,3.51,0.34,0.3552293577981651,0.84,99.47
2022-04-03,Chhattisgarh,573,3,565,7788,2362,47,7.36,5,32.7,687874,5785,684216,7.22,0.14,0.23816513761467886,0.84,99.47
2022-04-04,Chhattisgarh,412,2,404,5406,478,359,7.62,6,32.7,688286,5787,684620,1.46,1.1,0.16532110091743119,0.84,99.47
2022-04-05,Chhattisgarh,28,0,27,727,4392,4029,3.85,1,32.7,688314,5787,684647,13.43,12.32,0.02223241590214067,0.84,99.47
2022-04-06,Chhattisgarh,601,4,592,6918,94,7,8.69,5,32.7,688915,5791,685239,0.29,0.02,0.21155963302752293,0.84,99.47
2022-04-07,Chhattisgarh,311,4,310,3687,294,176,8.44,0,32.7,689226,5795,685549,0.9,0.54,0.11275229357798164,0.84,99.47
2022-04-08,Chhattisgarh,155,1,150,2158,3132,2547,7.18,4,32.7,689381,5796,685699,9.58,7.79,0.06599388379204892,0.84,99.47
2022-04-09,Chhattisgarh,884,5,880,11151,4337,3487,7.93,0,32.7,690265,5801,686579,13.26,10.66,0.34100917431192657,0.84,99.47
2022-04-10,Chhattisgarh,300,3,298,3820,1471,684,7.85,0,32.7,690565,5804,686877,4.5,2.09,0.11681957186544341,0.84,99.47
2022-04-11,Chhattisgarh,1031,13,1024,12812,705,255,8.05,0,32.7,691596,5817,687901,2.16,0.78,0.3918042813455657,0.84,99.47
2022-04-12,Chhattisgarh,870,9,864,10685,1083,231,8.14,0,32.7,692466,5826,688765,3.31,0.71,0.3267584097859327,0.84,99.47
2022-04-13,Chhattisgarh,1420,19,1417,17598,4805,4247,8.07,0,32.7,693886,5845,690182,14.69,12.99,0.5381651376146789,0.84,99.47
2022-04-14,Chhattisgarh,152,1,148,1910,2421,1862,7.96,3,32.7,694038,5846,690330,7.4,5.69,0.058409785932721704,0.84,99.47
2022-04-15,Chhattisgarh,143,1,137,1851,4433,4398,7.73,5,32.7,694181,5847,690467,13.56,13.45,0.05660550458715596,0.84,99.46
2022-04-16,Chhattisgarh,1441,19,1433,17694,1209,374,8.14,0,32.7,695622,5866,691900,3.7,1.14,0.5411009174311926,0.84,99.46
2022-04-17,Chhattisgarh,1282,9,1274,15862,3292,1110,8.08,0,32.7,696904,5875,693174,10.07,3.39,0.4850764525993883,0.84,99.46
2022-04-18,Chhattisgarh,827,2,823,10288,1465,502,8.04,2,32.7,697731,5877,693997,4.48,1.54,0.31461773700305806,0.84,99.46
2022-04-19,Chhattisgarh,1092,14,1090,13503,2213,1945,8.09,0,32.7,698823,5891,695087,6.77,5.95,0.4129357798165137,0.84,99.47
2022-04-20,Chhattisgarh,805,5,797,10562,3124,517,7.62,3,32.7,699628,5896,695884,9.55,1.58,0.3229969418960244,0.84,99.46
2022-04-21,Chhattisgarh,432,6,426,5428,4510,576,7.96,0,32.7,700060,5902,696310,13.79,1.76,0.1659938837920489,0.84,99.46
2022-04-22,Chhattisgarh,591,7,587,7319,421,164,8.07,0,32.7,700651,5909,696897,1.29,0.5,0.22382262996941893,0.84,99.46
2022-04-23,Chhattisgarh,681,3,678,8839,719,315,7.7,0,32.7,701332,5912,697575,2.2,0.96,0.27030581039755347,0.84,99.46
2022-04-24,Chhattisgarh,572,8,564,6774,2218,416,8.44,0,32.7,701904,5920,698139,6.78,1.27,0.20715596330275227,0.84,99.46
2022-04-25,Chhattisgarh,1469,8,1467,18051,3451,1567,8.14,0,32.7,703373,5928,699606,10.55,4.79,0.5520183486238531,0.84,99.46
2022-04-26,Chhattisgarh,738,9,733,9237,4289,688,7.99,0,32.7,704111,5937,700339,13.12,2.1,0.2824770642201834,0.84,99.46
2022-04-27,Chhattisgarh,1282,15,1273,15989,2874,812,8.02,0,32.7,705393,5952,701612,8.79,2.48,0.488960244648318,0.84,99.46
2022-04-28,Chhattisgarh,920,13,919,11363,4595,3285,8.1,0,32.7,706313,5965,702531,14.05,10.05,0.3474923547400611,0.84,99.46
2022-04-29,Chhattisgarh,1075,3,1075,13345,4925,3714,8.06,0,32.7,707388,5968,703606,15.06,11.36,0.40810397553516814,0.84,99.47
2022-04-30,Chhattisgarh,642,5,639,7848,4960,2364,8.18,0,32.7,708030,5973,704245,15.17,7.23,0.23999999999999996,0.84,99.47
2022-05-01,Chhattisgarh,1297,18,1292,16365,4096,3842,7.93,0,32.7,709327,5991,705537,12.53,11.75,0.5004587155963303,0.84,99.47
2022-05-02,Chhattisgarh,1082,15,1076,13344,3779,510,8.11,0,32.7,710409,6006,706613,11.56,1.56,0.4080733944954128,0.85,99.47
2022-05-03,Chhattisgarh,1473,11,1472,18609,40,13,7.92,0,32.7,711882,6017,708085,0.12,0.04,0.5690825688073394,0.85,99.47
2022-05-04,Chhattisgarh,461,1,453,5653,3564,3271,8.15,7,32.7,712343,6018,708538,10.9,10.0,0.17287461773700305,0.84,99.47
2022-05-05,Chhattisgarh,1491,21,1489,18482,2017,1440,8.07,0,32.7,713834,6039,710027,6.17,4.4,0.5651987767584097,0.85,99.47
2022-05-06,Chhattisgarh,335,3,328,4456,3006,631,7.52,4,32.7,714169,6042,710355,9.19,1.93,0.13626911314984708,0.85,99.47
2022-05-07,Chhattisgarh,373,5,369,4685,2324,1369,7.96,0,32.7,714542,6047,710724,7.11,4.19,0.1432721712538226,0.85,99.47
2022-05-08,Chhattisgarh,1575,13,1568,19490,4278,75,8.08,0,32.7,716117,6060,712292,13.08,0.23,0.5960244648318043,0.85,99.47
2022-05-09,Chhattisgarh,292,1,283,3555,624,4,8.21,8,32.7,716409,6061,712575,1.91,0.01,0.10871559633027522,0.85,99.46
2022-05-10,Chhattisgarh,1447,7,1443,18701,3898,1518,7.74,0,32.7,717856,6068,714018,11.92,4.64,0.5718960244648318,0.85,99.47
2022-05-11,Chhattisgarh,444,2,439,5272,4490,486,8.42,3,32.7,718300,6070,714457,13.73,1.49,0.16122324159021406,0.85,99.46
2022-05-12,Chhattisgarh,1342,14,1336,16720,3705,453,8.03,0,32.7,719642,6084,715793,11.33,1.39,0.5113149847094801,0.85,99.47
2022-05-13,Chhattisgarh,190,2,182,2336,4972,298,8.13,6,32.7,719832,6086,715975,15.2,0.91,0.07143730886850153,0.85,99.46
2022-05-14,Chhattisgarh,1552,17,1550,19391,3119,628,8.0,0,32.7,721384,6103,717525,9.54,1.92,0.5929969418960244,0.85,99.47
2022-05-15,Chhattisgarh,654,8,646,7893,245,52,8.29,0,32.7,722038,6111,718171,0.75,0.16,0.2413761467889908,0.85,99.46
2022-05-16,Chhattisgarh,569,7,561,7683,3430,873,7.41,1,32.7,722607,6118,718732,10.49,2.67,0.23495412844036695,0.85,99.46
2022-05-17,Chhattisgarh,1343,12,1341,17127,4415,1254,7.84,0,32.7,723950,6130,720073,13.5,3.83,0.5237614678899082,0.85,99.46
2022-05-18,Chhattisgarh,1229,10,1226,15216,3025,2696,8.08,0,32.7,725179,6140,721299,9.25,8.24,0.4653211009174311,0.85,99.46
2022-05-19,Chhattisgarh,339,1,334,4200,4719,2614,8.07,4,32.7,725518,6141,721633,14.43,7.99,0.12844036697247704,0.85,99.46
2022-05-20,Chhattisgarh,761,6,753,9485,3177,2185,8.02,2,32.7,726279,6147,722386,9.72,6.68,0.29006116207951066,0.85,99.46
2022-05-21,Chhattisgarh,557,5,554,6705,255,190,8.31,0,32.7,726836,6152,722940,0.78,0.58,0.205045871559633,0.85,99.46
2022-05-22,Chhattisgarh,1557,15,1556,19615,1954,1355,7.94,0,32.7,728393,6167,724496,5.98,4.14,0.5998470948012232,0.85,99.46
2022-05-23,Chhattisgarh,1567,4,1562,19561,4780,2868,8.01,1,32.7,729960,6171,726058,14.62,8.77,0.5981957186544342,0.85,99.47
2022-05-24,Chhattisgarh,642,2,639,8302,588,333,7.73,1,32.7,730602,6173,726697,1.8,1.02,0.25388379204892964,0.84,99.47
2022-05-25,Chhattisgarh,1014,10,1012,12899,2390,1227,7.86,0,32.7,731616,6183,727709,7.31,3.75,0.3944648318042813,0.85,99.47
2022-05-26,Chhattisgarh,561,3,561,6637,2283,818,8.45,0,32.7,732177,6186,728270,6.98,2.5,0.2029663608562691,0.84,99.47
2022-05-27,Chhattisgarh,586,5,583,7641,977,73,7.67,0,32.7,732763,6191,728853,2.99,0.22,0.23366972477064218,0.84,99.47
2022-05-28,Chhattisgarh,1345,19,1339,16585,2092,612,8.11,0,32.7,734108,6210,730192,6.4,1.87,0.5071865443425075,0.85,99.47
2022-05-29,Chhattisgarh,1412,19,1405,17191,510,83,8.21,0,32.7,735520,6229,731597,1.56,0.25,0.5257186544342507,0.85,99.47
2022-05-30,Chhattisgarh,704,5,701,8874,2132,45,7.93,0,32.7,736224,6234,732298,6.52,0.14,0.2713761467889908,0.85,99.47
2022-05-31,Chhattisgarh,874,9,866,11014,4561,2458,7.94,0,32.7,737098,6243,733164,13.95,7.52,0.33681957186544337,0.85,99.47
2022-06-01,Chhattisgarh,149,1,142,1459,2265,501,10.21,6,32.7,737247,6244,733306,6.93,1.53,0.0446177370030581,0.85,99.47
2022-06-02,Chhattisgarh,340,2,340,4245,2792,1043,8.01,0,32.7,737587,6246,733646,8.54,3.19,0.12981651376146788,0.85,99.47
2022-06-03,Chhattisgarh,136,1,132,1310,1593,1553,10.38,3,32.7,737723,6247,733778,4.87,4.75,0.0400611620795107,0.85,99.47
2022-06-04,Chhattisgarh,1082,14,1073,13319,2245,509,8.12,0,32.7,738805,6261,734851,6.87,1.56,0.40730886850152903,0.85,99.46
2022-06-05,Chhattisgarh,777,9,772,9789,370,140,7.94,0,32.7,739582,6270,735623,1.13,0.43,0.2993577981651376,0.85,99.46
2022-06-06,Chhattisgarh,850,8,849,10447,4979,1595,8.14,0,32.7,740432,6278,736472,15.23,4.88,0.319480122324159,0.85,99.47
2022-06-07,Chhattisgarh,1086,15,1083,13543,4205,1431,8.02,0,32.7,741518,6293,737555,12.86,4.38,0.4141590214067278,0.85,99.47
2022-06-08,Chhattisgarh,1403,5,1396,17144,2958,957,8.18,2,32.7,742921,6298,738951,9.05,2.93,0.5242813455657491,0.85,99.47
2022-06-09,Chhattisgarh,93,1,89,1222,133,98,7.61,3,32.7,743014,6299,739040,0.41,0.3,0.03737003058103975,0.85,99.47
2022-06-10,Chhattisgarh,546,3,544,6962,2288,272,7.84,0,32.7,743560,6302,739584,7.0,0.83,0.2129051987767584,0.85,99.47
2022-06-11,Chhattisgarh,113,0,110,1211,4507,127,9.33,3,32.7,743673,6302,739694,13.78,0.39,0.03703363914373088,0.85,99.46
2022-06-12,Chhattisgarh,1527,12,1518,18990,4355,853,8.04,0,32.7,745200,6314,741212,13.32,2.61,0.5807339449541283,0.85,99.46
2022-06-13,Chhattisgarh,635,2,629,7724,617,258,8.22,4,32.7,745835,6316,741841,1.89,0.79,0.23620795107033637,0.85,99.46
2022-06-14,Chhattisgarh,437,6,429,5363,135,61,8.15,2,32.7,746272,6322,742270,0.41,0.19,0.16400611620795105,0.85,99.46
2022-06-15,Chhattisgarh,549,3,543,6759,3916,3037,8.12,3,32.7,746821,6325,742813,11.98,9.29,0.206697247706422,0.85,99.46
2022-06-16,Chhattisgarh,726,8,719,8610,3199,3186,8.43,0,32.7,747547,6333,743532,9.78,9.74,0.26330275229357797,0.85,99.46
2022-06-17,Chhattisgarh,1000,9,1000,12393,3362,520,8.07,0,32.7,748547,6342,744532,10.28,1.59,0.37899082568807335,0.85,99.46
2022-06-18,Chhattisgarh,1446,15,1444,18109,343,14,7.98,0,32.7,749993,6357,745976,1.05,0.04,0.5537920489296635,0.85,99.46
2022-06-19,Chhattisgarh,1272,4,1271,16378,2709,908,7.77,0,32.7,751265,6361,747247,8.28,2.78,0.5008562691131498,0.85,99.47
2022-06-20,Chhattisgarh,1211,11,1203,15244,621,455,7.94,0,32.7,752476,6372,748450,1.9,1.39,0.46617737003058096,0.85,99.46
2022-06-21,Chhattisgarh,1038,5,1037,13062,4501,2268,7.95,0,32.7,753514,6377,749487,13.76,6.94,0.39944954128440363,0.85,99.47
2022-06-22,Chhattisgarh,1069,13,1061,13156,3501,2525,8.13,0,32.7,754583,6390,750548,10.71,7.72,0.40232415902140667,0.85,99.47
2022-06-23,Chhattisgarh,649,4,641,8153,4001,1648,7.96,4,32.7,755232,6394,751189,12.24,5.04,0.24932721712538222,0.85,99.46
2022-06-24,Chhattisgarh,1396,12,1388,17672,1485,1172,7.9,0,32.7,756628,6406,752577,4.54,3.58,0.5404281345565749,0.85,99.46
2022-06-25,Chhattisgarh,1363,7,1363,17762,1241,218,7.67,0,32.7,757991,6413,753940,3.8,0.67,0.5431804281345565,0.85,99.47
2022-06-26,Chhattisgarh,1462,15,1461,18437,3561,1420,7.93,0,32.7,759453,6428,755401,10.89,4.34,0.5638226299694189,0.85,99.47
2022-06-27,Chhattisgarh,639,6,633,7846,3648,2956,8.14,0,32.7,760092,6434,756034,11.16,9.04,0.23993883792048926,0.85,99.47
2022-06-28,Chhattisgarh,1168,6,1163,14613,1901,1557,7.99,0,32.7,761260,6440,757197,5.81,4.76,0.4468807339449541,0.85,99.47
2022-06-29,Chhattisgarh,1216,16,1211,15706,2579,2218,7.74,0,32.7,762476,6456,758408,7.89,6.78,0.4803058103975535,0.85,99.47
2022-06-30,Chhattisgarh,17,0,9,951,2365,865,1.79,8,32.7,762493,6456,758417,7.23,2.65,0.029082568807339445,0.85,99.47
2022-07-01,Chhattisgarh,1523,9,1519,18868,260,176,8.07,0,32.7,764016,6465,759936,0.8,0.54,0.5770030581039755,0.85,99.47
2022-07-02,Chhattisgarh,362,3,356,4479,471,57,8.08,3,32.7,764378,6468,760292,1.44,0.17,0.13697247706422017,0.85,99.47
2022-07-03,Chhattisgarh,1297,7,1297,16069,703,628,8.07,0,32.7,765675,6475,761589,2.15,1.92,0.4914067278287461,0.85,99.47
2022-07-04,Chhattisgarh,1531,20,1524,18817,3244,1973,8.14,0,32.7,767206,6495,763113,9.92,6.03,0.5754434250764525,0.85,99.47
2022-07-05,Chhattisgarh,1393,13,1393,17644,3394,1246,7.9,0,32.7,768599,6508,764506,10.38,3.81,0.5395718654434251,0.85,99.47
2022-07-06,Chhattisgarh,1207,4,1203,15073,4264,271,8.01,0,32.7,769806,6512,765709,13.04,0.83,0.4609480122324158,0.85,99.47
2022-07-07,Chhattisgarh,894,10,888,11544,857,349,7.74,0,32.7,770700,6522,766597,2.62,1.07,0.35302752293577977,0.85,99.47
2022-07-08,Chhattisgarh,1598,11,1598,19588,1431,942,8.16,0,32.7,772298,6533,768195,4.38,2.88,0.5990214067278287,0.85,99.47
2022-07-09,Chhattisgarh,1091,9,1087,13728,592,533,7.95,0,32.7,773389,6542,769282,1.81,1.63,0.41981651376146784,0.85,99.47
2022-07-10,Chhattisgarh,642,5,642,8302,1994,1558,7.73,0,32.7,774031,6547,769924,6.1,4.76,0.25388379204892964,0.85,99.47
2022-07-11,Chhattisgarh,1390,17,1382,17501,4235,3867,7.94,0,32.7,775421,6564,771306,12.95,11.83,0.5351987767584098,0.85,99.47
2022-07-12,Chhattisgarh,1173,5,1173,14524,1467,347,8.08,0,32.7,776594,6569,772479,4.49,1.06,0.4441590214067278,0.85,99.47
2022-07-13,Chhattisgarh,413,4,404,5053,1314,1102,8.17,5,32.7,777007,6573,772883,4.02,3.37,0.15452599388379204,0.85,99.47
2022-07-14,Chhattisgarh,1464,20,1457,17919,1449,545,8.17,0,32.7,778471,6593,774340,4.43,1.67,0.5479816513761467,0.85,99.47
2022-07-15,Chhattisgarh,1075,15,1070,13497,4892,949,7.96,0,32.7,779546,6608,775410,14.96,2.9,0.4127522935779816,0.85,99.47
2022-07-16,Chhattisgarh,845,12,839,10151,2335,1547,8.32,0,32.7,780391,6620,776249,7.14,4.73,0.31042813455657486,0.85,99.47
2022-07-17,Chhattisgarh,1391,20,1383,17726,2233,585,7.85,0,32.7,781782,6640,777632,6.83,1.79,0.5420795107033638,0.85,99.47
2022-07-18,Chhattisgarh,499,2,494,6293,4924,1106,7.93,3,32.7,782281,6642,778126,15.06,3.38,0.19244648318042812,0.85,99.47
2022-07-19,Chhattisgarh,1112,16,1103,13866,3112,415,8.02,0,32.7,783393,6658,779229,9.52,1.27,0.4240366972477064,0.85,99.47
2022-07-20,Chhattisgarh,514,5,514,6317,3830,3448,8.14,0,32.7,783907,6663,779743,11.71,10.54,0.19318042813455655,0.85,99.47
2022-07-21,Chhattisgarh,1101,14,1094,13802,772,433,7.98,0,32.7,785008,6677,780837,2.36,1.32,0.42207951070336386,0.85,99.47
2022-07-22,Chhattisgarh,1592,5,1585,19792,2649,2157,8.04,2,32.7,786600,6682,782422,8.1,6.6,0.6052599388379204,0.85,99.47
2022-07-23,Chhattisgarh,503,2,500,6145,877,871,8.19,1,32.7,787103,6684,782922,2.68,2.66,0.18792048929663607,0.85,99.47
2022-07-24,Chhattisgarh,176,1,169,2244,708,465,7.84,6,32.7,787279,6685,783091,2.17,1.42,0.06862385321100917,0.85,99.47
2022-07-25,Chhattisgarh,278,3,277,3098,786,429,8.97,0,32.7,787557,6688,783368,2.4,1.31,0.0947400611620795,0.85,99.47
2022-07-26,Chhattisgarh,1432,8,1431,17758,4801,2929,8.06,0,32.7,788989,6696,784799,14.68,8.96,0.5430581039755351,0.85,99.47
2022-07-27,Chhattisgarh,953,9,949,11831,650,590,8.06,0,32.7,789942,6705,785748,1.99,1.8,0.3618042813455657,0.85,99.47
2022-07-28,Chhattisgarh,1315,19,1311,16236,4472,1596,8.1,0,32.7,791257,6724,787059,13.68,4.88,0.49651376146788984,0.85,99.47
2022-07-29,Chhattisgarh,641,6,637,7966,749,518,8.05,0,32.7,791898,6730,787696,2.29,1.58,0.24360856269113146,0.85,99.47
2022-07-30,Chhattisgarh,1287,10,1279,16128,920,313,7.98,0,32.7,793185,6740,788975,2.81,0.96,0.4932110091743119,0.85,99.47
2022-07-31,Chhattisgarh,165,2,161,2138,2963,855,7.72,2,32.7,793350,6742,789136,9.06,2.61,0.06538226299694189,0.85,99.47
2022-08-01,Chhattisgarh,337,3,328,4302,4796,4644,7.83,6,32.7,793687,6745,789464,14.67,14.2,0.1315596330275229,0.85,99.47
2022-08-02,Chhattisgarh,1296,18,1294,16305,4606,4136,7.95,0,32.7,794983,6763,790758,14.09,12.65,0.4986238532110091,0.85,99.47
2022-08-03,Chhattisgarh,1145,14,1136,14047,784,564,8.15,0,32.7,796128,6777,791894,2.4,1.72,0.429571865443425,0.85,99.47
2022-08-04,Chhattisgarh,805,12,800,10044,2308,2307,8.01,0,32.7,796933,6789,792694,7.06,7.06,0.30715596330275224,0.85,99.47
2022-08-05,Chhattisgarh,282,1,274,3478,3921,3446,8.11,7,32.7,797215,6790,792968,11.99,10.54,0.10636085626911314,0.85,99.47
2022-08-06,Chhattisgarh,1599,8,1597,19646,3125,709,8.14,0,32.7,798814,6798,794565,9.56,2.17,0.600795107033639,0.85,99.47
2022-08-07,Chhattisgarh,1595,13,1594,19723,4195,3523,8.09,0,32.7,800409,6811,796159,12.83,10.77,0.6031498470948011,0.85,99.47
2022-08-08,Chhattisgarh,986,11,984,12271,691,121,8.04,0,32.7,801395,6822,797143,2.11,0.37,0.37525993883792047,0.85,99.47
2022-08-09,Chhattisgarh,1234,5,1230,15436,3004,2073,7.99,0,32.7,802629,6827,798373,9.19,6.34,0.4720489296636085,0.85,99.47
2022-08-10,Chhattisgarh,1579,15,1572,19219,3542,2116,8.22,0,32.7,804208,6842,799945,10.83,6.47,0.587737003058104,0.85,99.47
2022-08-11,Chhattisgarh,296,1,290,3908,4342,379,7.57,5,32.7,804504,6843,800235,13.28,1.16,0.11951070336391435,0.85,99.47
2022-08-12,Chhattisgarh,648,4,644,8110,2529,1962,7.99,0,32.7,805152,6847,800879,7.73,6.0,0.24801223241590212,0.85,99.47
2022-08-13,Chhattisgarh,743,7,739,9112,3494,2737,8.15,0,32.7,805895,6854,801618,10.69,8.37,0.27865443425076447,0.85,99.47
2022-08-14,Chhattisgarh,498,4,491,6908,4714,3695,7.21,3,32.7,806393,6858,802109,14.42,11.3,0.2112538226299694,0.85,99.47
2022-08-15,Chhattisgarh,1129,10,1122,13873,2074,1264,8.14,0,32.7,807522,6868,803231,6.34,3.87,0.42425076452599386,0.85,99.47
2022-08-16,Chhattisgarh,1514,10,1513,18590,2075,756,8.14,0,32.7,809036,6878,804744,6.35,2.31,0.5685015290519877,0.85,99.47
2022-08-17,Chhattisgarh,574,4,570,7419,4892,1233,7.74,0,32.7,809610,6882,805314,14.96,3.77,0.22688073394495412,0.85,99.47
2022-08-18,Chhattisgarh,594,5,593,7441,3422,1137,7.98,0,32.7,810204,6887,805907,10.46,3.48,0.22755351681957184,0.85,99.47
2022-08-19,Chhattisgarh,69,0,66,996,4450,510,6.93,3,32.7,810273,6887,805973,13.61,1.56,0.03045871559633027,0.85,99.47
2022-08-20,Chhattisgarh,866,5,863,10575,782,260,8.19,0,32.7,811139,6892,806836,2.39,0.8,0.323394495412844,0.85,99.47
2022-08-21,Chhattisgarh,1438,15,1431,17950,4330,535,8.01,0,32.7,812577,6907,808267,13.24,1.64,0.5489296636085627,0.85,99.47
2022-08-22,Chhattisgarh,384,3,379,4801,4263,2253,8.0,2,32.7,812961,6910,808646,13.04,6.89,0.14681957186544342,0.85,99.47
2022-08-23,Chhattisgarh,737,5,735,9447,1941,856,7.8,0,32.7,813698,6915,809381,5.94,2.62,0.2888990825688073,0.85,99.47
2022-08-24,Chhattisgarh,122,0,116,1234,2580,2408,9.89,6,32.7,813820,6915,809497,7.89,7.36,0.03773700305810397,0.85,99.47
2022-08-25,Chhattisgarh,396,1,390,4874,2696,933,8.12,5,32.7,814216,6916,809887,8.24,2.85,0.14905198776758408,0.85,99.47
2022-08-26,Chhattisgarh,1001,6,993,12139,2674,2045,8.25,2,32.7,815217,6922,810880,8.18,6.25,0.371223241590214,0.85,99.47
2022-08-27,Chhattisgarh,871,6,869,10880,1942,211,8.01,0,32.7,816088,6928,811749,5.94,0.65,0.33272171253822624,0.85,99.47
2022-08-28,Chhattisgarh,1296,5,1289,15989,1102,240,8.11,2,32.7,817384,6933,813038,3.37,0.73,0.488960244648318,0.85,99.47
2022-08-29,Chhattisgarh,376,2,370,4995,491,273,7.53,4,32.7,817760,6935,813408,1.5,0.83,0.15275229357798165,0.85,99.47
2022-08-30,Chhattisgarh,649,2,644,8000,3512,1742,8.11,3,32.7,818409,6937,814052,10.74,5.33,0.24464831804281342,0.85,99.47
2022-08-31,Chhattisgarh,1486,18,1485,18932,4777,628,7.85,0,32.7,819895,6955,815537,14.61,1.92,0.578960244648318,0.85,99.47
2022-09-01,Chhattisgarh,407,2,407,4627,4010,232,8.8,0,32.7,820302,6957,815944,12.26,0.71,0.1414984709480122,0.85,99.47
2022-09-02,Chhattisgarh,967,5,961,12277,2098,269,7.88,1,32.7,821269,6962,816905,6.42,0.82,0.37544342507645256,0.85,99.47
2022-09-03,Chhattisgarh,77,0,71,981,1072,591,7.85,6,32.7,821346,6962,816976,3.28,1.81,0.029999999999999995,0.85,99.47
2022-09-04,Chhattisgarh,409,3,405,5496,1937,1053,7.44,1,32.7,821755,6965,817381,5.92,3.22,0.16807339449541284,0.85,99.47
2022-09-05,Chhattisgarh,131,0,123,1829,841,438,7.16,8,32.7,821886,6965,817504,2.57,1.34,0.05593272171253822,0.85,99.47
2022-09-06,Chhattisgarh,1387,4,1384,17277,4163,3327,8.03,0,32.7,823273,6969,818888,12.73,10.17,0.5283486238532109,0.85,99.47
2022-09-07,Chhattisgarh,1182,4,1180,14889,1606,467,7.94,0,32.7,824455,6973,820068,4.91,1.43,0.45532110091743117,0.85,99.47
2022-09-08,Chhattisgarh,1337,7,1328,16528,353,207,8.09,2,32.7,825792,6980,821396,1.08,0.63,0.5054434250764526,0.85,99.47
2022-09-09,Chhattisgarh,1575,5,1567,19791,1655,103,7.96,3,32.7,827367,6985,822963,5.06,0.31,0.6052293577981651,0.84,99.47
2022-09-10,Chhattisgarh,241,2,241,3453,1176,586,6.98,0,32.7,827608,6987,823204,3.6,1.79,0.10559633027522934,0.84,99.47
2022-09-11,Chhattisgarh,859,12,859,10224,2388,1684,8.4,0,32.7,828467,6999,824063,7.3,5.15,0.31266055045871555,0.84,99.47
2022-09-12,Chhattisgarh,1094,6,1092,13622,3379,720,8.03,0,32.7,829561,7005,825155,10.33,2.2,0.41657492354740056,0.84,99.47
2022-09-13,Chhattisgarh,411,4,407,5553,1969,604,7.4,0,32.7,829972,7009,825562,6.02,1.85,0.16981651376146786,0.84,99.47
2022-09-14,Chhattisgarh,66,0,65,907,2706,1795,7.28,1,32.7,830038,7009,825627,8.28,5.49,0.027737003058103973,0.84,99.47
2022-09-15,Chhattisgarh,915,8,910,11341,3837,3787,8.07,0,32.7,830953,7017,826537,11.73,11.58,0.3468195718654434,0.84,99.47
2022-09-16,Chhattisgarh,45,0,37,798,2078,1766,5.64,8,32.7,830998,7017,826574,6.35,5.4,0.02440366972477064,0.84,99.47
2022-09-17,Chhattisgarh,1479,7,1479,18500,1039,222,7.99,0,32.7,832477,7024,828053,3.18,0.68,0.565749235474006,0.84,99.47
2022-09-18,Chhattisgarh,83,1,75,525,3787,2700,15.81,7,32.7,832560,7025,828128,11.58,8.26,0.01605504587155963,0.84,99.47
2022-09-19,Chhattisgarh,1115,8,1107,13970,3177,1877,7.98,0,32.7,833675,7033,829235,9.72,5.74,0.427217125382263,0.84,99.47
2022-09-20,Chhattisgarh,1341,6,1338,16663,393,358,8.05,0,32.7,835016,7039,830573,1.2,1.09,0.509571865443425,0.84,99.47
2022-09-21,Chhattisgarh,164,2,157,2576,60,56,6.37,5,32.7,835180,7041,830730,0.18,0.17,0.07877675840978593,0.84,99.47
2022-09-22,Chhattisgarh,426,3,426,5395,4457,1787,7.9,0,32.7,835606,7044,831156,13.63,5.46,0.1649847094801223,0.84,99.47
2022-09-23,Chhattisgarh,1365,20,1357,17106,2379,1222,7.98,0,32.7,836971,7064,832513,7.28,3.74,0.5231192660550458,0.84,99.47
2022-09-24,Chhattisgarh,447,4,443,5563,4815,4391,8.04,0,32.7,837418,7068,832956,14.72,13.43,0.1701223241590214,0.84,99.47
2022-09-25,Chhattisgarh,681,9,681,8126,1873,1010,8.38,0,32.7,838099,7077,833637,5.73,3.09,0.24850152905198775,0.84,99.47
2022-09-26,Chhattisgarh,254,1,251,2950,3104,687,8.61,2,32.7,838353,7078,833888,9.49,2.1,0.09021406727828746,0.84,99.47
2022-09-27,Chhattisgarh,208,1,203,2995,2895,2572,6.94,4,32.7,838561,7079,834091,8.85,7.87,0.09159021406727828,0.84,99.47
2022-09-28,Chhattisgarh,1327,11,1318,16310,4741,2866,8.14,0,32.7,839888,7090,835409,14.5,8.76,0.49877675840978586,0.84,99.47
2022-09-29,Chhattisgarh,941,13,934,11400,2184,2163,8.25,0,32.7,840829,7103,836343,6.68,6.61,0.34862385321100914,0.84,99.47
2022-09-30,Chhattisgarh,888,8,888,11222,1864,1315,7.91,0,32.7,841717,7111,837231,5.7,4.02,0.3431804281345565,0.84,99.47
2022-10-01,Chhattisgarh,1250,5,1246,15495,4745,4405,8.07,0,32.7,842967,7116,838477,14.51,13.47,0.47385321100917427,0.84,99.47
2022-10-02,Chhattisgarh,1340,14,1331,16717,3162,1792,8.02,0,32.7,844307,7130,839808,9.67,5.48,0.511223241590214,0.84,99.47
2022-10-03,Chhattisgarh,1562,13,1557,19650,2479,404,7.95,0,32.7,845869,7143,841365,7.58,1.24,0.6009174311926605,0.84,99.47
2022-10-04,Chhattisgarh,1367,10,1359,17147,992,217,7.97,0,32.7,847236,7153,842724,3.03,0.66,0.5243730886850152,0.84,99.47
2022-10-05,Chhattisgarh,357,4,348,4955,4351,2474,7.2,5,32.7,847593,7157,843072,13.31,7.57,0.15152905198776756,0.84,99.47
2022-10-06,Chhattisgarh,1297,7,1294,16174,2182,686,8.02,0,32.7,848890,7164,844366,6.67,2.1,0.49461773700305806,0.84,99.47
2022-10-07,Chhattisgarh,998,10,993,12695,4904,660,7.86,0,32.7,849888,7174,845359,15.0,2.02,0.38822629969418954,0.84,99.47
2022-10-08,Chhattisgarh,137,1,137,1760,208,45,7.78,0,32.7,850025,7175,845496,0.64,0.14,0.05382262996941895,0.84,99.47
2022-10-09,Chhattisgarh,1510,20,1504,19164,2269,2113,7.88,0,32.7,851535,7195,847000,6.94,6.46,0.5860550458715595,0.84,99.47
2022-10-10,Chhattisgarh,468,5,461,5477,2672,108,8.54,2,32.7,852003,7200,847461,8.17,0.33,0.16749235474006113,0.85,99.47
2022-10-11,Chhattisgarh,419,4,414,4716,2428,893,8.88,1,32.7,852422,7204,847875,7.43,2.73,0.14422018348623852,0.85,99.47
2022-10-12,Chhattisgarh,369,3,366,4637,3641,2345,7.96,0,32.7,852791,7207,848241,11.13,7.17,0.14180428134556575,0.85,99.47
2022-10-13,Chhattisgarh,692,6,692,8723,2334,1924,7.93,0,32.7,853483,7213,848933,7.14,5.88,0.2667584097859327,0.85,99.47
2022-10-14,Chhattisgarh,1410,11,1402,17432,3606,3101,8.09,0,32.7,854893,7224,850335,11.03,9.48,0.5330886850152905,0.85,99.47
2022-10-15,Chhattisgarh,1288,10,1279,16266,2809,2302,7.92,0,32.7,856181,7234,851614,8.59,7.04,0.4974311926605504,0.84,99.47
2022-10-16,Chhattisgarh,1515,18,1510,19146,4141,3059,7.91,0,32.7,857696,7252,853124,12.66,9.35,0.5855045871559632,0.85,99.47
2022-10-17,Chhattisgarh,375,4,368,4570,1435,184,8.21,3,32.7,858071,7256,853492,4.39,0.56,0.13975535168195716,0.85,99.47
2022-10-18,Chhattisgarh,298,3,297,3862,435,308,7.72,0,32.7,858369,7259,853789,1.33,0.94,0.11810397553516819,0.85,99.47
2022-10-19,Chhattisgarh,1070,4,1067,13243,4861,4453,8.08,0,32.7,859439,7263,854856,14.87,13.62,0.4049847094801223,0.85,99.47
2022-10-20,Chhattisgarh,272,1,268,3593,839,540,7.57,3,32.7,859711,7264,855124,2.57,1.65,0.10987767584097859,0.84,99.47
2022-10-21,Chhattisgarh,935,8,935,11570,4485,3684,8.08,0,32.7,860646,7272,856059,13.72,11.27,0.35382262996941893,0.84,99.47
2022-10-22,Chhattisgarh,428,2,423,5150,2208,2196,8.31,3,32.7,861074,7274,856482,6.75,6.72,0.15749235474006115,0.84,99.47
2022-10-23,Chhattisgarh,1039,5,1035,12798,2402,1921,8.12,0,32.7,862113,7279,857517,7.35,5.87,0.3913761467889908,0.84,99.47
2022-10-24,Chhattisgarh,295,3,292,3780,737,734,7.8,0,32.7,862408,7282,857809,2.25,2.24,0.11559633027522935,0.84,99.47
2022-10-25,Chhattisgarh,1523,19,1516,19019,3693,1326,8.01,0,32.7,863931,7301,859325,11.29,4.06,0.5816207951070336,0.85,99.47
2022-10-26,Chhattisgarh,937,13,930,11907,1916,1135,7.87,0,32.7,864868,7314,860255,5.86,3.47,0.36412844036697245,0.85,99.47
2022-10-27,Chhattisgarh,820,11,820,10255,3110,2783,8.0,0,32.7,865688,7325,861075,9.51,8.51,0.31360856269113146,0.85,99.47
2022-10-28,Chhattisgarh,292,3,292,3644,1488,221,8.01,0,32.7,865980,7328,861367,4.55,0.68,0.11143730886850152,0.85,99.47
2022-10-29,Chhattisgarh,1391,9,1391,17268,4735,4637,8.06,0,32.7,867371,7337,862758,14.48,14.18,0.5280733944954128,0.85,99.47
2022-10-30,Chhattisgarh,385,1,376,4605,1907,959,8.36,8,32.7,867756,7338,863134,5.83,2.93,0.1408256880733945,0.85,99.47
2022-10-31,Chhattisgarh,1065,6,1056,13017,3171,461,8.18,3,32.7,868821,7344,864190,9.7,1.41,0.3980733944954128,0.85,99.47
2022-11-01,Chhattisgarh,58,0,58,640,4544,3684,9.06,0,32.7,868879,7344,864248,13.9,11.27,0.019571865443425075,0.85,99.47
2022-11-02,Chhattisgarh,140,0,135,2070,3997,924,6.76,5,32.7,869019,7344,864383,12.22,2.83,0.06330275229357797,0.85,99.47
2022-11-03,Chhattisgarh,922,2,920,11893,4995,325,7.75,0,32.7,869941,7346,865303,15.28,0.99,0.36370030581039753,0.84,99.47
2022-11-04,Chhattisgarh,581,2,581,7690,4291,3108,7.56,0,32.7,870522,7348,865884,13.12,9.5,0.2351681957186544,0.84,99.47
2022-11-05,Chhattisgarh,306,1,303,4036,3304,836,7.58,2,32.7,870828,7349,866187,10.1,2.56,0.12342507645259937,0.84,99.47
2022-11-06,Chhattisgarh,828,12,828,10535,3622,2611,7.86,0,32.7,871656,7361,867015,11.08,7.98,0.32217125382262995,0.84,99.47
2022-11-07,Chhattisgarh,1297,9,1296,16400,4004,2353,7.91,0,32.7,872953,7370,868311,12.24,7.2,0.5015290519877675,0.84,99.47
2022-11-08,Chhattisgarh,1217,12,1214,15222,1714,1582,8.0,0,32.7,874170,7382,869525,5.24,4.84,0.46550458715596327,0.84,99.47
2022-11-09,Chhattisgarh,741,2,740,9219,494,441,8.04,0,32.7,874911,7384,870265,1.51,1.35,0.28192660550458715,0.84,99.47
2022-11-10,Chhattisgarh,952,12,949,12124,2622,1833,7.85,0,32.7,875863,7396,871214,8.02,5.61,0.37076452599388376,0.84,99.47
2022-11-11,Chhattisgarh,48,0,40,528,267,201,9.09,8,32.7,875911,7396,871254,0.82,0.61,0.016146788990825688,0.84,99.47
2022-11-12,Chhattisgarh,1439,16,1433,17659,1413,324,8.15,0,32.7,877350,7412,872687,4.32,0.99,0.5400305810397553,0.84,99.47
2022-11-13,Chhattisgarh,1582,8,1574,19969,3303,2557,7.92,0,32.7,878932,7420,874261,10.1,7.82,0.6106727828746177,0.84,99.47
2022-11-14,Chhattisgarh,170,1,168,1918,4288,2976,8.86,1,32.7,879102,7421,874429,13.11,9.1,0.05865443425076452,0.84,99.47
2022-11-15,Chhattisgarh,336,2,329,4274,4216,2887,7.86,5,32.7,879438,7423,874758,12.89,8.83,0.13070336391437307,0.84,99.47
2022-11-16,Chhattisgarh,923,6,918,10767,2483,1392,8.57,0,32.7,880361,7429,875676,7.59,4.26,0.32926605504587153,0.84,99.47
2022-11-17,Chhattisgarh,1372,12,1368,17215,3512,2007,7.97,0,32.7,881733,7441,877044,10.74,6.14,0.5264525993883792,0.84,99.47
2022-11-18,Chhattisgarh,940,7,934,11714,1791,70,8.02,0,32.7,882673,7448,877978,5.48,0.21,0.35822629969418956,0.84,99.47
2022-11-19,Chhattisgarh,157,1,152,2168,2226,1724,7.24,4,32.7,882830,7449,878130,6.81,5.27,0.06629969418960244,0.84,99.47
2022-11-20,Chhattisgarh,1057,5,1050,13526,506,98,7.81,2,32.7,883887,7454,879180,1.55,0.3,0.4136391437308868,0.84,99.47
2022-11-21,Chhattisgarh,268,4,268,3473,3354,1406,7.72,0,32.7,884155,7458,879448,10.26,4.3,0.10620795107033638,0.84,99.47
2022-11-22,Chhattisgarh,757,7,753,9437,2147,1196,8.02,0,32.7,884912,7465,880201,6.57,3.66,0.2885932721712538,0.84,99.47
2022-11-23,Chhattisgarh,1337,18,1336,17157,4622,3907,7.79,0,32.7,886249,7483,881537,14.13,11.95,0.5246788990825687,0.84,99.47
2022-11-24,Chhattisgarh,951,10,947,11600,3710,1708,8.2,0,32.7,887200,7493,882484,11.35,5.22,0.35474006116207946,0.84,99.47
2022-11-25,Chhattisgarh,512,5,511,6198,3497,3073,8.26,0,32.7,887712,7498,882995,10.69,9.4,0.1895412844036697,0.84,99.47
2022-11-26,Chhattisgarh,68,0,67,616,2329,2033,11.04,1,32.7,887780,7498,883062,7.12,6.22,0.018837920489296636,0.84,99.47
2022-11-27,Chhattisgarh,808,6,799,10037,135,135,8.05,3,32.7,888588,7504,883861,0.41,0.41,0.3069418960244648,0.84,99.47
2022-11-28,Chhattisgarh,355,2,352,4332,4277,2528,8.19,1,32.7,888943,7506,884213,13.08,7.73,0.13247706422018346,0.84,99.47
2022-11-29,Chhattisgarh,1013,14,1009,12854,2685,2655,7.88,0,32.7,889956,7520,885222,8.21,8.12,0.3930886850152905,0.84,99.47
2022-11-30,Chhattisgarh,226,0,218,2347,1161,819,9.63,8,32.7,890182,7520,885440,3.55,2.5,0.07177370030581039,0.84,99.47
2022-12-01,Chhattisgarh,213,0,212,3040,1043,594,7.01,1,32.7,890395,7520,885652,3.19,1.82,0.09296636085626911,0.84,99.47
2022-12-02,Chhattisgarh,1343,8,1343,16599,4178,706,8.09,0,32.7,891738,7528,886995,12.78,2.16,0.5076146788990825,0.84,99.47
2022-12-03,Chhattisgarh,103,1,100,1457,2270,1671,7.07,2,32.7,891841,7529,887095,6.94,5.11,0.04455657492354739,0.84,99.47
2022-12-04,Chhattisgarh,804,11,801,9772,1451,534,8.23,0,32.7,892645,7540,887896,4.44,1.63,0.2988379204892966,0.84,99.47
2022-12-05,Chhattisgarh,1206,8,1198,15158,2631,1913,7.96,0,32.7,893851,7548,889094,8.05,5.85,0.46354740061162075,0.84,99.47
2022-12-06,Chhattisgarh,997,4,992,12134,4939,4464,8.22,1,32.7,894848,7552,890086,15.1,13.65,0.37107033639143727,0.84,99.47
2022-12-07,Chhattisgarh,698,9,697,8701,508,2,8.02,0,32.7,895546,7561,890783,1.55,0.01,0.26608562691131493,0.84,99.47
2022-12-08,Chhattisgarh,1049,13,1045,12971,560,439,8.09,0,32.7,896595,7574,891828,1.71,1.34,0.3966666666666666,0.84,99.47
2022-12-09,Chhattisgarh,1256,5,1253,15750,3236,2832,7.97,0,32.7,897851,7579,893081,9.9,8.66,0.48165137614678893,0.84,99.47
2022-12-10,Chhattisgarh,1153,12,1144,14666,3365,2221,7.86,0,32.7,899004,7591,894225,10.29,6.79,0.4485015290519877,0.84,99.47
2022-12-11,Chhattisgarh,65,0,56,925,773,40,7.03,9,32.7,899069,7591,894281,2.36,0.12,0.0282874617737003,0.84,99.47
2022-12-12,Chhattisgarh,1326,17,1323,16777,3,2,7.9,0,32.7,900395,7608,895604,0.01,0.01,0.5130581039755351,0.84,99.47
2022-12-13,Chhattisgarh,210,1,207,2487,2192,62,8.44,2,32.7,900605,7609,895811,6.7,0.19,0.07605504587155962,0.84,99.47
2022-12-14,Chhattisgarh,1296,14,1295,16408,4029,1038,7.9,0,32.7,901901,7623,897106,12.32,3.17,0.5017737003058104,0.85,99.47
2022-12-15,Chhattisgarh,836,4,832,10471,3455,163,7.98,0,32.7,902737,7627,897938,10.57,0.5,0.32021406727828744,0.84,99.47
2022-12-16,Chhattisgarh,939,5,934,12029,546,355,7.81,0,32.7,903676,7632,898872,1.67,1.09,0.36785932721712533,0.84,99.47
2022-12-17,Chhattisgarh,323,3,318,4510,4160,3311,7.16,2,32.7,903999,7635,899190,12.72,10.13,0.13792048929663606,0.84,99.47
2022-12-18,Chhattisgarh,208,2,201,3017,1088,119,6.89,5,32.7,904207,7637,899391,3.33,0.36,0.09226299694189602,0.84,99.47
2022-12-19,Chhattisgarh,932,5,928,11779,3025,1709,7.91,0,32.7,905139,7642,900319,9.25,5.23,0.3602140672782874,0.84,99.47
2022-12-20,Chhattisgarh,275,3,271,3407,673,224,8.07,1,32.7,905414,7645,900590,2.06,0.69,0.10418960244648316,0.84,99.47
2022-12-21,Chhattisgarh,390,4,382,5309,3583,3438,7.35,4,32.7,905804,7649,900972,10.96,10.51,0.16235474006116207,0.84,99.47
2022-12-22,Chhattisgarh,893,8,885,10847,3532,1102,8.23,0,32.7,906697,7657,901857,10.8,3.37,0.33171253822629965,0.84,99.47
2022-12-23,Chhattisgarh,300,1,292,3894,98,72,7.7,7,32.7,906997,7658,902149,0.3,0.22,0.11908256880733943,0.84,99.47
2022-12-24,Chhattisgarh,1255,8,1249,15907,628,88,7.89,0,32.7,908252,7666,903398,1.92,0.27,0.48645259938837915,0.84,99.47
2022-12-25,Chhattisgarh,283,0,283,3599,2310,1658,7.86,0,32.7,908535,7666,903681,7.06,5.07,0.1100611620795107,0.84,99.47
2022-12-26,Chhattisgarh,656,2,647,8397,1869,982,7.81,7,32.7,909191,7668,904328,5.72,3.0,0.25678899082568807,0.84,99.47
2022-12-27,Chhattisgarh,179,1,179,2211,3902,3801,8.1,0,32.7,909370,7669,904507,11.93,11.62,0.06761467889908256,0.84,99.47
2022-12-28,Chhattisgarh,717,3,710,8843,1561,1170,8.11,4,32.7,910087,7672,905217,4.77,3.58,0.2704281345565749,0.84,99.46
2022-12-29,Chhattisgarh,1277,8,1272,15528,667,578,8.22,0,32.7,911364,7680,906489,2.04,1.77,0.47486238532110087,0.84,99.47
2022-12-30,Chhattisgarh,1318,13,1309,16591,2139,1903,7.94,0,32.7,912682,7693,907798,6.54,5.82,0.5073700305810397,0.84,99.46
2022-12-31,Chhattisgarh,130,0,127,1613,2094,1403,8.06,3,32.7,912812,7693,907925,6.4,4.29,0.04932721712538226,0.84,99.46
2020-01-01,Goa,168,0,162,1997,964,131,8.41,6,1.6,168,0,162,60.25,8.19,1.248125,0.0,96.43
2020-01-02,Goa,1031,10,1022,12853,114,59,8.02,0,1.6,1199,10,1184,7.12,3.69,8.033125,0.83,98.75
2020-01-03,Goa,1029,8,1029,12775,2087,1301,8.05,0,1.6,2228,18,2213,130.44,81.31,7.984375,0.81,99.33
2020-01-04,Goa,1034,4,1034,13169,4081,3083,7.85,0,1.6,3262,22,3247,255.06,192.69,8.230625,0.67,99.54
2020-01-05,Goa,1357,6,1351,16688,2657,2146,8.13,0,1.6,4619,28,4598,166.06,134.12,10.43,0.61,99.55
2020-01-06,Goa,660,5,653,8092,1194,480,8.16,2,1.6,5279,33,5251,74.62,30.0,5.0575,0.63,99.47
2020-01-07,Goa,1383,15,1379,16796,4806,4258,8.23,0,1.6,6662,48,6630,300.38,266.12,10.4975,0.72,99.52
2020-01-08,Goa,720,2,714,9427,3203,3172,7.64,4,1.6,7382,50,7344,200.19,198.25,5.891875,0.68,99.49
2020-01-09,Goa,1102,4,1096,13360,735,606,8.25,2,1.6,8484,54,8440,45.94,37.88,8.35,0.64,99.48
2020-01-10,Goa,628,6,627,8046,994,988,7.81,0,1.6,9112,60,9067,62.12,61.75,5.02875,0.66,99.51
2020-01-11,Goa,983,4,983,12474,1279,908,7.88,0,1.6,10095,64,10050,79.94,56.75,7.79625,0.63,99.55
2020-01-12,Goa,928,8,925,11682,4011,1755,7.94,0,1.6,11023,72,10975,250.69,109.69,7.30125,0.65,99.56
2020-01-13,Goa,885,10,880,10649,3306,1794,8.31,0,1.6,11908,82,11855,206.62,112.13,6.655625,0.69,99.55
2020-01-14,Goa,1526,14,1523,19072,4127,339,8.0,0,1.6,13434,96,13378,257.94,21.19,11.92,0.71,99.58
2020-01-15,Goa,1444,9,1439,17465,4200,2402,8.27,0,1.6,14878,105,14817,262.5,150.12,10.915625,0.71,99.59
2020-01-16,Goa,713,3,707,8939,74,67,7.98,3,1.6,15591,108,15524,4.62,4.19,5.586875,0.69,99.57
2020-01-17,Goa,1000,8,999,12819,2949,1337,7.8,0,1.6,16591,116,16523,184.31,83.56,8.011875,0.7,99.59
2020-01-18,Goa,663,4,657,8259,75,42,8.03,2,1.6,17254,120,17180,4.69,2.62,5.161875,0.7,99.57
2020-01-19,Goa,110,1,104,1196,3979,1687,9.2,5,1.6,17364,121,17284,248.69,105.44,0.7475,0.7,99.54
2020-01-20,Goa,1313,12,1312,16197,950,918,8.11,0,1.6,18677,133,18596,59.38,57.38,10.123125,0.71,99.57
2020-01-21,Goa,24,0,15,577,920,759,4.16,9,1.6,18701,133,18611,57.5,47.44,0.360625,0.71,99.52
2020-01-22,Goa,761,11,752,9741,4689,3097,7.81,0,1.6,19462,144,19363,293.06,193.56,6.088125,0.74,99.49
2020-01-23,Goa,1600,6,1600,19627,733,462,8.15,0,1.6,21062,150,20963,45.81,28.88,12.266875,0.71,99.53
2020-01-24,Goa,918,12,917,11578,1359,797,7.93,0,1.6,21980,162,21880,84.94,49.81,7.23625,0.74,99.55
2020-01-25,Goa,652,6,647,8418,4037,1808,7.75,0,1.6,22632,168,22527,252.31,113.0,5.26125,0.74,99.54
2020-01-26,Goa,73,1,67,1225,4364,2368,5.96,5,1.6,22705,169,22594,272.75,148.0,0.765625,0.74,99.51
2020-01-27,Goa,1285,3,1278,16300,3769,1436,7.88,4,1.6,23990,172,23872,235.56,89.75,10.1875,0.72,99.51
2020-01-28,Goa,797,9,796,9742,4053,2786,8.18,0,1.6,24787,181,24668,253.31,174.12,6.08875,0.73,99.52
2020-01-29,Goa,1350,15,1346,16734,1243,498,8.07,0,1.6,26137,196,26014,77.69,31.13,10.45875,0.75,99.53
2020-01-30,Goa,1333,8,1328,16410,1553,1093,8.12,0,1.6,27470,204,27342,97.06,68.31,10.25625,0.74,99.53
2020-01-31,Goa,304,3,304,4067,787,238,7.47,0,1.6,27774,207,27646,49.19,14.88,2.541875,0.75,99.54
2020-02-01,Goa,636,9,630,7344,3815,2126,8.66,0,1.6,28410,216,28276,238.44,132.88,4.59,0.76,99.53
2020-02-02,Goa,1445,8,1440,18018,3247,2150,8.02,0,1.6,29855,224,29716,202.94,134.38,11.26125,0.75,99.53
2020-02-03,Goa,841,6,840,10498,61,59,8.01,0,1.6,30696,230,30556,3.81,3.69,6.56125,0.75,99.54
2020-02-04,Goa,419,4,412,5134,1381,736,8.16,3,1.6,31115,234,30968,86.31,46.0,3.20875,0.75,99.53
2020-02-05,Goa,466,5,466,5796,3100,2611,8.04,0,1.6,31581,239,31434,193.75,163.19,3.6225,0.76,99.53
2020-02-06,Goa,1568,13,1564,19792,4867,792,7.92,0,1.6,33149,252,32998,304.19,49.5,12.37,0.76,99.54
2020-02-07,Goa,1331,10,1322,16844,3419,464,7.9,0,1.6,34480,262,34320,213.69,29.0,10.5275,0.76,99.54
2020-02-08,Goa,485,3,477,5891,2966,1949,8.23,5,1.6,34965,265,34797,185.38,121.81,3.681875,0.76,99.52
2020-02-09,Goa,446,1,446,5459,1207,238,8.17,0,1.6,35411,266,35243,75.44,14.88,3.411875,0.75,99.53
2020-02-10,Goa,427,2,419,5545,1444,681,7.7,6,1.6,35838,268,35662,90.25,42.56,3.465625,0.75,99.51
2020-02-11,Goa,652,7,650,7885,983,155,8.27,0,1.6,36490,275,36312,61.44,9.69,4.928125,0.75,99.51
2020-02-12,Goa,1480,5,1480,18142,1038,798,8.16,0,1.6,37970,280,37792,64.88,49.88,11.33875,0.74,99.53
2020-02-13,Goa,686,7,681,8645,197,161,7.94,0,1.6,38656,287,38473,12.31,10.06,5.403125,0.74,99.53
2020-02-14,Goa,1127,11,1126,13812,2017,371,8.16,0,1.6,39783,298,39599,126.06,23.19,8.6325,0.75,99.54
2020-02-15,Goa,378,4,369,5090,3517,284,7.43,5,1.6,40161,302,39968,219.81,17.75,3.18125,0.75,99.52
2020-02-16,Goa,1070,15,1068,13444,1667,1407,7.96,0,1.6,41231,317,41036,104.19,87.94,8.4025,0.77,99.53
2020-02-17,Goa,638,8,629,7790,2828,2330,8.19,1,1.6,41869,325,41665,176.75,145.62,4.86875,0.78,99.51
2020-02-18,Goa,850,6,846,10378,1833,369,8.19,0,1.6,42719,331,42511,114.56,23.06,6.48625,0.77,99.51
2020-02-19,Goa,1145,14,1136,14467,2507,2380,7.91,0,1.6,43864,345,43647,156.69,148.75,9.041875,0.79,99.51
2020-02-20,Goa,260,3,251,3165,3539,239,8.21,6,1.6,44124,348,43898,221.19,14.94,1.978125,0.79,99.49
2020-02-21,Goa,1418,12,1415,17470,3500,1575,8.12,0,1.6,45542,360,45313,218.75,98.44,10.91875,0.79,99.5
2020-02-22,Goa,1484,7,1484,18247,2685,1587,8.13,0,1.6,47026,367,46797,167.81,99.19,11.404375,0.78,99.51
2020-02-23,Goa,790,11,787,9968,2871,2555,7.93,0,1.6,47816,378,47584,179.44,159.69,6.23,0.79,99.51
2020-02-24,Goa,89,0,88,1270,3491,2723,7.01,1,1.6,47905,378,47672,218.19,170.19,0.79375,0.79,99.51
2020-02-25,Goa,711,6,705,9065,2900,2097,7.84,0,1.6,48616,384,48377,181.25,131.06,5.665625,0.79,99.51
2020-02-26,Goa,961,13,959,11694,4328,3668,8.22,0,1.6,49577,397,49336,270.5,229.25,7.30875,0.8,99.51
2020-02-27,Goa,1208,15,1207,15443,2844,387,7.82,0,1.6,50785,412,50543,177.75,24.19,9.651875,0.81,99.52
2020-02-28,Goa,225,1,222,3104,1439,74,7.25,2,1.6,51010,413,50765,89.94,4.62,1.94,0.81,99.52
2020-02-29,Goa,236,2,229,2671,1782,717,8.84,5,1.6,51246,415,50994,111.38,44.81,1.669375,0.81,99.51
2020-03-01,Goa,90,0,88,1026,4560,3008,8.77,2,1.6,51336,415,51082,285.0,188.0,0.64125,0.81,99.51
2020-03-02,Goa,606,8,598,7866,4132,1524,7.7,0,1.6,51942,423,51680,258.25,95.25,4.91625,0.81,99.5
2020-03-03,Goa,633,6,632,7870,1984,1268,8.04,0,1.6,52575,429,52312,124.0,79.25,4.91875,0.82,99.5
2020-03-04,Goa,1447,15,1447,18117,229,46,7.99,0,1.6,54022,444,53759,14.31,2.88,11.323125,0.82,99.51
2020-03-05,Goa,511,4,505,6334,4150,2946,8.07,2,1.6,54533,448,54264,259.38,184.12,3.95875,0.82,99.51
2020-03-06,Goa,181,0,176,2102,3114,2098,8.61,5,1.6,54714,448,54440,194.62,131.12,1.31375,0.82,99.5
2020-03-07,Goa,879,4,876,10781,923,661,8.15,0,1.6,55593,452,55316,57.69,41.31,6.738125,0.81,99.5
2020-03-08,Goa,906,7,897,11244,2586,2024,8.06,2,1.6,56499,459,56213,161.62,126.5,7.0275,0.81,99.49
2020-03-09,Goa,1207,11,1201,15458,1562,443,7.81,0,1.6,57706,470,57414,97.62,27.69,9.66125,0.81,99.49
2020-03-10,Goa,559,2,550,6845,3503,3493,8.17,7,1.6,58265,472,57964,218.94,218.31,4.278125,0.81,99.48
2020-03-11,Goa,1155,9,1150,13771,3356,3161,8.39,0,1.6,59420,481,59114,209.75,197.56,8.606875,0.81,99.49
2020-03-12,Goa,423,2,417,5502,4301,173,7.69,4,1.6,59843,483,59531,268.81,10.81,3.43875,0.81,99.48
2020-03-13,Goa,455,5,447,5713,1741,969,7.96,3,1.6,60298,488,59978,108.81,60.56,3.570625,0.81,99.47
2020-03-14,Goa,308,4,299,3789,1909,1069,8.13,5,1.6,60606,492,60277,119.31,66.81,2.368125,0.81,99.46
2020-03-15,Goa,1226,12,1222,15462,4385,617,7.93,0,1.6,61832,504,61499,274.06,38.56,9.66375,0.82,99.46
2020-03-16,Goa,844,7,842,10603,2770,2216,7.96,0,1.6,62676,511,62341,173.12,138.5,6.626875,0.82,99.47
2020-03-17,Goa,986,11,983,12549,2318,1862,7.86,0,1.6,63662,522,63324,144.88,116.38,7.843125,0.82,99.47
2020-03-18,Goa,739,8,730,9055,4971,4399,8.16,1,1.6,64401,530,64054,310.69,274.94,5.659375,0.82,99.46
2020-03-19,Goa,352,4,352,4581,2162,2000,7.68,0,1.6,64753,534,64406,135.12,125.0,2.863125,0.82,99.46
2020-03-20,Goa,1396,17,1395,17174,3658,1150,8.13,0,1.6,66149,551,65801,228.62,71.88,10.73375,0.83,99.47
2020-03-21,Goa,992,6,992,12106,290,105,8.19,0,1.6,67141,557,66793,18.12,6.56,7.56625,0.83,99.48
2020-03-22,Goa,1270,13,1266,15798,4113,2569,8.04,0,1.6,68411,570,68059,257.06,160.56,9.87375,0.83,99.49
2020-03-23,Goa,312,1,304,3939,1481,521,7.92,7,1.6,68723,571,68363,92.56,32.56,2.461875,0.83,99.48
2020-03-24,Goa,1086,5,1086,13173,1729,1486,8.24,0,1.6,69809,576,69449,108.06,92.88,8.233125,0.83,99.48
2020-03-25,Goa,1262,8,1256,15522,3052,2070,8.13,0,1.6,71071,584,70705,190.75,129.38,9.70125,0.82,99.49
2020-03-26,Goa,199,0,198,2670,1470,177,7.45,1,1.6,71270,584,70903,91.88,11.06,1.66875,0.82,99.49
2020-03-27,Goa,692,8,688,8777,1858,158,7.88,0,1.6,71962,592,71591,116.12,9.88,5.485625,0.82,99.48
2020-03-28,Goa,1142,11,1134,14057,1410,106,8.12,0,1.6,73104,603,72725,88.12,6.62,8.785625,0.82,99.48
2020-03-29,Goa,1125,16,1118,14002,1975,576,8.03,0,1.6,74229,619,73843,123.44,36.0,8.75125,0.83,99.48
2020-03-30,Goa,1071,5,1063,13752,4965,4815,7.79,3,1.6,75300,624,74906,310.31,300.94,8.595,0.83,99.48
2020-03-31,Goa,1409,8,1406,17742,1144,723,7.94,0,1.6,76709,632,76312,71.5,45.19,11.08875,0.82,99.48
2020-04-01,Goa,153,1,149,2001,1770,1493,7.65,3,1.6,76862,633,76461,110.62,93.31,1.250625,0.82,99.48
2020-04-02,Goa,415,3,407,5598,1161,273,7.41,5,1.6,77277,636,76868,72.56,17.06,3.49875,0.82,99.47
2020-04-03,Goa,306,1,303,4355,4094,3047,7.03,2,1.6,77583,637,77171,255.88,190.44,2.721875,0.82,99.47
2020-04-04,Goa,533,4,524,6215,4901,3374,8.58,5,1.6,78116,641,77695,306.31,210.88,3.884375,0.82,99.46
2020-04-05,Goa,988,8,988,12632,3893,3135,7.82,0,1.6,79104,649,78683,243.31,195.94,7.895,0.82,99.47
2020-04-06,Goa,1060,5,1054,13249,2188,1362,8.0,1,1.6,80164,654,79737,136.75,85.12,8.280625,0.82,99.47
2020-04-07,Goa,989,7,980,12685,4662,1616,7.8,2,1.6,81153,661,80717,291.38,101.0,7.928125,0.81,99.46
2020-04-08,Goa,568,7,561,6965,3757,1342,8.16,0,1.6,81721,668,81278,234.81,83.88,4.353125,0.82,99.46
2020-04-09,Goa,1193,7,1187,14463,2966,2785,8.25,0,1.6,82914,675,82465,185.38,174.06,9.039375,0.81,99.46
2020-04-10,Goa,1405,12,1404,18079,4719,2934,7.77,0,1.6,84319,687,83869,294.94,183.38,11.299375,0.81,99.47
2020-04-11,Goa,829,6,823,10584,1233,37,7.83,0,1.6,85148,693,84692,77.06,2.31,6.615,0.81,99.46
2020-04-12,Goa,1327,14,1325,16943,20,13,7.83,0,1.6,86475,707,86017,1.25,0.81,10.589375,0.82,99.47
2020-04-13,Goa,861,6,861,11112,3660,589,7.75,0,1.6,87336,713,86878,228.75,36.81,6.945,0.82,99.48
2020-04-14,Goa,761,3,754,9698,2882,2812,7.85,4,1.6,88097,716,87632,180.12,175.75,6.06125,0.81,99.47
2020-04-15,Goa,451,5,450,5812,766,651,7.76,0,1.6,88548,721,88082,47.88,40.69,3.6325,0.81,99.47
2020-04-16,Goa,890,4,883,10855,774,243,8.2,3,1.6,89438,725,88965,48.38,15.19,6.784375,0.81,99.47
2020-04-17,Goa,869,8,864,10985,4507,3901,7.91,0,1.6,90307,733,89829,281.69,243.81,6.865625,0.81,99.47
2020-04-18,Goa,246,1,239,3450,1492,337,7.13,6,1.6,90553,734,90068,93.25,21.06,2.15625,0.81,99.46
2020-04-19,Goa,759,10,752,9803,3448,2895,7.74,0,1.6,91312,744,90820,215.5,180.94,6.126875,0.81,99.46
2020-04-20,Goa,1280,16,1276,16205,2734,1785,7.9,0,1.6,92592,760,92096,170.88,111.56,10.128125,0.82,99.46
2020-04-21,Goa,1116,3,1114,13483,678,556,8.28,0,1.6,93708,763,93210,42.38,34.75,8.426875,0.81,99.47
2020-04-22,Goa,550,3,545,6780,4641,3087,8.11,2,1.6,94258,766,93755,290.06,192.94,4.2375,0.81,99.47
2020-04-23,Goa,294,0,291,3621,2197,106,8.12,3,1.6,94552,766,94046,137.31,6.62,2.263125,0.81,99.46
2020-04-24,Goa,751,7,750,9505,1080,76,7.9,0,1.6,95303,773,94796,67.5,4.75,5.940625,0.81,99.47
2020-04-25,Goa,1514,22,1506,18849,4800,2268,8.03,0,1.6,96817,795,96302,300.0,141.75,11.780625,0.82,99.47
2020-04-26,Goa,1525,9,1524,18789,212,24,8.12,0,1.6,98342,804,97826,13.25,1.5,11.743125,0.82,99.48
2020-04-27,Goa,707,6,702,8874,319,254,7.97,0,1.6,99049,810,98528,19.94,15.88,5.54625,0.82,99.47
2020-04-28,Goa,854,5,846,10783,1007,941,7.92,3,1.6,99903,815,99374,62.94,58.81,6.739375,0.82,99.47
2020-04-29,Goa,546,6,537,6753,4554,1941,8.09,3,1.6,100449,821,99911,284.62,121.31,4.220625,0.82,99.46
2020-04-30,Goa,554,7,552,7123,291,210,7.78,0,1.6,101003,828,100463,18.19,13.12,4.451875,0.82,99.47
2020-05-01,Goa,1473,21,1472,18512,24,22,7.96,0,1.6,102476,849,101935,1.5,1.38,11.57,0.83,99.47
2020-05-02,Goa,1080,9,1075,13570,4746,192,7.96,0,1.6,103556,858,103010,296.62,12.0,8.48125,0.83,99.47
2020-05-03,Goa,733,9,729,8921,4402,849,8.22,0,1.6,104289,867,103739,275.12,53.06,5.575625,0.83,99.47
2020-05-04,Goa,1061,11,1059,13454,461,65,7.89,0,1.6,105350,878,104798,28.81,4.06,8.40875,0.83,99.48
2020-05-05,Goa,377,3,368,4588,4937,4271,8.22,6,1.6,105727,881,105166,308.56,266.94,2.8675,0.83,99.47
2020-05-06,Goa,936,13,936,11994,3241,1449,7.8,0,1.6,106663,894,106102,202.56,90.56,7.49625,0.84,99.47
2020-05-07,Goa,1159,8,1151,15097,937,589,7.68,0,1.6,107822,902,107253,58.56,36.81,9.435625,0.84,99.47
2020-05-08,Goa,1289,13,1280,16723,2971,1110,7.71,0,1.6,109111,915,108533,185.69,69.38,10.451875,0.84,99.47
2020-05-09,Goa,436,4,433,5346,1537,1251,8.16,0,1.6,109547,919,108966,96.06,78.19,3.34125,0.84,99.47
2020-05-10,Goa,1602,11,1601,19996,1136,694,8.01,0,1.6,111149,930,110567,71.0,43.38,12.4975,0.84,99.48
2020-05-11,Goa,786,10,786,10145,1673,280,7.75,0,1.6,111935,940,111353,104.56,17.5,6.340625,0.84,99.48
2020-05-12,Goa,1113,6,1104,13327,1190,667,8.35,3,1.6,113048,946,112457,74.38,41.69,8.329375,0.84,99.48
2020-05-13,Goa,793,6,785,9859,2710,1447,8.04,2,1.6,113841,952,113242,169.38,90.44,6.161875,0.84,99.47
2020-05-14,Goa,1479,15,1476,18293,2696,2276,8.09,0,1.6,115320,967,114718,168.5,142.25,11.433125,0.84,99.48
2020-05-15,Goa,295,2,294,4032,1351,217,7.32,0,1.6,115615,969,115012,84.44,13.56,2.52,0.84,99.48
2020-05-16,Goa,1015,3,1013,12439,289,156,8.16,0,1.6,116630,972,116025,18.06,9.75,7.774375,0.83,99.48
2020-05-17,Goa,364,2,361,4892,2973,2539,7.44,1,1.6,116994,974,116386,185.81,158.69,3.0575,0.83,99.48
2020-05-18,Goa,403,4,402,4759,2569,1035,8.47,0,1.6,117397,978,116788,160.56,64.69,2.974375,0.83,99.48
2020-05-19,Goa,365,5,361,4625,2702,2452,7.89,0,1.6,117762,983,117149,168.88,153.25,2.890625,0.83,99.48
2020-05-20,Goa,813,4,808,10420,2007,287,7.8,1,1.6,118575,987,117957,125.44,17.94,6.5125,0.83,99.48
2020-05-21,Goa,281,1,272,3739,2000,296,7.52,8,1.6,118856,988,118229,125.0,18.5,2.336875,0.83,99.47
2020-05-22,Goa,1390,4,1381,17560,1756,89,7.92,5,1.6,120246,992,119610,109.75,5.56,10.975,0.82,99.47
2020-05-23,Goa,49,0,48,715,2526,269,6.85,1,1.6,120295,992,119658,157.88,16.81,0.446875,0.82,99.47
2020-05-24,Goa,894,6,893,11667,52,37,7.66,0,1.6,121189,998,120551,3.25,2.31,7.291875,0.82,99.47
2020-05-25,Goa,480,3,471,5880,3289,1200,8.16,6,1.6,121669,1001,121022,205.56,75.0,3.675,0.82,99.47
2020-05-26,Goa,1516,10,1515,19296,1346,1030,7.86,0,1.6,123185,1011,122537,84.12,64.38,12.06,0.82,99.47
2020-05-27,Goa,1400,14,1400,17775,1542,372,7.88,0,1.6,124585,1025,123937,96.38,23.25,11.109375,0.82,99.48
2020-05-28,Goa,491,6,491,5741,21,1,8.55,0,1.6,125076,1031,124428,1.31,0.06,3.588125,0.82,99.48
2020-05-29,Goa,1593,12,1587,19766,2013,193,8.06,0,1.6,126669,1043,126015,125.81,12.06,12.35375,0.82,99.48
2020-05-30,Goa,1185,4,1178,14961,1781,302,7.92,3,1.6,127854,1047,127193,111.31,18.88,9.350625,0.82,99.48
2020-05-31,Goa,1004,14,1001,12788,2899,2111,7.85,0,1.6,128858,1061,128194,181.19,131.94,7.9925,0.82,99.48
2020-06-01,Goa,378,2,375,4992,1515,1064,7.57,1,1.6,129236,1063,128569,94.69,66.5,3.12,0.82,99.48
2020-06-02,Goa,406,4,399,4885,3996,3486,8.31,3,1.6,129642,1067,128968,249.75,217.88,3.053125,0.82,99.48
2020-06-03,Goa,1235,4,1227,15071,1915,807,8.19,4,1.6,130877,1071,130195,119.69,50.44,9.419375,0.82,99.48
2020-06-04,Goa,836,11,830,10302,2925,502,8.11,0,1.6,131713,1082,131025,182.81,31.37,6.43875,0.82,99.48
2020-06-05,Goa,304,4,303,3544,1143,772,8.58,0,1.6,132017,1086,131328,71.44,48.25,2.215,0.82,99.48
2020-06-06,Goa,1250,13,1241,15407,4476,105,8.11,0,1.6,133267,1099,132569,279.75,6.56,9.629375,0.82,99.48
2020-06-07,Goa,184,2,177,2586,2806,2450,7.12,5,1.6,133451,1101,132746,175.38,153.12,1.61625,0.83,99.47
2020-06-08,Goa,305,4,305,3736,4507,1238,8.16,0,1.6,133756,1105,133051,281.69,77.38,2.335,0.83,99.47
2020-06-09,Goa,1095,9,1093,13432,41,40,8.15,0,1.6,134851,1114,134144,2.56,2.5,8.395,0.83,99.48
2020-06-10,Goa,887,9,887,11179,4351,67,7.93,0,1.6,135738,1123,135031,271.94,4.19,6.986875,0.83,99.48
2020-06-11,Goa,1555,6,1552,19274,3719,2607,8.07,0,1.6,137293,1129,136583,232.44,162.94,12.04625,0.82,99.48
2020-06-12,Goa,512,6,511,6502,2539,300,7.87,0,1.6,137805,1135,137094,158.69,18.75,4.06375,0.82,99.48
2020-06-13,Goa,1115,14,1107,14173,1039,1026,7.87,0,1.6,138920,1149,138201,64.94,64.12,8.858125,0.83,99.48
2020-06-14,Goa,825,7,822,10179,213,211,8.1,0,1.6,139745,1156,139023,13.31,13.19,6.361875,0.83,99.48
2020-06-15,Goa,304,2,298,3976,2934,963,7.65,4,1.6,140049,1158,139321,183.38,60.19,2.485,0.83,99.48
2020-06-16,Goa,1547,5,1544,19536,4097,1983,7.92,0,1.6,141596,1163,140865,256.06,123.94,12.21,0.82,99.48
2020-06-17,Goa,1452,14,1452,18306,2465,2190,7.93,0,1.6,143048,1177,142317,154.06,136.88,11.44125,0.82,99.49
2020-06-18,Goa,457,2,453,5545,4958,2408,8.24,2,1.6,143505,1179,142770,309.88,150.5,3.465625,0.82,99.49
2020-06-19,Goa,1590,7,1589,19779,4439,3882,8.04,0,1.6,145095,1186,144359,277.44,242.62,12.361875,0.82,99.49
2020-06-20,Goa,1326,10,1322,16742,1727,304,7.92,0,1.6,146421,1196,145681,107.94,19.0,10.46375,0.82,99.49
2020-06-21,Goa,557,3,552,6897,140,15,8.08,2,1.6,146978,1199,146233,8.75,0.94,4.310625,0.82,99.49
2020-06-22,Goa,1592,23,1589,19802,697,672,8.04,0,1.6,148570,1222,147822,43.56,42.0,12.37625,0.82,99.5
2020-06-23,Goa,593,7,591,8083,1633,109,7.34,0,1.6,149163,1229,148413,102.06,6.81,5.051875,0.82,99.5
2020-06-24,Goa,297,4,288,3835,2573,979,7.74,5,1.6,149460,1233,148701,160.81,61.19,2.396875,0.82,99.49
2020-06-25,Goa,823,6,816,10241,4878,4206,8.04,1,1.6,150283,1239,149517,304.88,262.88,6.400625,0.82,99.49
2020-06-26,Goa,401,4,400,5229,1695,950,7.67,0,1.6,150684,1243,149917,105.94,59.38,3.268125,0.82,99.49
2020-06-27,Goa,1068,12,1068,13206,1862,457,8.09,0,1.6,151752,1255,150985,116.38,28.56,8.25375,0.83,99.49
2020-06-28,Goa,1081,12,1076,13756,2246,1028,7.86,0,1.6,152833,1267,152061,140.38,64.25,8.5975,0.83,99.49
2020-06-29,Goa,1224,5,1220,15624,4020,646,7.83,0,1.6,154057,1272,153281,251.25,40.38,9.765,0.83,99.5
2020-06-30,Goa,1424,9,1420,17743,116,103,8.03,0,1.6,155481,1281,154701,7.25,6.44,11.089375,0.82,99.5
2020-07-01,Goa,186,0,186,2128,4817,4024,8.74,0,1.6,155667,1281,154887,301.06,251.5,1.33,0.82,99.5
2020-07-02,Goa,952,12,944,11927,4835,4376,7.98,0,1.6,156619,1293,155831,302.19,273.5,7.454375,0.83,99.5
2020-07-03,Goa,1525,16,1518,18723,958,89,8.15,0,1.6,158144,1309,157349,59.88,5.56,11.701875,0.83,99.5
2020-07-04,Goa,1299,7,1298,16418,4869,822,7.91,0,1.6,159443,1316,158647,304.31,51.38,10.26125,0.83,99.5
2020-07-05,Goa,499,3,496,6627,487,27,7.53,0,1.6,159942,1319,159143,30.44,1.69,4.141875,0.82,99.5
2020-07-06,Goa,1351,4,1345,16371,2697,771,8.25,2,1.6,161293,1323,160488,168.56,48.19,10.231875,0.82,99.5
2020-07-07,Goa,1014,14,1012,12483,4536,1522,8.12,0,1.6,162307,1337,161500,283.5,95.12,7.801875,0.82,99.5
2020-07-08,Goa,1139,10,1135,14300,3039,1480,7.97,0,1.6,163446,1347,162635,189.94,92.5,8.9375,0.82,99.5
2020-07-09,Goa,1502,13,1496,18832,1835,286,7.98,0,1.6,164948,1360,164131,114.69,17.88,11.77,0.82,99.5
2020-07-10,Goa,1303,5,1297,16371,2271,1917,7.96,1,1.6,166251,1365,165428,141.94,119.81,10.231875,0.82,99.5
2020-07-11,Goa,369,3,360,4294,4213,1802,8.59,6,1.6,166620,1368,165788,263.31,112.62,2.68375,0.82,99.5
2020-07-12,Goa,775,11,769,9588,4572,2545,8.08,0,1.6,167395,1379,166557,285.75,159.06,5.9925,0.82,99.5
2020-07-13,Goa,419,4,416,5488,4161,1593,7.63,0,1.6,167814,1383,166973,260.06,99.56,3.43,0.82,99.5
2020-07-14,Goa,1194,16,1192,14565,653,27,8.2,0,1.6,169008,1399,168165,40.81,1.69,9.103125,0.83,99.5
2020-07-15,Goa,1574,11,1570,19898,2859,1202,7.91,0,1.6,170582,1410,169735,178.69,75.12,12.43625,0.83,99.5
2020-07-16,Goa,311,3,310,3858,382,119,8.06,0,1.6,170893,1413,170045,23.88,7.44,2.41125,0.83,99.5
2020-07-17,Goa,1255,10,1248,15610,4035,2507,8.04,0,1.6,172148,1423,171293,252.19,156.69,9.75625,0.83,99.5
2020-07-18,Goa,874,9,865,10863,2398,802,8.05,0,1.6,173022,1432,172158,149.88,50.12,6.789375,0.83,99.5
2020-07-19,Goa,546,3,546,6632,1359,1127,8.23,0,1.6,173568,1435,172704,84.94,70.44,4.145,0.83,99.5
2020-07-20,Goa,255,3,253,3091,4889,1888,8.25,0,1.6,173823,1438,172957,305.56,118.0,1.931875,0.83,99.5
2020-07-21,Goa,1175,12,1168,14843,1454,659,7.92,0,1.6,174998,1450,174125,90.88,41.19,9.276875,0.83,99.5
2020-07-22,Goa,841,5,840,10862,4451,4141,7.74,0,1.6,175839,1455,174965,278.19,258.81,6.78875,0.83,99.5
2020-07-23,Goa,721,8,721,9053,3790,2517,7.96,0,1.6,176560,1463,175686,236.88,157.31,5.658125,0.83,99.5
2020-07-24,Goa,163,1,159,2320,3448,757,7.03,3,1.6,176723,1464,175845,215.5,47.31,1.45,0.83,99.5
2020-07-25,Goa,903,6,899,11657,4540,499,7.75,0,1.6,177626,1470,176744,283.75,31.19,7.285625,0.83,99.5
2020-07-26,Goa,1070,5,1063,13524,3661,1880,7.91,2,1.6,178696,1475,177807,228.81,117.5,8.4525,0.83,99.5
2020-07-27,Goa,1368,15,1360,16908,3261,1311,8.09,0,1.6,180064,1490,179167,203.81,81.94,10.5675,0.83,99.5
2020-07-28,Goa,1068,7,1059,12825,775,525,8.33,2,1.6,181132,1497,180226,48.44,32.81,8.015625,0.83,99.5
2020-07-29,Goa,129,0,128,1778,1827,1701,7.26,1,1.6,181261,1497,180354,114.19,106.31,1.11125,0.83,99.5
2020-07-30,Goa,938,12,931,11933,4544,2286,7.86,0,1.6,182199,1509,181285,284.0,142.88,7.458125,0.83,99.5
2020-07-31,Goa,855,4,850,10817,478,138,7.9,1,1.6,183054,1513,182135,29.88,8.62,6.760625,0.83,99.5
2020-08-01,Goa,1508,20,1502,18748,3260,1832,8.04,0,1.6,184562,1533,183637,203.75,114.5,11.7175,0.83,99.5
2020-08-02,Goa,1084,15,1077,13393,1771,1294,8.09,0,1.6,185646,1548,184714,110.69,80.88,8.370625,0.83,99.5
2020-08-03,Goa,287,3,285,3260,4635,3159,8.8,0,1.6,185933,1551,184999,289.69,197.44,2.0375,0.83,99.5
2020-08-04,Goa,332,2,331,4119,1905,1231,8.06,0,1.6,186265,1553,185330,119.06,76.94,2.574375,0.83,99.5
2020-08-05,Goa,995,12,993,12240,1103,427,8.13,0,1.6,187260,1565,186323,68.94,26.69,7.65,0.84,99.5
2020-08-06,Goa,1307,18,1307,16734,331,296,7.81,0,1.6,188567,1583,187630,20.69,18.5,10.45875,0.84,99.5
2020-08-07,Goa,1014,10,1007,12720,4173,1064,7.97,0,1.6,189581,1593,188637,260.81,66.5,7.95,0.84,99.5
2020-08-08,Goa,1252,16,1249,15581,4363,3833,8.04,0,1.6,190833,1609,189886,272.69,239.56,9.738125,0.84,99.5
2020-08-09,Goa,1080,13,1076,13686,3157,2644,7.89,0,1.6,191913,1622,190962,197.31,165.25,8.55375,0.85,99.5
2020-08-10,Goa,1284,17,1281,16446,984,49,7.81,0,1.6,193197,1639,192243,61.5,3.06,10.27875,0.85,99.51
2020-08-11,Goa,1089,4,1081,13643,4320,3882,7.98,4,1.6,194286,1643,193324,270.0,242.62,8.526875,0.85,99.5
2020-08-12,Goa,248,1,244,3248,4600,1352,7.64,3,1.6,194534,1644,193568,287.5,84.5,2.03,0.85,99.5
2020-08-13,Goa,1134,4,1132,14268,1177,355,7.95,0,1.6,195668,1648,194700,73.56,22.19,8.9175,0.84,99.51
2020-08-14,Goa,512,6,512,6009,4975,1025,8.52,0,1.6,196180,1654,195212,310.94,64.06,3.755625,0.84,99.51
2020-08-15,Goa,1049,12,1041,13143,2394,1174,7.98,0,1.6,197229,1666,196253,149.62,73.38,8.214375,0.84,99.51
2020-08-16,Goa,1450,17,1447,18285,1588,966,7.93,0,1.6,198679,1683,197700,99.25,60.38,11.428125,0.85,99.51
2020-08-17,Goa,1154,11,1146,14152,2547,204,8.15,0,1.6,199833,1694,198846,159.19,12.75,8.845,0.85,99.51
2020-08-18,Goa,1125,8,1119,14046,489,66,8.01,0,1.6,200958,1702,199965,30.56,4.12,8.77875,0.85,99.51
2020-08-19,Goa,1020,11,1015,12917,1874,563,7.9,0,1.6,201978,1713,200980,117.12,35.19,8.073125,0.85,99.51
2020-08-20,Goa,12,0,4,544,1004,786,2.21,8,1.6,201990,1713,200984,62.75,49.12,0.34,0.85,99.5
2020-08-21,Goa,489,2,484,5937,4997,2347,8.24,3,1.6,202479,1715,201468,312.31,146.69,3.710625,0.85,99.5
2020-08-22,Goa,849,3,841,10666,3455,3246,7.96,5,1.6,203328,1718,202309,215.94,202.88,6.66625,0.84,99.5
2020-08-23,Goa,297,1,288,3939,1372,913,7.54,8,1.6,203625,1719,202597,85.75,57.06,2.461875,0.84,99.5
2020-08-24,Goa,1109,7,1103,13679,1437,839,8.11,0,1.6,204734,1726,203700,89.81,52.44,8.549375,0.84,99.49
2020-08-25,Goa,1389,12,1384,17650,4723,2623,7.87,0,1.6,206123,1738,205084,295.19,163.94,11.03125,0.84,99.5
2020-08-26,Goa,642,4,634,8070,3362,2201,7.96,4,1.6,206765,1742,205718,210.12,137.56,5.04375,0.84,99.49
2020-08-27,Goa,1092,3,1091,13405,2605,204,8.15,0,1.6,207857,1745,206809,162.81,12.75,8.378125,0.84,99.5
2020-08-28,Goa,1430,17,1430,17388,2932,691,8.22,0,1.6,209287,1762,208239,183.25,43.19,10.8675,0.84,99.5
2020-08-29,Goa,108,1,108,833,1625,1561,12.97,0,1.6,209395,1763,208347,101.56,97.56,0.520625,0.84,99.5
2020-08-30,Goa,1220,11,1214,15020,1800,1269,8.12,0,1.6,210615,1774,209561,112.5,79.31,9.3875,0.84,99.5
2020-08-31,Goa,405,3,400,5302,2514,2200,7.64,2,1.6,211020,1777,209961,157.12,137.5,3.31375,0.84,99.5
2020-09-01,Goa,267,0,264,3275,165,79,8.15,3,1.6,211287,1777,210225,10.31,4.94,2.046875,0.84,99.5
2020-09-02,Goa,546,5,540,6585,49,3,8.29,1,1.6,211833,1782,210765,3.06,0.19,4.115625,0.84,99.5
2020-09-03,Goa,760,6,756,9698,1246,526,7.84,0,1.6,212593,1788,211521,77.88,32.88,6.06125,0.84,99.5
2020-09-04,Goa,990,7,986,12532,4723,4566,7.9,0,1.6,213583,1795,212507,295.19,285.38,7.8325,0.84,99.5
2020-09-05,Goa,352,1,348,4148,4891,2225,8.49,3,1.6,213935,1796,212855,305.69,139.06,2.5925,0.84,99.5
2020-09-06,Goa,705,10,699,9031,3119,1209,7.81,0,1.6,214640,1806,213554,194.94,75.56,5.644375,0.84,99.49
2020-09-07,Goa,93,0,88,1223,4156,1320,7.6,5,1.6,214733,1806,213642,259.75,82.5,0.764375,0.84,99.49
2020-09-08,Goa,1207,4,1203,15196,2969,1943,7.94,0,1.6,215940,1810,214845,185.56,121.44,9.4975,0.84,99.49
2020-09-09,Goa,594,4,590,7900,3454,1319,7.52,0,1.6,216534,1814,215435,215.88,82.44,4.9375,0.84,99.49
2020-09-10,Goa,837,10,834,10688,2452,1310,7.83,0,1.6,217371,1824,216269,153.25,81.88,6.68,0.84,99.49
2020-09-11,Goa,982,4,976,12196,2131,1967,8.05,2,1.6,218353,1828,217245,133.19,122.94,7.6225,0.84,99.49
2020-09-12,Goa,609,6,608,7412,4873,729,8.22,0,1.6,218962,1834,217853,304.56,45.56,4.6325,0.84,99.49
2020-09-13,Goa,1218,10,1209,15031,4300,2797,8.1,0,1.6,220180,1844,219062,268.75,174.81,9.394375,0.84,99.49
2020-09-14,Goa,709,3,700,9331,1692,1582,7.6,6,1.6,220889,1847,219762,105.75,98.88,5.831875,0.84,99.49
2020-09-15,Goa,1543,22,1541,18817,3996,843,8.2,0,1.6,222432,1869,221303,249.75,52.69,11.760625,0.84,99.49
2020-09-16,Goa,1490,21,1485,18514,3215,1923,8.05,0,1.6,223922,1890,222788,200.94,120.19,11.57125,0.84,99.49
2020-09-17,Goa,889,9,880,11071,1484,791,8.03,0,1.6,224811,1899,223668,92.75,49.44,6.919375,0.84,99.49
2020-09-18,Goa,368,1,367,4808,1104,586,7.65,0,1.6,225179,1900,224035,69.0,36.62,3.005,0.84,99.49
2020-09-19,Goa,1002,6,998,12271,1658,526,8.17,0,1.6,226181,1906,225033,103.62,32.88,7.669375,0.84,99.49
2020-09-20,Goa,127,0,125,1850,1267,177,6.86,2,1.6,226308,1906,225158,79.19,11.06,1.15625,0.84,99.49
2020-09-21,Goa,679,8,671,8557,4326,1395,7.94,0,1.6,226987,1914,225829,270.38,87.19,5.348125,0.84,99.49
2020-09-22,Goa,761,9,754,9357,683,394,8.13,0,1.6,227748,1923,226583,42.69,24.62,5.848125,0.84,99.49
2020-09-23,Goa,494,3,492,5845,2900,1049,8.45,0,1.6,228242,1926,227075,181.25,65.56,3.653125,0.84,99.49
2020-09-24,Goa,1325,5,1319,16457,18,4,8.05,1,1.6,229567,1931,228394,1.12,0.25,10.285625,0.84,99.49
2020-09-25,Goa,328,3,322,4291,1715,187,7.64,3,1.6,229895,1934,228716,107.19,11.69,2.681875,0.84,99.49
2020-09-26,Goa,1506,11,1497,18904,3080,1076,7.97,0,1.6,231401,1945,230213,192.5,67.25,11.815,0.84,99.49
2020-09-27,Goa,488,6,482,6304,4011,2831,7.74,0,1.6,231889,1951,230695,250.69,176.94,3.94,0.84,99.49
2020-09-28,Goa,562,6,558,6763,3782,2827,8.31,0,1.6,232451,1957,231253,236.38,176.69,4.226875,0.84,99.48
2020-09-29,Goa,1042,7,1033,13296,953,365,7.84,2,1.6,233493,1964,232286,59.56,22.81,8.31,0.84,99.48
2020-09-30,Goa,908,4,901,11158,3390,1978,8.14,3,1.6,234401,1968,233187,211.88,123.62,6.97375,0.84,99.48
2020-10-01,Goa,424,5,421,5572,4973,455,7.61,0,1.6,234825,1973,233608,310.81,28.44,3.4825,0.84,99.48
2020-10-02,Goa,439,6,430,5926,1282,1144,7.41,3,1.6,235264,1979,234038,80.12,71.5,3.70375,0.84,99.48
2020-10-03,Goa,683,7,683,8324,808,125,8.21,0,1.6,235947,1986,234721,50.5,7.81,5.2025,0.84,99.48
2020-10-04,Goa,1100,14,1093,13713,2991,1927,8.02,0,1.6,237047,2000,235814,186.94,120.44,8.570625,0.84,99.48
2020-10-05,Goa,102,0,102,1461,3168,1539,6.98,0,1.6,237149,2000,235916,198.0,96.19,0.913125,0.84,99.48
2020-10-06,Goa,236,1,233,2732,2501,855,8.64,2,1.6,237385,2001,236149,156.31,53.44,1.7075,0.84,99.48
2020-10-07,Goa,686,7,682,8261,4495,267,8.3,0,1.6,238071,2008,236831,280.94,16.69,5.163125,0.84,99.48
2020-10-08,Goa,203,0,199,2217,943,764,9.16,4,1.6,238274,2008,237030,58.94,47.75,1.385625,0.84,99.48
2020-10-09,Goa,321,1,315,4075,3558,1604,7.88,5,1.6,238595,2009,237345,222.38,100.25,2.546875,0.84,99.48
2020-10-10,Goa,868,10,867,11219,1106,454,7.74,0,1.6,239463,2019,238212,69.12,28.38,7.011875,0.84,99.48
2020-10-11,Goa,561,5,552,7139,4831,1926,7.86,4,1.6,240024,2024,238764,301.94,120.38,4.461875,0.84,99.48
2020-10-12,Goa,1164,17,1162,14576,130,101,7.99,0,1.6,241188,2041,239926,8.12,6.31,9.11,0.85,99.48
2020-10-13,Goa,863,4,856,10907,2877,2123,7.91,3,1.6,242051,2045,240782,179.81,132.69,6.816875,0.84,99.48
2020-10-14,Goa,527,6,518,6451,4714,3064,8.17,3,1.6,242578,2051,241300,294.62,191.5,4.031875,0.85,99.47
2020-10-15,Goa,1177,8,1170,14878,4265,774,7.91,0,1.6,243755,2059,242470,266.56,48.38,9.29875,0.84,99.47
2020-10-16,Goa,512,5,505,6441,4988,3201,7.95,2,1.6,244267,2064,242975,311.75,200.06,4.025625,0.84,99.47
2020-10-17,Goa,1194,4,1185,14700,141,118,8.12,5,1.6,245461,2068,244160,8.81,7.38,9.1875,0.84,99.47
2020-10-18,Goa,326,3,323,4427,2530,1182,7.36,0,1.6,245787,2071,244483,158.12,73.88,2.766875,0.84,99.47
2020-10-19,Goa,804,7,799,9958,2287,263,8.07,0,1.6,246591,2078,245282,142.94,16.44,6.22375,0.84,99.47
2020-10-20,Goa,401,1,398,5107,1176,259,7.85,2,1.6,246992,2079,245680,73.5,16.19,3.191875,0.84,99.47
2020-10-21,Goa,286,3,282,3362,762,574,8.51,1,1.6,247278,2082,245962,47.62,35.88,2.10125,0.84,99.47
2020-10-22,Goa,577,6,572,7126,3881,3861,8.1,0,1.6,247855,2088,246534,242.56,241.31,4.45375,0.84,99.47
2020-10-23,Goa,1327,15,1322,16719,824,194,7.94,0,1.6,249182,2103,247856,51.5,12.12,10.449375,0.84,99.47
2020-10-24,Goa,431,4,423,5628,3905,599,7.66,4,1.6,249613,2107,248279,244.06,37.44,3.5175,0.84,99.47
2020-10-25,Goa,80,0,71,1347,4292,450,5.94,9,1.6,249693,2107,248350,268.25,28.12,0.841875,0.84,99.46
2020-10-26,Goa,581,2,574,6894,97,65,8.43,5,1.6,250274,2109,248924,6.06,4.06,4.30875,0.84,99.46
2020-10-27,Goa,1007,10,1003,12393,3700,1398,8.13,0,1.6,251281,2119,249927,231.25,87.38,7.745625,0.84,99.46
2020-10-28,Goa,781,6,773,9916,3213,1419,7.88,2,1.6,252062,2125,250700,200.81,88.69,6.1975,0.84,99.46
2020-10-29,Goa,1476,14,1468,18652,2977,505,7.91,0,1.6,253538,2139,252168,186.06,31.56,11.6575,0.84,99.46
2020-10-30,Goa,1005,12,998,12825,1675,1436,7.84,0,1.6,254543,2151,253166,104.69,89.75,8.015625,0.85,99.46
2020-10-31,Goa,43,0,41,545,2853,523,7.89,2,1.6,254586,2151,253207,178.31,32.69,0.340625,0.84,99.46
2020-11-01,Goa,1405,5,1405,17561,3653,1464,8.0,0,1.6,255991,2156,254612,228.31,91.5,10.975625,0.84,99.46
2020-11-02,Goa,274,2,274,3467,1482,1033,7.9,0,1.6,256265,2158,254886,92.62,64.56,2.166875,0.84,99.46
2020-11-03,Goa,144,1,136,1845,941,249,7.8,7,1.6,256409,2159,255022,58.81,15.56,1.153125,0.84,99.46
2020-11-04,Goa,1006,6,999,12435,3711,2038,8.09,1,1.6,257415,2165,256021,231.94,127.38,7.771875,0.84,99.46
2020-11-05,Goa,1535,22,1531,19410,4092,466,7.91,0,1.6,258950,2187,257552,255.75,29.12,12.13125,0.84,99.46
2020-11-06,Goa,1066,7,1060,13173,356,67,8.09,0,1.6,260016,2194,258612,22.25,4.19,8.233125,0.84,99.46
2020-11-07,Goa,601,2,597,7383,4369,3209,8.14,2,1.6,260617,2196,259209,273.06,200.56,4.614375,0.84,99.46
2020-11-08,Goa,550,2,548,7022,664,616,7.83,0,1.6,261167,2198,259757,41.5,38.5,4.38875,0.84,99.46
2020-11-09,Goa,231,1,224,2502,2855,841,9.23,6,1.6,261398,2199,259981,178.44,52.56,1.56375,0.84,99.46
2020-11-10,Goa,1511,20,1506,18697,442,424,8.08,0,1.6,262909,2219,261487,27.62,26.5,11.685625,0.84,99.46
2020-11-11,Goa,253,1,247,3076,2284,1048,8.22,5,1.6,263162,2220,261734,142.75,65.5,1.9225,0.84,99.46
2020-11-12,Goa,1404,13,1404,17759,3125,2634,7.91,0,1.6,264566,2233,263138,195.31,164.62,11.099375,0.84,99.46
2020-11-13,Goa,722,5,714,9475,3148,1906,7.62,3,1.6,265288,2238,263852,196.75,119.12,5.921875,0.84,99.46
2020-11-14,Goa,811,4,806,9956,179,142,8.15,1,1.6,266099,2242,264658,11.19,8.88,6.2225,0.84,99.46
2020-11-15,Goa,1051,15,1044,13139,1955,169,8.0,0,1.6,267150,2257,265702,122.19,10.56,8.211875,0.84,99.46
2020-11-16,Goa,486,5,477,6244,1403,88,7.78,4,1.6,267636,2262,266179,87.69,5.5,3.9025,0.85,99.46
2020-11-17,Goa,1420,6,1413,17743,4998,3203,8.0,1,1.6,269056,2268,267592,312.38,200.19,11.089375,0.84,99.46
2020-11-18,Goa,555,6,553,6728,4973,4118,8.25,0,1.6,269611,2274,268145,310.81,257.38,4.205,0.84,99.46
2020-11-19,Goa,1228,6,1223,15340,139,81,8.01,0,1.6,270839,2280,269368,8.69,5.06,9.5875,0.84,99.46
2020-11-20,Goa,564,3,562,7034,3654,3546,8.02,0,1.6,271403,2283,269930,228.38,221.62,4.39625,0.84,99.46
2020-11-21,Goa,263,2,257,3535,4042,168,7.44,4,1.6,271666,2285,270187,252.62,10.5,2.209375,0.84,99.46
2020-11-22,Goa,240,2,233,3036,4084,1700,7.91,5,1.6,271906,2287,270420,255.25,106.25,1.8975,0.84,99.45
2020-11-23,Goa,110,1,105,826,3886,1230,13.32,4,1.6,272016,2288,270525,242.88,76.88,0.51625,0.84,99.45
2020-11-24,Goa,1098,11,1091,13966,443,41,7.86,0,1.6,273114,2299,271616,27.69,2.56,8.72875,0.84,99.45
2020-11-25,Goa,1039,14,1034,12830,825,326,8.1,0,1.6,274153,2313,272650,51.56,20.38,8.01875,0.84,99.45
2020-11-26,Goa,306,1,299,3809,1480,1423,8.03,6,1.6,274459,2314,272949,92.5,88.94,2.380625,0.84,99.45
2020-11-27,Goa,736,9,736,8971,1460,1055,8.2,0,1.6,275195,2323,273685,91.25,65.94,5.606875,0.84,99.45
2020-11-28,Goa,813,11,804,10241,146,52,7.94,0,1.6,276008,2334,274489,9.12,3.25,6.400625,0.85,99.45
2020-11-29,Goa,158,0,150,2252,750,608,7.02,8,1.6,276166,2334,274639,46.88,38.0,1.4075,0.85,99.45
2020-11-30,Goa,1419,17,1411,17893,1723,812,7.93,0,1.6,277585,2351,276050,107.69,50.75,11.183125,0.85,99.45
2020-12-01,Goa,774,5,771,9315,3283,2143,8.31,0,1.6,278359,2356,276821,205.19,133.94,5.821875,0.85,99.45
2020-12-02,Goa,967,3,961,12012,2591,1094,8.05,3,1.6,279326,2359,277782,161.94,68.38,7.5075,0.84,99.45
2020-12-03,Goa,942,8,942,11829,3137,323,7.96,0,1.6,280268,2367,278724,196.06,20.19,7.393125,0.84,99.45
2020-12-04,Goa,1312,17,1310,16624,1083,927,7.89,0,1.6,281580,2384,280034,67.69,57.94,10.39,0.85,99.45
2020-12-05,Goa,427,3,427,5191,4832,73,8.23,0,1.6,282007,2387,280461,302.0,4.56,3.244375,0.85,99.45
2020-12-06,Goa,1130,4,1123,13350,3868,2672,8.46,3,1.6,283137,2391,281584,241.75,167.0,8.34375,0.84,99.45
2020-12-07,Goa,1190,15,1184,14900,944,427,7.99,0,1.6,284327,2406,282768,59.0,26.69,9.3125,0.85,99.45
2020-12-08,Goa,151,1,144,2190,4816,4143,6.89,6,1.6,284478,2407,282912,301.0,258.94,1.36875,0.85,99.45
2020-12-09,Goa,558,2,556,6960,4287,1321,8.02,0,1.6,285036,2409,283468,267.94,82.56,4.35,0.85,99.45
2020-12-10,Goa,83,0,83,1190,1696,1219,6.97,0,1.6,285119,2409,283551,106.0,76.19,0.74375,0.84,99.45
2020-12-11,Goa,203,1,201,2380,3998,3726,8.53,1,1.6,285322,2410,283752,249.87,232.88,1.4875,0.84,99.45
2020-12-12,Goa,894,13,888,10921,1463,1303,8.19,0,1.6,286216,2423,284640,91.44,81.44,6.825625,0.85,99.45
2020-12-13,Goa,112,1,107,1571,10,6,7.13,4,1.6,286328,2424,284747,0.62,0.38,0.981875,0.85,99.45
2020-12-14,Goa,916,6,913,11499,4482,1085,7.97,0,1.6,287244,2430,285660,280.12,67.81,7.186875,0.85,99.45
2020-12-15,Goa,403,5,398,4923,3158,572,8.19,0,1.6,287647,2435,286058,197.38,35.75,3.076875,0.85,99.45
2020-12-16,Goa,1427,4,1421,17787,3843,1741,8.02,2,1.6,289074,2439,287479,240.19,108.81,11.116875,0.84,99.45
2020-12-17,Goa,71,0,70,637,3498,2723,11.15,1,1.6,289145,2439,287549,218.62,170.19,0.398125,0.84,99.45
2020-12-18,Goa,524,3,521,6545,3926,2824,8.01,0,1.6,289669,2442,288070,245.38,176.5,4.090625,0.84,99.45
2020-12-19,Goa,967,8,961,11735,1140,474,8.24,0,1.6,290636,2450,289031,71.25,29.62,7.334375,0.84,99.45
2020-12-20,Goa,652,4,643,8474,1215,227,7.69,5,1.6,291288,2454,289674,75.94,14.19,5.29625,0.84,99.45
2020-12-21,Goa,841,9,833,10609,111,89,7.93,0,1.6,292129,2463,290507,6.94,5.56,6.630625,0.84,99.44
2020-12-22,Goa,1448,14,1447,17670,2854,2187,8.19,0,1.6,293577,2477,291954,178.38,136.69,11.04375,0.84,99.45
2020-12-23,Goa,277,2,270,3753,4841,2795,7.38,5,1.6,293854,2479,292224,302.56,174.69,2.345625,0.84,99.45
2020-12-24,Goa,1589,23,1584,19394,4474,2593,8.19,0,1.6,295443,2502,293808,279.62,162.06,12.12125,0.85,99.45
2020-12-25,Goa,186,2,180,2529,1900,33,7.35,4,1.6,295629,2504,293988,118.75,2.06,1.580625,0.85,99.44
2020-12-26,Goa,27,0,23,704,3577,3394,3.84,4,1.6,295656,2504,294011,223.56,212.12,0.44,0.85,99.44
2020-12-27,Goa,791,3,790,9751,4209,1265,8.11,0,1.6,296447,2507,294801,263.06,79.06,6.094375,0.85,99.44
2020-12-28,Goa,243,1,239,2898,406,352,8.39,3,1.6,296690,2508,295040,25.37,22.0,1.81125,0.85,99.44
2020-12-29,Goa,1053,4,1044,12754,191,183,8.26,5,1.6,297743,2512,296084,11.94,11.44,7.97125,0.84,99.44
2020-12-30,Goa,388,2,380,5100,1989,1306,7.61,6,1.6,298131,2514,296464,124.31,81.62,3.1875,0.84,99.44
2020-12-31,Goa,1119,8,1118,13979,1832,1060,8.0,0,1.6,299250,2522,297582,114.5,66.25,8.736875,0.84,99.44
2021-01-01,Goa,927,6,920,11724,630,618,7.91,1,1.6,300177,2528,298502,39.38,38.62,7.3275,0.84,99.44
2021-01-02,Goa,370,3,361,4919,3643,1566,7.52,6,1.6,300547,2531,298863,227.69,97.88,3.074375,0.84,99.44
2021-01-03,Goa,521,3,518,6206,4506,1468,8.4,0,1.6,301068,2534,299381,281.62,91.75,3.87875,0.84,99.44
2021-01-04,Goa,1078,8,1073,12972,2876,2077,8.31,0,1.6,302146,2542,300454,179.75,129.81,8.1075,0.84,99.44
2021-01-05,Goa,600,7,598,7796,2976,1890,7.7,0,1.6,302746,2549,301052,186.0,118.12,4.8725,0.84,99.44
2021-01-06,Goa,1316,14,1307,16595,3199,1397,7.93,0,1.6,304062,2563,302359,199.94,87.31,10.371875,0.84,99.44
2021-01-07,Goa,979,8,974,12386,4443,1708,7.9,0,1.6,305041,2571,303333,277.69,106.75,7.74125,0.84,99.44
2021-01-08,Goa,349,3,348,4561,781,724,7.65,0,1.6,305390,2574,303681,48.81,45.25,2.850625,0.84,99.44
2021-01-09,Goa,626,6,624,7740,3233,682,8.09,0,1.6,306016,2580,304305,202.06,42.62,4.8375,0.84,99.44
2021-01-10,Goa,380,3,373,5266,304,230,7.22,4,1.6,306396,2583,304678,19.0,14.37,3.29125,0.84,99.44
2021-01-11,Goa,1426,20,1420,17862,2396,859,7.98,0,1.6,307822,2603,306098,149.75,53.69,11.16375,0.85,99.44
2021-01-12,Goa,142,0,138,1514,3557,2412,9.38,4,1.6,307964,2603,306236,222.31,150.75,0.94625,0.85,99.44
2021-01-13,Goa,267,2,262,3048,1962,1542,8.76,3,1.6,308231,2605,306498,122.62,96.38,1.905,0.85,99.44
2021-01-14,Goa,585,1,582,7050,2353,379,8.3,2,1.6,308816,2606,307080,147.06,23.69,4.40625,0.84,99.44
2021-01-15,Goa,1292,17,1284,15998,1433,556,8.08,0,1.6,310108,2623,308364,89.56,34.75,9.99875,0.85,99.44
2021-01-16,Goa,1134,12,1127,13984,4536,2796,8.11,0,1.6,311242,2635,309491,283.5,174.75,8.74,0.85,99.44
2021-01-17,Goa,716,9,716,8576,1380,1053,8.35,0,1.6,311958,2644,310207,86.25,65.81,5.36,0.85,99.44
2021-01-18,Goa,1188,6,1188,15131,2783,52,7.85,0,1.6,313146,2650,311395,173.94,3.25,9.456875,0.85,99.44
2021-01-19,Goa,138,1,135,1889,4560,3359,7.31,2,1.6,313284,2651,311530,285.0,209.94,1.180625,0.85,99.44
2021-01-20,Goa,361,1,357,4746,1831,170,7.61,3,1.6,313645,2652,311887,114.44,10.62,2.96625,0.85,99.44
2021-01-21,Goa,1329,9,1322,16597,4231,884,8.01,0,1.6,314974,2661,313209,264.44,55.25,10.373125,0.84,99.44
2021-01-22,Goa,683,2,681,8381,728,200,8.15,0,1.6,315657,2663,313890,45.5,12.5,5.238125,0.84,99.44
2021-01-23,Goa,564,8,558,6896,4787,339,8.18,0,1.6,316221,2671,314448,299.19,21.19,4.31,0.84,99.44
2021-01-24,Goa,880,7,874,11067,4544,2171,7.95,0,1.6,317101,2678,315322,284.0,135.69,6.916875,0.84,99.44
2021-01-25,Goa,944,6,937,12181,2895,1831,7.75,1,1.6,318045,2684,316259,180.94,114.44,7.613125,0.84,99.44
2021-01-26,Goa,983,8,983,12005,2578,795,8.19,0,1.6,319028,2692,317242,161.12,49.69,7.503125,0.84,99.44
2021-01-27,Goa,397,3,397,4838,3320,966,8.21,0,1.6,319425,2695,317639,207.5,60.38,3.02375,0.84,99.44
2021-01-28,Goa,889,7,884,10763,2433,2267,8.26,0,1.6,320314,2702,318523,152.06,141.69,6.726875,0.84,99.44
2021-01-29,Goa,841,8,838,10806,1700,390,7.78,0,1.6,321155,2710,319361,106.25,24.38,6.75375,0.84,99.44
2021-01-30,Goa,633,3,625,8046,2607,1429,7.87,5,1.6,321788,2713,319986,162.94,89.31,5.02875,0.84,99.44
2021-01-31,Goa,584,4,582,7737,1750,785,7.55,0,1.6,322372,2717,320568,109.38,49.06,4.835625,0.84,99.44
2021-02-01,Goa,1360,19,1351,17083,1304,1197,7.96,0,1.6,323732,2736,321919,81.5,74.81,10.676875,0.85,99.44
2021-02-02,Goa,512,2,505,6163,589,559,8.31,5,1.6,324244,2738,322424,36.81,34.94,3.851875,0.84,99.44
2021-02-03,Goa,273,3,270,3744,977,16,7.29,0,1.6,324517,2741,322694,61.06,1.0,2.34,0.84,99.44
2021-02-04,Goa,49,0,46,946,3287,1721,5.18,3,1.6,324566,2741,322740,205.44,107.56,0.59125,0.84,99.44
2021-02-05,Goa,189,0,188,2920,1769,895,6.47,1,1.6,324755,2741,322928,110.56,55.94,1.825,0.84,99.44
2021-02-06,Goa,1440,8,1439,17809,1241,494,8.09,0,1.6,326195,2749,324367,77.56,30.88,11.130625,0.84,99.44
2021-02-07,Goa,1051,13,1045,12733,2184,2166,8.25,0,1.6,327246,2762,325412,136.5,135.38,7.958125,0.84,99.44
2021-02-08,Goa,540,2,533,6591,740,521,8.19,5,1.6,327786,2764,325945,46.25,32.56,4.119375,0.84,99.44
2021-02-09,Goa,529,4,528,7246,974,513,7.3,0,1.6,328315,2768,326473,60.88,32.06,4.52875,0.84,99.44
2021-02-10,Goa,1222,16,1220,15255,1561,1103,8.01,0,1.6,329537,2784,327693,97.56,68.94,9.534375,0.84,99.44
2021-02-11,Goa,1242,9,1240,15429,4120,4065,8.05,0,1.6,330779,2793,328933,257.5,254.06,9.643125,0.84,99.44
2021-02-12,Goa,1508,18,1506,18730,3856,824,8.05,0,1.6,332287,2811,330439,241.0,51.5,11.70625,0.85,99.44
2021-02-13,Goa,270,3,264,3082,1814,590,8.76,3,1.6,332557,2814,330703,113.38,36.88,1.92625,0.85,99.44
2021-02-14,Goa,1422,6,1413,17545,4345,4080,8.1,3,1.6,333979,2820,332116,271.56,255.0,10.965625,0.84,99.44
2021-02-15,Goa,516,7,515,6664,4413,2419,7.74,0,1.6,334495,2827,332631,275.81,151.19,4.165,0.85,99.44
2021-02-16,Goa,1147,16,1144,14595,2809,1079,7.86,0,1.6,335642,2843,333775,175.56,67.44,9.121875,0.85,99.44
2021-02-17,Goa,1156,7,1149,14222,3661,1106,8.13,0,1.6,336798,2850,334924,228.81,69.12,8.88875,0.85,99.44
2021-02-18,Goa,1274,9,1268,15363,4947,3684,8.29,0,1.6,338072,2859,336192,309.19,230.25,9.601875,0.85,99.44
2021-02-19,Goa,379,4,377,4875,3,1,7.77,0,1.6,338451,2863,336569,0.19,0.06,3.046875,0.85,99.44
2021-02-20,Goa,1118,6,1115,13875,4062,13,8.06,0,1.6,339569,2869,337684,253.87,0.81,8.671875,0.84,99.44
2021-02-21,Goa,259,2,257,3289,4061,2425,7.87,0,1.6,339828,2871,337941,253.81,151.56,2.055625,0.84,99.44
2021-02-22,Goa,614,2,609,7378,545,331,8.32,3,1.6,340442,2873,338550,34.06,20.69,4.61125,0.84,99.44
2021-02-23,Goa,604,8,597,7780,872,402,7.76,0,1.6,341046,2881,339147,54.5,25.12,4.8625,0.84,99.44
2021-02-24,Goa,1541,15,1532,19189,2208,19,8.03,0,1.6,342587,2896,340679,138.0,1.19,11.993125,0.85,99.44
2021-02-25,Goa,893,3,884,11456,3242,2399,7.8,6,1.6,343480,2899,341563,202.62,149.94,7.16,0.84,99.44
2021-02-26,Goa,1138,5,1138,14427,692,345,7.89,0,1.6,344618,2904,342701,43.25,21.56,9.016875,0.84,99.44
2021-02-27,Goa,550,1,550,6606,1688,243,8.33,0,1.6,345168,2905,343251,105.5,15.19,4.12875,0.84,99.44
2021-02-28,Goa,1331,13,1326,16809,527,256,7.92,0,1.6,346499,2918,344577,32.94,16.0,10.505625,0.84,99.45
2021-03-01,Goa,1567,5,1561,19502,3313,2585,8.04,1,1.6,348066,2923,346138,207.06,161.56,12.18875,0.84,99.45
2021-03-02,Goa,507,5,505,6081,4296,704,8.34,0,1.6,348573,2928,346643,268.5,44.0,3.800625,0.84,99.45
2021-03-03,Goa,1414,11,1405,17325,4774,673,8.16,0,1.6,349987,2939,348048,298.38,42.06,10.828125,0.84,99.45
2021-03-04,Goa,1076,8,1073,13560,4127,37,7.94,0,1.6,351063,2947,349121,257.94,2.31,8.475,0.84,99.45
2021-03-05,Goa,1452,20,1450,18135,954,532,8.01,0,1.6,352515,2967,350571,59.62,33.25,11.334375,0.84,99.45
2021-03-06,Goa,573,5,568,6717,1124,923,8.53,0,1.6,353088,2972,351139,70.25,57.69,4.198125,0.84,99.45
2021-03-07,Goa,521,6,515,6122,1755,1160,8.51,0,1.6,353609,2978,351654,109.69,72.5,3.82625,0.84,99.45
2021-03-08,Goa,512,3,512,6826,5,5,7.5,0,1.6,354121,2981,352166,0.31,0.31,4.26625,0.84,99.45
2021-03-09,Goa,1310,16,1310,15919,1394,474,8.23,0,1.6,355431,2997,353476,87.12,29.62,9.949375,0.84,99.45
2021-03-10,Goa,1293,13,1292,16177,4895,2240,7.99,0,1.6,356724,3010,354768,305.94,140.0,10.110625,0.84,99.45
2021-03-11,Goa,1328,5,1325,16996,4261,1957,7.81,0,1.6,358052,3015,356093,266.31,122.31,10.6225,0.84,99.45
2021-03-12,Goa,71,0,65,1142,1745,683,6.22,6,1.6,358123,3015,356158,109.06,42.69,0.71375,0.84,99.45
2021-03-13,Goa,854,9,854,10366,2312,1670,8.24,0,1.6,358977,3024,357012,144.5,104.38,6.47875,0.84,99.45
2021-03-14,Goa,430,5,428,5621,1468,68,7.65,0,1.6,359407,3029,357440,91.75,4.25,3.513125,0.84,99.45
2021-03-15,Goa,1190,5,1189,14771,3643,2167,8.06,0,1.6,360597,3034,358629,227.69,135.44,9.231875,0.84,99.45
2021-03-16,Goa,1338,9,1332,16630,424,35,8.05,0,1.6,361935,3043,359961,26.5,2.19,10.39375,0.84,99.45
2021-03-17,Goa,1380,6,1371,17285,2839,1294,7.98,3,1.6,363315,3049,361332,177.44,80.88,10.803125,0.84,99.45
2021-03-18,Goa,684,4,678,8459,865,380,8.09,2,1.6,363999,3053,362010,54.06,23.75,5.286875,0.84,99.45
2021-03-19,Goa,1103,6,1100,14033,3309,2123,7.86,0,1.6,365102,3059,363110,206.81,132.69,8.770625,0.84,99.45
2021-03-20,Goa,658,9,657,8286,514,436,7.94,0,1.6,365760,3068,363767,32.12,27.25,5.17875,0.84,99.46
2021-03-21,Goa,301,2,292,3806,3639,2781,7.91,7,1.6,366061,3070,364059,227.44,173.81,2.37875,0.84,99.45
2021-03-22,Goa,1396,19,1392,17547,4129,3899,7.96,0,1.6,367457,3089,365451,258.06,243.69,10.966875,0.84,99.45
2021-03-23,Goa,985,13,980,12456,2071,442,7.91,0,1.6,368442,3102,366431,129.44,27.62,7.785,0.84,99.45
2021-03-24,Goa,1489,17,1480,18643,273,26,7.99,0,1.6,369931,3119,367911,17.06,1.62,11.651875,0.84,99.45
2021-03-25,Goa,445,5,438,4924,2793,2082,9.04,2,1.6,370376,3124,368349,174.56,130.12,3.0775,0.84,99.45
2021-03-26,Goa,1358,12,1352,17309,517,294,7.85,0,1.6,371734,3136,369701,32.31,18.38,10.818125,0.84,99.45
2021-03-27,Goa,19,0,15,652,1612,671,2.91,4,1.6,371753,3136,369716,100.75,41.94,0.4075,0.84,99.45
2021-03-28,Goa,1044,5,1040,13094,2425,2071,7.97,0,1.6,372797,3141,370756,151.56,129.44,8.18375,0.84,99.45
2021-03-29,Goa,94,0,92,1265,2791,2311,7.43,2,1.6,372891,3141,370848,174.44,144.44,0.790625,0.84,99.45
2021-03-30,Goa,584,1,577,7481,4940,561,7.81,6,1.6,373475,3142,371425,308.75,35.06,4.675625,0.84,99.45
2021-03-31,Goa,60,0,58,585,3583,2123,10.26,2,1.6,373535,3142,371483,223.94,132.69,0.365625,0.84,99.45
2021-04-01,Goa,568,6,568,7149,3609,1922,7.95,0,1.6,374103,3148,372051,225.56,120.12,4.468125,0.84,99.45
2021-04-02,Goa,172,2,167,2288,3189,2003,7.52,3,1.6,374275,3150,372218,199.31,125.19,1.43,0.84,99.45
2021-04-03,Goa,1546,9,1543,19056,1878,90,8.11,0,1.6,375821,3159,373761,117.38,5.62,11.91,0.84,99.45
2021-04-04,Goa,250,1,248,3177,2139,1977,7.87,1,1.6,376071,3160,374009,133.69,123.56,1.985625,0.84,99.45
2021-04-05,Goa,1298,11,1292,16361,1311,929,7.93,0,1.6,377369,3171,375301,81.94,58.06,10.225625,0.84,99.45
2021-04-06,Goa,276,2,267,3228,2727,1061,8.55,7,1.6,377645,3173,375568,170.44,66.31,2.0175,0.84,99.45
2021-04-07,Goa,858,7,857,10845,1840,1353,7.91,0,1.6,378503,3180,376425,115.0,84.56,6.778125,0.84,99.45
2021-04-08,Goa,790,10,790,9936,4979,1280,7.95,0,1.6,379293,3190,377215,311.19,80.0,6.21,0.84,99.45
2021-04-09,Goa,386,1,384,4877,1631,90,7.91,1,1.6,379679,3191,377599,101.94,5.62,3.048125,0.84,99.45
2021-04-10,Goa,522,5,513,6237,1699,756,8.37,4,1.6,380201,3196,378112,106.19,47.25,3.898125,0.84,99.45
2021-04-11,Goa,649,7,645,7905,3,1,8.21,0,1.6,380850,3203,378757,0.19,0.06,4.940625,0.84,99.45
2021-04-12,Goa,460,5,455,5743,3385,16,8.01,0,1.6,381310,3208,379212,211.56,1.0,3.589375,0.84,99.45
2021-04-13,Goa,1485,8,1485,18417,1847,1424,8.06,0,1.6,382795,3216,380697,115.44,89.0,11.510625,0.84,99.45
2021-04-14,Goa,1177,14,1174,14836,475,108,7.93,0,1.6,383972,3230,381871,29.69,6.75,9.2725,0.84,99.45
2021-04-15,Goa,672,4,665,8778,1769,814,7.66,3,1.6,384644,3234,382536,110.56,50.88,5.48625,0.84,99.45
2021-04-16,Goa,156,1,147,1741,278,81,8.96,8,1.6,384800,3235,382683,17.38,5.06,1.088125,0.84,99.45
2021-04-17,Goa,1444,11,1437,18012,2675,1909,8.02,0,1.6,386244,3246,384120,167.19,119.31,11.2575,0.84,99.45
2021-04-18,Goa,1255,8,1251,15634,884,553,8.03,0,1.6,387499,3254,385371,55.25,34.56,9.77125,0.84,99.45
2021-04-19,Goa,1457,8,1456,18292,1489,1142,7.97,0,1.6,388956,3262,386827,93.06,71.38,11.4325,0.84,99.45
2021-04-20,Goa,1466,4,1463,17925,3124,1332,8.18,0,1.6,390422,3266,388290,195.25,83.25,11.203125,0.84,99.45
2021-04-21,Goa,1250,7,1247,15448,4224,3956,8.09,0,1.6,391672,3273,389537,264.0,247.25,9.655,0.84,99.45
2021-04-22,Goa,1411,10,1411,18172,3423,1708,7.76,0,1.6,393083,3283,390948,213.94,106.75,11.3575,0.84,99.46
2021-04-23,Goa,62,0,62,598,4351,1166,10.37,0,1.6,393145,3283,391010,271.94,72.88,0.37375,0.84,99.46
2021-04-24,Goa,1029,6,1020,13024,4774,3988,7.9,3,1.6,394174,3289,392030,298.38,249.25,8.14,0.83,99.46
2021-04-25,Goa,553,2,549,6784,1012,536,8.15,2,1.6,394727,3291,392579,63.25,33.5,4.24,0.83,99.46
2021-04-26,Goa,176,0,174,2241,1611,1185,7.85,2,1.6,394903,3291,392753,100.69,74.06,1.400625,0.83,99.46
2021-04-27,Goa,64,0,56,1012,2589,2538,6.32,8,1.6,394967,3291,392809,161.81,158.62,0.6325,0.83,99.45
2021-04-28,Goa,398,2,393,5454,3563,1000,7.3,3,1.6,395365,3293,393202,222.69,62.5,3.40875,0.83,99.45
2021-04-29,Goa,911,10,903,11184,3156,2216,8.15,0,1.6,396276,3303,394105,197.25,138.5,6.99,0.83,99.45
2021-04-30,Goa,601,2,600,7375,3832,1429,8.15,0,1.6,396877,3305,394705,239.5,89.31,4.609375,0.83,99.45
2021-05-01,Goa,916,6,912,11765,3811,1812,7.79,0,1.6,397793,3311,395617,238.19,113.25,7.353125,0.83,99.45
2021-05-02,Goa,321,2,316,4465,182,74,7.19,3,1.6,398114,3313,395933,11.38,4.62,2.790625,0.83,99.45
2021-05-03,Goa,758,4,749,9688,539,176,7.82,5,1.6,398872,3317,396682,33.69,11.0,6.055,0.83,99.45
2021-05-04,Goa,643,6,636,7751,1983,1395,8.3,1,1.6,399515,3323,397318,123.94,87.19,4.844375,0.83,99.45
2021-05-05,Goa,227,3,218,2517,35,7,9.02,6,1.6,399742,3326,397536,2.19,0.44,1.573125,0.83,99.45
2021-05-06,Goa,952,7,945,11490,2838,1905,8.29,0,1.6,400694,3333,398481,177.38,119.06,7.18125,0.83,99.45
2021-05-07,Goa,808,3,801,10027,2965,2151,8.06,4,1.6,401502,3336,399282,185.31,134.44,6.266875,0.83,99.45
2021-05-08,Goa,1093,4,1087,13552,549,344,8.07,2,1.6,402595,3340,400369,34.31,21.5,8.47,0.83,99.45
2021-05-09,Goa,1258,18,1249,15543,1498,1073,8.09,0,1.6,403853,3358,401618,93.62,67.06,9.714375,0.83,99.45
2021-05-10,Goa,1248,18,1240,15483,246,77,8.06,0,1.6,405101,3376,402858,15.38,4.81,9.676875,0.83,99.45
2021-05-11,Goa,691,10,684,8154,822,408,8.47,0,1.6,405792,3386,403542,51.38,25.5,5.09625,0.83,99.45
2021-05-12,Goa,469,6,462,6199,1712,1657,7.57,1,1.6,406261,3392,404004,107.0,103.56,3.874375,0.83,99.44
2021-05-13,Goa,1597,9,1595,19861,4917,2148,8.04,0,1.6,407858,3401,405599,307.31,134.25,12.413125,0.83,99.45
2021-05-14,Goa,305,3,301,3378,2880,1046,9.03,1,1.6,408163,3404,405900,180.0,65.38,2.11125,0.83,99.45
2021-05-15,Goa,820,7,819,10481,3370,97,7.82,0,1.6,408983,3411,406719,210.63,6.06,6.550625,0.83,99.45
2021-05-16,Goa,407,2,406,4497,4375,3237,9.05,0,1.6,409390,3413,407125,273.44,202.31,2.810625,0.83,99.45
2021-05-17,Goa,1110,10,1107,14361,1624,88,7.73,0,1.6,410500,3423,408232,101.5,5.5,8.975625,0.83,99.45
2021-05-18,Goa,43,0,43,601,2113,455,7.15,0,1.6,410543,3423,408275,132.06,28.44,0.375625,0.83,99.45
2021-05-19,Goa,139,1,139,2088,3177,3097,6.66,0,1.6,410682,3424,408414,198.56,193.56,1.305,0.83,99.45
2021-05-20,Goa,1114,5,1107,13988,248,193,7.96,2,1.6,411796,3429,409521,15.5,12.06,8.7425,0.83,99.45
2021-05-21,Goa,256,1,254,3414,2420,282,7.5,1,1.6,412052,3430,409775,151.25,17.62,2.13375,0.83,99.45
2021-05-22,Goa,1322,5,1319,16596,3475,3293,7.97,0,1.6,413374,3435,411094,217.19,205.81,10.3725,0.83,99.45
2021-05-23,Goa,1309,5,1308,16421,504,238,7.97,0,1.6,414683,3440,412402,31.5,14.88,10.263125,0.83,99.45
2021-05-24,Goa,977,12,973,12562,4370,747,7.78,0,1.6,415660,3452,413375,273.12,46.69,7.85125,0.83,99.45
2021-05-25,Goa,774,5,767,9533,162,49,8.12,2,1.6,416434,3457,414142,10.12,3.06,5.958125,0.83,99.45
2021-05-26,Goa,1048,11,1041,12806,2820,375,8.18,0,1.6,417482,3468,415183,176.25,23.44,8.00375,0.83,99.45
2021-05-27,Goa,1259,16,1256,15849,3311,1327,7.94,0,1.6,418741,3484,416439,206.94,82.94,9.905625,0.83,99.45
2021-05-28,Goa,816,10,808,10083,697,175,8.09,0,1.6,419557,3494,417247,43.56,10.94,6.301875,0.83,99.45
2021-05-29,Goa,333,1,329,4383,1048,448,7.6,3,1.6,419890,3495,417576,65.5,28.0,2.739375,0.83,99.45
2021-05-30,Goa,1467,20,1461,18097,557,418,8.11,0,1.6,421357,3515,419037,34.81,26.12,11.310625,0.83,99.45
2021-05-31,Goa,155,1,151,1912,3860,288,8.11,3,1.6,421512,3516,419188,241.25,18.0,1.195,0.83,99.45
2021-06-01,Goa,817,7,808,10261,30,2,7.96,2,1.6,422329,3523,419996,1.88,0.12,6.413125,0.83,99.45
2021-06-02,Goa,623,7,619,7964,867,783,7.82,0,1.6,422952,3530,420615,54.19,48.94,4.9775,0.83,99.45
2021-06-03,Goa,863,5,862,11325,1462,394,7.62,0,1.6,423815,3535,421477,91.38,24.62,7.078125,0.83,99.45
2021-06-04,Goa,75,0,72,1096,2328,1535,6.84,3,1.6,423890,3535,421549,145.5,95.94,0.685,0.83,99.45
2021-06-05,Goa,1268,16,1265,15665,1658,1313,8.09,0,1.6,425158,3551,422814,103.62,82.06,9.790625,0.84,99.45
2021-06-06,Goa,848,7,848,11020,2191,1418,7.7,0,1.6,426006,3558,423662,136.94,88.62,6.8875,0.84,99.45
2021-06-07,Goa,507,3,499,6455,4725,2099,7.85,5,1.6,426513,3561,424161,295.31,131.19,4.034375,0.83,99.45
2021-06-08,Goa,1334,4,1333,16523,797,621,8.07,0,1.6,427847,3565,425494,49.81,38.81,10.326875,0.83,99.45
2021-06-09,Goa,994,5,988,12871,3861,2148,7.72,1,1.6,428841,3570,426482,241.31,134.25,8.044375,0.83,99.45
2021-06-10,Goa,1015,7,1011,12534,294,149,8.1,0,1.6,429856,3577,427493,18.38,9.31,7.83375,0.83,99.45
2021-06-11,Goa,299,2,298,3396,1583,892,8.8,0,1.6,430155,3579,427791,98.94,55.75,2.1225,0.83,99.45
2021-06-12,Goa,1426,9,1425,18365,1451,89,7.76,0,1.6,431581,3588,429216,90.69,5.56,11.478125,0.83,99.45
2021-06-13,Goa,1534,16,1528,19112,1740,1043,8.03,0,1.6,433115,3604,430744,108.75,65.19,11.945,0.83,99.45
2021-06-14,Goa,474,4,469,5558,2962,993,8.53,1,1.6,433589,3608,431213,185.12,62.06,3.47375,0.83,99.45
2021-06-15,Goa,1607,5,1605,19764,2751,459,8.13,0,1.6,435196,3613,432818,171.94,28.69,12.3525,0.83,99.45
2021-06-16,Goa,1121,4,1117,14166,341,209,7.91,0,1.6,436317,3617,433935,21.31,13.06,8.85375,0.83,99.45
2021-06-17,Goa,1501,11,1501,18414,2631,2328,8.15,0,1.6,437818,3628,435436,164.44,145.5,11.50875,0.83,99.46
2021-06-18,Goa,270,2,263,3432,4830,3203,7.87,5,1.6,438088,3630,435699,301.88,200.19,2.145,0.83,99.45
2021-06-19,Goa,1245,15,1239,15861,4625,2329,7.85,0,1.6,439333,3645,436938,289.06,145.56,9.913125,0.83,99.45
2021-06-20,Goa,1179,16,1171,14617,899,551,8.07,0,1.6,440512,3661,438109,56.19,34.44,9.135625,0.83,99.45
2021-06-21,Goa,686,8,684,8139,471,119,8.43,0,1.6,441198,3669,438793,29.44,7.44,5.086875,0.83,99.45
2021-06-22,Goa,142,1,136,1491,4967,3618,9.52,5,1.6,441340,3670,438929,310.44,226.12,0.931875,0.83,99.45
2021-06-23,Goa,1554,6,1553,19418,1967,247,8.0,0,1.6,442894,3676,440482,122.94,15.44,12.13625,0.83,99.46
2021-06-24,Goa,513,4,506,6788,2232,1912,7.56,3,1.6,443407,3680,440988,139.5,119.5,4.2425,0.83,99.45
2021-06-25,Goa,450,3,445,5801,4120,3846,7.76,2,1.6,443857,3683,441433,257.5,240.38,3.625625,0.83,99.45
2021-06-26,Goa,85,0,76,1121,1735,1535,7.58,9,1.6,443942,3683,441509,108.44,95.94,0.700625,0.83,99.45
2021-06-27,Goa,63,0,56,870,3718,663,7.24,7,1.6,444005,3683,441565,232.38,41.44,0.54375,0.83,99.45
2021-06-28,Goa,125,0,122,1566,3006,1875,7.98,3,1.6,444130,3683,441687,187.88,117.19,0.97875,0.83,99.45
2021-06-29,Goa,957,8,956,11445,3263,2226,8.36,0,1.6,445087,3691,442643,203.94,139.12,7.153125,0.83,99.45
2021-06-30,Goa,341,1,332,4661,4430,4395,7.32,8,1.6,445428,3692,442975,276.88,274.69,2.913125,0.83,99.45
2021-07-01,Goa,863,6,856,10877,3435,2454,7.93,1,1.6,446291,3698,443831,214.69,153.38,6.798125,0.83,99.45
2021-07-02,Goa,954,10,948,11848,4617,462,8.05,0,1.6,447245,3708,444779,288.56,28.88,7.405,0.83,99.45
2021-07-03,Goa,623,2,621,8036,2076,1131,7.75,0,1.6,447868,3710,445400,129.75,70.69,5.0225,0.83,99.45
2021-07-04,Goa,1425,16,1418,17722,307,72,8.04,0,1.6,449293,3726,446818,19.19,4.5,11.07625,0.83,99.45
2021-07-05,Goa,823,6,821,10574,2690,69,7.78,0,1.6,450116,3732,447639,168.12,4.31,6.60875,0.83,99.45
2021-07-06,Goa,1457,4,1452,18400,1000,593,7.92,1,1.6,451573,3736,449091,62.5,37.06,11.5,0.83,99.45
2021-07-07,Goa,204,1,200,2940,833,284,6.94,3,1.6,451777,3737,449291,52.06,17.75,1.8375,0.83,99.45
2021-07-08,Goa,696,2,693,8709,2965,2030,7.99,1,1.6,452473,3739,449984,185.31,126.88,5.443125,0.83,99.45
2021-07-09,Goa,1215,17,1214,15126,4518,3076,8.03,0,1.6,453688,3756,451198,282.38,192.25,9.45375,0.83,99.45
2021-07-10,Goa,159,1,152,2056,3409,2757,7.73,6,1.6,453847,3757,451350,213.06,172.31,1.285,0.83,99.45
2021-07-11,Goa,470,3,468,5863,4369,2318,8.02,0,1.6,454317,3760,451818,273.06,144.88,3.664375,0.83,99.45
2021-07-12,Goa,1431,17,1427,17934,1406,1030,7.98,0,1.6,455748,3777,453245,87.88,64.38,11.20875,0.83,99.45
2021-07-13,Goa,1239,11,1239,15498,1048,198,7.99,0,1.6,456987,3788,454484,65.5,12.38,9.68625,0.83,99.45
2021-07-14,Goa,536,2,534,6883,731,723,7.79,0,1.6,457523,3790,455018,45.69,45.19,4.301875,0.83,99.45
2021-07-15,Goa,224,2,215,1933,2394,1125,11.59,7,1.6,457747,3792,455233,149.62,70.31,1.208125,0.83,99.45
2021-07-16,Goa,1045,10,1039,13486,187,4,7.75,0,1.6,458792,3802,456272,11.69,0.25,8.42875,0.83,99.45
2021-07-17,Goa,830,5,822,10123,4210,1093,8.2,3,1.6,459622,3807,457094,263.12,68.31,6.326875,0.83,99.45
2021-07-18,Goa,1005,4,1003,12517,4963,1016,8.03,0,1.6,460627,3811,458097,310.19,63.5,7.823125,0.83,99.45
2021-07-19,Goa,1578,10,1571,19670,1148,623,8.02,0,1.6,462205,3821,459668,71.75,38.94,12.29375,0.83,99.45
2021-07-20,Goa,510,5,510,7017,2907,2299,7.27,0,1.6,462715,3826,460178,181.69,143.69,4.385625,0.83,99.45
2021-07-21,Goa,637,2,631,7854,4423,3384,8.11,4,1.6,463352,3828,460809,276.44,211.5,4.90875,0.83,99.45
2021-07-22,Goa,364,3,356,4346,4952,2005,8.38,5,1.6,463716,3831,461165,309.5,125.31,2.71625,0.83,99.45
2021-07-23,Goa,1494,17,1485,19440,3554,2978,7.69,0,1.6,465210,3848,462650,222.12,186.12,12.15,0.83,99.45
2021-07-24,Goa,538,6,534,6694,1172,338,8.04,0,1.6,465748,3854,463184,73.25,21.12,4.18375,0.83,99.45
2021-07-25,Goa,884,12,880,11132,152,104,7.94,0,1.6,466632,3866,464064,9.5,6.5,6.9575,0.83,99.45
2021-07-26,Goa,475,1,473,6398,3636,1259,7.42,1,1.6,467107,3867,464537,227.25,78.69,3.99875,0.83,99.45
2021-07-27,Goa,348,1,347,4583,3359,2837,7.59,0,1.6,467455,3868,464884,209.94,177.31,2.864375,0.83,99.45
2021-07-28,Goa,237,1,228,3239,528,55,7.32,8,1.6,467692,3869,465112,33.0,3.44,2.024375,0.83,99.45
2021-07-29,Goa,497,1,490,6239,2261,1661,7.97,6,1.6,468189,3870,465602,141.31,103.81,3.899375,0.83,99.45
2021-07-30,Goa,1047,13,1042,13359,4687,4228,7.84,0,1.6,469236,3883,466644,292.94,264.25,8.349375,0.83,99.45
2021-07-31,Goa,146,1,141,1861,2149,258,7.85,4,1.6,469382,3884,466785,134.31,16.12,1.163125,0.83,99.45
2021-08-01,Goa,1513,14,1512,19082,4898,752,7.93,0,1.6,470895,3898,468297,306.12,47.0,11.92625,0.83,99.45
2021-08-02,Goa,513,5,509,6335,2508,1045,8.1,0,1.6,471408,3903,468806,156.75,65.31,3.959375,0.83,99.45
2021-08-03,Goa,856,4,850,10689,3830,891,8.01,2,1.6,472264,3907,469656,239.37,55.69,6.680625,0.83,99.45
2021-08-04,Goa,1461,14,1454,18262,2669,559,8.0,0,1.6,473725,3921,471110,166.81,34.94,11.41375,0.83,99.45
2021-08-05,Goa,582,4,581,7262,615,329,8.01,0,1.6,474307,3925,471691,38.44,20.56,4.53875,0.83,99.45
2021-08-06,Goa,173,1,170,2197,2928,2643,7.87,2,1.6,474480,3926,471861,183.0,165.19,1.373125,0.83,99.45
2021-08-07,Goa,1454,17,1445,17864,2497,411,8.14,0,1.6,475934,3943,473306,156.06,25.69,11.165,0.83,99.45
2021-08-08,Goa,156,1,148,1801,2527,1072,8.66,7,1.6,476090,3944,473454,157.94,67.0,1.125625,0.83,99.45
2021-08-09,Goa,835,5,835,10494,309,38,7.96,0,1.6,476925,3949,474289,19.31,2.38,6.55875,0.83,99.45
2021-08-10,Goa,242,1,233,3126,4134,2626,7.74,8,1.6,477167,3950,474522,258.38,164.12,1.95375,0.83,99.45
2021-08-11,Goa,1459,9,1450,18157,2740,503,8.04,0,1.6,478626,3959,475972,171.25,31.44,11.348125,0.83,99.45
2021-08-12,Goa,906,5,897,11549,2786,1246,7.84,4,1.6,479532,3964,476869,174.12,77.88,7.218125,0.83,99.44
2021-08-13,Goa,1610,15,1604,19893,3874,1090,8.09,0,1.6,481142,3979,478473,242.12,68.12,12.433125,0.83,99.45
2021-08-14,Goa,108,0,102,1270,189,69,8.5,6,1.6,481250,3979,478575,11.81,4.31,0.79375,0.83,99.44
2021-08-15,Goa,879,8,874,11100,3544,2712,7.92,0,1.6,482129,3987,479449,221.5,169.5,6.9375,0.83,99.44
2021-08-16,Goa,1041,7,1038,12910,4537,4094,8.06,0,1.6,483170,3994,480487,283.56,255.88,8.06875,0.83,99.44
2021-08-17,Goa,1394,5,1394,17690,3822,2125,7.88,0,1.6,484564,3999,481881,238.88,132.81,11.05625,0.83,99.45
2021-08-18,Goa,1324,6,1321,16379,1509,376,8.08,0,1.6,485888,4005,483202,94.31,23.5,10.236875,0.82,99.45
2021-08-19,Goa,538,4,534,6604,2893,2150,8.15,0,1.6,486426,4009,483736,180.81,134.38,4.1275,0.82,99.45
2021-08-20,Goa,157,1,153,1525,3908,3489,10.3,3,1.6,486583,4010,483889,244.25,218.06,0.953125,0.82,99.45
2021-08-21,Goa,279,3,272,3163,4353,1379,8.82,4,1.6,486862,4013,484161,272.06,86.19,1.976875,0.82,99.45
2021-08-22,Goa,906,12,906,11377,1768,1648,7.96,0,1.6,487768,4025,485067,110.5,103.0,7.110625,0.83,99.45
2021-08-23,Goa,328,2,322,4200,1740,539,7.81,4,1.6,488096,4027,485389,108.75,33.69,2.625,0.83,99.45
2021-08-24,Goa,147,1,144,2401,718,207,6.12,2,1.6,488243,4028,485533,44.88,12.94,1.500625,0.82,99.44
2021-08-25,Goa,1458,19,1450,18189,4388,2229,8.02,0,1.6,489701,4047,486983,274.25,139.31,11.368125,0.83,99.44
2021-08-26,Goa,1576,23,1573,19411,4866,1820,8.12,0,1.6,491277,4070,488556,304.12,113.75,12.131875,0.83,99.45
2021-08-27,Goa,238,1,237,3038,2617,1368,7.83,0,1.6,491515,4071,488793,163.56,85.5,1.89875,0.83,99.45
2021-08-28,Goa,335,3,329,4311,487,398,7.77,3,1.6,491850,4074,489122,30.44,24.88,2.694375,0.83,99.45
2021-08-29,Goa,1557,7,1548,19143,2308,1957,8.13,2,1.6,493407,4081,490670,144.25,122.31,11.964375,0.83,99.45
2021-08-30,Goa,1021,7,1018,12495,1626,642,8.17,0,1.6,494428,4088,491688,101.63,40.12,7.809375,0.83,99.45
2021-08-31,Goa,725,5,719,9177,1617,953,7.9,1,1.6,495153,4093,492407,101.06,59.56,5.735625,0.83,99.45
2021-09-01,Goa,340,1,332,4161,4038,1277,8.17,7,1.6,495493,4094,492739,252.38,79.81,2.600625,0.83,99.44
2021-09-02,Goa,662,8,655,8112,3863,3451,8.16,0,1.6,496155,4102,493394,241.44,215.69,5.07,0.83,99.44
2021-09-03,Goa,794,10,793,10102,282,224,7.86,0,1.6,496949,4112,494187,17.62,14.0,6.31375,0.83,99.44
2021-09-04,Goa,518,4,511,6360,4392,3732,8.14,3,1.6,497467,4116,494698,274.5,233.25,3.975,0.83,99.44
2021-09-05,Goa,457,5,450,5622,3480,3171,8.13,2,1.6,497924,4121,495148,217.5,198.19,3.51375,0.83,99.44
2021-09-06,Goa,898,8,895,11384,1566,510,7.89,0,1.6,498822,4129,496043,97.88,31.87,7.115,0.83,99.44
2021-09-07,Goa,1519,6,1512,19032,331,29,7.98,1,1.6,500341,4135,497555,20.69,1.81,11.895,0.83,99.44
2021-09-08,Goa,1582,4,1577,19616,3193,2619,8.06,1,1.6,501923,4139,499132,199.56,163.69,12.26,0.82,99.44
2021-09-09,Goa,291,1,290,3661,4281,1503,7.95,0,1.6,502214,4140,499422,267.56,93.94,2.288125,0.82,99.44
2021-09-10,Goa,1480,21,1477,18653,844,359,7.93,0,1.6,503694,4161,500899,52.75,22.44,11.658125,0.83,99.45
2021-09-11,Goa,980,10,978,12382,793,562,7.91,0,1.6,504674,4171,501877,49.56,35.12,7.73875,0.83,99.45
2021-09-12,Goa,1055,5,1054,13774,2547,1454,7.66,0,1.6,505729,4176,502931,159.19,90.88,8.60875,0.83,99.45
2021-09-13,Goa,511,6,508,6180,4165,3432,8.27,0,1.6,506240,4182,503439,260.31,214.5,3.8625,0.83,99.45
2021-09-14,Goa,149,1,140,1993,2043,631,7.48,8,1.6,506389,4183,503579,127.69,39.44,1.245625,0.83,99.45
2021-09-15,Goa,776,5,769,9800,488,430,7.92,2,1.6,507165,4188,504348,30.5,26.88,6.125,0.83,99.44
2021-09-16,Goa,204,2,201,2570,1014,974,7.94,1,1.6,507369,4190,504549,63.38,60.88,1.60625,0.83,99.44
2021-09-17,Goa,912,10,910,11761,3930,1414,7.75,0,1.6,508281,4200,505459,245.62,88.38,7.350625,0.83,99.44
2021-09-18,Goa,1544,20,1544,19244,182,171,8.02,0,1.6,509825,4220,507003,11.38,10.69,12.0275,0.83,99.45
2021-09-19,Goa,1065,11,1064,13054,3716,3110,8.16,0,1.6,510890,4231,508067,232.25,194.38,8.15875,0.83,99.45
2021-09-20,Goa,452,6,452,5968,1430,486,7.57,0,1.6,511342,4237,508519,89.38,30.38,3.73,0.83,99.45
2021-09-21,Goa,1530,9,1530,18791,1176,504,8.14,0,1.6,512872,4246,510049,73.5,31.5,11.744375,0.83,99.45
2021-09-22,Goa,1322,12,1313,16651,2301,95,7.94,0,1.6,514194,4258,511362,143.81,5.94,10.406875,0.83,99.45
2021-09-23,Goa,856,10,850,11014,3070,6,7.77,0,1.6,515050,4268,512212,191.88,0.38,6.88375,0.83,99.45
2021-09-24,Goa,625,5,617,8164,91,23,7.66,3,1.6,515675,4273,512829,5.69,1.44,5.1025,0.83,99.45
2021-09-25,Goa,728,10,727,9160,4014,316,7.95,0,1.6,516403,4283,513556,250.88,19.75,5.725,0.83,99.45
2021-09-26,Goa,311,4,304,4006,2514,2066,7.76,3,1.6,516714,4287,513860,157.12,129.12,2.50375,0.83,99.45
2021-09-27,Goa,603,2,597,7958,990,323,7.58,4,1.6,517317,4289,514457,61.88,20.19,4.97375,0.83,99.45
2021-09-28,Goa,596,4,587,7467,2936,973,7.98,5,1.6,517913,4293,515044,183.5,60.81,4.666875,0.83,99.45
2021-09-29,Goa,1031,4,1030,13106,2862,1572,7.87,0,1.6,518944,4297,516074,178.88,98.25,8.19125,0.83,99.45
2021-09-30,Goa,479,3,471,6031,4593,2400,7.94,5,1.6,519423,4300,516545,287.06,150.0,3.769375,0.83,99.45
2021-10-01,Goa,1382,15,1379,17346,3278,344,7.97,0,1.6,520805,4315,517924,204.88,21.5,10.84125,0.83,99.45
2021-10-02,Goa,99,0,98,1256,4522,3372,7.88,1,1.6,520904,4315,518022,282.62,210.75,0.785,0.83,99.45
2021-10-03,Goa,320,2,315,3970,4901,4883,8.06,3,1.6,521224,4317,518337,306.31,305.19,2.48125,0.83,99.45
2021-10-04,Goa,1081,15,1079,13279,4390,2258,8.14,0,1.6,522305,4332,519416,274.38,141.12,8.299375,0.83,99.45
2021-10-05,Goa,263,2,257,3845,960,830,6.84,4,1.6,522568,4334,519673,60.0,51.88,2.403125,0.83,99.45
2021-10-06,Goa,408,1,402,4945,2328,1661,8.25,5,1.6,522976,4335,520075,145.5,103.81,3.090625,0.83,99.45
2021-10-07,Goa,1493,15,1489,18570,1204,56,8.04,0,1.6,524469,4350,521564,75.25,3.5,11.60625,0.83,99.45
2021-10-08,Goa,1421,13,1418,17985,207,31,7.9,0,1.6,525890,4363,522982,12.94,1.94,11.240625,0.83,99.45
2021-10-09,Goa,66,0,61,1173,4696,4594,5.63,5,1.6,525956,4363,523043,293.5,287.12,0.733125,0.83,99.45
2021-10-10,Goa,613,7,606,7810,403,226,7.85,0,1.6,526569,4370,523649,25.19,14.12,4.88125,0.83,99.45
2021-10-11,Goa,1382,5,1379,17058,3150,2852,8.1,0,1.6,527951,4375,525028,196.88,178.25,10.66125,0.83,99.45
2021-10-12,Goa,654,2,653,7757,1466,607,8.43,0,1.6,528605,4377,525681,91.62,37.94,4.848125,0.83,99.45
2021-10-13,Goa,768,6,762,9666,4681,695,7.95,0,1.6,529373,4383,526443,292.56,43.44,6.04125,0.83,99.45
2021-10-14,Goa,1148,11,1145,14108,2812,232,8.14,0,1.6,530521,4394,527588,175.75,14.5,8.8175,0.83,99.45
2021-10-15,Goa,847,12,841,10807,1946,122,7.84,0,1.6,531368,4406,528429,121.62,7.62,6.754375,0.83,99.45
2021-10-16,Goa,1218,12,1217,15262,4492,194,7.98,0,1.6,532586,4418,529646,280.75,12.12,9.53875,0.83,99.45
2021-10-17,Goa,973,12,968,12264,4172,2109,7.93,0,1.6,533559,4430,530614,260.75,131.81,7.665,0.83,99.45
2021-10-18,Goa,71,0,62,1085,508,148,6.54,9,1.6,533630,4430,530676,31.75,9.25,0.678125,0.83,99.45
2021-10-19,Goa,119,1,111,1582,2672,299,7.52,7,1.6,533749,4431,530787,167.0,18.69,0.98875,0.83,99.45
2021-10-20,Goa,954,11,948,12419,3886,3373,7.68,0,1.6,534703,4442,531735,242.88,210.81,7.761875,0.83,99.44
2021-10-21,Goa,592,5,583,7504,149,106,7.89,4,1.6,535295,4447,532318,9.31,6.62,4.69,0.83,99.44
2021-10-22,Goa,285,2,276,3191,318,126,8.93,7,1.6,535580,4449,532594,19.88,7.88,1.994375,0.83,99.44
2021-10-23,Goa,638,6,635,8029,1857,1083,7.95,0,1.6,536218,4455,533229,116.06,67.69,5.018125,0.83,99.44
2021-10-24,Goa,1304,7,1304,16114,2565,1489,8.09,0,1.6,537522,4462,534533,160.31,93.06,10.07125,0.83,99.44
2021-10-25,Goa,432,3,431,5686,1303,441,7.6,0,1.6,537954,4465,534964,81.44,27.56,3.55375,0.83,99.44
2021-10-26,Goa,75,0,68,800,2428,1297,9.38,7,1.6,538029,4465,535032,151.75,81.06,0.5,0.83,99.44
2021-10-27,Goa,233,1,225,3372,3577,2625,6.91,7,1.6,538262,4466,535257,223.56,164.06,2.1075,0.83,99.44
2021-10-28,Goa,184,1,175,2340,1038,474,7.86,8,1.6,538446,4467,535432,64.88,29.62,1.4625,0.83,99.44
2021-10-29,Goa,1342,15,1334,16794,625,306,7.99,0,1.6,539788,4482,536766,39.06,19.12,10.49625,0.83,99.44
2021-10-30,Goa,1605,20,1599,19941,541,151,8.05,0,1.6,541393,4502,538365,33.81,9.44,12.463125,0.83,99.44
2021-10-31,Goa,1272,7,1270,15867,1158,815,8.02,0,1.6,542665,4509,539635,72.38,50.94,9.916875,0.83,99.44
2021-11-01,Goa,1134,13,1132,13887,2047,662,8.17,0,1.6,543799,4522,540767,127.94,41.38,8.679375,0.83,99.44
2021-11-02,Goa,937,10,928,12087,3838,2556,7.75,0,1.6,544736,4532,541695,239.88,159.75,7.554375,0.83,99.44
2021-11-03,Goa,851,11,848,10602,169,61,8.03,0,1.6,545587,4543,542543,10.56,3.81,6.62625,0.83,99.44
2021-11-04,Goa,215,2,211,2782,4855,357,7.73,2,1.6,545802,4545,542754,303.44,22.31,1.73875,0.83,99.44
2021-11-05,Goa,1192,14,1188,15190,1865,1591,7.85,0,1.6,546994,4559,543942,116.56,99.44,9.49375,0.83,99.44
2021-11-06,Goa,285,4,280,3285,568,540,8.68,1,1.6,547279,4563,544222,35.5,33.75,2.053125,0.83,99.44
2021-11-07,Goa,284,2,283,3631,2685,1029,7.82,0,1.6,547563,4565,544505,167.81,64.31,2.269375,0.83,99.44
2021-11-08,Goa,1095,12,1092,13796,2503,1251,7.94,0,1.6,548658,4577,545597,156.44,78.19,8.6225,0.83,99.44
2021-11-09,Goa,236,2,230,3072,957,389,7.68,4,1.6,548894,4579,545827,59.81,24.31,1.92,0.83,99.44
2021-11-10,Goa,297,3,288,4200,2030,1948,7.07,6,1.6,549191,4582,546115,126.88,121.75,2.625,0.83,99.44
2021-11-11,Goa,279,3,273,3720,3480,3281,7.5,3,1.6,549470,4585,546388,217.5,205.06,2.325,0.83,99.44
2021-11-12,Goa,1297,16,1295,16268,1253,428,7.97,0,1.6,550767,4601,547683,78.31,26.75,10.1675,0.84,99.44
2021-11-13,Goa,652,7,645,8021,1736,102,8.13,0,1.6,551419,4608,548328,108.5,6.38,5.013125,0.84,99.44
2021-11-14,Goa,296,3,292,3785,3741,1060,7.82,1,1.6,551715,4611,548620,233.81,66.25,2.365625,0.84,99.44
2021-11-15,Goa,1049,7,1042,12462,942,133,8.42,0,1.6,552764,4618,549662,58.88,8.31,7.78875,0.84,99.44
2021-11-16,Goa,607,7,602,7447,489,154,8.15,0,1.6,553371,4625,550264,30.56,9.62,4.654375,0.84,99.44
2021-11-17,Goa,783,2,783,9375,2687,1635,8.35,0,1.6,554154,4627,551047,167.94,102.19,5.859375,0.83,99.44
2021-11-18,Goa,863,4,855,10836,53,4,7.96,4,1.6,555017,4631,551902,3.31,0.25,6.7725,0.83,99.44
2021-11-19,Goa,1088,8,1086,13374,552,174,8.14,0,1.6,556105,4639,552988,34.5,10.88,8.35875,0.83,99.44
2021-11-20,Goa,450,5,442,5748,1072,610,7.83,3,1.6,556555,4644,553430,67.0,38.12,3.5925,0.83,99.44
2021-11-21,Goa,1190,15,1189,15109,2546,1771,7.88,0,1.6,557745,4659,554619,159.12,110.69,9.443125,0.84,99.44
2021-11-22,Goa,940,4,935,11803,2235,1920,7.96,1,1.6,558685,4663,555554,139.69,120.0,7.376875,0.83,99.44
2021-11-23,Goa,1528,12,1523,19056,1341,3,8.02,0,1.6,560213,4675,557077,83.81,0.19,11.91,0.83,99.44
2021-11-24,Goa,243,2,238,3321,1506,792,7.32,3,1.6,560456,4677,557315,94.12,49.5,2.075625,0.83,99.44
2021-11-25,Goa,1398,7,1393,17933,4374,1150,7.8,0,1.6,561854,4684,558708,273.38,71.88,11.208125,0.83,99.44
2021-11-26,Goa,1069,3,1061,12831,2016,1460,8.33,5,1.6,562923,4687,559769,126.0,91.25,8.019375,0.83,99.44
2021-11-27,Goa,361,2,361,4510,1538,703,8.0,0,1.6,563284,4689,560130,96.12,43.94,2.81875,0.83,99.44
2021-11-28,Goa,158,2,157,1414,1163,563,11.17,0,1.6,563442,4691,560287,72.69,35.19,0.88375,0.83,99.44
2021-11-29,Goa,591,2,588,6573,2543,971,8.99,1,1.6,564033,4693,560875,158.94,60.69,4.108125,0.83,99.44
2021-11-30,Goa,1244,6,1238,15718,2042,483,7.91,0,1.6,565277,4699,562113,127.63,30.19,9.82375,0.83,99.44
2021-12-01,Goa,734,5,726,8957,2369,2126,8.19,3,1.6,566011,4704,562839,148.06,132.88,5.598125,0.83,99.44
2021-12-02,Goa,721,4,718,9255,2086,1602,7.79,0,1.6,566732,4708,563557,130.38,100.12,5.784375,0.83,99.44
2021-12-03,Goa,1428,13,1428,17965,38,11,7.95,0,1.6,568160,4721,564985,2.38,0.69,11.228125,0.83,99.44
2021-12-04,Goa,1343,5,1340,16716,123,6,8.03,0,1.6,569503,4726,566325,7.69,0.38,10.4475,0.83,99.44
2021-12-05,Goa,1182,7,1177,14816,170,163,7.98,0,1.6,570685,4733,567502,10.62,10.19,9.26,0.83,99.44
2021-12-06,Goa,1174,8,1166,14694,864,603,7.99,0,1.6,571859,4741,568668,54.0,37.69,9.18375,0.83,99.44
2021-12-07,Goa,917,8,908,11865,1566,853,7.73,1,1.6,572776,4749,569576,97.88,53.31,7.415625,0.83,99.44
2021-12-08,Goa,1202,9,1200,15154,566,34,7.93,0,1.6,573978,4758,570776,35.38,2.12,9.47125,0.83,99.44
2021-12-09,Goa,913,5,908,11687,2133,601,7.81,0,1.6,574891,4763,571684,133.31,37.56,7.304375,0.83,99.44
2021-12-10,Goa,821,9,818,10020,3524,2514,8.19,0,1.6,575712,4772,572502,220.25,157.12,6.2625,0.83,99.44
2021-12-11,Goa,449,4,445,5214,3646,440,8.61,0,1.6,576161,4776,572947,227.88,27.5,3.25875,0.83,99.44
2021-12-12,Goa,82,0,73,1125,4327,895,7.29,9,1.6,576243,4776,573020,270.44,55.94,0.703125,0.83,99.44
2021-12-13,Goa,950,11,941,11999,216,7,7.92,0,1.6,577193,4787,573961,13.5,0.44,7.499375,0.83,99.44
2021-12-14,Goa,1313,9,1307,16510,610,404,7.95,0,1.6,578506,4796,575268,38.12,25.25,10.31875,0.83,99.44
2021-12-15,Goa,838,8,829,10469,842,201,8.0,1,1.6,579344,4804,576097,52.62,12.56,6.543125,0.83,99.44
2021-12-16,Goa,435,2,430,5345,4253,2253,8.14,3,1.6,579779,4806,576527,265.81,140.81,3.340625,0.83,99.44
2021-12-17,Goa,844,7,839,10700,1115,6,7.89,0,1.6,580623,4813,577366,69.69,0.38,6.6875,0.83,99.44
2021-12-18,Goa,657,5,648,7820,2004,1811,8.4,4,1.6,581280,4818,578014,125.25,113.19,4.8875,0.83,99.44
2021-12-19,Goa,867,4,866,10519,2182,1217,8.24,0,1.6,582147,4822,578880,136.38,76.06,6.574375,0.83,99.44
2021-12-20,Goa,69,0,66,1163,479,215,5.93,3,1.6,582216,4822,578946,29.94,13.44,0.726875,0.83,99.44
2021-12-21,Goa,1076,11,1068,13813,603,205,7.79,0,1.6,583292,4833,580014,37.69,12.81,8.633125,0.83,99.44
2021-12-22,Goa,367,2,361,5007,4900,769,7.33,4,1.6,583659,4835,580375,306.25,48.06,3.129375,0.83,99.44
2021-12-23,Goa,1317,7,1314,16526,4423,2626,7.97,0,1.6,584976,4842,581689,276.44,164.12,10.32875,0.83,99.44
2021-12-24,Goa,1231,8,1230,15137,4492,2819,8.13,0,1.6,586207,4850,582919,280.75,176.19,9.460625,0.83,99.44
2021-12-25,Goa,764,3,760,9627,4872,4777,7.94,1,1.6,586971,4853,583679,304.5,298.56,6.016875,0.83,99.44
2021-12-26,Goa,1107,5,1101,13842,3556,1209,8.0,1,1.6,588078,4858,584780,222.25,75.56,8.65125,0.83,99.44
2021-12-27,Goa,353,2,353,4476,3345,2999,7.89,0,1.6,588431,4860,585133,209.06,187.44,2.7975,0.83,99.44
2021-12-28,Goa,921,13,918,11800,3694,547,7.81,0,1.6,589352,4873,586051,230.88,34.19,7.375,0.83,99.44
2021-12-29,Goa,964,13,957,12247,2448,1858,7.87,0,1.6,590316,4886,587008,153.0,116.12,7.654375,0.83,99.44
2021-12-30,Goa,1623,9,1619,19941,1228,436,8.14,0,1.6,591939,4895,588627,76.75,27.25,12.463125,0.83,99.44
2021-12-31,Goa,330,4,328,3683,2133,1020,8.96,0,1.6,592269,4899,588955,133.31,63.75,2.301875,0.83,99.44
2022-01-01,Goa,895,6,889,10938,4435,900,8.18,0,1.6,593164,4905,589844,277.19,56.25,6.83625,0.83,99.44
2022-01-02,Goa,301,1,301,3755,3769,69,8.02,0,1.6,593465,4906,590145,235.56,4.31,2.346875,0.83,99.44
2022-01-03,Goa,244,1,238,3306,1127,568,7.38,5,1.6,593709,4907,590383,70.44,35.5,2.06625,0.83,99.44
2022-01-04,Goa,1454,15,1449,17866,956,444,8.14,0,1.6,595163,4922,591832,59.75,27.75,11.16625,0.83,99.44
2022-01-05,Goa,1072,13,1071,13809,2449,1471,7.76,0,1.6,596235,4935,592903,153.06,91.94,8.630625,0.83,99.44
2022-01-06,Goa,206,2,199,2440,1400,778,8.44,5,1.6,596441,4937,593102,87.5,48.62,1.525,0.83,99.44
2022-01-07,Goa,62,0,54,1087,3058,203,5.7,8,1.6,596503,4937,593156,191.12,12.69,0.679375,0.83,99.44
2022-01-08,Goa,499,7,497,6220,3571,1677,8.02,0,1.6,597002,4944,593653,223.19,104.81,3.8875,0.83,99.44
2022-01-09,Goa,924,4,917,11525,2529,1805,8.02,3,1.6,597926,4948,594570,158.06,112.81,7.203125,0.83,99.44
2022-01-10,Goa,630,7,624,8147,4934,931,7.73,0,1.6,598556,4955,595194,308.38,58.19,5.091875,0.83,99.44
2022-01-11,Goa,742,4,734,9025,1357,1054,8.22,4,1.6,599298,4959,595928,84.81,65.88,5.640625,0.83,99.44
2022-01-12,Goa,1458,5,1455,18118,4452,1328,8.05,0,1.6,600756,4964,597383,278.25,83.0,11.32375,0.83,99.44
2022-01-13,Goa,1018,14,1014,12935,2091,1300,7.87,0,1.6,601774,4978,598397,130.69,81.25,8.084375,0.83,99.44
2022-01-14,Goa,735,5,729,9090,1073,795,8.09,1,1.6,602509,4983,599126,67.06,49.69,5.68125,0.83,99.44
2022-01-15,Goa,1204,17,1198,14718,2172,83,8.18,0,1.6,603713,5000,600324,135.75,5.19,9.19875,0.83,99.44
2022-01-16,Goa,370,3,364,4719,112,110,7.84,3,1.6,604083,5003,600688,7.0,6.88,2.949375,0.83,99.44
2022-01-17,Goa,1472,6,1464,18077,4730,2897,8.14,2,1.6,605555,5009,602152,295.62,181.06,11.298125,0.83,99.44
2022-01-18,Goa,251,2,251,3193,3273,406,7.86,0,1.6,605806,5011,602403,204.56,25.37,1.995625,0.83,99.44
2022-01-19,Goa,685,10,680,8537,3307,963,8.02,0,1.6,606491,5021,603083,206.69,60.19,5.335625,0.83,99.44
2022-01-20,Goa,544,7,538,6861,1474,117,7.93,0,1.6,607035,5028,603621,92.12,7.31,4.288125,0.83,99.44
2022-01-21,Goa,576,7,574,7401,1171,177,7.78,0,1.6,607611,5035,604195,73.19,11.06,4.625625,0.83,99.44
2022-01-22,Goa,218,1,216,2690,4018,1486,8.1,1,1.6,607829,5036,604411,251.12,92.88,1.68125,0.83,99.44
2022-01-23,Goa,41,0,40,617,4537,1948,6.65,1,1.6,607870,5036,604451,283.56,121.75,0.385625,0.83,99.44
2022-01-24,Goa,104,0,97,1354,3618,607,7.68,7,1.6,607974,5036,604548,226.12,37.94,0.84625,0.83,99.44
2022-01-25,Goa,398,1,390,5020,4125,2502,7.93,7,1.6,608372,5037,604938,257.81,156.38,3.1375,0.83,99.44
2022-01-26,Goa,366,4,360,4572,923,293,8.01,2,1.6,608738,5041,605298,57.69,18.31,2.8575,0.83,99.43
2022-01-27,Goa,893,6,889,10774,841,455,8.29,0,1.6,609631,5047,606187,52.56,28.44,6.73375,0.83,99.44
2022-01-28,Goa,1142,16,1133,14351,1758,797,7.96,0,1.6,610773,5063,607320,109.87,49.81,8.969375,0.83,99.43
2022-01-29,Goa,434,3,427,5457,3964,689,7.95,4,1.6,611207,5066,607747,247.75,43.06,3.410625,0.83,99.43
2022-01-30,Goa,1301,6,1298,16444,4509,918,7.91,0,1.6,612508,5072,609045,281.81,57.38,10.2775,0.83,99.43
2022-01-31,Goa,1120,4,1117,13713,897,638,8.17,0,1.6,613628,5076,610162,56.06,39.88,8.570625,0.83,99.44
2022-02-01,Goa,193,1,192,2272,2729,1255,8.49,0,1.6,613821,5077,610354,170.56,78.44,1.42,0.83,99.44
2022-02-02,Goa,33,0,25,634,4833,834,5.21,8,1.6,613854,5077,610379,302.06,52.12,0.39625,0.83,99.43
2022-02-03,Goa,1485,9,1484,18826,845,743,7.89,0,1.6,615339,5086,611863,52.81,46.44,11.76625,0.83,99.44
2022-02-04,Goa,1209,12,1206,15227,3768,253,7.94,0,1.6,616548,5098,613069,235.5,15.81,9.516875,0.83,99.44
2022-02-05,Goa,150,1,145,2047,4482,4139,7.33,4,1.6,616698,5099,613214,280.12,258.69,1.279375,0.83,99.44
2022-02-06,Goa,715,6,707,8487,1773,77,8.42,2,1.6,617413,5105,613921,110.81,4.81,5.304375,0.83,99.43
2022-02-07,Goa,54,0,53,837,4913,2358,6.45,1,1.6,617467,5105,613974,307.06,147.38,0.523125,0.83,99.43
2022-02-08,Goa,1125,9,1124,14242,4167,636,7.9,0,1.6,618592,5114,615098,260.44,39.75,8.90125,0.83,99.44
2022-02-09,Goa,972,3,969,11768,3368,1818,8.26,0,1.6,619564,5117,616067,210.5,113.62,7.355,0.83,99.44
2022-02-10,Goa,113,0,108,1639,3522,387,6.89,5,1.6,619677,5117,616175,220.12,24.19,1.024375,0.83,99.43
2022-02-11,Goa,852,9,851,10529,2884,1113,8.09,0,1.6,620529,5126,617026,180.25,69.56,6.580625,0.83,99.44
2022-02-12,Goa,1378,6,1372,17306,1984,209,7.96,0,1.6,621907,5132,618398,124.0,13.06,10.81625,0.83,99.44
2022-02-13,Goa,444,6,442,5477,187,73,8.11,0,1.6,622351,5138,618840,11.69,4.56,3.423125,0.83,99.44
2022-02-14,Goa,75,1,69,936,1307,666,8.01,5,1.6,622426,5139,618909,81.69,41.62,0.585,0.83,99.43
2022-02-15,Goa,1533,18,1527,19549,1834,869,7.84,0,1.6,623959,5157,620436,114.62,54.31,12.218125,0.83,99.44
2022-02-16,Goa,82,0,73,1187,3266,2506,6.91,9,1.6,624041,5157,620509,204.12,156.62,0.741875,0.83,99.43
2022-02-17,Goa,572,4,565,7283,1970,1700,7.85,3,1.6,624613,5161,621074,123.12,106.25,4.551875,0.83,99.43
2022-02-18,Goa,1113,16,1107,14232,2352,359,7.82,0,1.6,625726,5177,622181,147.0,22.44,8.895,0.83,99.43
2022-02-19,Goa,251,2,251,3129,3273,915,8.02,0,1.6,625977,5179,622432,204.56,57.19,1.955625,0.83,99.43
2022-02-20,Goa,68,0,64,586,2886,1954,11.6,4,1.6,626045,5179,622496,180.38,122.12,0.36625,0.83,99.43
2022-02-21,Goa,1225,13,1224,15400,3070,1365,7.95,0,1.6,627270,5192,623720,191.88,85.31,9.625,0.83,99.43
2022-02-22,Goa,864,7,861,10657,2132,1529,8.11,0,1.6,628134,5199,624581,133.25,95.56,6.660625,0.83,99.43
2022-02-23,Goa,1123,3,1115,14198,4652,4174,7.91,5,1.6,629257,5202,625696,290.75,260.88,8.87375,0.83,99.43
2022-02-24,Goa,1409,17,1408,17344,3421,230,8.12,0,1.6,630666,5219,627104,213.81,14.37,10.84,0.83,99.44
2022-02-25,Goa,1345,12,1343,16719,141,109,8.04,0,1.6,632011,5231,628447,8.81,6.81,10.449375,0.83,99.44
2022-02-26,Goa,784,11,776,9655,3481,227,8.12,0,1.6,632795,5242,629223,217.56,14.19,6.034375,0.83,99.44
2022-02-27,Goa,723,7,718,9364,3524,2476,7.72,0,1.6,633518,5249,629941,220.25,154.75,5.8525,0.83,99.44
2022-02-28,Goa,1092,8,1084,13713,542,192,7.96,0,1.6,634610,5257,631025,33.88,12.0,8.570625,0.83,99.44
2022-03-01,Goa,346,4,341,4413,1152,429,7.84,1,1.6,634956,5261,631366,72.0,26.81,2.758125,0.83,99.43
2022-03-02,Goa,601,1,599,7821,3969,1421,7.68,1,1.6,635557,5262,631965,248.06,88.81,4.888125,0.83,99.43
2022-03-03,Goa,910,5,910,11497,4560,977,7.92,0,1.6,636467,5267,632875,285.0,61.06,7.185625,0.83,99.44
2022-03-04,Goa,1163,3,1155,14438,106,67,8.06,5,1.6,637630,5270,634030,6.62,4.19,9.02375,0.83,99.44
2022-03-05,Goa,1128,6,1122,13895,4541,2716,8.12,0,1.6,638758,5276,635152,283.81,169.75,8.684375,0.83,99.44
2022-03-06,Goa,1166,8,1165,14647,3842,773,7.96,0,1.6,639924,5284,636317,240.12,48.31,9.154375,0.83,99.44
2022-03-07,Goa,622,5,622,7608,553,431,8.18,0,1.6,640546,5289,636939,34.56,26.94,4.755,0.83,99.44
2022-03-08,Goa,1218,4,1218,15601,4813,847,7.81,0,1.6,641764,5293,638157,300.81,52.94,9.750625,0.82,99.44
2022-03-09,Goa,111,0,103,1402,178,99,7.92,8,1.6,641875,5293,638260,11.12,6.19,0.87625,0.82,99.44
2022-03-10,Goa,1137,13,1128,14431,1468,853,7.88,0,1.6,643012,5306,639388,91.75,53.31,9.019375,0.83,99.44
2022-03-11,Goa,681,7,680,8471,1476,966,8.04,0,1.6,643693,5313,640068,92.25,60.38,5.294375,0.83,99.44
2022-03-12,Goa,1483,15,1481,18623,837,312,7.96,0,1.6,645176,5328,641549,52.31,19.5,11.639375,0.83,99.44
2022-03-13,Goa,541,2,538,6904,1052,250,7.84,1,1.6,645717,5330,642087,65.75,15.62,4.315,0.83,99.44
2022-03-14,Goa,479,2,475,6116,1706,1463,7.83,2,1.6,646196,5332,642562,106.62,91.44,3.8225,0.83,99.44
2022-03-15,Goa,1363,5,1362,16906,2517,2425,8.06,0,1.6,647559,5337,643924,157.31,151.56,10.56625,0.82,99.44
2022-03-16,Goa,735,3,733,9179,3811,2985,8.01,0,1.6,648294,5340,644657,238.19,186.56,5.736875,0.82,99.44
2022-03-17,Goa,969,8,961,12365,3354,1023,7.84,0,1.6,649263,5348,645618,209.62,63.94,7.728125,0.82,99.44
2022-03-18,Goa,242,1,235,2678,2840,502,9.04,6,1.6,649505,5349,645853,177.5,31.37,1.67375,0.82,99.44
2022-03-19,Goa,1399,11,1394,17449,3468,584,8.02,0,1.6,650904,5360,647247,216.75,36.5,10.905625,0.82,99.44
2022-03-20,Goa,1227,9,1227,15077,1427,1262,8.14,0,1.6,652131,5369,648474,89.19,78.88,9.423125,0.82,99.44
2022-03-21,Goa,190,0,181,2368,3002,2877,8.02,9,1.6,652321,5369,648655,187.62,179.81,1.48,0.82,99.44
2022-03-22,Goa,472,1,470,6247,416,312,7.56,1,1.6,652793,5370,649125,26.0,19.5,3.904375,0.82,99.44
2022-03-23,Goa,1385,18,1376,17506,1950,154,7.91,0,1.6,654178,5388,650501,121.88,9.62,10.94125,0.82,99.44
2022-03-24,Goa,382,1,375,4408,310,180,8.67,6,1.6,654560,5389,650876,19.38,11.25,2.755,0.82,99.44
2022-03-25,Goa,492,6,483,6378,1907,142,7.71,3,1.6,655052,5395,651359,119.19,8.88,3.98625,0.82,99.44
2022-03-26,Goa,979,4,977,12050,4583,1987,8.12,0,1.6,656031,5399,652336,286.44,124.19,7.53125,0.82,99.44
2022-03-27,Goa,1531,16,1525,18831,3117,1150,8.13,0,1.6,657562,5415,653861,194.81,71.88,11.769375,0.82,99.44
2022-03-28,Goa,1212,3,1203,15320,2489,1152,7.91,6,1.6,658774,5418,655064,155.56,72.0,9.575,0.82,99.44
2022-03-29,Goa,901,11,901,11304,178,88,7.97,0,1.6,659675,5429,655965,11.12,5.5,7.065,0.82,99.44
2022-03-30,Goa,797,8,788,9562,2245,835,8.34,1,1.6,660472,5437,656753,140.31,52.19,5.97625,0.82,99.44
2022-03-31,Goa,1547,16,1540,19397,2794,174,7.98,0,1.6,662019,5453,658293,174.62,10.88,12.123125,0.82,99.44
2022-04-01,Goa,1405,13,1403,17901,260,135,7.85,0,1.6,663424,5466,659696,16.25,8.44,11.188125,0.82,99.44
2022-04-02,Goa,1002,8,1002,12267,3880,1236,8.17,0,1.6,664426,5474,660698,242.5,77.25,7.666875,0.82,99.44
2022-04-03,Goa,76,0,73,1021,1805,1301,7.44,3,1.6,664502,5474,660771,112.81,81.31,0.638125,0.82,99.44
2022-04-04,Goa,307,2,306,3968,1480,313,7.74,0,1.6,664809,5476,661077,92.5,19.56,2.48,0.82,99.44
2022-04-05,Goa,1340,15,1333,16690,3419,2234,8.03,0,1.6,666149,5491,662410,213.69,139.62,10.43125,0.82,99.44
2022-04-06,Goa,986,13,980,12837,4519,3479,7.68,0,1.6,667135,5504,663390,282.44,217.44,8.023125,0.83,99.44
2022-04-07,Goa,1344,5,1342,16867,2706,2350,7.97,0,1.6,668479,5509,664732,169.12,146.88,10.541875,0.82,99.44
2022-04-08,Goa,1246,18,1240,15659,1822,1084,7.96,0,1.6,669725,5527,665972,113.88,67.75,9.786875,0.83,99.44
2022-04-09,Goa,700,4,696,8664,4463,1833,8.08,0,1.6,670425,5531,666668,278.94,114.56,5.415,0.82,99.44
2022-04-10,Goa,1140,16,1140,14380,2060,1459,7.93,0,1.6,671565,5547,667808,128.75,91.19,8.9875,0.83,99.44
2022-04-11,Goa,1452,17,1444,18361,968,873,7.91,0,1.6,673017,5564,669252,60.5,54.56,11.475625,0.83,99.44
2022-04-12,Goa,1321,17,1314,16354,2958,2426,8.08,0,1.6,674338,5581,670566,184.88,151.62,10.22125,0.83,99.44
2022-04-13,Goa,455,4,451,5548,3827,1774,8.2,0,1.6,674793,5585,671017,239.19,110.87,3.4675,0.83,99.44
2022-04-14,Goa,712,3,709,8915,959,753,7.99,0,1.6,675505,5588,671726,59.94,47.06,5.571875,0.83,99.44
2022-04-15,Goa,912,9,905,11210,4004,1543,8.14,0,1.6,676417,5597,672631,250.25,96.44,7.00625,0.83,99.44
2022-04-16,Goa,588,2,584,7453,1642,135,7.89,2,1.6,677005,5599,673215,102.63,8.44,4.658125,0.83,99.44
2022-04-17,Goa,770,9,766,9396,3726,2643,8.19,0,1.6,677775,5608,673981,232.88,165.19,5.8725,0.83,99.44
2022-04-18,Goa,109,0,108,1397,2006,12,7.8,1,1.6,677884,5608,674089,125.37,0.75,0.873125,0.83,99.44
2022-04-19,Goa,1385,7,1379,17628,4440,402,7.86,0,1.6,679269,5615,675468,277.5,25.12,11.0175,0.83,99.44
2022-04-20,Goa,70,1,62,952,1213,604,7.35,7,1.6,679339,5616,675530,75.81,37.75,0.595,0.83,99.44
2022-04-21,Goa,1448,7,1444,18120,840,1,7.99,0,1.6,680787,5623,676974,52.5,0.06,11.325,0.83,99.44
2022-04-22,Goa,1314,15,1313,16622,1489,1000,7.91,0,1.6,682101,5638,678287,93.06,62.5,10.38875,0.83,99.44
2022-04-23,Goa,1329,7,1327,17098,4463,2972,7.77,0,1.6,683430,5645,679614,278.94,185.75,10.68625,0.83,99.44
2022-04-24,Goa,404,5,403,5392,3399,2964,7.49,0,1.6,683834,5650,680017,212.44,185.25,3.37,0.83,99.44
2022-04-25,Goa,750,4,746,9656,690,532,7.77,0,1.6,684584,5654,680763,43.12,33.25,6.035,0.83,99.44
2022-04-26,Goa,375,1,369,4479,4745,500,8.37,5,1.6,684959,5655,681132,296.56,31.25,2.799375,0.83,99.44
2022-04-27,Goa,867,7,866,10956,1559,116,7.91,0,1.6,685826,5662,681998,97.44,7.25,6.8475,0.83,99.44
2022-04-28,Goa,1398,14,1390,17414,2652,1043,8.03,0,1.6,687224,5676,683388,165.75,65.19,10.88375,0.83,99.44
2022-04-29,Goa,1284,17,1275,16270,3256,177,7.89,0,1.6,688508,5693,684663,203.5,11.06,10.16875,0.83,99.44
2022-04-30,Goa,578,3,574,7476,3477,921,7.73,1,1.6,689086,5696,685237,217.31,57.56,4.6725,0.83,99.44
2022-05-01,Goa,172,1,171,2380,4242,1220,7.23,0,1.6,689258,5697,685408,265.12,76.25,1.4875,0.83,99.44
2022-05-02,Goa,118,1,114,1152,1096,850,10.24,3,1.6,689376,5698,685522,68.5,53.12,0.72,0.83,99.44
2022-05-03,Goa,848,3,846,10520,2830,684,8.06,0,1.6,690224,5701,686368,176.88,42.75,6.575,0.83,99.44
2022-05-04,Goa,1021,14,1015,12670,2364,949,8.06,0,1.6,691245,5715,687383,147.75,59.31,7.91875,0.83,99.44
2022-05-05,Goa,1576,7,1572,19595,1667,1237,8.04,0,1.6,692821,5722,688955,104.19,77.31,12.246875,0.83,99.44
2022-05-06,Goa,1055,14,1053,13018,157,119,8.1,0,1.6,693876,5736,690008,9.81,7.44,8.13625,0.83,99.44
2022-05-07,Goa,1281,13,1280,16220,3123,2975,7.9,0,1.6,695157,5749,691288,195.19,185.94,10.1375,0.83,99.44
2022-05-08,Goa,338,1,330,3934,2259,1903,8.59,7,1.6,695495,5750,691618,141.19,118.94,2.45875,0.83,99.44
2022-05-09,Goa,215,1,210,2566,2960,1704,8.38,4,1.6,695710,5751,691828,185.0,106.5,1.60375,0.83,99.44
2022-05-10,Goa,917,11,913,11353,4808,3381,8.08,0,1.6,696627,5762,692741,300.5,211.31,7.095625,0.83,99.44
2022-05-11,Goa,416,3,411,5139,4281,1964,8.09,2,1.6,697043,5765,693152,267.56,122.75,3.211875,0.83,99.44
2022-05-12,Goa,637,2,628,7721,2128,1823,8.25,7,1.6,697680,5767,693780,133.0,113.94,4.825625,0.83,99.44
2022-05-13,Goa,571,5,571,7017,3070,545,8.14,0,1.6,698251,5772,694351,191.88,34.06,4.385625,0.83,99.44
2022-05-14,Goa,1451,19,1445,17903,4619,3928,8.1,0,1.6,699702,5791,695796,288.69,245.5,11.189375,0.83,99.44
2022-05-15,Goa,609,5,605,7330,2424,982,8.31,0,1.6,700311,5796,696401,151.5,61.38,4.58125,0.83,99.44
2022-05-16,Goa,537,7,535,6752,3256,2717,7.95,0,1.6,700848,5803,696936,203.5,169.81,4.22,0.83,99.44
2022-05-17,Goa,1513,19,1510,19018,4915,3521,7.96,0,1.6,702361,5822,698446,307.19,220.06,11.88625,0.83,99.44
2022-05-18,Goa,81,0,78,1078,1333,1325,7.51,3,1.6,702442,5822,698524,83.31,82.81,0.67375,0.83,99.44
2022-05-19,Goa,1378,15,1376,17711,129,100,7.78,0,1.6,703820,5837,699900,8.06,6.25,11.069375,0.83,99.44
2022-05-20,Goa,1044,12,1044,13206,1055,669,7.91,0,1.6,704864,5849,700944,65.94,41.81,8.25375,0.83,99.44
2022-05-21,Goa,925,9,921,11014,4127,3193,8.4,0,1.6,705789,5858,701865,257.94,199.56,6.88375,0.83,99.44
2022-05-22,Goa,17,0,16,612,3952,2740,2.78,1,1.6,705806,5858,701881,247.0,171.25,0.3825,0.83,99.44
2022-05-23,Goa,1498,17,1489,18734,2187,1240,8.0,0,1.6,707304,5875,703370,136.69,77.5,11.70875,0.83,99.44
2022-05-24,Goa,1287,11,1287,16108,4568,1044,7.99,0,1.6,708591,5886,704657,285.5,65.25,10.0675,0.83,99.44
2022-05-25,Goa,668,5,659,8775,1682,717,7.61,4,1.6,709259,5891,705316,105.12,44.81,5.484375,0.83,99.44
2022-05-26,Goa,1398,12,1398,17720,1872,1649,7.89,0,1.6,710657,5903,706714,117.0,103.06,11.075,0.83,99.45
2022-05-27,Goa,112,0,108,1691,2519,1133,6.62,4,1.6,710769,5903,706822,157.44,70.81,1.056875,0.83,99.44
2022-05-28,Goa,460,3,454,5283,474,148,8.71,3,1.6,711229,5906,707276,29.62,9.25,3.301875,0.83,99.44
2022-05-29,Goa,759,11,757,9125,3146,974,8.32,0,1.6,711988,5917,708033,196.62,60.88,5.703125,0.83,99.44
2022-05-30,Goa,1362,9,1358,17085,2369,1029,7.97,0,1.6,713350,5926,709391,148.06,64.31,10.678125,0.83,99.45
2022-05-31,Goa,969,13,965,12003,1784,157,8.07,0,1.6,714319,5939,710356,111.5,9.81,7.501875,0.83,99.45
2022-06-01,Goa,1098,7,1097,13582,4638,1555,8.08,0,1.6,715417,5946,711453,289.88,97.19,8.48875,0.83,99.45
2022-06-02,Goa,180,0,179,2352,3958,2522,7.65,1,1.6,715597,5946,711632,247.38,157.62,1.47,0.83,99.45
2022-06-03,Goa,1291,9,1287,16069,1615,338,8.03,0,1.6,716888,5955,712919,100.94,21.12,10.043125,0.83,99.45
2022-06-04,Goa,975,5,975,12347,2612,720,7.9,0,1.6,717863,5960,713894,163.25,45.0,7.716875,0.83,99.45
2022-06-05,Goa,786,8,779,10058,2931,1314,7.81,0,1.6,718649,5968,714673,183.19,82.12,6.28625,0.83,99.45
2022-06-06,Goa,1535,18,1530,19393,3856,1006,7.92,0,1.6,720184,5986,716203,241.0,62.88,12.120625,0.83,99.45
2022-06-07,Goa,1374,20,1368,16927,3452,2623,8.12,0,1.6,721558,6006,717571,215.75,163.94,10.579375,0.83,99.45
2022-06-08,Goa,955,13,950,11802,2437,2081,8.09,0,1.6,722513,6019,718521,152.31,130.06,7.37625,0.83,99.45
2022-06-09,Goa,276,3,276,2879,1787,538,9.59,0,1.6,722789,6022,718797,111.69,33.62,1.799375,0.83,99.45
2022-06-10,Goa,1055,4,1048,13132,169,154,8.03,3,1.6,723844,6026,719845,10.56,9.62,8.2075,0.83,99.45
2022-06-11,Goa,340,3,333,3818,2498,683,8.91,4,1.6,724184,6029,720178,156.12,42.69,2.38625,0.83,99.45
2022-06-12,Goa,764,10,763,9267,4398,2448,8.24,0,1.6,724948,6039,720941,274.88,153.0,5.791875,0.83,99.45
2022-06-13,Goa,286,2,283,3647,1627,260,7.84,1,1.6,725234,6041,721224,101.69,16.25,2.279375,0.83,99.45
2022-06-14,Goa,885,5,876,10974,155,155,8.06,4,1.6,726119,6046,722100,9.69,9.69,6.85875,0.83,99.45
2022-06-15,Goa,849,7,842,10500,3337,1589,8.09,0,1.6,726968,6053,722942,208.56,99.31,6.5625,0.83,99.45
2022-06-16,Goa,369,5,366,4144,4778,2971,8.9,0,1.6,727337,6058,723308,298.62,185.69,2.59,0.83,99.45
2022-06-17,Goa,64,0,59,803,1860,993,7.97,5,1.6,727401,6058,723367,116.25,62.06,0.501875,0.83,99.45
2022-06-18,Goa,1564,17,1560,19761,2417,845,7.91,0,1.6,728965,6075,724927,151.06,52.81,12.350625,0.83,99.45
2022-06-19,Goa,1288,18,1283,16301,4028,2524,7.9,0,1.6,730253,6093,726210,251.75,157.75,10.188125,0.83,99.45
2022-06-20,Goa,919,12,918,11351,1569,376,8.1,0,1.6,731172,6105,727128,98.06,23.5,7.094375,0.83,99.45
2022-06-21,Goa,1474,8,1473,17993,2795,1773,8.19,0,1.6,732646,6113,728601,174.69,110.81,11.245625,0.83,99.45
2022-06-22,Goa,1524,8,1524,19193,1105,710,7.94,0,1.6,734170,6121,730125,69.06,44.38,11.995625,0.83,99.45
2022-06-23,Goa,485,6,479,5859,2018,1117,8.28,0,1.6,734655,6127,730604,126.12,69.81,3.661875,0.83,99.45
2022-06-24,Goa,969,9,967,12475,4837,1194,7.77,0,1.6,735624,6136,731571,302.31,74.62,7.796875,0.83,99.45
2022-06-25,Goa,563,7,561,6888,3831,776,8.17,0,1.6,736187,6143,732132,239.44,48.5,4.305,0.83,99.45
2022-06-26,Goa,214,2,208,2429,206,91,8.81,4,1.6,736401,6145,732340,12.88,5.69,1.518125,0.83,99.45
2022-06-27,Goa,916,10,913,11482,3978,2079,7.98,0,1.6,737317,6155,733253,248.62,129.94,7.17625,0.83,99.45
2022-06-28,Goa,1573,16,1570,19812,3459,1234,7.94,0,1.6,738890,6171,734823,216.19,77.12,12.3825,0.84,99.45
2022-06-29,Goa,926,4,918,11711,1431,703,7.91,4,1.6,739816,6175,735741,89.44,43.94,7.319375,0.83,99.45
2022-06-30,Goa,987,11,978,11991,233,111,8.23,0,1.6,740803,6186,736719,14.56,6.94,7.494375,0.84,99.45
2022-07-01,Goa,1421,16,1412,17951,4763,3392,7.92,0,1.6,742224,6202,738131,297.69,212.0,11.219375,0.84,99.45
2022-07-02,Goa,57,0,53,635,94,69,8.98,4,1.6,742281,6202,738184,5.88,4.31,0.396875,0.84,99.45
2022-07-03,Goa,85,1,85,1240,4287,2779,6.85,0,1.6,742366,6203,738269,267.94,173.69,0.775,0.84,99.45
2022-07-04,Goa,238,1,237,3048,3680,1691,7.81,0,1.6,742604,6204,738506,230.0,105.69,1.905,0.84,99.45
2022-07-05,Goa,1187,7,1187,14826,4405,94,8.01,0,1.6,743791,6211,739693,275.31,5.88,9.26625,0.84,99.45
2022-07-06,Goa,1474,19,1470,18324,4393,2446,8.04,0,1.6,745265,6230,741163,274.56,152.88,11.4525,0.84,99.45
2022-07-07,Goa,1085,7,1084,13248,1981,1804,8.19,0,1.6,746350,6237,742247,123.81,112.75,8.28,0.84,99.45
2022-07-08,Goa,587,8,579,7213,2830,2796,8.14,0,1.6,746937,6245,742826,176.88,174.75,4.508125,0.84,99.45
2022-07-09,Goa,315,3,315,3880,557,370,8.12,0,1.6,747252,6248,743141,34.81,23.12,2.425,0.84,99.45
2022-07-10,Goa,723,7,719,8697,1839,1138,8.31,0,1.6,747975,6255,743860,114.94,71.12,5.435625,0.84,99.45
2022-07-11,Goa,242,2,235,2834,2019,53,8.54,5,1.6,748217,6257,744095,126.19,3.31,1.77125,0.84,99.45
2022-07-12,Goa,519,3,513,6633,2915,2036,7.82,3,1.6,748736,6260,744608,182.19,127.25,4.145625,0.84,99.45
2022-07-13,Goa,824,11,817,10109,3555,2134,8.15,0,1.6,749560,6271,745425,222.19,133.38,6.318125,0.84,99.45
2022-07-14,Goa,1241,4,1233,15204,3101,2536,8.16,4,1.6,750801,6275,746658,193.81,158.5,9.5025,0.84,99.45
2022-07-15,Goa,337,1,329,4287,1363,115,7.86,7,1.6,751138,6276,746987,85.19,7.19,2.679375,0.84,99.45
2022-07-16,Goa,955,6,947,12245,1916,1175,7.8,2,1.6,752093,6282,747934,119.75,73.44,7.653125,0.84,99.45
2022-07-17,Goa,868,3,867,10781,2438,301,8.05,0,1.6,752961,6285,748801,152.38,18.81,6.738125,0.83,99.45
2022-07-18,Goa,829,10,829,10545,1420,1403,7.86,0,1.6,753790,6295,749630,88.75,87.69,6.590625,0.84,99.45
2022-07-19,Goa,814,9,814,10281,4984,4924,7.92,0,1.6,754604,6304,750444,311.5,307.75,6.425625,0.84,99.45
2022-07-20,Goa,1474,19,1468,18826,2477,1845,7.83,0,1.6,756078,6323,751912,154.81,115.31,11.76625,0.84,99.45
2022-07-21,Goa,1479,7,1470,18632,1866,1563,7.94,2,1.6,757557,6330,753382,116.62,97.69,11.645,0.84,99.45
2022-07-22,Goa,1247,10,1242,15281,401,384,8.16,0,1.6,758804,6340,754624,25.06,24.0,9.550625,0.84,99.45
2022-07-23,Goa,119,1,112,1310,2696,2636,9.08,6,1.6,758923,6341,754736,168.5,164.75,0.81875,0.84,99.45
2022-07-24,Goa,61,0,54,526,2572,676,11.6,7,1.6,758984,6341,754790,160.75,42.25,0.32875,0.84,99.45
2022-07-25,Goa,818,8,812,9786,2928,1312,8.36,0,1.6,759802,6349,755602,183.0,82.0,6.11625,0.84,99.45
2022-07-26,Goa,1572,16,1565,19320,1244,83,8.14,0,1.6,761374,6365,757167,77.75,5.19,12.075,0.84,99.45
2022-07-27,Goa,47,0,44,852,3203,2795,5.52,3,1.6,761421,6365,757211,200.19,174.69,0.5325,0.84,99.45
2022-07-28,Goa,1175,15,1169,14610,2265,875,8.04,0,1.6,762596,6380,758380,141.56,54.69,9.13125,0.84,99.45
2022-07-29,Goa,512,7,507,6483,966,880,7.9,0,1.6,763108,6387,758887,60.38,55.0,4.051875,0.84,99.45
2022-07-30,Goa,224,2,224,2217,4962,4292,10.1,0,1.6,763332,6389,759111,310.12,268.25,1.385625,0.84,99.45
2022-07-31,Goa,662,4,656,8545,1073,596,7.75,2,1.6,763994,6393,759767,67.06,37.25,5.340625,0.84,99.45
2022-08-01,Goa,326,1,324,4160,3270,1192,7.84,1,1.6,764320,6394,760091,204.38,74.5,2.6,0.84,99.45
2022-08-02,Goa,464,6,461,5777,3952,1610,8.03,0,1.6,764784,6400,760552,247.0,100.63,3.610625,0.84,99.45
2022-08-03,Goa,139,1,139,2066,3612,894,6.73,0,1.6,764923,6401,760691,225.75,55.88,1.29125,0.84,99.45
2022-08-04,Goa,273,2,270,3218,3786,3652,8.48,1,1.6,765196,6403,760961,236.62,228.25,2.01125,0.84,99.45
2022-08-05,Goa,286,1,286,3340,4653,4186,8.56,0,1.6,765482,6404,761247,290.81,261.62,2.0875,0.84,99.45
2022-08-06,Goa,750,2,744,9640,4644,480,7.78,4,1.6,766232,6406,761991,290.25,30.0,6.025,0.84,99.45
2022-08-07,Goa,954,8,953,11623,1538,747,8.21,0,1.6,767186,6414,762944,96.12,46.69,7.264375,0.84,99.45
2022-08-08,Goa,173,0,164,2018,3113,1158,8.57,9,1.6,767359,6414,763108,194.56,72.38,1.26125,0.84,99.45
2022-08-09,Goa,1328,4,1328,17200,4676,1554,7.72,0,1.6,768687,6418,764436,292.25,97.12,10.75,0.83,99.45
2022-08-10,Goa,1497,11,1491,18163,363,264,8.24,0,1.6,770184,6429,765927,22.69,16.5,11.351875,0.83,99.45
2022-08-11,Goa,1368,6,1359,17462,2841,755,7.83,3,1.6,771552,6435,767286,177.56,47.19,10.91375,0.83,99.45
2022-08-12,Goa,1329,18,1326,16485,4194,4116,8.06,0,1.6,772881,6453,768612,262.12,257.25,10.303125,0.83,99.45
2022-08-13,Goa,689,2,685,8380,1548,86,8.22,2,1.6,773570,6455,769297,96.75,5.38,5.2375,0.83,99.45
2022-08-14,Goa,939,4,934,11689,2719,1326,8.03,1,1.6,774509,6459,770231,169.94,82.88,7.305625,0.83,99.45
2022-08-15,Goa,1360,7,1359,17322,10,0,7.85,0,1.6,775869,6466,771590,0.62,0.0,10.82625,0.83,99.45
2022-08-16,Goa,1225,3,1222,15375,734,407,7.97,0,1.6,777094,6469,772812,45.88,25.44,9.609375,0.83,99.45
2022-08-17,Goa,704,2,698,8973,4805,2050,7.85,4,1.6,777798,6471,773510,300.31,128.12,5.608125,0.83,99.45
2022-08-18,Goa,40,0,36,1030,536,323,3.88,4,1.6,777838,6471,773546,33.5,20.19,0.64375,0.83,99.45
2022-08-19,Goa,1499,12,1498,18464,1716,805,8.12,0,1.6,779337,6483,775044,107.25,50.31,11.54,0.83,99.45
2022-08-20,Goa,66,0,65,954,3194,2276,6.92,1,1.6,779403,6483,775109,199.62,142.25,0.59625,0.83,99.45
2022-08-21,Goa,261,2,254,3453,3160,528,7.56,5,1.6,779664,6485,775363,197.5,33.0,2.158125,0.83,99.45
2022-08-22,Goa,1043,10,1042,12859,74,15,8.11,0,1.6,780707,6495,776405,4.62,0.94,8.036875,0.83,99.45
2022-08-23,Goa,1131,10,1130,14101,4424,2189,8.02,0,1.6,781838,6505,777535,276.5,136.81,8.813125,0.83,99.45
2022-08-24,Goa,1245,3,1239,15623,2147,1830,7.97,3,1.6,783083,6508,778774,134.19,114.38,9.764375,0.83,99.45
2022-08-25,Goa,352,2,352,4510,4188,56,7.8,0,1.6,783435,6510,779126,261.75,3.5,2.81875,0.83,99.45
2022-08-26,Goa,921,6,914,11347,3367,1282,8.12,1,1.6,784356,6516,780040,210.44,80.12,7.091875,0.83,99.45
2022-08-27,Goa,1333,7,1328,16998,4416,1421,7.84,0,1.6,785689,6523,781368,276.0,88.81,10.62375,0.83,99.45
2022-08-28,Goa,115,1,112,1611,1231,389,7.14,2,1.6,785804,6524,781480,76.94,24.31,1.006875,0.83,99.45
2022-08-29,Goa,587,5,585,7616,4468,3907,7.71,0,1.6,786391,6529,782065,279.25,244.19,4.76,0.83,99.45
2022-08-30,Goa,894,9,894,11291,3546,599,7.92,0,1.6,787285,6538,782959,221.62,37.44,7.056875,0.83,99.45
2022-08-31,Goa,779,5,771,10052,1870,1758,7.75,3,1.6,788064,6543,783730,116.88,109.87,6.2825,0.83,99.45
2022-09-01,Goa,146,0,137,1545,4649,3549,9.45,9,1.6,788210,6543,783867,290.56,221.81,0.965625,0.83,99.45
2022-09-02,Goa,537,4,534,6703,3554,2015,8.01,0,1.6,788747,6547,784401,222.12,125.94,4.189375,0.83,99.45
2022-09-03,Goa,72,1,64,1421,1414,696,5.07,7,1.6,788819,6548,784465,88.38,43.5,0.888125,0.83,99.45
2022-09-04,Goa,1084,8,1076,13688,533,79,7.92,0,1.6,789903,6556,785541,33.31,4.94,8.555,0.83,99.45
2022-09-05,Goa,1490,5,1482,18740,3612,83,7.95,3,1.6,791393,6561,787023,225.75,5.19,11.7125,0.83,99.45
2022-09-06,Goa,486,6,483,6070,2088,1775,8.01,0,1.6,791879,6567,787506,130.5,110.94,3.79375,0.83,99.45
2022-09-07,Goa,421,4,419,4883,1688,781,8.62,0,1.6,792300,6571,787925,105.5,48.81,3.051875,0.83,99.45
2022-09-08,Goa,541,4,537,6480,3655,2729,8.35,0,1.6,792841,6575,788462,228.44,170.56,4.05,0.83,99.45
2022-09-09,Goa,1212,14,1210,15011,1234,73,8.07,0,1.6,794053,6589,789672,77.12,4.56,9.381875,0.83,99.45
2022-09-10,Goa,767,10,761,9790,2535,1154,7.83,0,1.6,794820,6599,790433,158.44,72.12,6.11875,0.83,99.45
2022-09-11,Goa,1088,13,1079,13896,125,37,7.83,0,1.6,795908,6612,791512,7.81,2.31,8.685,0.83,99.45
2022-09-12,Goa,1190,6,1188,14845,721,614,8.02,0,1.6,797098,6618,792700,45.06,38.38,9.278125,0.83,99.45
2022-09-13,Goa,1150,9,1149,14417,4291,109,7.98,0,1.6,798248,6627,793849,268.19,6.81,9.010625,0.83,99.45
2022-09-14,Goa,1250,18,1250,15645,3241,1532,7.99,0,1.6,799498,6645,795099,202.56,95.75,9.778125,0.83,99.45
2022-09-15,Goa,59,0,55,820,1842,311,7.2,4,1.6,799557,6645,795154,115.13,19.44,0.5125,0.83,99.45
2022-09-16,Goa,1502,17,1499,18588,2492,1441,8.08,0,1.6,801059,6662,796653,155.75,90.06,11.6175,0.83,99.45
2022-09-17,Goa,755,7,750,9650,3986,2278,7.82,0,1.6,801814,6669,797403,249.12,142.38,6.03125,0.83,99.45
2022-09-18,Goa,994,8,993,12374,4885,74,8.03,0,1.6,802808,6677,798396,305.31,4.62,7.73375,0.83,99.45
2022-09-19,Goa,296,1,289,3744,2328,937,7.91,6,1.6,803104,6678,798685,145.5,58.56,2.34,0.83,99.45
2022-09-20,Goa,994,4,985,12391,3936,1032,8.02,5,1.6,804098,6682,799670,246.0,64.5,7.744375,0.83,99.45
2022-09-21,Goa,341,4,341,4244,418,27,8.03,0,1.6,804439,6686,800011,26.12,1.69,2.6525,0.83,99.45
2022-09-22,Goa,338,1,337,3976,2944,2766,8.5,0,1.6,804777,6687,800348,184.0,172.88,2.485,0.83,99.45
2022-09-23,Goa,131,0,127,2122,243,153,6.17,4,1.6,804908,6687,800475,15.19,9.56,1.32625,0.83,99.45
2022-09-24,Goa,1479,9,1477,18789,1072,31,7.87,0,1.6,806387,6696,801952,67.0,1.94,11.743125,0.83,99.45
2022-09-25,Goa,593,5,586,7949,3799,1583,7.46,2,1.6,806980,6701,802538,237.44,98.94,4.968125,0.83,99.45
2022-09-26,Goa,921,6,917,11620,3516,2263,7.93,0,1.6,807901,6707,803455,219.75,141.44,7.2625,0.83,99.45
2022-09-27,Goa,217,1,217,2748,3758,166,7.9,0,1.6,808118,6708,803672,234.88,10.38,1.7175,0.83,99.45
2022-09-28,Goa,223,2,216,2790,357,137,7.99,5,1.6,808341,6710,803888,22.31,8.56,1.74375,0.83,99.45
2022-09-29,Goa,995,14,989,12386,3937,3038,8.03,0,1.6,809336,6724,804877,246.06,189.88,7.74125,0.83,99.45
2022-09-30,Goa,965,6,963,11825,2734,1247,8.16,0,1.6,810301,6730,805840,170.88,77.94,7.390625,0.83,99.45
2022-10-01,Goa,1408,19,1404,17534,169,131,8.03,0,1.6,811709,6749,807244,10.56,8.19,10.95875,0.83,99.45
2022-10-02,Goa,1443,8,1435,18099,2311,1710,7.97,0,1.6,813152,6757,808679,144.44,106.88,11.311875,0.83,99.45
2022-10-03,Goa,823,7,819,10054,2924,1861,8.19,0,1.6,813975,6764,809498,182.75,116.31,6.28375,0.83,99.45
2022-10-04,Goa,855,10,846,10434,2317,1995,8.19,0,1.6,814830,6774,810344,144.81,124.69,6.52125,0.83,99.45
2022-10-05,Goa,1501,7,1494,18449,3807,1105,8.14,0,1.6,816331,6781,811838,237.94,69.06,11.530625,0.83,99.45
2022-10-06,Goa,1645,5,1644,19990,933,516,8.23,0,1.6,817976,6786,813482,58.31,32.25,12.49375,0.83,99.45
2022-10-07,Goa,639,7,636,8345,4538,1211,7.66,0,1.6,818615,6793,814118,283.62,75.69,5.215625,0.83,99.45
2022-10-08,Goa,849,6,840,10150,1571,746,8.36,3,1.6,819464,6799,814958,98.19,46.62,6.34375,0.83,99.45
2022-10-09,Goa,926,13,923,11509,421,272,8.05,0,1.6,820390,6812,815881,26.31,17.0,7.193125,0.83,99.45
2022-10-10,Goa,1443,17,1434,17945,3136,2339,8.04,0,1.6,821833,6829,817315,196.0,146.19,11.215625,0.83,99.45
2022-10-11,Goa,1367,6,1358,17348,1863,1659,7.88,3,1.6,823200,6835,818673,116.44,103.69,10.8425,0.83,99.45
2022-10-12,Goa,388,1,381,4614,1460,481,8.41,6,1.6,823588,6836,819054,91.25,30.06,2.88375,0.83,99.45
2022-10-13,Goa,721,4,720,9138,3417,3257,7.89,0,1.6,824309,6840,819774,213.56,203.56,5.71125,0.83,99.45
2022-10-14,Goa,1152,5,1145,13920,4636,3396,8.28,2,1.6,825461,6845,820919,289.75,212.25,8.7,0.83,99.45
2022-10-15,Goa,651,7,643,8095,956,530,8.04,1,1.6,826112,6852,821562,59.75,33.12,5.059375,0.83,99.45
2022-10-16,Goa,851,8,848,10458,291,43,8.14,0,1.6,826963,6860,822410,18.19,2.69,6.53625,0.83,99.45
2022-10-17,Goa,763,3,759,9664,575,355,7.9,1,1.6,827726,6863,823169,35.94,22.19,6.04,0.83,99.45
2022-10-18,Goa,304,3,301,3583,2492,240,8.48,0,1.6,828030,6866,823470,155.75,15.0,2.239375,0.83,99.45
2022-10-19,Goa,1195,6,1195,14882,981,92,8.03,0,1.6,829225,6872,824665,61.31,5.75,9.30125,0.83,99.45
2022-10-20,Goa,308,1,304,3331,217,165,9.25,3,1.6,829533,6873,824969,13.56,10.31,2.081875,0.83,99.45
2022-10-21,Goa,569,3,562,7105,394,146,8.01,4,1.6,830102,6876,825531,24.62,9.12,4.440625,0.83,99.45
2022-10-22,Goa,201,2,192,2226,4697,2654,9.03,7,1.6,830303,6878,825723,293.56,165.88,1.39125,0.83,99.45
2022-10-23,Goa,169,2,169,1764,1184,775,9.58,0,1.6,830472,6880,825892,74.0,48.44,1.1025,0.83,99.45
2022-10-24,Goa,1172,13,1166,14925,1542,978,7.85,0,1.6,831644,6893,827058,96.38,61.12,9.328125,0.83,99.45
2022-10-25,Goa,1122,11,1113,13674,1345,957,8.21,0,1.6,832766,6904,828171,84.06,59.81,8.54625,0.83,99.45
2022-10-26,Goa,1595,13,1588,19934,2494,1399,8.0,0,1.6,834361,6917,829759,155.88,87.44,12.45875,0.83,99.45
2022-10-27,Goa,192,2,183,2662,3114,1774,7.21,7,1.6,834553,6919,829942,194.62,110.87,1.66375,0.83,99.45
2022-10-28,Goa,340,4,340,4258,897,297,7.98,0,1.6,834893,6923,830282,56.06,18.56,2.66125,0.83,99.45
2022-10-29,Goa,373,3,372,4956,2885,883,7.53,0,1.6,835266,6926,830654,180.31,55.19,3.0975,0.83,99.45
2022-10-30,Goa,163,2,155,2096,3636,319,7.78,6,1.6,835429,6928,830809,227.25,19.94,1.31,0.83,99.45
2022-10-31,Goa,626,7,620,7702,1280,190,8.13,0,1.6,836055,6935,831429,80.0,11.88,4.81375,0.83,99.45
2022-11-01,Goa,1194,10,1188,15032,245,232,7.94,0,1.6,837249,6945,832617,15.31,14.5,9.395,0.83,99.45
2022-11-02,Goa,667,9,663,8670,495,337,7.69,0,1.6,837916,6954,833280,30.94,21.06,5.41875,0.83,99.45
2022-11-03,Goa,929,13,929,11296,3986,3948,8.22,0,1.6,838845,6967,834209,249.12,246.75,7.06,0.83,99.45
2022-11-04,Goa,1533,9,1532,18882,3521,1176,8.12,0,1.6,840378,6976,835741,220.06,73.5,11.80125,0.83,99.45
2022-11-05,Goa,557,4,554,6860,1519,1092,8.12,0,1.6,840935,6980,836295,94.94,68.25,4.2875,0.83,99.45
2022-11-06,Goa,1232,10,1232,15263,1257,483,8.07,0,1.6,842167,6990,837527,78.56,30.19,9.539375,0.83,99.45
2022-11-07,Goa,1221,6,1213,15370,2952,2510,7.94,2,1.6,843388,6996,838740,184.5,156.88,9.60625,0.83,99.45
2022-11-08,Goa,867,6,865,10710,2780,1381,8.1,0,1.6,844255,7002,839605,173.75,86.31,6.69375,0.83,99.45
2022-11-09,Goa,1230,11,1224,15215,88,13,8.08,0,1.6,845485,7013,840829,5.5,0.81,9.509375,0.83,99.45
2022-11-10,Goa,609,5,604,7584,1355,972,8.03,0,1.6,846094,7018,841433,84.69,60.75,4.74,0.83,99.45
2022-11-11,Goa,880,2,877,10753,2564,1331,8.18,1,1.6,846974,7020,842310,160.25,83.19,6.720625,0.83,99.45
2022-11-12,Goa,283,3,280,3807,4181,333,7.43,0,1.6,847257,7023,842590,261.31,20.81,2.379375,0.83,99.45
2022-11-13,Goa,1624,6,1622,19988,4705,2531,8.12,0,1.6,848881,7029,844212,294.06,158.19,12.4925,0.83,99.45
2022-11-14,Goa,435,4,426,5401,289,159,8.05,5,1.6,849316,7033,844638,18.06,9.94,3.375625,0.83,99.45
2022-11-15,Goa,1104,5,1104,13770,4503,2099,8.02,0,1.6,850420,7038,845742,281.44,131.19,8.60625,0.83,99.45
2022-11-16,Goa,324,2,321,3945,2579,2493,8.21,1,1.6,850744,7040,846063,161.19,155.81,2.465625,0.83,99.45
2022-11-17,Goa,493,4,493,6025,2428,874,8.18,0,1.6,851237,7044,846556,151.75,54.62,3.765625,0.83,99.45
2022-11-18,Goa,657,2,657,7925,3464,1873,8.29,0,1.6,851894,7046,847213,216.5,117.06,4.953125,0.83,99.45
2022-11-19,Goa,768,3,766,9435,2973,926,8.14,0,1.6,852662,7049,847979,185.81,57.88,5.896875,0.83,99.45
2022-11-20,Goa,435,3,431,5418,219,32,8.03,1,1.6,853097,7052,848410,13.69,2.0,3.38625,0.83,99.45
2022-11-21,Goa,65,0,61,720,896,581,9.03,4,1.6,853162,7052,848471,56.0,36.31,0.45,0.83,99.45
2022-11-22,Goa,787,4,781,9477,3984,503,8.3,2,1.6,853949,7056,849252,249.0,31.44,5.923125,0.83,99.45
2022-11-23,Goa,1235,16,1234,15304,2886,1142,8.07,0,1.6,855184,7072,850486,180.38,71.38,9.565,0.83,99.45
2022-11-24,Goa,410,4,407,4677,1411,622,8.77,0,1.6,855594,7076,850893,88.19,38.88,2.923125,0.83,99.45
2022-11-25,Goa,989,10,981,12657,2770,2199,7.81,0,1.6,856583,7086,851874,173.12,137.44,7.910625,0.83,99.45
2022-11-26,Goa,64,0,59,965,1584,1250,6.63,5,1.6,856647,7086,851933,99.0,78.12,0.603125,0.83,99.45
2022-11-27,Goa,1199,13,1197,14930,4079,43,8.03,0,1.6,857846,7099,853130,254.94,2.69,9.33125,0.83,99.45
2022-11-28,Goa,1227,15,1226,15533,2039,1254,7.9,0,1.6,859073,7114,854356,127.44,78.38,9.708125,0.83,99.45
2022-11-29,Goa,1539,21,1539,18908,3878,294,8.14,0,1.6,860612,7135,855895,242.38,18.38,11.8175,0.83,99.45
2022-11-30,Goa,1430,21,1429,17745,4101,1123,8.06,0,1.6,862042,7156,857324,256.31,70.19,11.090625,0.83,99.45
2022-12-01,Goa,238,2,236,3295,1968,493,7.22,0,1.6,862280,7158,857560,123.0,30.81,2.059375,0.83,99.45
2022-12-02,Goa,438,4,430,5350,3228,1497,8.19,4,1.6,862718,7162,857990,201.75,93.56,3.34375,0.83,99.45
2022-12-03,Goa,229,2,229,3251,619,361,7.04,0,1.6,862947,7164,858219,38.69,22.56,2.031875,0.83,99.45
2022-12-04,Goa,1529,16,1520,18735,1875,620,8.16,0,1.6,864476,7180,859739,117.19,38.75,11.709375,0.83,99.45
2022-12-05,Goa,1453,7,1452,17970,4697,4265,8.09,0,1.6,865929,7187,861191,293.56,266.56,11.23125,0.83,99.45
2022-12-06,Goa,346,4,338,4606,3513,449,7.51,4,1.6,866275,7191,861529,219.56,28.06,2.87875,0.83,99.45
2022-12-07,Goa,1177,8,1173,14957,3209,2474,7.87,0,1.6,867452,7199,862702,200.56,154.62,9.348125,0.83,99.45
2022-12-08,Goa,1312,14,1311,16338,3949,266,8.03,0,1.6,868764,7213,864013,246.81,16.62,10.21125,0.83,99.45
2022-12-09,Goa,750,4,745,9448,1795,1112,7.94,1,1.6,869514,7217,864758,112.19,69.5,5.905,0.83,99.45
2022-12-10,Goa,444,6,439,5450,1091,62,8.15,0,1.6,869958,7223,865197,68.19,3.88,3.40625,0.83,99.45
2022-12-11,Goa,1491,14,1491,18704,3301,1214,7.97,0,1.6,871449,7237,866688,206.31,75.88,11.69,0.83,99.45
2022-12-12,Goa,400,3,392,5130,1871,795,7.8,5,1.6,871849,7240,867080,116.94,49.69,3.20625,0.83,99.45
2022-12-13,Goa,60,0,54,1106,260,160,5.42,6,1.6,871909,7240,867134,16.25,10.0,0.69125,0.83,99.45
2022-12-14,Goa,850,9,844,10503,1125,80,8.09,0,1.6,872759,7249,867978,70.31,5.0,6.564375,0.83,99.45
2022-12-15,Goa,727,3,726,8810,1928,485,8.25,0,1.6,873486,7252,868704,120.5,30.31,5.50625,0.83,99.45
2022-12-16,Goa,1271,9,1265,16066,4690,3028,7.91,0,1.6,874757,7261,869969,293.12,189.25,10.04125,0.83,99.45
2022-12-17,Goa,303,1,295,3810,1058,891,7.95,7,1.6,875060,7262,870264,66.12,55.69,2.38125,0.83,99.45
2022-12-18,Goa,888,9,884,10851,455,182,8.18,0,1.6,875948,7271,871148,28.44,11.38,6.781875,0.83,99.45
2022-12-19,Goa,633,6,628,7959,627,302,7.95,0,1.6,876581,7277,871776,39.19,18.88,4.974375,0.83,99.45
2022-12-20,Goa,206,1,201,2599,3535,1316,7.93,4,1.6,876787,7278,871977,220.94,82.25,1.624375,0.83,99.45
2022-12-21,Goa,879,10,872,11538,4635,3765,7.62,0,1.6,877666,7288,872849,289.69,235.31,7.21125,0.83,99.45
2022-12-22,Goa,1465,18,1461,18258,3857,1472,8.02,0,1.6,879131,7306,874310,241.06,92.0,11.41125,0.83,99.45
2022-12-23,Goa,97,0,96,1368,1384,753,7.09,1,1.6,879228,7306,874406,86.5,47.06,0.855,0.83,99.45
2022-12-24,Goa,657,6,651,8113,3622,1412,8.1,0,1.6,879885,7312,875057,226.38,88.25,5.070625,0.83,99.45
2022-12-25,Goa,1374,15,1373,16880,2949,638,8.14,0,1.6,881259,7327,876430,184.31,39.88,10.55,0.83,99.45
2022-12-26,Goa,219,0,211,2889,1477,206,7.58,8,1.6,881478,7327,876641,92.31,12.88,1.805625,0.83,99.45
2022-12-27,Goa,700,8,696,9214,2829,2753,7.6,0,1.6,882178,7335,877337,176.81,172.06,5.75875,0.83,99.45
2022-12-28,Goa,1201,6,1195,15152,3138,1028,7.93,0,1.6,883379,7341,878532,196.12,64.25,9.47,0.83,99.45
2022-12-29,Goa,973,12,972,11493,947,735,8.47,0,1.6,884352,7353,879504,59.19,45.94,7.183125,0.83,99.45
2022-12-30,Goa,783,3,780,9830,1369,448,7.97,0,1.6,885135,7356,880284,85.56,28.0,6.14375,0.83,99.45
2022-12-31,Goa,829,8,825,10570,948,885,7.84,0,1.6,885964,7364,881109,59.25,55.31,6.60625,0.83,99.45
2020-01-01,Gujarat,45,0,40,766,172,106,5.87,5,71.5,45,0,40,0.24,0.15,0.010713286713286713,0.0,88.89
2020-01-02,Gujarat,888,4,883,11250,3824,3245,7.89,1,71.5,933,4,923,5.35,4.54,0.15734265734265734,0.43,98.93
2020-01-03,Gujarat,1616,17,1607,19855,4653,4554,8.14,0,71.5,2549,21,2530,6.51,6.37,0.2776923076923077,0.82,99.25
2020-01-04,Gujarat,1501,6,1500,18379,2508,2211,8.17,0,71.5,4050,27,4030,3.51,3.09,0.25704895104895104,0.67,99.51
2020-01-05,Gujarat,894,5,891,11074,1676,1460,8.07,0,71.5,4944,32,4921,2.34,2.04,0.15488111888111888,0.65,99.53
2020-01-06,Gujarat,1606,21,1605,19745,912,284,8.13,0,71.5,6550,53,6526,1.28,0.4,0.27615384615384614,0.81,99.63
2020-01-07,Gujarat,1183,6,1177,14802,4538,2094,7.99,0,71.5,7733,59,7703,6.35,2.93,0.20702097902097902,0.76,99.61
2020-01-08,Gujarat,1235,5,1234,15537,532,61,7.95,0,71.5,8968,64,8937,0.74,0.09,0.2173006993006993,0.71,99.65
2020-01-09,Gujarat,1466,10,1457,18515,2407,927,7.92,0,71.5,10434,74,10394,3.37,1.3,0.258951048951049,0.71,99.62
2020-01-10,Gujarat,765,5,759,9622,4486,2279,7.95,1,71.5,11199,79,11153,6.27,3.19,0.13457342657342658,0.71,99.59
2020-01-11,Gujarat,871,8,869,10447,941,288,8.34,0,71.5,12070,87,12022,1.32,0.4,0.1461118881118881,0.72,99.6
2020-01-12,Gujarat,541,3,534,7099,2707,662,7.62,4,71.5,12611,90,12556,3.79,0.93,0.09928671328671329,0.71,99.56
2020-01-13,Gujarat,218,2,214,2676,1044,227,8.15,2,71.5,12829,92,12770,1.46,0.32,0.03742657342657343,0.72,99.54
2020-01-14,Gujarat,1118,15,1112,13814,1339,783,8.09,0,71.5,13947,107,13882,1.87,1.1,0.1932027972027972,0.77,99.53
2020-01-15,Gujarat,1361,9,1355,16630,2983,1003,8.18,0,71.5,15308,116,15237,4.17,1.4,0.23258741258741258,0.76,99.54
2020-01-16,Gujarat,978,9,976,12100,3441,163,8.08,0,71.5,16286,125,16213,4.81,0.23,0.16923076923076924,0.77,99.55
2020-01-17,Gujarat,115,1,115,1465,2141,77,7.85,0,71.5,16401,126,16328,2.99,0.11,0.02048951048951049,0.77,99.55
2020-01-18,Gujarat,267,2,265,3319,2670,2283,8.04,0,71.5,16668,128,16593,3.73,3.19,0.04641958041958042,0.77,99.55
2020-01-19,Gujarat,1507,14,1501,18861,1312,847,7.99,0,71.5,18175,142,18094,1.83,1.18,0.2637902097902098,0.78,99.55
2020-01-20,Gujarat,1188,5,1183,14346,1949,407,8.28,0,71.5,19363,147,19277,2.73,0.57,0.20064335664335664,0.76,99.56
2020-01-21,Gujarat,704,3,696,8533,715,489,8.25,5,71.5,20067,150,19973,1.0,0.68,0.11934265734265734,0.75,99.53
2020-01-22,Gujarat,851,11,845,10940,3748,1316,7.78,0,71.5,20918,161,20818,5.24,1.84,0.153006993006993,0.77,99.52
2020-01-23,Gujarat,1450,17,1441,18736,3824,1506,7.74,0,71.5,22368,178,22259,5.35,2.11,0.26204195804195807,0.8,99.51
2020-01-24,Gujarat,246,0,246,2933,3835,2602,8.39,0,71.5,22614,178,22505,5.36,3.64,0.04102097902097902,0.79,99.52
2020-01-25,Gujarat,168,1,161,2378,953,870,7.06,6,71.5,22782,179,22666,1.33,1.22,0.03325874125874126,0.79,99.49
2020-01-26,Gujarat,1220,7,1213,15192,4862,2665,8.03,0,71.5,24002,186,23879,6.8,3.73,0.21247552447552448,0.77,99.49
2020-01-27,Gujarat,404,3,402,5198,162,27,7.77,0,71.5,24406,189,24281,0.23,0.04,0.0726993006993007,0.77,99.49
2020-01-28,Gujarat,846,11,839,10203,3280,393,8.29,0,71.5,25252,200,25120,4.59,0.55,0.1426993006993007,0.79,99.48
2020-01-29,Gujarat,148,0,142,1946,2538,68,7.61,6,71.5,25400,200,25262,3.55,0.1,0.027216783216783218,0.79,99.46
2020-01-30,Gujarat,655,3,652,8652,3560,3338,7.57,0,71.5,26055,203,25914,4.98,4.67,0.12100699300699301,0.78,99.46
2020-01-31,Gujarat,426,5,424,5456,4153,1925,7.81,0,71.5,26481,208,26338,5.81,2.69,0.07630769230769231,0.79,99.46
2020-02-01,Gujarat,722,10,716,8752,1335,977,8.25,0,71.5,27203,218,27054,1.87,1.37,0.12240559440559441,0.8,99.45
2020-02-02,Gujarat,534,3,531,6622,1935,479,8.06,0,71.5,27737,221,27585,2.71,0.67,0.09261538461538461,0.8,99.45
2020-02-03,Gujarat,1357,17,1350,17526,532,336,7.74,0,71.5,29094,238,28935,0.74,0.47,0.2451188811188811,0.82,99.45
2020-02-04,Gujarat,567,6,561,7316,3028,371,7.75,0,71.5,29661,244,29496,4.23,0.52,0.10232167832167832,0.82,99.44
2020-02-05,Gujarat,499,3,493,6197,1268,158,8.05,3,71.5,30160,247,29989,1.77,0.22,0.08667132867132867,0.82,99.43
2020-02-06,Gujarat,515,2,509,6270,418,258,8.21,4,71.5,30675,249,30498,0.58,0.36,0.0876923076923077,0.81,99.42
2020-02-07,Gujarat,560,4,559,7174,1143,1075,7.81,0,71.5,31235,253,31057,1.6,1.5,0.10033566433566433,0.81,99.43
2020-02-08,Gujarat,1491,20,1487,18608,4143,1479,8.01,0,71.5,32726,273,32544,5.79,2.07,0.26025174825174824,0.83,99.44
2020-02-09,Gujarat,743,3,742,9558,4276,2487,7.77,0,71.5,33469,276,33286,5.98,3.48,0.13367832167832167,0.82,99.45
2020-02-10,Gujarat,248,1,247,3001,2342,1415,8.26,0,71.5,33717,277,33533,3.28,1.98,0.041972027972027974,0.82,99.45
2020-02-11,Gujarat,720,2,716,8744,1065,227,8.23,2,71.5,34437,279,34249,1.49,0.32,0.1222937062937063,0.81,99.45
2020-02-12,Gujarat,1377,11,1368,17506,4632,1079,7.87,0,71.5,35814,290,35617,6.48,1.51,0.24483916083916085,0.81,99.45
2020-02-13,Gujarat,1214,15,1211,15546,4310,3238,7.81,0,71.5,37028,305,36828,6.03,4.53,0.21742657342657343,0.82,99.46
2020-02-14,Gujarat,622,3,616,7686,1656,935,8.09,3,71.5,37650,308,37444,2.32,1.31,0.1074965034965035,0.82,99.45
2020-02-15,Gujarat,1195,13,1195,15178,2676,1616,7.87,0,71.5,38845,321,38639,3.74,2.26,0.21227972027972028,0.83,99.47
2020-02-16,Gujarat,984,11,980,12006,4596,1424,8.2,0,71.5,39829,332,39619,6.43,1.99,0.16791608391608392,0.83,99.47
2020-02-17,Gujarat,546,5,538,6957,1877,478,7.85,3,71.5,40375,337,40157,2.63,0.67,0.0973006993006993,0.83,99.46
2020-02-18,Gujarat,285,1,280,3348,1565,895,8.51,4,71.5,40660,338,40437,2.19,1.25,0.04682517482517483,0.83,99.45
2020-02-19,Gujarat,592,5,589,7713,598,214,7.68,0,71.5,41252,343,41026,0.84,0.3,0.10787412587412587,0.83,99.45
2020-02-20,Gujarat,441,3,440,5500,1495,564,8.02,0,71.5,41693,346,41466,2.09,0.79,0.07692307692307693,0.83,99.46
2020-02-21,Gujarat,1386,11,1384,17454,2024,38,7.94,0,71.5,43079,357,42850,2.83,0.05,0.2441118881118881,0.83,99.47
2020-02-22,Gujarat,1066,5,1062,12869,1345,1109,8.28,0,71.5,44145,362,43912,1.88,1.55,0.179986013986014,0.82,99.47
2020-02-23,Gujarat,315,1,314,3961,1174,1128,7.95,0,71.5,44460,363,44226,1.64,1.58,0.0553986013986014,0.82,99.47
2020-02-24,Gujarat,735,4,734,9614,370,175,7.65,0,71.5,45195,367,44960,0.52,0.24,0.13446153846153847,0.81,99.48
2020-02-25,Gujarat,496,2,492,6765,2432,1856,7.33,2,71.5,45691,369,45452,3.4,2.6,0.09461538461538462,0.81,99.48
2020-02-26,Gujarat,434,2,432,5507,2288,658,7.88,0,71.5,46125,371,45884,3.2,0.92,0.07702097902097903,0.8,99.48
2020-02-27,Gujarat,1559,15,1557,19343,1106,523,8.06,0,71.5,47684,386,47441,1.55,0.73,0.27053146853146853,0.81,99.49
2020-02-28,Gujarat,195,0,194,2894,101,61,6.74,1,71.5,47879,386,47635,0.14,0.09,0.04047552447552447,0.81,99.49
2020-02-29,Gujarat,69,0,65,777,58,1,8.88,4,71.5,47948,386,47700,0.08,0.0,0.010867132867132867,0.81,99.48
2020-03-01,Gujarat,721,2,712,8940,4722,4347,8.06,7,71.5,48669,388,48412,6.6,6.08,0.12503496503496503,0.8,99.47
2020-03-02,Gujarat,1290,14,1283,15980,2534,1359,8.07,0,71.5,49959,402,49695,3.54,1.9,0.2234965034965035,0.8,99.47
2020-03-03,Gujarat,1536,19,1530,19316,606,273,7.95,0,71.5,51495,421,51225,0.85,0.38,0.27015384615384613,0.82,99.48
2020-03-04,Gujarat,1370,14,1368,17548,3004,2314,7.81,0,71.5,52865,435,52593,4.2,3.24,0.24542657342657342,0.82,99.49
2020-03-05,Gujarat,801,5,796,9831,3269,51,8.15,0,71.5,53666,440,53389,4.57,0.07,0.1374965034965035,0.82,99.48
2020-03-06,Gujarat,89,0,83,1230,4799,2188,7.24,6,71.5,53755,440,53472,6.71,3.06,0.0172027972027972,0.82,99.47
2020-03-07,Gujarat,1348,16,1346,17006,3560,452,7.93,0,71.5,55103,456,54818,4.98,0.63,0.23784615384615385,0.83,99.48
2020-03-08,Gujarat,412,1,407,4902,1319,425,8.4,4,71.5,55515,457,55225,1.84,0.59,0.06855944055944056,0.82,99.48
2020-03-09,Gujarat,366,4,360,4505,3288,874,8.12,2,71.5,55881,461,55585,4.6,1.22,0.063006993006993,0.82,99.47
2020-03-10,Gujarat,885,7,879,11170,4258,3451,7.92,0,71.5,56766,468,56464,5.96,4.83,0.15622377622377623,0.82,99.47
2020-03-11,Gujarat,1401,9,1393,17302,322,205,8.1,0,71.5,58167,477,57857,0.45,0.29,0.241986013986014,0.82,99.47
2020-03-12,Gujarat,996,11,994,12581,1349,45,7.92,0,71.5,59163,488,58851,1.89,0.06,0.17595804195804196,0.82,99.47
2020-03-13,Gujarat,1134,15,1129,14207,558,171,7.98,0,71.5,60297,503,59980,0.78,0.24,0.1986993006993007,0.83,99.47
2020-03-14,Gujarat,484,3,480,6036,1633,795,8.02,1,71.5,60781,506,60460,2.28,1.11,0.08441958041958042,0.83,99.47
2020-03-15,Gujarat,79,0,78,728,433,177,10.85,1,71.5,60860,506,60538,0.61,0.25,0.010181818181818183,0.83,99.47
2020-03-16,Gujarat,527,3,526,6449,3133,1008,8.17,0,71.5,61387,509,61064,4.38,1.41,0.0901958041958042,0.83,99.47
2020-03-17,Gujarat,1488,20,1480,18471,1217,20,8.06,0,71.5,62875,529,62544,1.7,0.03,0.25833566433566435,0.84,99.47
2020-03-18,Gujarat,1385,14,1381,17127,3398,2293,8.09,0,71.5,64260,543,63925,4.75,3.21,0.23953846153846153,0.85,99.48
2020-03-19,Gujarat,347,5,345,3941,3451,2781,8.8,0,71.5,64607,548,64270,4.83,3.89,0.05511888111888112,0.85,99.48
2020-03-20,Gujarat,1466,9,1465,18278,2186,796,8.02,0,71.5,66073,557,65735,3.06,1.11,0.25563636363636366,0.84,99.49
2020-03-21,Gujarat,1380,5,1378,17227,4287,3980,8.01,0,71.5,67453,562,67113,6.0,5.57,0.24093706293706293,0.83,99.5
2020-03-22,Gujarat,766,11,759,9720,3799,3259,7.88,0,71.5,68219,573,67872,5.31,4.56,0.13594405594405595,0.84,99.49
2020-03-23,Gujarat,479,6,470,5975,3189,1256,8.02,3,71.5,68698,579,68342,4.46,1.76,0.08356643356643356,0.84,99.48
2020-03-24,Gujarat,652,7,646,8434,2693,2252,7.73,0,71.5,69350,586,68988,3.77,3.15,0.11795804195804196,0.84,99.48
2020-03-25,Gujarat,1057,7,1053,13279,582,390,7.96,0,71.5,70407,593,70041,0.81,0.55,0.1857202797202797,0.84,99.48
2020-03-26,Gujarat,826,2,819,10549,1387,1305,7.83,5,71.5,71233,595,70860,1.94,1.83,0.14753846153846153,0.84,99.48
2020-03-27,Gujarat,599,6,590,7731,3919,657,7.75,3,71.5,71832,601,71450,5.48,0.92,0.10812587412587413,0.84,99.47
2020-03-28,Gujarat,388,5,388,5036,607,47,7.7,0,71.5,72220,606,71838,0.85,0.07,0.07043356643356644,0.84,99.47
2020-03-29,Gujarat,1230,13,1228,15423,1712,590,7.98,0,71.5,73450,619,73066,2.39,0.83,0.2157062937062937,0.84,99.48
2020-03-30,Gujarat,37,0,29,876,3165,1663,4.22,8,71.5,73487,619,73095,4.43,2.33,0.012251748251748252,0.84,99.47
2020-03-31,Gujarat,1357,14,1352,17335,705,477,7.83,0,71.5,74844,633,74447,0.99,0.67,0.24244755244755245,0.85,99.47
2020-04-01,Gujarat,211,2,210,2527,1441,505,8.35,0,71.5,75055,635,74657,2.02,0.71,0.03534265734265734,0.85,99.47
2020-04-02,Gujarat,894,5,889,11189,4928,3631,7.99,0,71.5,75949,640,75546,6.89,5.08,0.15648951048951049,0.84,99.47
2020-04-03,Gujarat,510,5,510,6448,40,0,7.91,0,71.5,76459,645,76056,0.06,0.0,0.09018181818181818,0.84,99.47
2020-04-04,Gujarat,457,3,456,6023,4127,2055,7.59,0,71.5,76916,648,76512,5.77,2.87,0.08423776223776223,0.84,99.47
2020-04-05,Gujarat,1452,17,1444,18347,211,174,7.91,0,71.5,78368,665,77956,0.3,0.24,0.2566013986013986,0.85,99.47
2020-04-06,Gujarat,1491,9,1488,18852,161,28,7.91,0,71.5,79859,674,79444,0.23,0.04,0.26366433566433567,0.84,99.48
2020-04-07,Gujarat,1064,13,1062,13254,2276,1957,8.03,0,71.5,80923,687,80506,3.18,2.74,0.18537062937062937,0.85,99.48
2020-04-08,Gujarat,270,3,269,3352,408,22,8.05,0,71.5,81193,690,80775,0.57,0.03,0.04688111888111888,0.85,99.49
2020-04-09,Gujarat,738,2,737,9945,4888,771,7.42,0,71.5,81931,692,81512,6.84,1.08,0.1390909090909091,0.84,99.49
2020-04-10,Gujarat,253,2,244,3559,4041,10,7.11,7,71.5,82184,694,81756,5.65,0.01,0.049776223776223774,0.84,99.48
2020-04-11,Gujarat,1089,11,1086,13978,3922,1050,7.79,0,71.5,83273,705,82842,5.49,1.47,0.1954965034965035,0.85,99.48
2020-04-12,Gujarat,248,1,246,2937,2002,481,8.44,1,71.5,83521,706,83088,2.8,0.67,0.04107692307692308,0.85,99.48
2020-04-13,Gujarat,1188,15,1187,15165,445,84,7.83,0,71.5,84709,721,84275,0.62,0.12,0.2120979020979021,0.85,99.49
2020-04-14,Gujarat,86,0,80,997,4617,1537,8.63,6,71.5,84795,721,84355,6.46,2.15,0.013944055944055945,0.85,99.48
2020-04-15,Gujarat,464,3,461,5739,4506,2648,8.09,0,71.5,85259,724,84816,6.3,3.7,0.08026573426573426,0.85,99.48
2020-04-16,Gujarat,175,1,175,1969,3745,3420,8.89,0,71.5,85434,725,84991,5.24,4.78,0.02753846153846154,0.85,99.48
2020-04-17,Gujarat,1570,10,1565,19637,4809,2494,8.0,0,71.5,87004,735,86556,6.73,3.49,0.27464335664335665,0.84,99.49
2020-04-18,Gujarat,1154,3,1149,14555,3511,2079,7.93,2,71.5,88158,738,87705,4.91,2.91,0.20356643356643356,0.84,99.49
2020-04-19,Gujarat,1399,14,1396,17585,3462,1021,7.96,0,71.5,89557,752,89101,4.84,1.43,0.24594405594405594,0.84,99.49
2020-04-20,Gujarat,368,3,365,4395,4878,2792,8.37,0,71.5,89925,755,89466,6.82,3.9,0.06146853146853147,0.84,99.49
2020-04-21,Gujarat,784,7,779,9857,3653,1175,7.95,0,71.5,90709,762,90245,5.11,1.64,0.13786013986013987,0.84,99.49
2020-04-22,Gujarat,84,0,79,1302,1771,516,6.45,5,71.5,90793,762,90324,2.48,0.72,0.01820979020979021,0.84,99.48
2020-04-23,Gujarat,524,3,521,6251,1586,1389,8.38,0,71.5,91317,765,90845,2.22,1.94,0.08742657342657342,0.84,99.48
2020-04-24,Gujarat,1163,7,1158,14616,4384,138,7.96,0,71.5,92480,772,92003,6.13,0.19,0.20441958041958042,0.83,99.48
2020-04-25,Gujarat,1339,7,1335,16740,4685,3006,8.0,0,71.5,93819,779,93338,6.55,4.2,0.23412587412587413,0.83,99.49
2020-04-26,Gujarat,221,3,221,3085,3980,1709,7.16,0,71.5,94040,782,93559,5.57,2.39,0.04314685314685315,0.83,99.49
2020-04-27,Gujarat,1371,18,1366,17573,193,143,7.8,0,71.5,95411,800,94925,0.27,0.2,0.24577622377622377,0.84,99.49
2020-04-28,Gujarat,1387,15,1380,17219,1201,671,8.06,0,71.5,96798,815,96305,1.68,0.94,0.24082517482517482,0.84,99.49
2020-04-29,Gujarat,551,3,551,7052,4083,2847,7.81,0,71.5,97349,818,96856,5.71,3.98,0.09862937062937063,0.84,99.49
2020-04-30,Gujarat,280,2,272,3691,2742,2069,7.59,6,71.5,97629,820,97128,3.83,2.89,0.051622377622377626,0.84,99.49
2020-05-01,Gujarat,520,7,516,6738,1109,230,7.72,0,71.5,98149,827,97644,1.55,0.32,0.09423776223776224,0.84,99.49
2020-05-02,Gujarat,435,5,430,5669,94,14,7.67,0,71.5,98584,832,98074,0.13,0.02,0.07928671328671329,0.84,99.48
2020-05-03,Gujarat,1536,13,1529,19513,900,490,7.87,0,71.5,100120,845,99603,1.26,0.69,0.27290909090909093,0.84,99.48
2020-05-04,Gujarat,120,0,120,1603,3413,1899,7.49,0,71.5,100240,845,99723,4.77,2.66,0.02241958041958042,0.84,99.48
2020-05-05,Gujarat,263,1,263,3346,19,7,7.86,0,71.5,100503,846,99986,0.03,0.01,0.0467972027972028,0.84,99.49
2020-05-06,Gujarat,508,2,508,6751,1169,626,7.52,0,71.5,101011,848,100494,1.63,0.88,0.09441958041958042,0.84,99.49
2020-05-07,Gujarat,493,4,484,6217,1742,256,7.93,5,71.5,101504,852,100978,2.44,0.36,0.08695104895104895,0.84,99.48
2020-05-08,Gujarat,489,2,481,6169,3584,3548,7.93,6,71.5,101993,854,101459,5.01,4.96,0.08627972027972028,0.84,99.48
2020-05-09,Gujarat,924,9,924,11200,4755,4234,8.25,0,71.5,102917,863,102383,6.65,5.92,0.15664335664335666,0.84,99.48
2020-05-10,Gujarat,664,6,663,8266,1085,79,8.03,0,71.5,103581,869,103046,1.52,0.11,0.1156083916083916,0.84,99.48
2020-05-11,Gujarat,58,0,58,809,1144,395,7.17,0,71.5,103639,869,103104,1.6,0.55,0.011314685314685314,0.84,99.48
2020-05-12,Gujarat,129,0,121,1549,1340,743,8.33,8,71.5,103768,869,103225,1.87,1.04,0.021664335664335663,0.84,99.48
2020-05-13,Gujarat,818,7,815,10044,3078,850,8.14,0,71.5,104586,876,104040,4.3,1.19,0.14047552447552447,0.84,99.48
2020-05-14,Gujarat,248,0,243,2939,1043,355,8.44,5,71.5,104834,876,104283,1.46,0.5,0.0411048951048951,0.84,99.47
2020-05-15,Gujarat,1037,6,1034,12972,1581,1447,7.99,0,71.5,105871,882,105317,2.21,2.02,0.18142657342657342,0.83,99.48
2020-05-16,Gujarat,527,5,518,6687,4857,1850,7.88,4,71.5,106398,887,105835,6.79,2.59,0.09352447552447553,0.83,99.47
2020-05-17,Gujarat,1431,8,1422,17611,2015,1253,8.13,1,71.5,107829,895,107257,2.82,1.75,0.2463076923076923,0.83,99.47
2020-05-18,Gujarat,67,0,65,1124,1326,662,5.96,2,71.5,107896,895,107322,1.85,0.93,0.01572027972027972,0.83,99.47
2020-05-19,Gujarat,229,1,226,2587,4962,1383,8.85,2,71.5,108125,896,107548,6.94,1.93,0.03618181818181818,0.83,99.47
2020-05-20,Gujarat,564,7,559,7176,1367,653,7.86,0,71.5,108689,903,108107,1.91,0.91,0.10036363636363636,0.83,99.46
2020-05-21,Gujarat,694,4,687,8613,1673,1594,8.06,3,71.5,109383,907,108794,2.34,2.23,0.12046153846153847,0.83,99.46
2020-05-22,Gujarat,1136,4,1135,13969,1083,72,8.13,0,71.5,110519,911,109929,1.51,0.1,0.19537062937062938,0.82,99.47
2020-05-23,Gujarat,1289,8,1288,16347,3694,2571,7.89,0,71.5,111808,919,111217,5.17,3.6,0.22862937062937064,0.82,99.47
2020-05-24,Gujarat,1025,10,1016,12933,4285,2421,7.93,0,71.5,112833,929,112233,5.99,3.39,0.18088111888111888,0.82,99.47
2020-05-25,Gujarat,1041,11,1040,13381,587,196,7.78,0,71.5,113874,940,113273,0.82,0.27,0.18714685314685314,0.83,99.47
2020-05-26,Gujarat,345,4,339,4502,58,53,7.66,2,71.5,114219,944,113612,0.08,0.07,0.06296503496503497,0.83,99.47
2020-05-27,Gujarat,1281,17,1273,15909,3606,2755,8.05,0,71.5,115500,961,114885,5.04,3.85,0.22250349650349652,0.83,99.47
2020-05-28,Gujarat,1058,5,1056,13009,3639,1750,8.13,0,71.5,116558,966,115941,5.09,2.45,0.18194405594405594,0.83,99.47
2020-05-29,Gujarat,109,0,107,1381,3852,1526,7.89,2,71.5,116667,966,116048,5.39,2.13,0.019314685314685314,0.83,99.47
2020-05-30,Gujarat,780,3,773,9771,926,552,7.98,4,71.5,117447,969,116821,1.3,0.77,0.13665734265734267,0.83,99.47
2020-05-31,Gujarat,51,0,44,553,4753,479,9.22,7,71.5,117498,969,116865,6.65,0.67,0.007734265734265734,0.82,99.46
2020-06-01,Gujarat,1075,6,1068,13957,2481,249,7.7,1,71.5,118573,975,117933,3.47,0.35,0.1952027972027972,0.82,99.46
2020-06-02,Gujarat,870,10,865,10641,67,15,8.18,0,71.5,119443,985,118798,0.09,0.02,0.14882517482517482,0.82,99.46
2020-06-03,Gujarat,1470,11,1463,18358,2698,1819,8.01,0,71.5,120913,996,120261,3.77,2.54,0.25675524475524475,0.82,99.46
2020-06-04,Gujarat,460,3,460,5641,3879,1368,8.15,0,71.5,121373,999,120721,5.43,1.91,0.0788951048951049,0.82,99.46
2020-06-05,Gujarat,472,4,469,6277,3874,1675,7.52,0,71.5,121845,1003,121190,5.42,2.34,0.0877902097902098,0.82,99.46
2020-06-06,Gujarat,259,3,252,3085,3313,2389,8.4,4,71.5,122104,1006,121442,4.63,3.34,0.04314685314685315,0.82,99.46
2020-06-07,Gujarat,256,2,253,3159,1572,170,8.1,1,71.5,122360,1008,121695,2.2,0.24,0.04418181818181818,0.82,99.46
2020-06-08,Gujarat,1081,7,1075,13818,3203,2226,7.82,0,71.5,123441,1015,122770,4.48,3.11,0.19325874125874126,0.82,99.46
2020-06-09,Gujarat,798,2,790,9859,4286,612,8.09,6,71.5,124239,1017,123560,5.99,0.86,0.1378881118881119,0.82,99.45
2020-06-10,Gujarat,509,3,507,6583,3041,2719,7.73,0,71.5,124748,1020,124067,4.25,3.8,0.09206993006993007,0.82,99.45
2020-06-11,Gujarat,466,1,458,5673,2398,756,8.21,7,71.5,125214,1021,124525,3.35,1.06,0.07934265734265734,0.82,99.45
2020-06-12,Gujarat,622,8,618,7554,971,369,8.23,0,71.5,125836,1029,125143,1.36,0.52,0.10565034965034965,0.82,99.45
2020-06-13,Gujarat,1104,9,1098,13570,1192,771,8.14,0,71.5,126940,1038,126241,1.67,1.08,0.1897902097902098,0.82,99.45
2020-06-14,Gujarat,1389,14,1387,17466,1699,1324,7.95,0,71.5,128329,1052,127628,2.38,1.85,0.24427972027972028,0.82,99.45
2020-06-15,Gujarat,387,4,381,4744,2737,2726,8.16,2,71.5,128716,1056,128009,3.83,3.81,0.06634965034965035,0.82,99.45
2020-06-16,Gujarat,609,6,600,8084,103,59,7.53,3,71.5,129325,1062,128609,0.14,0.08,0.11306293706293706,0.82,99.45
2020-06-17,Gujarat,321,4,319,4065,1132,667,7.9,0,71.5,129646,1066,128928,1.58,0.93,0.05685314685314685,0.82,99.45
2020-06-18,Gujarat,296,1,287,3352,807,509,8.83,8,71.5,129942,1067,129215,1.13,0.71,0.04688111888111888,0.82,99.44
2020-06-19,Gujarat,37,0,36,630,769,379,5.87,1,71.5,129979,1067,129251,1.08,0.53,0.008811188811188812,0.82,99.44
2020-06-20,Gujarat,752,3,743,9385,1265,36,8.01,6,71.5,130731,1070,129994,1.77,0.05,0.13125874125874126,0.82,99.44
2020-06-21,Gujarat,1576,15,1568,19920,1152,113,7.91,0,71.5,132307,1085,131562,1.61,0.16,0.2786013986013986,0.82,99.44
2020-06-22,Gujarat,265,2,264,3651,4571,2627,7.26,0,71.5,132572,1087,131826,6.39,3.67,0.05106293706293706,0.82,99.44
2020-06-23,Gujarat,387,3,387,5017,2258,835,7.71,0,71.5,132959,1090,132213,3.16,1.17,0.07016783216783216,0.82,99.44
2020-06-24,Gujarat,1547,5,1539,19183,1480,255,8.06,3,71.5,134506,1095,133752,2.07,0.36,0.2682937062937063,0.81,99.44
2020-06-25,Gujarat,349,3,344,4189,989,805,8.33,2,71.5,134855,1098,134096,1.38,1.13,0.05858741258741259,0.81,99.44
2020-06-26,Gujarat,1209,5,1208,14846,425,107,8.14,0,71.5,136064,1103,135304,0.59,0.15,0.20763636363636365,0.81,99.44
2020-06-27,Gujarat,1567,9,1566,19376,799,328,8.09,0,71.5,137631,1112,136870,1.12,0.46,0.270993006993007,0.81,99.45
2020-06-28,Gujarat,1133,14,1133,14517,1681,721,7.8,0,71.5,138764,1126,138003,2.35,1.01,0.20303496503496504,0.81,99.45
2020-06-29,Gujarat,508,3,507,6422,1657,376,7.91,0,71.5,139272,1129,138510,2.32,0.53,0.08981818181818182,0.81,99.45
2020-06-30,Gujarat,860,4,853,10697,4900,4309,8.04,3,71.5,140132,1133,139363,6.85,6.03,0.14960839160839162,0.81,99.45
2020-07-01,Gujarat,1011,3,1003,12450,4877,2137,8.12,5,71.5,141143,1136,140366,6.82,2.99,0.17412587412587413,0.8,99.45
2020-07-02,Gujarat,911,12,902,11706,3866,284,7.78,0,71.5,142054,1148,141268,5.41,0.4,0.16372027972027972,0.81,99.45
2020-07-03,Gujarat,725,4,719,8994,1979,1585,8.06,2,71.5,142779,1152,141987,2.77,2.22,0.1257902097902098,0.81,99.45
2020-07-04,Gujarat,1593,20,1586,19587,4746,1068,8.13,0,71.5,144372,1172,143573,6.64,1.49,0.27394405594405596,0.81,99.45
2020-07-05,Gujarat,78,0,77,815,4480,4311,9.57,1,71.5,144450,1172,143650,6.27,6.03,0.011398601398601398,0.81,99.45
2020-07-06,Gujarat,795,6,793,9736,1121,1114,8.17,0,71.5,145245,1178,144443,1.57,1.56,0.13616783216783218,0.81,99.45
2020-07-07,Gujarat,499,3,492,5987,3225,76,8.33,4,71.5,145744,1181,144935,4.51,0.11,0.08373426573426573,0.81,99.44
2020-07-08,Gujarat,1296,14,1295,16316,195,192,7.94,0,71.5,147040,1195,146230,0.27,0.27,0.2281958041958042,0.81,99.45
2020-07-09,Gujarat,317,4,314,3770,2215,155,8.41,0,71.5,147357,1199,146544,3.1,0.22,0.05272727272727273,0.81,99.45
2020-07-10,Gujarat,634,5,631,7941,4212,1255,7.98,0,71.5,147991,1204,147175,5.89,1.76,0.11106293706293706,0.81,99.45
2020-07-11,Gujarat,47,0,40,811,1179,714,5.8,7,71.5,148038,1204,147215,1.65,1.0,0.011342657342657343,0.81,99.44
2020-07-12,Gujarat,268,2,266,3622,1167,1102,7.4,0,71.5,148306,1206,147481,1.63,1.54,0.05065734265734266,0.81,99.44
2020-07-13,Gujarat,1381,8,1381,17589,2448,208,7.85,0,71.5,149687,1214,148862,3.42,0.29,0.246,0.81,99.45
2020-07-14,Gujarat,701,8,695,8566,646,292,8.18,0,71.5,150388,1222,149557,0.9,0.41,0.11980419580419581,0.81,99.45
2020-07-15,Gujarat,1430,16,1426,18087,503,114,7.91,0,71.5,151818,1238,150983,0.7,0.16,0.252965034965035,0.82,99.45
2020-07-16,Gujarat,883,12,877,10913,891,521,8.09,0,71.5,152701,1250,151860,1.25,0.73,0.15262937062937063,0.82,99.45
2020-07-17,Gujarat,1310,13,1309,16225,3396,2665,8.07,0,71.5,154011,1263,153169,4.75,3.73,0.22692307692307692,0.82,99.45
2020-07-18,Gujarat,431,3,422,5140,318,28,8.39,6,71.5,154442,1266,153591,0.44,0.04,0.0718881118881119,0.82,99.45
2020-07-19,Gujarat,115,1,106,1075,4593,3544,10.7,8,71.5,154557,1267,153697,6.42,4.96,0.015034965034965035,0.82,99.44
2020-07-20,Gujarat,194,1,187,1909,2376,1392,10.16,6,71.5,154751,1268,153884,3.32,1.95,0.0266993006993007,0.82,99.44
2020-07-21,Gujarat,388,3,386,5013,288,215,7.74,0,71.5,155139,1271,154270,0.4,0.3,0.07011188811188811,0.82,99.44
2020-07-22,Gujarat,89,0,87,1092,1219,418,8.15,2,71.5,155228,1271,154357,1.7,0.58,0.015272727272727273,0.82,99.44
2020-07-23,Gujarat,1179,6,1173,14858,3305,3178,7.94,0,71.5,156407,1277,155530,4.62,4.44,0.2078041958041958,0.82,99.44
2020-07-24,Gujarat,124,1,122,1662,4636,3335,7.46,1,71.5,156531,1278,155652,6.48,4.66,0.023244755244755246,0.82,99.44
2020-07-25,Gujarat,637,8,635,7872,176,89,8.09,0,71.5,157168,1286,156287,0.25,0.12,0.1100979020979021,0.82,99.44
2020-07-26,Gujarat,428,3,421,5489,4452,2671,7.8,4,71.5,157596,1289,156708,6.23,3.74,0.07676923076923077,0.82,99.44
2020-07-27,Gujarat,360,2,355,4527,2190,1389,7.95,3,71.5,157956,1291,157063,3.06,1.94,0.06331468531468532,0.82,99.43
2020-07-28,Gujarat,1519,5,1516,18322,3557,439,8.29,0,71.5,159475,1296,158579,4.97,0.61,0.25625174825174823,0.81,99.44
2020-07-29,Gujarat,330,3,325,4327,3919,3762,7.63,2,71.5,159805,1299,158904,5.48,5.26,0.06051748251748252,0.81,99.44
2020-07-30,Gujarat,337,4,332,4359,476,140,7.73,1,71.5,160142,1303,159236,0.67,0.2,0.06096503496503496,0.81,99.43
2020-07-31,Gujarat,1314,5,1313,16386,3980,1248,8.02,0,71.5,161456,1308,160549,5.57,1.75,0.22917482517482518,0.81,99.44
2020-08-01,Gujarat,202,2,196,2358,2732,1966,8.57,4,71.5,161658,1310,160745,3.82,2.75,0.03297902097902098,0.81,99.44
2020-08-02,Gujarat,185,2,184,2482,1651,77,7.45,0,71.5,161843,1312,160929,2.31,0.11,0.03471328671328671,0.81,99.44
2020-08-03,Gujarat,1043,5,1040,13234,723,562,7.88,0,71.5,162886,1317,161969,1.01,0.79,0.18509090909090908,0.81,99.44
2020-08-04,Gujarat,1595,19,1595,19559,496,94,8.15,0,71.5,164481,1336,163564,0.69,0.13,0.27355244755244756,0.81,99.44
2020-08-05,Gujarat,207,1,198,2495,600,190,8.3,8,71.5,164688,1337,163762,0.84,0.27,0.034895104895104896,0.81,99.44
2020-08-06,Gujarat,1298,7,1292,16027,4723,2402,8.1,0,71.5,165986,1344,165054,6.61,3.36,0.22415384615384615,0.81,99.44
2020-08-07,Gujarat,1114,4,1114,14112,4028,3254,7.89,0,71.5,167100,1348,166168,5.63,4.55,0.19737062937062938,0.81,99.44
2020-08-08,Gujarat,1185,13,1185,14796,3098,1945,8.01,0,71.5,168285,1361,167353,4.33,2.72,0.20693706293706293,0.81,99.45
2020-08-09,Gujarat,1293,12,1289,16059,1265,478,8.05,0,71.5,169578,1373,168642,1.77,0.67,0.2246013986013986,0.81,99.45
2020-08-10,Gujarat,641,5,633,7869,758,219,8.15,3,71.5,170219,1378,169275,1.06,0.31,0.11005594405594406,0.81,99.45
2020-08-11,Gujarat,286,3,284,3652,553,404,7.83,0,71.5,170505,1381,169559,0.77,0.57,0.051076923076923075,0.81,99.45
2020-08-12,Gujarat,971,4,966,12125,1187,781,8.01,1,71.5,171476,1385,170525,1.66,1.09,0.16958041958041958,0.81,99.45
2020-08-13,Gujarat,525,7,524,6752,4305,1715,7.78,0,71.5,172001,1392,171049,6.02,2.4,0.09443356643356643,0.81,99.45
2020-08-14,Gujarat,1234,14,1228,15237,3877,2173,8.1,0,71.5,173235,1406,172277,5.42,3.04,0.2131048951048951,0.81,99.45
2020-08-15,Gujarat,783,4,776,9523,560,137,8.22,3,71.5,174018,1410,173053,0.78,0.19,0.13318881118881118,0.81,99.45
2020-08-16,Gujarat,428,6,423,5639,2175,468,7.59,0,71.5,174446,1416,173476,3.04,0.65,0.07886713286713287,0.81,99.44
2020-08-17,Gujarat,1598,7,1593,19421,4211,2958,8.23,0,71.5,176044,1423,175069,5.89,4.14,0.2716223776223776,0.81,99.45
2020-08-18,Gujarat,1420,16,1419,17358,3364,2919,8.18,0,71.5,177464,1439,176488,4.7,4.08,0.24276923076923076,0.81,99.45
2020-08-19,Gujarat,320,3,312,4182,2668,329,7.65,5,71.5,177784,1442,176800,3.73,0.46,0.05848951048951049,0.81,99.45
2020-08-20,Gujarat,1199,11,1191,15281,4170,672,7.85,0,71.5,178983,1453,177991,5.83,0.94,0.2137202797202797,0.81,99.45
2020-08-21,Gujarat,1406,11,1404,17517,4733,1927,8.03,0,71.5,180389,1464,179395,6.62,2.7,0.244993006993007,0.81,99.45
2020-08-22,Gujarat,34,0,29,536,1806,1276,6.34,5,71.5,180423,1464,179424,2.53,1.78,0.007496503496503496,0.81,99.45
2020-08-23,Gujarat,1431,10,1429,17925,4758,603,7.98,0,71.5,181854,1474,180853,6.65,0.84,0.2506993006993007,0.81,99.45
2020-08-24,Gujarat,1095,6,1094,13376,1517,1198,8.19,0,71.5,182949,1480,181947,2.12,1.68,0.18707692307692309,0.81,99.45
2020-08-25,Gujarat,162,1,161,1942,1806,923,8.34,0,71.5,183111,1481,182108,2.53,1.29,0.02716083916083916,0.81,99.45
2020-08-26,Gujarat,888,9,884,11241,2786,893,7.9,0,71.5,183999,1490,182992,3.9,1.25,0.15721678321678323,0.81,99.45
2020-08-27,Gujarat,81,0,73,1062,1370,713,7.63,8,71.5,184080,1490,183065,1.92,1.0,0.014853146853146853,0.81,99.45
2020-08-28,Gujarat,394,1,392,5375,4863,3350,7.33,1,71.5,184474,1491,183457,6.8,4.69,0.07517482517482517,0.81,99.45
2020-08-29,Gujarat,719,6,716,9123,7,3,7.88,0,71.5,185193,1497,184173,0.01,0.0,0.1275944055944056,0.81,99.45
2020-08-30,Gujarat,407,3,398,4955,2299,1368,8.21,6,71.5,185600,1500,184571,3.22,1.91,0.0693006993006993,0.81,99.45
2020-08-31,Gujarat,770,3,768,9818,3018,244,7.84,0,71.5,186370,1503,185339,4.22,0.34,0.13731468531468533,0.81,99.45
2020-09-01,Gujarat,777,8,774,9933,3442,774,7.82,0,71.5,187147,1511,186113,4.81,1.08,0.13892307692307693,0.81,99.45
2020-09-02,Gujarat,1338,9,1337,16441,2668,1659,8.14,0,71.5,188485,1520,187450,3.73,2.32,0.22994405594405595,0.81,99.45
2020-09-03,Gujarat,449,2,448,5982,3051,1477,7.51,0,71.5,188934,1522,187898,4.27,2.07,0.08366433566433566,0.81,99.45
2020-09-04,Gujarat,681,8,672,8243,4876,527,8.26,1,71.5,189615,1530,188570,6.82,0.74,0.11528671328671329,0.81,99.45
2020-09-05,Gujarat,1129,8,1122,14102,2324,51,8.01,0,71.5,190744,1538,189692,3.25,0.07,0.19723076923076924,0.81,99.45
2020-09-06,Gujarat,285,1,280,3669,835,509,7.77,4,71.5,191029,1539,189972,1.17,0.71,0.05131468531468531,0.81,99.45
2020-09-07,Gujarat,951,12,942,11449,1157,478,8.31,0,71.5,191980,1551,190914,1.62,0.67,0.16012587412587412,0.81,99.44
2020-09-08,Gujarat,47,0,38,1033,1626,1003,4.55,9,71.5,192027,1551,190952,2.27,1.4,0.014447552447552447,0.81,99.44
2020-09-09,Gujarat,1179,12,1171,14790,286,61,7.97,0,71.5,193206,1563,192123,0.4,0.09,0.20685314685314685,0.81,99.44
2020-09-10,Gujarat,215,3,211,2933,369,87,7.33,1,71.5,193421,1566,192334,0.52,0.12,0.04102097902097902,0.81,99.44
2020-09-11,Gujarat,1360,17,1352,17134,795,505,7.94,0,71.5,194781,1583,193686,1.11,0.71,0.23963636363636365,0.81,99.44
2020-09-12,Gujarat,1579,5,1574,19469,693,512,8.11,0,71.5,196360,1588,195260,0.97,0.72,0.2722937062937063,0.81,99.44
2020-09-13,Gujarat,273,3,266,3361,1720,624,8.12,4,71.5,196633,1591,195526,2.41,0.87,0.04700699300699301,0.81,99.44
2020-09-14,Gujarat,785,4,785,9675,474,40,8.11,0,71.5,197418,1595,196311,0.66,0.06,0.13531468531468532,0.81,99.44
2020-09-15,Gujarat,894,5,892,10750,1009,432,8.32,0,71.5,198312,1600,197203,1.41,0.6,0.15034965034965034,0.81,99.44
2020-09-16,Gujarat,1120,14,1111,13870,1854,1131,8.07,0,71.5,199432,1614,198314,2.59,1.58,0.19398601398601398,0.81,99.44
2020-09-17,Gujarat,833,6,830,10778,4950,4302,7.73,0,71.5,200265,1620,199144,6.92,6.02,0.15074125874125874,0.81,99.44
2020-09-18,Gujarat,223,3,215,2792,4905,1839,7.99,5,71.5,200488,1623,199359,6.86,2.57,0.03904895104895105,0.81,99.44
2020-09-19,Gujarat,640,7,634,7822,1788,613,8.18,0,71.5,201128,1630,199993,2.5,0.86,0.1093986013986014,0.81,99.44
2020-09-20,Gujarat,532,5,527,7245,2745,50,7.34,0,71.5,201660,1635,200520,3.84,0.07,0.10132867132867134,0.81,99.43
2020-09-21,Gujarat,1036,5,1034,12798,2189,354,8.1,0,71.5,202696,1640,201554,3.06,0.5,0.178993006993007,0.81,99.44
2020-09-22,Gujarat,274,1,269,3717,2096,240,7.37,4,71.5,202970,1641,201823,2.93,0.34,0.05198601398601398,0.81,99.43
2020-09-23,Gujarat,1490,10,1489,18306,3361,1009,8.14,0,71.5,204460,1651,203312,4.7,1.41,0.256027972027972,0.81,99.44
2020-09-24,Gujarat,1388,17,1380,17282,4995,3786,8.03,0,71.5,205848,1668,204692,6.99,5.3,0.2417062937062937,0.81,99.44
2020-09-25,Gujarat,670,7,662,8845,2430,328,7.57,1,71.5,206518,1675,205354,3.4,0.46,0.12370629370629371,0.81,99.44
2020-09-26,Gujarat,129,1,121,2049,3151,1599,6.3,7,71.5,206647,1676,205475,4.41,2.24,0.02865734265734266,0.81,99.43
2020-09-27,Gujarat,222,2,219,3115,3411,2036,7.13,1,71.5,206869,1678,205694,4.77,2.85,0.04356643356643357,0.81,99.43
2020-09-28,Gujarat,122,0,119,2032,950,570,6.0,3,71.5,206991,1678,205813,1.33,0.8,0.02841958041958042,0.81,99.43
2020-09-29,Gujarat,193,0,193,2517,886,437,7.67,0,71.5,207184,1678,206006,1.24,0.61,0.035202797202797204,0.81,99.43
2020-09-30,Gujarat,1007,4,1001,12298,3842,1572,8.19,2,71.5,208191,1682,207007,5.37,2.2,0.172,0.81,99.43
2020-10-01,Gujarat,263,3,261,3417,4916,4907,7.7,0,71.5,208454,1685,207268,6.88,6.86,0.047790209790209794,0.81,99.43
2020-10-02,Gujarat,409,4,409,5011,176,135,8.16,0,71.5,208863,1689,207677,0.25,0.19,0.07008391608391608,0.81,99.43
2020-10-03,Gujarat,587,8,581,6710,1326,870,8.75,0,71.5,209450,1697,208258,1.85,1.22,0.09384615384615384,0.81,99.43
2020-10-04,Gujarat,1271,11,1270,15833,2703,1898,8.03,0,71.5,210721,1708,209528,3.78,2.65,0.22144055944055943,0.81,99.43
2020-10-05,Gujarat,344,1,344,3942,4504,2495,8.73,0,71.5,211065,1709,209872,6.3,3.49,0.055132867132867136,0.81,99.43
2020-10-06,Gujarat,1318,4,1309,16409,3925,1777,8.03,5,71.5,212383,1713,211181,5.49,2.49,0.2294965034965035,0.81,99.43
2020-10-07,Gujarat,552,6,550,7361,3807,801,7.5,0,71.5,212935,1719,211731,5.32,1.12,0.10295104895104895,0.81,99.43
2020-10-08,Gujarat,1407,6,1398,17454,81,77,8.06,3,71.5,214342,1725,213129,0.11,0.11,0.2441118881118881,0.8,99.43
2020-10-09,Gujarat,1324,19,1318,16205,453,16,8.17,0,71.5,215666,1744,214447,0.63,0.02,0.22664335664335664,0.81,99.43
2020-10-10,Gujarat,1423,6,1414,18030,1619,1203,7.89,3,71.5,217089,1750,215861,2.26,1.68,0.2521678321678322,0.81,99.43
2020-10-11,Gujarat,1148,11,1143,14632,1516,857,7.85,0,71.5,218237,1761,217004,2.12,1.2,0.20464335664335664,0.81,99.44
2020-10-12,Gujarat,1540,12,1538,19209,2469,134,8.02,0,71.5,219777,1773,218542,3.45,0.19,0.26865734265734265,0.81,99.44
2020-10-13,Gujarat,386,2,384,4852,4755,3120,7.96,0,71.5,220163,1775,218926,6.65,4.36,0.06786013986013986,0.81,99.44
2020-10-14,Gujarat,1530,16,1525,18868,1097,203,8.11,0,71.5,221693,1791,220451,1.53,0.28,0.2638881118881119,0.81,99.44
2020-10-15,Gujarat,383,1,375,4386,4376,1077,8.73,7,71.5,222076,1792,220826,6.12,1.51,0.06134265734265734,0.81,99.44
2020-10-16,Gujarat,1074,7,1068,13349,4431,1583,8.05,0,71.5,223150,1799,221894,6.2,2.21,0.1866993006993007,0.81,99.44
2020-10-17,Gujarat,957,6,951,11599,1838,89,8.25,0,71.5,224107,1805,222845,2.57,0.12,0.16222377622377623,0.81,99.44
2020-10-18,Gujarat,1569,9,1560,19823,2211,1300,7.92,0,71.5,225676,1814,224405,3.09,1.82,0.2772447552447552,0.8,99.44
2020-10-19,Gujarat,833,5,832,10508,1406,293,7.93,0,71.5,226509,1819,225237,1.97,0.41,0.14696503496503496,0.8,99.44
2020-10-20,Gujarat,1579,17,1577,19732,2200,1702,8.0,0,71.5,228088,1836,226814,3.08,2.38,0.27597202797202797,0.8,99.44
2020-10-21,Gujarat,1224,18,1222,15073,462,101,8.12,0,71.5,229312,1854,228036,0.65,0.14,0.21081118881118882,0.81,99.44
2020-10-22,Gujarat,917,4,911,11425,296,27,8.03,2,71.5,230229,1858,228947,0.41,0.04,0.1597902097902098,0.81,99.44
2020-10-23,Gujarat,922,4,914,11709,2221,675,7.87,4,71.5,231151,1862,229861,3.11,0.94,0.16376223776223775,0.81,99.44
2020-10-24,Gujarat,992,4,992,12689,3567,1428,7.82,0,71.5,232143,1866,230853,4.99,2.0,0.17746853146853148,0.8,99.44
2020-10-25,Gujarat,1416,12,1407,17570,4163,1835,8.06,0,71.5,233559,1878,232260,5.82,2.57,0.24573426573426574,0.8,99.44
2020-10-26,Gujarat,496,7,487,5670,1962,352,8.75,2,71.5,234055,1885,232747,2.74,0.49,0.0793006993006993,0.81,99.44
2020-10-27,Gujarat,233,0,231,2879,4278,724,8.09,2,71.5,234288,1885,232978,5.98,1.01,0.040265734265734265,0.8,99.44
2020-10-28,Gujarat,173,0,168,1863,3755,3183,9.29,5,71.5,234461,1885,233146,5.25,4.45,0.026055944055944056,0.8,99.44
2020-10-29,Gujarat,613,2,610,7401,26,2,8.28,1,71.5,235074,1887,233756,0.04,0.0,0.10351048951048951,0.8,99.44
2020-10-30,Gujarat,112,1,110,1683,288,245,6.65,1,71.5,235186,1888,233866,0.4,0.34,0.02353846153846154,0.8,99.44
2020-10-31,Gujarat,431,4,425,5288,356,184,8.15,2,71.5,235617,1892,234291,0.5,0.26,0.07395804195804195,0.8,99.44
2020-11-01,Gujarat,455,3,446,5442,1135,794,8.36,6,71.5,236072,1895,234737,1.59,1.11,0.07611188811188811,0.8,99.43
2020-11-02,Gujarat,516,6,509,5998,3064,2831,8.6,1,71.5,236588,1901,235246,4.29,3.96,0.08388811188811189,0.8,99.43
2020-11-03,Gujarat,1167,10,1166,14663,4577,427,7.96,0,71.5,237755,1911,236412,6.4,0.6,0.20507692307692307,0.8,99.44
2020-11-04,Gujarat,1536,14,1536,19152,2189,246,8.02,0,71.5,239291,1925,237948,3.06,0.34,0.26786013986013985,0.8,99.44
2020-11-05,Gujarat,948,6,939,11602,3926,1360,8.17,3,71.5,240239,1931,238887,5.49,1.9,0.16226573426573426,0.8,99.44
2020-11-06,Gujarat,790,7,789,9542,716,600,8.28,0,71.5,241029,1938,239676,1.0,0.84,0.13345454545454546,0.8,99.44
2020-11-07,Gujarat,744,4,739,9381,4352,1433,7.93,1,71.5,241773,1942,240415,6.09,2.0,0.1312027972027972,0.8,99.44
2020-11-08,Gujarat,1087,9,1078,13678,2525,150,7.95,0,71.5,242860,1951,241493,3.53,0.21,0.1913006993006993,0.8,99.44
2020-11-09,Gujarat,1106,10,1104,13907,309,205,7.95,0,71.5,243966,1961,242597,0.43,0.29,0.1945034965034965,0.8,99.44
2020-11-10,Gujarat,1486,11,1485,18813,3287,578,7.9,0,71.5,245452,1972,244082,4.6,0.81,0.2631188811188811,0.8,99.44
2020-11-11,Gujarat,439,4,433,5440,870,311,8.07,2,71.5,245891,1976,244515,1.22,0.43,0.07608391608391608,0.8,99.44
2020-11-12,Gujarat,820,9,816,9874,1833,968,8.3,0,71.5,246711,1985,245331,2.56,1.35,0.1380979020979021,0.8,99.44
2020-11-13,Gujarat,447,1,444,5644,3747,1084,7.92,2,71.5,247158,1986,245775,5.24,1.52,0.07893706293706294,0.8,99.44
2020-11-14,Gujarat,1377,6,1370,16966,4106,1019,8.12,1,71.5,248535,1992,247145,5.74,1.43,0.23728671328671327,0.8,99.44
2020-11-15,Gujarat,1530,7,1522,19530,4174,3959,7.83,1,71.5,250065,1999,248667,5.84,5.54,0.27314685314685316,0.8,99.44
2020-11-16,Gujarat,382,4,378,4594,4470,316,8.32,0,71.5,250447,2003,249045,6.25,0.44,0.06425174825174826,0.8,99.44
2020-11-17,Gujarat,663,4,661,8521,4853,1233,7.78,0,71.5,251110,2007,249706,6.79,1.72,0.11917482517482518,0.8,99.44
2020-11-18,Gujarat,363,2,356,4582,4037,246,7.92,5,71.5,251473,2009,250062,5.65,0.34,0.06408391608391609,0.8,99.44
2020-11-19,Gujarat,879,3,875,10904,4902,4039,8.06,1,71.5,252352,2012,250937,6.86,5.65,0.1525034965034965,0.8,99.44
2020-11-20,Gujarat,424,3,422,5607,1413,550,7.56,0,71.5,252776,2015,251359,1.98,0.77,0.07841958041958041,0.8,99.44
2020-11-21,Gujarat,1367,13,1363,17252,687,545,7.92,0,71.5,254143,2028,252722,0.96,0.76,0.24128671328671328,0.8,99.44
2020-11-22,Gujarat,1541,10,1532,19234,899,709,8.01,0,71.5,255684,2038,254254,1.26,0.99,0.269006993006993,0.8,99.44
2020-11-23,Gujarat,189,0,181,2197,4897,832,8.6,8,71.5,255873,2038,254435,6.85,1.16,0.030727272727272728,0.8,99.44
2020-11-24,Gujarat,1526,7,1524,19206,2089,1705,7.95,0,71.5,257399,2045,255959,2.92,2.38,0.2686153846153846,0.79,99.44
2020-11-25,Gujarat,729,8,728,9018,4516,2761,8.08,0,71.5,258128,2053,256687,6.32,3.86,0.12612587412587412,0.8,99.44
2020-11-26,Gujarat,1386,5,1377,17204,575,335,8.06,4,71.5,259514,2058,258064,0.8,0.47,0.24061538461538462,0.79,99.44
2020-11-27,Gujarat,1167,7,1160,14500,2063,1228,8.05,0,71.5,260681,2065,259224,2.89,1.72,0.20279720279720279,0.79,99.44
2020-11-28,Gujarat,1103,10,1096,13793,4791,2480,8.0,0,71.5,261784,2075,260320,6.7,3.47,0.19290909090909092,0.79,99.44
2020-11-29,Gujarat,36,0,32,512,2947,1845,7.03,4,71.5,261820,2075,260352,4.12,2.58,0.007160839160839161,0.79,99.44
2020-11-30,Gujarat,240,2,233,2963,2435,1940,8.1,5,71.5,262060,2077,260585,3.41,2.71,0.04144055944055944,0.79,99.44
2020-12-01,Gujarat,84,1,82,975,4931,4306,8.62,1,71.5,262144,2078,260667,6.9,6.02,0.013636363636363636,0.79,99.44
2020-12-02,Gujarat,239,3,233,2972,2444,611,8.04,3,71.5,262383,2081,260900,3.42,0.85,0.04156643356643357,0.79,99.43
2020-12-03,Gujarat,754,5,752,8792,4250,1373,8.58,0,71.5,263137,2086,261652,5.94,1.92,0.12296503496503497,0.79,99.44
2020-12-04,Gujarat,498,2,495,6067,3166,1411,8.21,1,71.5,263635,2088,262147,4.43,1.97,0.08485314685314685,0.79,99.44
2020-12-05,Gujarat,868,2,859,10721,4101,186,8.1,7,71.5,264503,2090,263006,5.74,0.26,0.14994405594405594,0.79,99.43
2020-12-06,Gujarat,1297,9,1288,16290,4218,2836,7.96,0,71.5,265800,2099,264294,5.9,3.97,0.22783216783216784,0.79,99.43
2020-12-07,Gujarat,432,1,429,5381,2369,1282,8.03,2,71.5,266232,2100,264723,3.31,1.79,0.07525874125874125,0.79,99.43
2020-12-08,Gujarat,74,0,67,1020,1898,492,7.25,7,71.5,266306,2100,264790,2.65,0.69,0.014265734265734267,0.79,99.43
2020-12-09,Gujarat,748,5,742,9479,296,21,7.89,1,71.5,267054,2105,265532,0.41,0.03,0.13257342657342658,0.79,99.43
2020-12-10,Gujarat,13,0,13,556,1930,85,2.34,0,71.5,267067,2105,265545,2.7,0.12,0.007776223776223776,0.79,99.43
2020-12-11,Gujarat,323,3,315,3670,2851,2064,8.8,5,71.5,267390,2108,265860,3.99,2.89,0.051328671328671326,0.79,99.43
2020-12-12,Gujarat,474,3,466,5837,2309,2296,8.12,5,71.5,267864,2111,266326,3.23,3.21,0.08163636363636363,0.79,99.43
2020-12-13,Gujarat,406,1,398,5140,3993,843,7.9,7,71.5,268270,2112,266724,5.58,1.18,0.0718881118881119,0.79,99.42
2020-12-14,Gujarat,790,5,786,9836,1594,1259,8.03,0,71.5,269060,2117,267510,2.23,1.76,0.13756643356643355,0.79,99.42
2020-12-15,Gujarat,1045,9,1039,12913,1255,513,8.09,0,71.5,270105,2126,268549,1.76,0.72,0.1806013986013986,0.79,99.42
2020-12-16,Gujarat,580,7,575,7676,1214,1002,7.56,0,71.5,270685,2133,269124,1.7,1.4,0.10735664335664336,0.79,99.42
2020-12-17,Gujarat,491,4,488,6127,2613,558,8.01,0,71.5,271176,2137,269612,3.65,0.78,0.08569230769230769,0.79,99.42
2020-12-18,Gujarat,1305,14,1297,16617,1870,1110,7.85,0,71.5,272481,2151,270909,2.62,1.55,0.2324055944055944,0.79,99.42
2020-12-19,Gujarat,1292,16,1288,16211,1139,495,7.97,0,71.5,273773,2167,272197,1.59,0.69,0.22672727272727272,0.79,99.42
2020-12-20,Gujarat,1184,6,1182,15197,908,579,7.79,0,71.5,274957,2173,273379,1.27,0.81,0.21254545454545454,0.79,99.43
2020-12-21,Gujarat,308,1,306,3606,92,77,8.54,1,71.5,275265,2174,273685,0.13,0.11,0.05043356643356643,0.79,99.43
2020-12-22,Gujarat,910,8,902,11591,2578,1496,7.85,0,71.5,276175,2182,274587,3.61,2.09,0.16211188811188812,0.79,99.43
2020-12-23,Gujarat,907,4,901,11033,4612,3861,8.22,2,71.5,277082,2186,275488,6.45,5.4,0.1543076923076923,0.79,99.42
2020-12-24,Gujarat,483,5,480,5812,3061,2059,8.31,0,71.5,277565,2191,275968,4.28,2.88,0.08128671328671329,0.79,99.42
2020-12-25,Gujarat,1531,16,1531,19152,3040,20,7.99,0,71.5,279096,2207,277499,4.25,0.03,0.26786013986013985,0.79,99.43
2020-12-26,Gujarat,472,6,463,5783,2975,2313,8.16,3,71.5,279568,2213,277962,4.16,3.23,0.08088111888111889,0.79,99.43
2020-12-27,Gujarat,459,6,454,5585,2177,587,8.22,0,71.5,280027,2219,278416,3.04,0.82,0.07811188811188811,0.79,99.42
2020-12-28,Gujarat,1323,11,1316,16472,2946,2012,8.03,0,71.5,281350,2230,279732,4.12,2.81,0.23037762237762238,0.79,99.42
2020-12-29,Gujarat,1308,14,1301,16843,1717,272,7.77,0,71.5,282658,2244,281033,2.4,0.38,0.23556643356643356,0.79,99.43
2020-12-30,Gujarat,239,2,233,2799,2181,661,8.54,4,71.5,282897,2246,281266,3.05,0.92,0.03914685314685315,0.79,99.42
2020-12-31,Gujarat,893,11,892,11162,99,72,8.0,0,71.5,283790,2257,282158,0.14,0.1,0.15611188811188811,0.8,99.42
2021-01-01,Gujarat,464,4,461,5653,385,93,8.21,0,71.5,284254,2261,282619,0.54,0.13,0.07906293706293706,0.8,99.42
2021-01-02,Gujarat,1252,12,1252,15910,1723,51,7.87,0,71.5,285506,2273,283871,2.41,0.07,0.22251748251748252,0.8,99.43
2021-01-03,Gujarat,227,2,221,2949,2811,1059,7.7,4,71.5,285733,2275,284092,3.93,1.48,0.041244755244755245,0.8,99.43
2021-01-04,Gujarat,1269,9,1263,15802,2474,1928,8.03,0,71.5,287002,2284,285355,3.46,2.7,0.221006993006993,0.8,99.43
2021-01-05,Gujarat,690,5,689,8928,2069,913,7.73,0,71.5,287692,2289,286044,2.89,1.28,0.12486713286713287,0.8,99.43
2021-01-06,Gujarat,134,1,133,2073,3053,81,6.46,0,71.5,287826,2290,286177,4.27,0.11,0.028993006993006994,0.8,99.43
2021-01-07,Gujarat,1492,8,1492,18552,545,50,8.04,0,71.5,289318,2298,287669,0.76,0.07,0.2594685314685315,0.79,99.43
2021-01-08,Gujarat,239,0,231,2359,2061,61,10.13,8,71.5,289557,2298,287900,2.88,0.09,0.032993006993006994,0.79,99.43
2021-01-09,Gujarat,730,10,729,9184,3364,1304,7.95,0,71.5,290287,2308,288629,4.7,1.82,0.12844755244755246,0.8,99.43
2021-01-10,Gujarat,416,5,416,5452,956,362,7.63,0,71.5,290703,2313,289045,1.34,0.51,0.07625174825174826,0.8,99.43
2021-01-11,Gujarat,528,7,526,6929,1261,664,7.62,0,71.5,291231,2320,289571,1.76,0.93,0.0969090909090909,0.8,99.43
2021-01-12,Gujarat,667,2,658,8344,3524,3409,7.99,7,71.5,291898,2322,290229,4.93,4.77,0.11669930069930069,0.8,99.43
2021-01-13,Gujarat,257,2,257,3165,2613,1655,8.12,0,71.5,292155,2324,290486,3.65,2.31,0.04426573426573427,0.8,99.43
2021-01-14,Gujarat,729,9,728,8964,3958,2797,8.13,0,71.5,292884,2333,291214,5.54,3.91,0.12537062937062937,0.8,99.43
2021-01-15,Gujarat,1240,4,1237,15488,831,620,8.01,0,71.5,294124,2337,292451,1.16,0.87,0.21661538461538463,0.79,99.43
2021-01-16,Gujarat,1043,12,1039,12767,2897,1648,8.17,0,71.5,295167,2349,293490,4.05,2.3,0.17855944055944056,0.8,99.43
2021-01-17,Gujarat,1166,12,1159,14421,24,7,8.09,0,71.5,296333,2361,294649,0.03,0.01,0.2016923076923077,0.8,99.43
2021-01-18,Gujarat,728,8,725,9133,4873,2499,7.97,0,71.5,297061,2369,295374,6.82,3.5,0.12773426573426575,0.8,99.43
2021-01-19,Gujarat,1357,4,1353,17313,2450,911,7.84,0,71.5,298418,2373,296727,3.43,1.27,0.24213986013986014,0.8,99.43
2021-01-20,Gujarat,1168,16,1159,14881,4336,924,7.85,0,71.5,299586,2389,297886,6.06,1.29,0.20812587412587413,0.8,99.43
2021-01-21,Gujarat,302,2,299,4179,1360,802,7.23,1,71.5,299888,2391,298185,1.9,1.12,0.058447552447552446,0.8,99.43
2021-01-22,Gujarat,1246,10,1246,15948,4243,3263,7.81,0,71.5,301134,2401,299431,5.93,4.56,0.22304895104895106,0.8,99.43
2021-01-23,Gujarat,520,5,513,6200,4569,1419,8.39,2,71.5,301654,2406,299944,6.39,1.98,0.08671328671328671,0.8,99.43
2021-01-24,Gujarat,700,9,699,8803,164,67,7.95,0,71.5,302354,2415,300643,0.23,0.09,0.12311888111888111,0.8,99.43
2021-01-25,Gujarat,197,2,189,2424,4876,3600,8.13,6,71.5,302551,2417,300832,6.82,5.03,0.0339020979020979,0.8,99.43
2021-01-26,Gujarat,1549,18,1549,19398,190,185,7.99,0,71.5,304100,2435,302381,0.27,0.26,0.2713006993006993,0.8,99.43
2021-01-27,Gujarat,1539,11,1537,19214,2111,1173,8.01,0,71.5,305639,2446,303918,2.95,1.64,0.2687272727272727,0.8,99.44
2021-01-28,Gujarat,782,8,777,9304,4723,59,8.4,0,71.5,306421,2454,304695,6.61,0.08,0.13012587412587412,0.8,99.44
2021-01-29,Gujarat,895,3,893,11582,1956,1288,7.73,0,71.5,307316,2457,305588,2.74,1.8,0.16198601398601398,0.8,99.44
2021-01-30,Gujarat,1541,16,1534,19229,764,159,8.01,0,71.5,308857,2473,307122,1.07,0.22,0.26893706293706293,0.8,99.44
2021-01-31,Gujarat,1418,16,1415,17840,604,58,7.95,0,71.5,310275,2489,308537,0.84,0.08,0.2495104895104895,0.8,99.44
2021-02-01,Gujarat,1335,7,1329,16811,422,180,7.94,0,71.5,311610,2496,309866,0.59,0.25,0.23511888111888113,0.8,99.44
2021-02-02,Gujarat,747,5,743,8781,3742,1256,8.51,0,71.5,312357,2501,310609,5.23,1.76,0.12281118881118881,0.8,99.44
2021-02-03,Gujarat,1539,5,1536,19690,3284,2038,7.82,0,71.5,313896,2506,312145,4.59,2.85,0.2753846153846154,0.8,99.44
2021-02-04,Gujarat,145,0,142,1634,1551,887,8.87,3,71.5,314041,2506,312287,2.17,1.24,0.022853146853146853,0.8,99.44
2021-02-05,Gujarat,473,6,473,6042,2329,284,7.83,0,71.5,314514,2512,312760,3.26,0.4,0.0845034965034965,0.8,99.44
2021-02-06,Gujarat,1150,12,1150,14367,2649,109,8.0,0,71.5,315664,2524,313910,3.7,0.15,0.20093706293706293,0.8,99.44
2021-02-07,Gujarat,888,3,884,10991,1747,779,8.08,1,71.5,316552,2527,314794,2.44,1.09,0.1537202797202797,0.8,99.44
2021-02-08,Gujarat,1332,12,1325,16710,714,220,7.97,0,71.5,317884,2539,316119,1.0,0.31,0.2337062937062937,0.8,99.44
2021-02-09,Gujarat,652,4,644,7895,4455,4132,8.26,4,71.5,318536,2543,316763,6.23,5.78,0.11041958041958042,0.8,99.44
2021-02-10,Gujarat,455,5,453,5847,2810,1089,7.78,0,71.5,318991,2548,317216,3.93,1.52,0.08177622377622377,0.8,99.44
2021-02-11,Gujarat,1190,16,1190,15618,1406,336,7.62,0,71.5,320181,2564,318406,1.97,0.47,0.21843356643356643,0.8,99.45
2021-02-12,Gujarat,85,0,85,720,1049,304,11.81,0,71.5,320266,2564,318491,1.47,0.43,0.01006993006993007,0.8,99.45
2021-02-13,Gujarat,161,2,152,1834,1161,1025,8.78,7,71.5,320427,2566,318643,1.62,1.43,0.025650349650349652,0.8,99.44
2021-02-14,Gujarat,1524,20,1523,18947,4424,3087,8.04,0,71.5,321951,2586,320166,6.19,4.32,0.264993006993007,0.8,99.45
2021-02-15,Gujarat,1558,18,1553,19379,3422,2911,8.04,0,71.5,323509,2604,321719,4.79,4.07,0.27103496503496505,0.8,99.45
2021-02-16,Gujarat,1303,10,1301,16484,2713,1256,7.9,0,71.5,324812,2614,323020,3.79,1.76,0.23054545454545455,0.8,99.45
2021-02-17,Gujarat,1030,8,1030,12695,3186,773,8.11,0,71.5,325842,2622,324050,4.46,1.08,0.17755244755244756,0.8,99.45
2021-02-18,Gujarat,1364,16,1356,16947,3904,3524,8.05,0,71.5,327206,2638,325406,5.46,4.93,0.23702097902097902,0.81,99.45
2021-02-19,Gujarat,1294,16,1286,16333,1498,957,7.92,0,71.5,328500,2654,326692,2.1,1.34,0.22843356643356644,0.81,99.45
2021-02-20,Gujarat,667,9,659,8739,2102,1710,7.63,0,71.5,329167,2663,327351,2.94,2.39,0.12222377622377623,0.81,99.45
2021-02-21,Gujarat,1344,10,1336,16713,2651,2387,8.04,0,71.5,330511,2673,328687,3.71,3.34,0.23374825174825176,0.81,99.45
2021-02-22,Gujarat,1343,7,1342,17112,4509,1063,7.85,0,71.5,331854,2680,330029,6.31,1.49,0.23932867132867133,0.81,99.45
2021-02-23,Gujarat,1050,6,1048,13529,176,97,7.76,0,71.5,332904,2686,331077,0.25,0.14,0.18921678321678323,0.81,99.45
2021-02-24,Gujarat,563,4,555,6677,1678,1254,8.43,4,71.5,333467,2690,331632,2.35,1.75,0.09338461538461539,0.81,99.45
2021-02-25,Gujarat,491,6,484,5965,3722,3009,8.23,1,71.5,333958,2696,332116,5.21,4.21,0.08342657342657343,0.81,99.45
2021-02-26,Gujarat,901,10,892,11518,2359,1328,7.82,0,71.5,334859,2706,333008,3.3,1.86,0.1610909090909091,0.81,99.45
2021-02-27,Gujarat,1304,5,1301,16361,2412,298,7.97,0,71.5,336163,2711,334309,3.37,0.42,0.22882517482517484,0.81,99.45
2021-02-28,Gujarat,433,4,431,5104,4632,973,8.48,0,71.5,336596,2715,334740,6.48,1.36,0.07138461538461538,0.81,99.45
2021-03-01,Gujarat,146,0,145,1789,4140,2439,8.16,1,71.5,336742,2715,334885,5.79,3.41,0.02502097902097902,0.81,99.45
2021-03-02,Gujarat,1405,18,1396,17964,3979,3970,7.82,0,71.5,338147,2733,336281,5.57,5.55,0.25124475524475526,0.81,99.45
2021-03-03,Gujarat,1179,9,1172,14269,607,577,8.26,0,71.5,339326,2742,337453,0.85,0.81,0.19956643356643355,0.81,99.45
2021-03-04,Gujarat,661,7,657,7958,2199,1896,8.31,0,71.5,339987,2749,338110,3.08,2.65,0.1113006993006993,0.81,99.45
2021-03-05,Gujarat,1233,18,1231,15384,1331,429,8.01,0,71.5,341220,2767,339341,1.86,0.6,0.21516083916083917,0.81,99.45
2021-03-06,Gujarat,1341,17,1336,17086,841,378,7.85,0,71.5,342561,2784,340677,1.18,0.53,0.23896503496503496,0.81,99.45
2021-03-07,Gujarat,1311,18,1305,16218,4481,1060,8.08,0,71.5,343872,2802,341982,6.27,1.48,0.22682517482517484,0.81,99.45
2021-03-08,Gujarat,844,4,835,10488,4930,4267,8.05,5,71.5,344716,2806,342817,6.9,5.97,0.14668531468531468,0.81,99.45
2021-03-09,Gujarat,292,1,283,3559,879,863,8.2,8,71.5,345008,2807,343100,1.23,1.21,0.049776223776223774,0.81,99.45
2021-03-10,Gujarat,1077,3,1071,13943,2391,1296,7.72,3,71.5,346085,2810,344171,3.34,1.81,0.195006993006993,0.81,99.45
2021-03-11,Gujarat,559,6,556,6778,4183,2864,8.25,0,71.5,346644,2816,344727,5.85,4.01,0.0947972027972028,0.81,99.45
2021-03-12,Gujarat,548,1,541,6688,1630,1332,8.19,6,71.5,347192,2817,345268,2.28,1.86,0.09353846153846154,0.81,99.45
2021-03-13,Gujarat,835,3,827,10515,4851,1746,7.94,5,71.5,348027,2820,346095,6.78,2.44,0.14706293706293705,0.81,99.44
2021-03-14,Gujarat,449,4,449,5645,857,83,7.95,0,71.5,348476,2824,346544,1.2,0.12,0.07895104895104896,0.81,99.45
2021-03-15,Gujarat,1123,11,1122,14119,3746,2473,7.95,0,71.5,349599,2835,347666,5.24,3.46,0.19746853146853147,0.81,99.45
2021-03-16,Gujarat,1538,8,1537,19157,4316,3006,8.03,0,71.5,351137,2843,349203,6.04,4.2,0.2679300699300699,0.81,99.45
2021-03-17,Gujarat,1338,7,1338,16600,498,236,8.06,0,71.5,352475,2850,350541,0.7,0.33,0.23216783216783216,0.81,99.45
2021-03-18,Gujarat,1496,10,1495,18063,1064,891,8.28,0,71.5,353971,2860,352036,1.49,1.25,0.25262937062937063,0.81,99.45
2021-03-19,Gujarat,440,5,439,5480,295,227,8.03,0,71.5,354411,2865,352475,0.41,0.32,0.07664335664335664,0.81,99.45
2021-03-20,Gujarat,441,4,437,5335,1172,915,8.27,0,71.5,354852,2869,352912,1.64,1.28,0.07461538461538461,0.81,99.45
2021-03-21,Gujarat,992,12,992,13013,593,373,7.62,0,71.5,355844,2881,353904,0.83,0.52,0.182,0.81,99.45
2021-03-22,Gujarat,245,3,241,2603,3390,2094,9.41,1,71.5,356089,2884,354145,4.74,2.93,0.036405594405594405,0.81,99.45
2021-03-23,Gujarat,133,1,132,2061,4664,1357,6.45,0,71.5,356222,2885,354277,6.52,1.9,0.028825174825174826,0.81,99.45
2021-03-24,Gujarat,1125,5,1118,14131,3896,1442,7.96,2,71.5,357347,2890,355395,5.45,2.02,0.19763636363636364,0.81,99.45
2021-03-25,Gujarat,962,12,953,12309,877,56,7.82,0,71.5,358309,2902,356348,1.23,0.08,0.17215384615384616,0.81,99.45
2021-03-26,Gujarat,804,10,797,10148,3171,1588,7.92,0,71.5,359113,2912,357145,4.43,2.22,0.14193006993006993,0.81,99.45
2021-03-27,Gujarat,1581,13,1579,19831,3835,1695,7.97,0,71.5,360694,2925,358724,5.36,2.37,0.27735664335664334,0.81,99.45
2021-03-28,Gujarat,195,0,188,2427,2989,1650,8.03,7,71.5,360889,2925,358912,4.18,2.31,0.033944055944055945,0.81,99.45
2021-03-29,Gujarat,1590,18,1590,19989,937,214,7.95,0,71.5,362479,2943,360502,1.31,0.3,0.27956643356643357,0.81,99.45
2021-03-30,Gujarat,882,11,881,10636,1930,701,8.29,0,71.5,363361,2954,361383,2.7,0.98,0.14875524475524476,0.81,99.46
2021-03-31,Gujarat,296,3,293,3190,4472,2733,9.28,0,71.5,363657,2957,361676,6.25,3.82,0.04461538461538461,0.81,99.46
2021-04-01,Gujarat,1470,4,1469,18106,3135,2000,8.12,0,71.5,365127,2961,363145,4.38,2.8,0.2532307692307692,0.81,99.46
2021-04-02,Gujarat,97,1,96,958,1951,1436,10.13,0,71.5,365224,2962,363241,2.73,2.01,0.013398601398601398,0.81,99.46
2021-04-03,Gujarat,252,2,245,2998,2910,480,8.41,5,71.5,365476,2964,363486,4.07,0.67,0.04193006993006993,0.81,99.46
2021-04-04,Gujarat,1233,7,1225,15392,4189,2297,8.01,1,71.5,366709,2971,364711,5.86,3.21,0.21527272727272728,0.81,99.46
2021-04-05,Gujarat,164,1,158,2055,4467,3536,7.98,5,71.5,366873,2972,364869,6.25,4.95,0.02874125874125874,0.81,99.45
2021-04-06,Gujarat,1412,10,1403,17753,4696,2334,7.95,0,71.5,368285,2982,366272,6.57,3.26,0.24829370629370628,0.81,99.45
2021-04-07,Gujarat,790,7,789,9778,2317,2024,8.08,0,71.5,369075,2989,367061,3.24,2.83,0.13675524475524475,0.81,99.45
2021-04-08,Gujarat,766,6,766,9538,755,395,8.03,0,71.5,369841,2995,367827,1.06,0.55,0.1333986013986014,0.81,99.46
2021-04-09,Gujarat,567,2,563,7326,741,103,7.74,2,71.5,370408,2997,368390,1.04,0.14,0.10246153846153847,0.81,99.46
2021-04-10,Gujarat,1025,14,1016,12617,2364,2084,8.12,0,71.5,371433,3011,369406,3.31,2.91,0.17646153846153848,0.81,99.45
2021-04-11,Gujarat,166,1,164,1971,645,218,8.42,1,71.5,371599,3012,369570,0.9,0.3,0.027566433566433568,0.81,99.45
2021-04-12,Gujarat,1261,5,1259,15844,2849,1499,7.96,0,71.5,372860,3017,370829,3.98,2.1,0.2215944055944056,0.81,99.46
2021-04-13,Gujarat,1058,5,1051,12991,4677,1929,8.14,2,71.5,373918,3022,371880,6.54,2.7,0.18169230769230768,0.81,99.45
2021-04-14,Gujarat,51,0,47,934,1266,60,5.46,4,71.5,373969,3022,371927,1.77,0.08,0.013062937062937064,0.81,99.45
2021-04-15,Gujarat,203,1,201,2385,1635,805,8.51,1,71.5,374172,3023,372128,2.29,1.13,0.03335664335664336,0.81,99.45
2021-04-16,Gujarat,1284,11,1281,15798,3408,777,8.13,0,71.5,375456,3034,373409,4.77,1.09,0.22095104895104895,0.81,99.45
2021-04-17,Gujarat,995,3,993,12553,1423,354,7.93,0,71.5,376451,3037,374402,1.99,0.5,0.17556643356643356,0.81,99.46
2021-04-18,Gujarat,246,2,245,2946,1412,1386,8.35,0,71.5,376697,3039,374647,1.97,1.94,0.0412027972027972,0.81,99.46
2021-04-19,Gujarat,1562,6,1556,19414,4058,1877,8.05,0,71.5,378259,3045,376203,5.68,2.63,0.2715244755244755,0.81,99.46
2021-04-20,Gujarat,145,1,137,1695,3318,2741,8.55,7,71.5,378404,3046,376340,4.64,3.83,0.023706293706293707,0.8,99.45
2021-04-21,Gujarat,1095,5,1088,13564,3053,2641,8.07,2,71.5,379499,3051,377428,4.27,3.69,0.18970629370629372,0.8,99.45
2021-04-22,Gujarat,548,5,540,6598,3746,3346,8.31,3,71.5,380047,3056,377968,5.24,4.68,0.09227972027972028,0.8,99.45
2021-04-23,Gujarat,214,1,210,2458,4054,2739,8.71,3,71.5,380261,3057,378178,5.67,3.83,0.034377622377622374,0.8,99.45
2021-04-24,Gujarat,1566,16,1561,19709,1331,202,7.95,0,71.5,381827,3073,379739,1.86,0.28,0.2756503496503496,0.8,99.45
2021-04-25,Gujarat,936,11,927,11965,3759,2252,7.82,0,71.5,382763,3084,380666,5.26,3.15,0.16734265734265735,0.81,99.45
2021-04-26,Gujarat,490,6,482,6055,1569,290,8.09,2,71.5,383253,3090,381148,2.19,0.41,0.08468531468531469,0.81,99.45
2021-04-27,Gujarat,1283,9,1278,15967,1025,829,8.04,0,71.5,384536,3099,382426,1.43,1.16,0.22331468531468532,0.81,99.45
2021-04-28,Gujarat,1215,4,1211,15269,3579,2277,7.96,0,71.5,385751,3103,383637,5.01,3.18,0.21355244755244757,0.8,99.45
2021-04-29,Gujarat,113,1,107,1034,2648,2506,10.93,5,71.5,385864,3104,383744,3.7,3.5,0.014461538461538461,0.8,99.45
2021-04-30,Gujarat,442,4,434,5413,3624,1946,8.17,4,71.5,386306,3108,384178,5.07,2.72,0.07570629370629371,0.8,99.45
2021-05-01,Gujarat,399,3,392,5097,2182,806,7.83,4,71.5,386705,3111,384570,3.05,1.13,0.0712867132867133,0.8,99.45
2021-05-02,Gujarat,288,1,288,3669,500,94,7.85,0,71.5,386993,3112,384858,0.7,0.13,0.05131468531468531,0.8,99.45
2021-05-03,Gujarat,982,12,975,12173,4180,3115,8.07,0,71.5,387975,3124,385833,5.85,4.36,0.17025174825174824,0.81,99.45
2021-05-04,Gujarat,277,1,269,3611,4502,3152,7.67,7,71.5,388252,3125,386102,6.3,4.41,0.0505034965034965,0.8,99.45
2021-05-05,Gujarat,244,0,236,2671,2928,1971,9.14,8,71.5,388496,3125,386338,4.1,2.76,0.037356643356643356,0.8,99.44
2021-05-06,Gujarat,793,4,784,10343,3227,2050,7.67,5,71.5,389289,3129,387122,4.51,2.87,0.14465734265734265,0.8,99.44
2021-05-07,Gujarat,1229,12,1227,15312,2354,842,8.03,0,71.5,390518,3141,388349,3.29,1.18,0.21415384615384617,0.8,99.44
2021-05-08,Gujarat,1156,4,1148,14367,4290,1956,8.05,4,71.5,391674,3145,389497,6.0,2.74,0.20093706293706293,0.8,99.44
2021-05-09,Gujarat,1053,12,1046,13036,933,308,8.08,0,71.5,392727,3157,390543,1.3,0.43,0.1823216783216783,0.8,99.44
2021-05-10,Gujarat,578,8,573,6953,867,563,8.31,0,71.5,393305,3165,391116,1.21,0.79,0.09724475524475525,0.8,99.44
2021-05-11,Gujarat,860,5,859,11204,1,0,7.68,0,71.5,394165,3170,391975,0.0,0.0,0.1566993006993007,0.8,99.44
2021-05-12,Gujarat,257,3,252,3181,3098,840,8.08,2,71.5,394422,3173,392227,4.33,1.17,0.04448951048951049,0.8,99.44
2021-05-13,Gujarat,236,2,227,3166,3396,2880,7.45,7,71.5,394658,3175,392454,4.75,4.03,0.044279720279720276,0.8,99.44
2021-05-14,Gujarat,585,4,582,6769,3060,872,8.64,0,71.5,395243,3179,393036,4.28,1.22,0.09467132867132867,0.8,99.44
2021-05-15,Gujarat,135,1,128,1861,4419,2568,7.25,6,71.5,395378,3180,393164,6.18,3.59,0.026027972027972027,0.8,99.44
2021-05-16,Gujarat,744,5,743,9391,4380,767,7.92,0,71.5,396122,3185,393907,6.13,1.07,0.13134265734265735,0.8,99.44
2021-05-17,Gujarat,409,1,409,5085,1529,555,8.04,0,71.5,396531,3186,394316,2.14,0.78,0.07111888111888112,0.8,99.44
2021-05-18,Gujarat,222,2,213,2577,1551,1005,8.61,7,71.5,396753,3188,394529,2.17,1.41,0.03604195804195804,0.8,99.44
2021-05-19,Gujarat,18,0,15,511,2496,1931,3.52,3,71.5,396771,3188,394544,3.49,2.7,0.007146853146853147,0.8,99.44
2021-05-20,Gujarat,86,0,82,1238,4719,3549,6.95,4,71.5,396857,3188,394626,6.6,4.96,0.017314685314685316,0.8,99.44
2021-05-21,Gujarat,634,4,628,8050,3585,3577,7.88,2,71.5,397491,3192,395254,5.01,5.0,0.11258741258741259,0.8,99.44
2021-05-22,Gujarat,1015,9,1013,12654,4480,1112,8.02,0,71.5,398506,3201,396267,6.27,1.56,0.176979020979021,0.8,99.44
2021-05-23,Gujarat,1290,8,1286,15675,4229,503,8.23,0,71.5,399796,3209,397553,5.91,0.7,0.21923076923076923,0.8,99.44
2021-05-24,Gujarat,344,1,339,4242,3978,3152,8.11,4,71.5,400140,3210,397892,5.56,4.41,0.059328671328671326,0.8,99.44
2021-05-25,Gujarat,80,1,75,967,724,436,8.27,4,71.5,400220,3211,397967,1.01,0.61,0.013524475524475525,0.8,99.44
2021-05-26,Gujarat,73,0,70,1392,1164,465,5.24,3,71.5,400293,3211,398037,1.63,0.65,0.019468531468531468,0.8,99.44
2021-05-27,Gujarat,157,0,153,1720,4367,2706,9.13,4,71.5,400450,3211,398190,6.11,3.78,0.024055944055944058,0.8,99.44
2021-05-28,Gujarat,1207,5,1207,14955,3933,615,8.07,0,71.5,401657,3216,399397,5.5,0.86,0.20916083916083916,0.8,99.44
2021-05-29,Gujarat,796,4,795,9985,1713,278,7.97,0,71.5,402453,3220,400192,2.4,0.39,0.13965034965034964,0.8,99.44
2021-05-30,Gujarat,515,3,510,6262,1130,157,8.22,2,71.5,402968,3223,400702,1.58,0.22,0.08758041958041958,0.8,99.44
2021-05-31,Gujarat,782,3,779,10044,2248,475,7.79,0,71.5,403750,3226,401481,3.14,0.66,0.14047552447552447,0.8,99.44
2021-06-01,Gujarat,1388,5,1381,17364,2749,1435,7.99,2,71.5,405138,3231,402862,3.84,2.01,0.24285314685314685,0.8,99.44
2021-06-02,Gujarat,201,2,198,2398,4846,1191,8.38,1,71.5,405339,3233,403060,6.78,1.67,0.03353846153846154,0.8,99.44
2021-06-03,Gujarat,1013,10,1012,12501,1425,355,8.1,0,71.5,406352,3243,404072,1.99,0.5,0.17483916083916085,0.8,99.44
2021-06-04,Gujarat,1407,15,1406,17387,4921,2580,8.09,0,71.5,407759,3258,405478,6.88,3.61,0.24317482517482517,0.8,99.44
2021-06-05,Gujarat,408,4,407,4981,1312,1047,8.19,0,71.5,408167,3262,405885,1.83,1.46,0.06966433566433566,0.8,99.44
2021-06-06,Gujarat,56,0,56,656,3673,1430,8.54,0,71.5,408223,3262,405941,5.14,2.0,0.009174825174825174,0.8,99.44
2021-06-07,Gujarat,175,1,169,2109,849,476,8.3,5,71.5,408398,3263,406110,1.19,0.67,0.029496503496503495,0.8,99.44
2021-06-08,Gujarat,260,3,251,3288,4952,4432,7.91,6,71.5,408658,3266,406361,6.93,6.2,0.045986013986013985,0.8,99.44
2021-06-09,Gujarat,1308,12,1300,16228,1770,1551,8.06,0,71.5,409966,3278,407661,2.48,2.17,0.22696503496503498,0.8,99.44
2021-06-10,Gujarat,1554,9,1552,19494,32,17,7.97,0,71.5,411520,3287,409213,0.04,0.02,0.27264335664335665,0.8,99.44
2021-06-11,Gujarat,1115,8,1115,13481,3377,2546,8.27,0,71.5,412635,3295,410328,4.72,3.56,0.18854545454545454,0.8,99.44
2021-06-12,Gujarat,263,3,258,3688,3165,2067,7.13,2,71.5,412898,3298,410586,4.43,2.89,0.05158041958041958,0.8,99.44
2021-06-13,Gujarat,171,2,166,2247,1873,75,7.61,3,71.5,413069,3300,410752,2.62,0.1,0.03142657342657343,0.8,99.44
2021-06-14,Gujarat,374,4,369,4557,1103,1095,8.21,1,71.5,413443,3304,411121,1.54,1.53,0.06373426573426573,0.8,99.44
2021-06-15,Gujarat,1109,3,1104,13888,918,619,7.99,2,71.5,414552,3307,412225,1.28,0.87,0.19423776223776223,0.8,99.44
2021-06-16,Gujarat,435,2,431,5658,4908,3625,7.69,2,71.5,414987,3309,412656,6.86,5.07,0.07913286713286713,0.8,99.44
2021-06-17,Gujarat,971,4,966,11858,2596,949,8.19,1,71.5,415958,3313,413622,3.63,1.33,0.16584615384615384,0.8,99.44
2021-06-18,Gujarat,1532,19,1530,19012,4585,2319,8.06,0,71.5,417490,3332,415152,6.41,3.24,0.2659020979020979,0.8,99.44
2021-06-19,Gujarat,181,2,178,2105,28,16,8.6,1,71.5,417671,3334,415330,0.04,0.02,0.02944055944055944,0.8,99.44
2021-06-20,Gujarat,1423,18,1422,17784,1540,478,8.0,0,71.5,419094,3352,416752,2.15,0.67,0.2487272727272727,0.8,99.44
2021-06-21,Gujarat,1297,18,1294,15890,4306,967,8.16,0,71.5,420391,3370,418046,6.02,1.35,0.22223776223776223,0.8,99.44
2021-06-22,Gujarat,276,2,267,3447,2164,109,8.01,7,71.5,420667,3372,418313,3.03,0.15,0.04820979020979021,0.8,99.44
2021-06-23,Gujarat,151,2,143,1796,3417,2892,8.41,6,71.5,420818,3374,418456,4.78,4.04,0.02511888111888112,0.8,99.44
2021-06-24,Gujarat,1276,13,1267,16160,3676,3030,7.9,0,71.5,422094,3387,419723,5.14,4.24,0.226013986013986,0.8,99.44
2021-06-25,Gujarat,525,4,518,6781,4915,1528,7.74,3,71.5,422619,3391,420241,6.87,2.14,0.09483916083916084,0.8,99.44
2021-06-26,Gujarat,288,0,285,3274,3970,1531,8.8,3,71.5,422907,3391,420526,5.55,2.14,0.04579020979020979,0.8,99.44
2021-06-27,Gujarat,1352,6,1352,17008,3756,543,7.95,0,71.5,424259,3397,421878,5.25,0.76,0.23787412587412587,0.8,99.44
2021-06-28,Gujarat,287,3,285,3246,444,314,8.84,0,71.5,424546,3400,422163,0.62,0.44,0.0453986013986014,0.8,99.44
2021-06-29,Gujarat,157,1,151,2415,4711,2606,6.5,5,71.5,424703,3401,422314,6.59,3.64,0.033776223776223774,0.8,99.44
2021-06-30,Gujarat,844,7,844,11077,4501,4099,7.62,0,71.5,425547,3408,423158,6.3,5.73,0.1549230769230769,0.8,99.44
2021-07-01,Gujarat,1532,11,1532,18950,1035,174,8.08,0,71.5,427079,3419,424690,1.45,0.24,0.26503496503496504,0.8,99.44
2021-07-02,Gujarat,105,0,100,1034,3187,537,10.15,5,71.5,427184,3419,424790,4.46,0.75,0.014461538461538461,0.8,99.44
2021-07-03,Gujarat,1139,12,1139,14201,2009,1445,8.02,0,71.5,428323,3431,425929,2.81,2.02,0.1986153846153846,0.8,99.44
2021-07-04,Gujarat,47,0,46,614,1102,824,7.65,1,71.5,428370,3431,425975,1.54,1.15,0.008587412587412588,0.8,99.44
2021-07-05,Gujarat,616,4,610,7917,2230,1069,7.78,2,71.5,428986,3435,426585,3.12,1.5,0.11072727272727273,0.8,99.44
2021-07-06,Gujarat,1190,14,1190,14979,3805,3073,7.94,0,71.5,430176,3449,427775,5.32,4.3,0.2094965034965035,0.8,99.44
2021-07-07,Gujarat,193,1,185,2182,2488,381,8.85,7,71.5,430369,3450,427960,3.48,0.53,0.030517482517482517,0.8,99.44
2021-07-08,Gujarat,1464,15,1458,18249,28,13,8.02,0,71.5,431833,3465,429418,0.04,0.02,0.2552307692307692,0.8,99.44
2021-07-09,Gujarat,740,4,737,9120,1889,7,8.11,0,71.5,432573,3469,430155,2.64,0.01,0.12755244755244755,0.8,99.44
2021-07-10,Gujarat,650,2,650,8348,1624,1583,7.79,0,71.5,433223,3471,430805,2.27,2.21,0.11675524475524475,0.8,99.44
2021-07-11,Gujarat,389,1,384,4492,4751,2428,8.66,4,71.5,433612,3472,431189,6.64,3.4,0.06282517482517483,0.8,99.44
2021-07-12,Gujarat,365,1,359,4453,3908,1572,8.2,5,71.5,433977,3473,431548,5.47,2.2,0.06227972027972028,0.8,99.44
2021-07-13,Gujarat,655,4,650,7984,763,508,8.2,1,71.5,434632,3477,432198,1.07,0.71,0.11166433566433566,0.8,99.44
2021-07-14,Gujarat,917,8,912,11459,84,36,8.0,0,71.5,435549,3485,433110,0.12,0.05,0.16026573426573426,0.8,99.44
2021-07-15,Gujarat,90,1,90,1308,4624,2354,6.88,0,71.5,435639,3486,433200,6.47,3.29,0.018293706293706295,0.8,99.44
2021-07-16,Gujarat,756,6,751,9592,4595,3340,7.88,0,71.5,436395,3492,433951,6.43,4.67,0.13415384615384615,0.8,99.44
2021-07-17,Gujarat,346,1,345,4126,3415,1286,8.39,0,71.5,436741,3493,434296,4.78,1.8,0.0577062937062937,0.8,99.44
2021-07-18,Gujarat,968,10,964,11343,301,46,8.53,0,71.5,437709,3503,435260,0.42,0.06,0.15864335664335663,0.8,99.44
2021-07-19,Gujarat,106,0,103,1180,4517,2517,8.98,3,71.5,437815,3503,435363,6.32,3.52,0.016503496503496504,0.8,99.44
2021-07-20,Gujarat,779,8,779,9333,4086,3886,8.35,0,71.5,438594,3511,436142,5.71,5.43,0.13053146853146852,0.8,99.44
2021-07-21,Gujarat,381,4,375,4417,2315,842,8.63,2,71.5,438975,3515,436517,3.24,1.18,0.06177622377622378,0.8,99.44
2021-07-22,Gujarat,637,7,630,7783,3769,132,8.18,0,71.5,439612,3522,437147,5.27,0.18,0.10885314685314686,0.8,99.44
2021-07-23,Gujarat,1591,5,1582,19653,272,258,8.1,4,71.5,441203,3527,438729,0.38,0.36,0.2748671328671329,0.8,99.44
2021-07-24,Gujarat,426,6,424,5691,2109,2048,7.49,0,71.5,441629,3533,439153,2.95,2.86,0.0795944055944056,0.8,99.44
2021-07-25,Gujarat,711,7,705,9026,4005,1171,7.88,0,71.5,442340,3540,439858,5.6,1.64,0.12623776223776223,0.8,99.44
2021-07-26,Gujarat,1198,11,1198,15086,1846,1104,7.94,0,71.5,443538,3551,441056,2.58,1.54,0.210993006993007,0.8,99.44
2021-07-27,Gujarat,1580,21,1573,19255,4776,4630,8.21,0,71.5,445118,3572,442629,6.68,6.48,0.2693006993006993,0.8,99.44
2021-07-28,Gujarat,844,4,844,10753,4130,3136,7.85,0,71.5,445962,3576,443473,5.78,4.39,0.1503916083916084,0.8,99.44
2021-07-29,Gujarat,274,1,265,3567,2649,2092,7.68,8,71.5,446236,3577,443738,3.7,2.93,0.04988811188811189,0.8,99.44
2021-07-30,Gujarat,1083,12,1078,13944,3265,1377,7.77,0,71.5,447319,3589,444816,4.57,1.93,0.195020979020979,0.8,99.44
2021-07-31,Gujarat,1213,9,1212,15463,3424,706,7.84,0,71.5,448532,3598,446028,4.79,0.99,0.21626573426573426,0.8,99.44
2021-08-01,Gujarat,471,5,471,5948,4639,2573,7.92,0,71.5,449003,3603,446499,6.49,3.6,0.08318881118881119,0.8,99.44
2021-08-02,Gujarat,681,5,677,8436,2932,2042,8.07,0,71.5,449684,3608,447176,4.1,2.86,0.11798601398601398,0.8,99.44
2021-08-03,Gujarat,1074,11,1074,13539,1077,1006,7.93,0,71.5,450758,3619,448250,1.51,1.41,0.18935664335664334,0.8,99.44
2021-08-04,Gujarat,885,12,881,11247,202,29,7.87,0,71.5,451643,3631,449131,0.28,0.04,0.1573006993006993,0.8,99.44
2021-08-05,Gujarat,291,1,287,3472,2638,2435,8.38,3,71.5,451934,3632,449418,3.69,3.41,0.04855944055944056,0.8,99.44
2021-08-06,Gujarat,209,1,208,2665,1206,784,7.84,0,71.5,452143,3633,449626,1.69,1.1,0.03727272727272727,0.8,99.44
2021-08-07,Gujarat,684,7,679,8343,3779,2483,8.2,0,71.5,452827,3640,450305,5.29,3.47,0.11668531468531469,0.8,99.44
2021-08-08,Gujarat,627,3,623,8265,3117,1321,7.59,1,71.5,453454,3643,450928,4.36,1.85,0.11559440559440559,0.8,99.44
2021-08-09,Gujarat,1451,11,1448,18169,2285,1490,7.99,0,71.5,454905,3654,452376,3.2,2.08,0.2541118881118881,0.8,99.44
2021-08-10,Gujarat,1331,9,1330,16857,2873,2122,7.9,0,71.5,456236,3663,453706,4.02,2.97,0.23576223776223776,0.8,99.45
2021-08-11,Gujarat,526,5,525,6629,1551,1483,7.93,0,71.5,456762,3668,454231,2.17,2.07,0.09271328671328671,0.8,99.45
2021-08-12,Gujarat,1378,20,1374,17042,172,10,8.09,0,71.5,458140,3688,455605,0.24,0.01,0.23834965034965036,0.8,99.45
2021-08-13,Gujarat,1081,6,1078,13593,3808,1902,7.95,0,71.5,459221,3694,456683,5.33,2.66,0.19011188811188812,0.8,99.45
2021-08-14,Gujarat,1176,17,1172,15009,3191,2766,7.84,0,71.5,460397,3711,457855,4.46,3.87,0.2099160839160839,0.81,99.45
2021-08-15,Gujarat,1259,6,1251,15991,1572,243,7.87,2,71.5,461656,3717,459106,2.2,0.34,0.22365034965034966,0.81,99.45
2021-08-16,Gujarat,909,13,907,11828,3846,801,7.69,0,71.5,462565,3730,460013,5.38,1.12,0.16542657342657344,0.81,99.45
2021-08-17,Gujarat,846,11,840,10232,3047,1769,8.27,0,71.5,463411,3741,460853,4.26,2.47,0.1431048951048951,0.81,99.45
2021-08-18,Gujarat,556,3,556,6990,986,200,7.95,0,71.5,463967,3744,461409,1.38,0.28,0.09776223776223776,0.81,99.45
2021-08-19,Gujarat,165,2,160,1962,1879,1013,8.41,3,71.5,464132,3746,461569,2.63,1.42,0.02744055944055944,0.81,99.45
2021-08-20,Gujarat,1345,5,1345,16930,4797,4781,7.94,0,71.5,465477,3751,462914,6.71,6.69,0.2367832167832168,0.81,99.45
2021-08-21,Gujarat,1500,15,1493,18640,1548,1318,8.05,0,71.5,466977,3766,464407,2.17,1.84,0.2606993006993007,0.81,99.45
2021-08-22,Gujarat,1410,17,1407,17566,3663,1624,8.03,0,71.5,468387,3783,465814,5.12,2.27,0.24567832167832168,0.81,99.45
2021-08-23,Gujarat,1588,8,1585,19949,3597,779,7.96,0,71.5,469975,3791,467399,5.03,1.09,0.279006993006993,0.81,99.45
2021-08-24,Gujarat,1489,9,1483,18231,4365,2642,8.17,0,71.5,471464,3800,468882,6.1,3.7,0.254979020979021,0.81,99.45
2021-08-25,Gujarat,752,8,751,9821,633,86,7.66,0,71.5,472216,3808,469633,0.89,0.12,0.13735664335664335,0.81,99.45
2021-08-26,Gujarat,1150,12,1142,14197,203,27,8.1,0,71.5,473366,3820,470775,0.28,0.04,0.19855944055944055,0.81,99.45
2021-08-27,Gujarat,125,1,125,1719,2028,317,7.27,0,71.5,473491,3821,470900,2.84,0.44,0.024041958041958043,0.81,99.45
2021-08-28,Gujarat,364,2,359,4540,4829,2993,8.02,3,71.5,473855,3823,471259,6.75,4.19,0.0634965034965035,0.81,99.45
2021-08-29,Gujarat,1580,7,1572,19925,3388,2131,7.93,1,71.5,475435,3830,472831,4.74,2.98,0.27867132867132866,0.81,99.45
2021-08-30,Gujarat,1420,13,1419,17379,2388,225,8.17,0,71.5,476855,3843,474250,3.34,0.31,0.24306293706293705,0.81,99.45
2021-08-31,Gujarat,996,8,993,12846,2941,1609,7.75,0,71.5,477851,3851,475243,4.11,2.25,0.17966433566433568,0.81,99.45
2021-09-01,Gujarat,396,2,388,5058,1876,509,7.83,6,71.5,478247,3853,475631,2.62,0.71,0.07074125874125874,0.81,99.45
2021-09-02,Gujarat,1394,11,1385,17425,393,128,8.0,0,71.5,479641,3864,477016,0.55,0.18,0.2437062937062937,0.81,99.45
2021-09-03,Gujarat,1418,14,1409,17630,2019,1403,8.04,0,71.5,481059,3878,478425,2.82,1.96,0.24657342657342657,0.81,99.45
2021-09-04,Gujarat,1137,4,1134,13977,1610,697,8.13,0,71.5,482196,3882,479559,2.25,0.97,0.1954825174825175,0.81,99.45
2021-09-05,Gujarat,1525,9,1524,19086,830,522,7.99,0,71.5,483721,3891,481083,1.16,0.73,0.26693706293706293,0.8,99.45
2021-09-06,Gujarat,1241,6,1235,15070,4606,1463,8.23,0,71.5,484962,3897,482318,6.44,2.05,0.21076923076923076,0.8,99.45
2021-09-07,Gujarat,329,2,322,3915,3157,504,8.4,5,71.5,485291,3899,482640,4.42,0.7,0.05475524475524476,0.8,99.45
2021-09-08,Gujarat,1424,6,1421,17552,1148,779,8.11,0,71.5,486715,3905,484061,1.61,1.09,0.24548251748251748,0.8,99.45
2021-09-09,Gujarat,1027,6,1019,12700,1953,404,8.09,2,71.5,487742,3911,485080,2.73,0.57,0.17762237762237762,0.8,99.45
2021-09-10,Gujarat,103,1,99,902,164,81,11.42,3,71.5,487845,3912,485179,0.23,0.11,0.012615384615384615,0.8,99.45
2021-09-11,Gujarat,89,0,85,812,1546,263,10.96,4,71.5,487934,3912,485264,2.16,0.37,0.011356643356643357,0.8,99.45
2021-09-12,Gujarat,990,7,981,12255,468,272,8.08,2,71.5,488924,3919,486245,0.65,0.38,0.17139860139860139,0.8,99.45
2021-09-13,Gujarat,820,9,820,9762,3039,1236,8.4,0,71.5,489744,3928,487065,4.25,1.73,0.13653146853146853,0.8,99.45
2021-09-14,Gujarat,1046,8,1045,13037,4184,1736,8.02,0,71.5,490790,3936,488110,5.85,2.43,0.18233566433566434,0.8,99.45
2021-09-15,Gujarat,346,3,345,4405,108,107,7.85,0,71.5,491136,3939,488455,0.15,0.15,0.061608391608391606,0.8,99.45
2021-09-16,Gujarat,413,2,408,5490,2472,1292,7.52,3,71.5,491549,3941,488863,3.46,1.81,0.07678321678321678,0.8,99.45
2021-09-17,Gujarat,1546,21,1544,19422,704,561,7.96,0,71.5,493095,3962,490407,0.98,0.78,0.2716363636363636,0.8,99.45
2021-09-18,Gujarat,554,6,548,7222,4536,1237,7.67,0,71.5,493649,3968,490955,6.34,1.73,0.101006993006993,0.8,99.45
2021-09-19,Gujarat,647,2,643,7754,601,125,8.34,2,71.5,494296,3970,491598,0.84,0.17,0.10844755244755244,0.8,99.45
2021-09-20,Gujarat,775,10,769,9379,712,59,8.26,0,71.5,495071,3980,492367,1.0,0.08,0.13117482517482518,0.8,99.45
2021-09-21,Gujarat,651,7,649,8272,3311,1837,7.87,0,71.5,495722,3987,493016,4.63,2.57,0.11569230769230769,0.8,99.45
2021-09-22,Gujarat,796,11,795,10581,4949,2202,7.52,0,71.5,496518,3998,493811,6.92,3.08,0.147986013986014,0.81,99.45
2021-09-23,Gujarat,177,0,170,2712,686,356,6.53,7,71.5,496695,3998,493981,0.96,0.5,0.03793006993006993,0.8,99.45
2021-09-24,Gujarat,1555,16,1549,19204,1430,441,8.1,0,71.5,498250,4014,495530,2.0,0.62,0.2685874125874126,0.81,99.45
2021-09-25,Gujarat,732,8,730,8700,2989,1664,8.41,0,71.5,498982,4022,496260,4.18,2.33,0.12167832167832168,0.81,99.45
2021-09-26,Gujarat,301,2,296,3917,3526,2609,7.68,3,71.5,499283,4024,496556,4.93,3.65,0.054783216783216786,0.81,99.45
2021-09-27,Gujarat,467,2,458,5624,1750,1464,8.3,7,71.5,499750,4026,497014,2.45,2.05,0.07865734265734266,0.81,99.45
2021-09-28,Gujarat,367,2,363,5166,2694,2287,7.1,2,71.5,500117,4028,497377,3.77,3.2,0.07225174825174825,0.81,99.45
2021-09-29,Gujarat,161,1,158,1911,1857,1024,8.42,2,71.5,500278,4029,497535,2.6,1.43,0.026727272727272728,0.81,99.45
2021-09-30,Gujarat,465,3,460,5667,1168,390,8.21,2,71.5,500743,4032,497995,1.63,0.55,0.07925874125874126,0.81,99.45
2021-10-01,Gujarat,1006,10,1002,12475,1311,1217,8.06,0,71.5,501749,4042,498997,1.83,1.7,0.17447552447552447,0.81,99.45
2021-10-02,Gujarat,1619,13,1619,19975,3626,2284,8.11,0,71.5,503368,4055,500616,5.07,3.19,0.2793706293706294,0.81,99.45
2021-10-03,Gujarat,757,9,751,9252,4532,3399,8.18,0,71.5,504125,4064,501367,6.34,4.75,0.1293986013986014,0.81,99.45
2021-10-04,Gujarat,1348,17,1342,16669,1515,1263,8.09,0,71.5,505473,4081,502709,2.12,1.77,0.23313286713286713,0.81,99.45
2021-10-05,Gujarat,1109,15,1103,13941,3268,1573,7.95,0,71.5,506582,4096,503812,4.57,2.2,0.19497902097902098,0.81,99.45
2021-10-06,Gujarat,1351,5,1342,16485,2072,544,8.2,4,71.5,507933,4101,505154,2.9,0.76,0.23055944055944055,0.81,99.45
2021-10-07,Gujarat,711,6,706,8686,4431,1534,8.19,0,71.5,508644,4107,505860,6.2,2.15,0.12148251748251748,0.81,99.45
2021-10-08,Gujarat,97,0,97,1300,1290,1093,7.46,0,71.5,508741,4107,505957,1.8,1.53,0.01818181818181818,0.81,99.45
2021-10-09,Gujarat,354,2,352,4545,2080,760,7.79,0,71.5,509095,4109,506309,2.91,1.06,0.06356643356643357,0.81,99.45
2021-10-10,Gujarat,771,5,764,9840,479,290,7.84,2,71.5,509866,4114,507073,0.67,0.41,0.1376223776223776,0.81,99.45
2021-10-11,Gujarat,1497,4,1496,18628,4349,3328,8.04,0,71.5,511363,4118,508569,6.08,4.65,0.2605314685314685,0.81,99.45
2021-10-12,Gujarat,753,8,744,9124,2678,1947,8.25,1,71.5,512116,4126,509313,3.75,2.72,0.1276083916083916,0.81,99.45
2021-10-13,Gujarat,1126,12,1121,13650,1023,884,8.25,0,71.5,513242,4138,510434,1.43,1.24,0.19090909090909092,0.81,99.45
2021-10-14,Gujarat,460,3,457,5880,4669,1084,7.82,0,71.5,513702,4141,510891,6.53,1.52,0.08223776223776223,0.81,99.45
2021-10-15,Gujarat,1137,11,1128,14384,2186,2007,7.9,0,71.5,514839,4152,512019,3.06,2.81,0.20117482517482518,0.81,99.45
2021-10-16,Gujarat,1140,14,1138,14431,4437,2353,7.9,0,71.5,515979,4166,513157,6.21,3.29,0.20183216783216784,0.81,99.45
2021-10-17,Gujarat,172,1,172,2091,3868,2838,8.23,0,71.5,516151,4167,513329,5.41,3.97,0.029244755244755245,0.81,99.45
2021-10-18,Gujarat,851,7,849,10337,1683,1245,8.23,0,71.5,517002,4174,514178,2.35,1.74,0.14457342657342656,0.81,99.45
2021-10-19,Gujarat,687,7,683,8766,4563,2581,7.84,0,71.5,517689,4181,514861,6.38,3.61,0.1226013986013986,0.81,99.45
2021-10-20,Gujarat,1229,9,1229,15766,2366,1264,7.8,0,71.5,518918,4190,516090,3.31,1.77,0.22050349650349652,0.81,99.46
2021-10-21,Gujarat,781,6,773,9231,1863,1442,8.46,2,71.5,519699,4196,516863,2.61,2.02,0.12910489510489512,0.81,99.45
2021-10-22,Gujarat,258,1,251,3564,1411,1377,7.24,6,71.5,519957,4197,517114,1.97,1.93,0.049846153846153846,0.81,99.45
2021-10-23,Gujarat,371,4,371,4851,3812,493,7.65,0,71.5,520328,4201,517485,5.33,0.69,0.06784615384615385,0.81,99.45
2021-10-24,Gujarat,304,3,296,3601,4887,552,8.44,5,71.5,520632,4204,517781,6.83,0.77,0.05036363636363636,0.81,99.45
2021-10-25,Gujarat,45,0,37,710,825,543,6.34,8,71.5,520677,4204,517818,1.15,0.76,0.00993006993006993,0.81,99.45
2021-10-26,Gujarat,840,12,836,10807,1836,1082,7.77,0,71.5,521517,4216,518654,2.57,1.51,0.15114685314685314,0.81,99.45
2021-10-27,Gujarat,1359,18,1357,17118,2325,1107,7.94,0,71.5,522876,4234,520011,3.25,1.55,0.23941258741258742,0.81,99.45
2021-10-28,Gujarat,122,0,114,1720,3350,1088,7.09,8,71.5,522998,4234,520125,4.69,1.52,0.024055944055944058,0.81,99.45
2021-10-29,Gujarat,921,10,921,11145,205,154,8.26,0,71.5,523919,4244,521046,0.29,0.22,0.15587412587412589,0.81,99.45
2021-10-30,Gujarat,842,8,833,10555,814,76,7.98,1,71.5,524761,4252,521879,1.14,0.11,0.14762237762237762,0.81,99.45
2021-10-31,Gujarat,1594,18,1593,19738,1422,15,8.08,0,71.5,526355,4270,523472,1.99,0.02,0.2760559440559441,0.81,99.45
2021-11-01,Gujarat,1221,11,1221,15154,1798,1637,8.06,0,71.5,527576,4281,524693,2.51,2.29,0.21194405594405594,0.81,99.45
2021-11-02,Gujarat,1076,9,1072,13486,3250,1299,7.98,0,71.5,528652,4290,525765,4.55,1.82,0.18861538461538463,0.81,99.45
2021-11-03,Gujarat,638,4,632,7990,3020,722,7.98,2,71.5,529290,4294,526397,4.22,1.01,0.11174825174825175,0.81,99.45
2021-11-04,Gujarat,1003,3,999,13023,760,713,7.7,1,71.5,530293,4297,527396,1.06,1.0,0.18213986013986014,0.81,99.45
2021-11-05,Gujarat,1255,5,1250,16154,4754,2181,7.77,0,71.5,531548,4302,528646,6.65,3.05,0.22593006993006992,0.81,99.45
2021-11-06,Gujarat,93,0,89,1339,3307,1200,6.95,4,71.5,531641,4302,528735,4.63,1.68,0.018727272727272728,0.81,99.45
2021-11-07,Gujarat,193,2,190,2462,4062,2311,7.84,1,71.5,531834,4304,528925,5.68,3.23,0.03443356643356643,0.81,99.45
2021-11-08,Gujarat,727,7,726,9306,3208,1503,7.81,0,71.5,532561,4311,529651,4.49,2.1,0.13015384615384615,0.81,99.45
2021-11-09,Gujarat,613,7,610,7633,9,6,8.03,0,71.5,533174,4318,530261,0.01,0.01,0.10675524475524475,0.81,99.45
2021-11-10,Gujarat,496,2,496,6359,2355,374,7.8,0,71.5,533670,4320,530757,3.29,0.52,0.08893706293706294,0.81,99.45
2021-11-11,Gujarat,1085,9,1084,13490,1898,1837,8.04,0,71.5,534755,4329,531841,2.65,2.57,0.18867132867132866,0.81,99.46
2021-11-12,Gujarat,545,6,536,6978,3133,2625,7.81,3,71.5,535300,4335,532377,4.38,3.67,0.09759440559440559,0.81,99.45
2021-11-13,Gujarat,744,9,735,9516,4145,1949,7.82,0,71.5,536044,4344,533112,5.8,2.73,0.1330909090909091,0.81,99.45
2021-11-14,Gujarat,1512,10,1509,19237,2082,845,7.86,0,71.5,537556,4354,534621,2.91,1.18,0.26904895104895105,0.81,99.45
2021-11-15,Gujarat,375,3,373,4685,550,3,8.0,0,71.5,537931,4357,534994,0.77,0.0,0.06552447552447553,0.81,99.45
2021-11-16,Gujarat,555,4,547,6795,249,137,8.17,4,71.5,538486,4361,535541,0.35,0.19,0.09503496503496503,0.81,99.45
2021-11-17,Gujarat,1212,12,1204,14893,4539,1799,8.14,0,71.5,539698,4373,536745,6.35,2.52,0.2082937062937063,0.81,99.45
2021-11-18,Gujarat,1352,4,1350,16616,1146,614,8.14,0,71.5,541050,4377,538095,1.6,0.86,0.23239160839160838,0.81,99.45
2021-11-19,Gujarat,286,3,278,4120,2416,496,6.94,5,71.5,541336,4380,538373,3.38,0.69,0.057622377622377624,0.81,99.45
2021-11-20,Gujarat,812,3,810,9923,3682,1354,8.18,0,71.5,542148,4383,539183,5.15,1.89,0.13878321678321678,0.81,99.45
2021-11-21,Gujarat,1241,14,1236,15832,4136,518,7.84,0,71.5,543389,4397,540419,5.78,0.72,0.22142657342657343,0.81,99.45
2021-11-22,Gujarat,118,0,109,1745,2421,820,6.76,9,71.5,543507,4397,540528,3.39,1.15,0.024405594405594404,0.81,99.45
2021-11-23,Gujarat,92,0,83,953,1717,390,9.65,9,71.5,543599,4397,540611,2.4,0.55,0.013328671328671328,0.81,99.45
2021-11-24,Gujarat,728,6,727,8936,3917,2338,8.15,0,71.5,544327,4403,541338,5.48,3.27,0.12497902097902099,0.81,99.45
2021-11-25,Gujarat,1007,11,1003,12880,444,319,7.82,0,71.5,545334,4414,542341,0.62,0.45,0.18013986013986014,0.81,99.45
2021-11-26,Gujarat,896,11,890,11150,2894,2596,8.04,0,71.5,546230,4425,543231,4.05,3.63,0.15594405594405594,0.81,99.45
2021-11-27,Gujarat,294,2,289,3427,401,126,8.58,3,71.5,546524,4427,543520,0.56,0.18,0.04793006993006993,0.81,99.45
2021-11-28,Gujarat,1471,10,1470,18799,3386,2824,7.82,0,71.5,547995,4437,544990,4.74,3.95,0.2629230769230769,0.81,99.45
2021-11-29,Gujarat,233,2,232,2636,2877,2146,8.84,0,71.5,548228,4439,545222,4.02,3.0,0.03686713286713287,0.81,99.45
2021-11-30,Gujarat,750,3,749,9271,1194,49,8.09,0,71.5,548978,4442,545971,1.67,0.07,0.12966433566433566,0.81,99.45
2021-12-01,Gujarat,1190,11,1189,14750,2839,513,8.07,0,71.5,550168,4453,547160,3.97,0.72,0.2062937062937063,0.81,99.45
2021-12-02,Gujarat,497,5,489,5885,3408,3160,8.45,3,71.5,550665,4458,547649,4.77,4.42,0.0823076923076923,0.81,99.45
2021-12-03,Gujarat,1468,15,1461,18521,2888,2053,7.93,0,71.5,552133,4473,549110,4.04,2.87,0.25903496503496504,0.81,99.45
2021-12-04,Gujarat,252,3,252,3090,1389,293,8.16,0,71.5,552385,4476,549362,1.94,0.41,0.04321678321678322,0.81,99.45
2021-12-05,Gujarat,949,4,945,11368,769,305,8.35,0,71.5,553334,4480,550307,1.08,0.43,0.158993006993007,0.81,99.45
2021-12-06,Gujarat,941,11,938,12050,2482,1960,7.81,0,71.5,554275,4491,551245,3.47,2.74,0.16853146853146853,0.81,99.45
2021-12-07,Gujarat,1494,12,1485,19075,3186,2214,7.83,0,71.5,555769,4503,552730,4.46,3.1,0.26678321678321676,0.81,99.45
2021-12-08,Gujarat,984,4,984,12003,2017,146,8.2,0,71.5,556753,4507,553714,2.82,0.2,0.16787412587412587,0.81,99.45
2021-12-09,Gujarat,1222,12,1213,15318,3383,1270,7.98,0,71.5,557975,4519,554927,4.73,1.78,0.21423776223776222,0.81,99.45
2021-12-10,Gujarat,1217,10,1208,15256,2847,1268,7.98,0,71.5,559192,4529,556135,3.98,1.77,0.21337062937062937,0.81,99.45
2021-12-11,Gujarat,900,8,893,11362,2638,2578,7.92,0,71.5,560092,4537,557028,3.69,3.61,0.15890909090909092,0.81,99.45
2021-12-12,Gujarat,381,4,376,5012,2052,54,7.6,1,71.5,560473,4541,557404,2.87,0.08,0.07009790209790209,0.81,99.45
2021-12-13,Gujarat,1347,14,1343,16772,4617,3271,8.03,0,71.5,561820,4555,558747,6.46,4.57,0.23457342657342659,0.81,99.45
2021-12-14,Gujarat,446,5,441,5918,2598,1373,7.54,0,71.5,562266,4560,559188,3.63,1.92,0.08276923076923078,0.81,99.45
2021-12-15,Gujarat,1206,9,1203,14758,1008,124,8.17,0,71.5,563472,4569,560391,1.41,0.17,0.20640559440559442,0.81,99.45
2021-12-16,Gujarat,727,3,720,9502,4711,4018,7.65,4,71.5,564199,4572,561111,6.59,5.62,0.1328951048951049,0.81,99.45
2021-12-17,Gujarat,1068,6,1063,13361,2306,489,7.99,0,71.5,565267,4578,562174,3.23,0.68,0.18686713286713286,0.81,99.45
2021-12-18,Gujarat,653,7,646,8345,2962,2014,7.83,0,71.5,565920,4585,562820,4.14,2.82,0.1167132867132867,0.81,99.45
2021-12-19,Gujarat,829,8,824,10705,1864,1370,7.74,0,71.5,566749,4593,563644,2.61,1.92,0.1497202797202797,0.81,99.45
2021-12-20,Gujarat,601,2,598,7570,1170,1040,7.94,1,71.5,567350,4595,564242,1.64,1.45,0.10587412587412587,0.81,99.45
2021-12-21,Gujarat,513,7,511,6367,2515,1297,8.06,0,71.5,567863,4602,564753,3.52,1.81,0.08904895104895105,0.81,99.45
2021-12-22,Gujarat,797,9,791,9580,873,505,8.32,0,71.5,568660,4611,565544,1.22,0.71,0.13398601398601398,0.81,99.45
2021-12-23,Gujarat,1084,11,1082,13920,1642,177,7.79,0,71.5,569744,4622,566626,2.3,0.25,0.1946853146853147,0.81,99.45
2021-12-24,Gujarat,245,3,245,3214,970,761,7.62,0,71.5,569989,4625,566871,1.36,1.06,0.04495104895104895,0.81,99.45
2021-12-25,Gujarat,304,3,299,3854,3913,1391,7.89,2,71.5,570293,4628,567170,5.47,1.95,0.0539020979020979,0.81,99.45
2021-12-26,Gujarat,1505,14,1501,19262,3526,965,7.81,0,71.5,571798,4642,568671,4.93,1.35,0.2693986013986014,0.81,99.45
2021-12-27,Gujarat,672,10,663,8324,2994,1662,8.07,0,71.5,572470,4652,569334,4.19,2.32,0.11641958041958042,0.81,99.45
2021-12-28,Gujarat,466,4,458,5607,1439,988,8.31,4,71.5,572936,4656,569792,2.01,1.38,0.07841958041958041,0.81,99.45
2021-12-29,Gujarat,685,6,679,8779,648,620,7.8,0,71.5,573621,4662,570471,0.91,0.87,0.12278321678321678,0.81,99.45
2021-12-30,Gujarat,1074,9,1070,12985,3943,1146,8.27,0,71.5,574695,4671,571541,5.51,1.6,0.1816083916083916,0.81,99.45
2021-12-31,Gujarat,99,0,91,1218,266,118,8.13,8,71.5,574794,4671,571632,0.37,0.17,0.017034965034965033,0.81,99.45
2022-01-01,Gujarat,178,2,173,2137,3460,1598,8.33,3,71.5,574972,4673,571805,4.84,2.23,0.029888111888111888,0.81,99.45
2022-01-02,Gujarat,723,6,720,9453,1014,444,7.65,0,71.5,575695,4679,572525,1.42,0.62,0.1322097902097902,0.81,99.45
2022-01-03,Gujarat,770,11,767,9587,2576,423,8.03,0,71.5,576465,4690,573292,3.6,0.59,0.1340839160839161,0.81,99.45
2022-01-04,Gujarat,744,3,737,9532,3460,559,7.81,4,71.5,577209,4693,574029,4.84,0.78,0.13331468531468532,0.81,99.45
2022-01-05,Gujarat,219,3,219,2797,4131,2173,7.83,0,71.5,577428,4696,574248,5.78,3.04,0.03911888111888112,0.81,99.45
2022-01-06,Gujarat,1512,16,1510,18957,2026,1269,7.98,0,71.5,578940,4712,575758,2.83,1.77,0.26513286713286716,0.81,99.45
2022-01-07,Gujarat,1485,8,1481,18559,2840,2066,8.0,0,71.5,580425,4720,577239,3.97,2.89,0.25956643356643355,0.81,99.45
2022-01-08,Gujarat,1141,5,1140,14544,1134,128,7.85,0,71.5,581566,4725,578379,1.59,0.18,0.20341258741258741,0.81,99.45
2022-01-09,Gujarat,133,1,126,1612,3108,1978,8.25,6,71.5,581699,4726,578505,4.35,2.77,0.022545454545454546,0.81,99.45
2022-01-10,Gujarat,750,10,743,9030,2525,2506,8.31,0,71.5,582449,4736,579248,3.53,3.5,0.1262937062937063,0.81,99.45
2022-01-11,Gujarat,636,4,635,8158,1201,578,7.8,0,71.5,583085,4740,579883,1.68,0.81,0.1140979020979021,0.81,99.45
2022-01-12,Gujarat,930,10,921,11538,613,269,8.06,0,71.5,584015,4750,580804,0.86,0.38,0.16137062937062938,0.81,99.45
2022-01-13,Gujarat,767,7,767,9832,2874,931,7.8,0,71.5,584782,4757,581571,4.02,1.3,0.1375104895104895,0.81,99.45
2022-01-14,Gujarat,594,5,594,7708,3140,1828,7.71,0,71.5,585376,4762,582165,4.39,2.56,0.1078041958041958,0.81,99.45
2022-01-15,Gujarat,316,1,310,4037,2901,932,7.83,5,71.5,585692,4763,582475,4.06,1.3,0.05646153846153846,0.81,99.45
2022-01-16,Gujarat,224,3,223,2630,3803,105,8.52,0,71.5,585916,4766,582698,5.32,0.15,0.036783216783216784,0.81,99.45
2022-01-17,Gujarat,219,1,219,2752,4154,1195,7.96,0,71.5,586135,4767,582917,5.81,1.67,0.03848951048951049,0.81,99.45
2022-01-18,Gujarat,425,6,422,5434,799,550,7.82,0,71.5,586560,4773,583339,1.12,0.77,0.076,0.81,99.45
2022-01-19,Gujarat,1445,19,1437,17906,25,11,8.07,0,71.5,588005,4792,584776,0.03,0.02,0.25043356643356646,0.81,99.45
2022-01-20,Gujarat,921,9,916,11342,2830,165,8.12,0,71.5,588926,4801,585692,3.96,0.23,0.15862937062937063,0.82,99.45
2022-01-21,Gujarat,661,5,660,7903,1594,870,8.36,0,71.5,589587,4806,586352,2.23,1.22,0.11053146853146853,0.82,99.45
2022-01-22,Gujarat,321,2,317,4209,17,17,7.63,2,71.5,589908,4808,586669,0.02,0.02,0.05886713286713287,0.82,99.45
2022-01-23,Gujarat,838,3,829,10229,1973,765,8.19,6,71.5,590746,4811,587498,2.76,1.07,0.14306293706293707,0.81,99.45
2022-01-24,Gujarat,1291,5,1291,16033,3942,2311,8.05,0,71.5,592037,4816,588789,5.51,3.23,0.22423776223776223,0.81,99.45
2022-01-25,Gujarat,944,13,937,11939,2227,2118,7.91,0,71.5,592981,4829,589726,3.11,2.96,0.16697902097902098,0.81,99.45
2022-01-26,Gujarat,866,10,865,10783,3849,2091,8.03,0,71.5,593847,4839,590591,5.38,2.92,0.15081118881118882,0.81,99.45
2022-01-27,Gujarat,218,1,209,2798,4920,688,7.79,8,71.5,594065,4840,590800,6.88,0.96,0.039132867132867136,0.81,99.45
2022-01-28,Gujarat,1525,18,1522,19382,1338,769,7.87,0,71.5,595590,4858,592322,1.87,1.08,0.2710769230769231,0.82,99.45
2022-01-29,Gujarat,972,11,971,12467,306,12,7.8,0,71.5,596562,4869,593293,0.43,0.02,0.17436363636363636,0.82,99.45
2022-01-30,Gujarat,385,1,377,5245,4972,1922,7.34,7,71.5,596947,4870,593670,6.95,2.69,0.07335664335664335,0.82,99.45
2022-01-31,Gujarat,1013,10,1007,12840,872,737,7.89,0,71.5,597960,4880,594677,1.22,1.03,0.1795804195804196,0.82,99.45
2022-02-01,Gujarat,247,2,243,3045,2338,1724,8.11,2,71.5,598207,4882,594920,3.27,2.41,0.04258741258741259,0.82,99.45
2022-02-02,Gujarat,1579,17,1578,19550,2300,296,8.08,0,71.5,599786,4899,596498,3.22,0.41,0.27342657342657345,0.82,99.45
2022-02-03,Gujarat,1190,17,1186,15268,49,45,7.79,0,71.5,600976,4916,597684,0.07,0.06,0.21353846153846154,0.82,99.45
2022-02-04,Gujarat,159,0,151,2170,1843,934,7.33,8,71.5,601135,4916,597835,2.58,1.31,0.03034965034965035,0.82,99.45
2022-02-05,Gujarat,1205,10,1200,15200,883,124,7.93,0,71.5,602340,4926,599035,1.23,0.17,0.2125874125874126,0.82,99.45
2022-02-06,Gujarat,1259,18,1252,15784,3474,3191,7.98,0,71.5,603599,4944,600287,4.86,4.46,0.22075524475524474,0.82,99.45
2022-02-07,Gujarat,888,3,886,11446,1919,802,7.76,0,71.5,604487,4947,601173,2.68,1.12,0.1600839160839161,0.82,99.45
2022-02-08,Gujarat,910,10,905,11412,3032,2812,7.97,0,71.5,605397,4957,602078,4.24,3.93,0.1596083916083916,0.82,99.45
2022-02-09,Gujarat,1052,9,1045,13447,14,9,7.82,0,71.5,606449,4966,603123,0.02,0.01,0.18806993006993006,0.82,99.45
2022-02-10,Gujarat,472,4,463,6164,4564,266,7.66,5,71.5,606921,4970,603586,6.38,0.37,0.08620979020979021,0.82,99.45
2022-02-11,Gujarat,1398,16,1394,17126,148,24,8.16,0,71.5,608319,4986,604980,0.21,0.03,0.23952447552447553,0.82,99.45
2022-02-12,Gujarat,447,4,439,5315,3406,1044,8.41,4,71.5,608766,4990,605419,4.76,1.46,0.07433566433566434,0.82,99.45
2022-02-13,Gujarat,163,1,161,2103,3399,2745,7.75,1,71.5,608929,4991,605580,4.75,3.84,0.029412587412587413,0.82,99.45
2022-02-14,Gujarat,1337,19,1335,17104,2910,44,7.82,0,71.5,610266,5010,606915,4.07,0.06,0.23921678321678322,0.82,99.45
2022-02-15,Gujarat,730,9,725,9331,397,148,7.82,0,71.5,610996,5019,607640,0.56,0.21,0.1305034965034965,0.82,99.45
2022-02-16,Gujarat,403,4,395,5505,4491,4354,7.32,4,71.5,611399,5023,608035,6.28,6.09,0.076993006993007,0.82,99.45
2022-02-17,Gujarat,116,0,111,1499,2143,350,7.74,5,71.5,611515,5023,608146,3.0,0.49,0.020965034965034966,0.82,99.45
2022-02-18,Gujarat,408,1,402,4817,2039,1302,8.47,5,71.5,611923,5024,608548,2.85,1.82,0.06737062937062938,0.82,99.45
2022-02-19,Gujarat,1437,7,1434,17653,1166,348,8.14,0,71.5,613360,5031,609982,1.63,0.49,0.24689510489510488,0.82,99.45
2022-02-20,Gujarat,395,5,389,5001,4498,3014,7.9,1,71.5,613755,5036,610371,6.29,4.22,0.06994405594405595,0.82,99.45
2022-02-21,Gujarat,1013,3,1008,12767,1469,1178,7.93,2,71.5,614768,5039,611379,2.05,1.65,0.17855944055944056,0.82,99.45
2022-02-22,Gujarat,963,13,962,12216,4560,4274,7.88,0,71.5,615731,5052,612341,6.38,5.98,0.17085314685314684,0.82,99.45
2022-02-23,Gujarat,769,3,768,9323,663,165,8.25,0,71.5,616500,5055,613109,0.93,0.23,0.1303916083916084,0.82,99.45
2022-02-24,Gujarat,1027,14,1023,13031,486,428,7.88,0,71.5,617527,5069,614132,0.68,0.6,0.18225174825174825,0.82,99.45
2022-02-25,Gujarat,699,6,698,8763,1885,693,7.98,0,71.5,618226,5075,614830,2.64,0.97,0.12255944055944056,0.82,99.45
2022-02-26,Gujarat,1293,15,1290,16437,4615,3680,7.87,0,71.5,619519,5090,616120,6.45,5.15,0.2298881118881119,0.82,99.45
2022-02-27,Gujarat,1409,8,1403,17796,802,365,7.92,0,71.5,620928,5098,617523,1.12,0.51,0.24889510489510489,0.82,99.45
2022-02-28,Gujarat,1138,7,1129,14632,1211,39,7.78,2,71.5,622066,5105,618652,1.69,0.05,0.20464335664335664,0.82,99.45
2022-03-01,Gujarat,595,4,592,7456,4079,1268,7.98,0,71.5,622661,5109,619244,5.7,1.77,0.10427972027972028,0.82,99.45
2022-03-02,Gujarat,565,7,563,7005,3147,2123,8.07,0,71.5,623226,5116,619807,4.4,2.97,0.09797202797202798,0.82,99.45
2022-03-03,Gujarat,945,12,936,11631,3486,2614,8.12,0,71.5,624171,5128,620743,4.88,3.66,0.16267132867132866,0.82,99.45
2022-03-04,Gujarat,1309,11,1302,15902,3171,1443,8.23,0,71.5,625480,5139,622045,4.43,2.02,0.2224055944055944,0.82,99.45
2022-03-05,Gujarat,328,4,323,4270,4337,1001,7.68,1,71.5,625808,5143,622368,6.07,1.4,0.05972027972027972,0.82,99.45
2022-03-06,Gujarat,1414,17,1414,17614,2801,2630,8.03,0,71.5,627222,5160,623782,3.92,3.68,0.24634965034965034,0.82,99.45
2022-03-07,Gujarat,284,2,279,3385,1140,414,8.39,3,71.5,627506,5162,624061,1.59,0.58,0.04734265734265734,0.82,99.45
2022-03-08,Gujarat,1254,6,1247,15823,4969,989,7.93,1,71.5,628760,5168,625308,6.95,1.38,0.2213006993006993,0.82,99.45
2022-03-09,Gujarat,292,2,283,3902,2036,94,7.48,7,71.5,629052,5170,625591,2.85,0.13,0.05457342657342657,0.82,99.45
2022-03-10,Gujarat,1241,10,1241,15419,2990,2911,8.05,0,71.5,630293,5180,626832,4.18,4.07,0.21565034965034965,0.82,99.45
2022-03-11,Gujarat,163,1,162,2003,4157,1253,8.14,0,71.5,630456,5181,626994,5.81,1.75,0.028013986013986015,0.82,99.45
2022-03-12,Gujarat,1032,5,1032,13615,2087,1719,7.58,0,71.5,631488,5186,628026,2.92,2.4,0.19041958041958043,0.82,99.45
2022-03-13,Gujarat,968,6,965,12021,1317,433,8.05,0,71.5,632456,5192,628991,1.84,0.61,0.16812587412587413,0.82,99.45
2022-03-14,Gujarat,173,1,164,2172,476,270,7.97,8,71.5,632629,5193,629155,0.67,0.38,0.030377622377622378,0.82,99.45
2022-03-15,Gujarat,384,2,376,5186,4117,3303,7.4,6,71.5,633013,5195,629531,5.76,4.62,0.07253146853146854,0.82,99.45
2022-03-16,Gujarat,302,1,300,3290,85,60,9.18,1,71.5,633315,5196,629831,0.12,0.08,0.046013986013986014,0.82,99.45
2022-03-17,Gujarat,1425,4,1423,17643,3965,2698,8.08,0,71.5,634740,5200,631254,5.55,3.77,0.24675524475524477,0.82,99.45
2022-03-18,Gujarat,799,9,792,10175,3340,2020,7.85,0,71.5,635539,5209,632046,4.67,2.83,0.1423076923076923,0.82,99.45
2022-03-19,Gujarat,1397,15,1388,17446,1418,945,8.01,0,71.5,636936,5224,633434,1.98,1.32,0.244,0.82,99.45
2022-03-20,Gujarat,1101,9,1101,13597,1298,329,8.1,0,71.5,638037,5233,634535,1.82,0.46,0.19016783216783217,0.82,99.45
2022-03-21,Gujarat,94,0,87,1417,2502,1507,6.63,7,71.5,638131,5233,634622,3.5,2.11,0.019818181818181818,0.82,99.45
2022-03-22,Gujarat,1426,6,1421,17723,2763,1077,8.05,0,71.5,639557,5239,636043,3.86,1.51,0.24787412587412588,0.82,99.45
2022-03-23,Gujarat,242,1,239,3271,3575,3514,7.4,2,71.5,639799,5240,636282,5.0,4.91,0.04574825174825175,0.82,99.45
2022-03-24,Gujarat,1410,8,1405,17782,513,105,7.93,0,71.5,641209,5248,637687,0.72,0.15,0.2486993006993007,0.82,99.45
2022-03-25,Gujarat,73,0,64,748,3553,2598,9.76,9,71.5,641282,5248,637751,4.97,3.63,0.010461538461538461,0.82,99.45
2022-03-26,Gujarat,815,5,807,10191,530,37,8.0,3,71.5,642097,5253,638558,0.74,0.05,0.14253146853146853,0.82,99.45
2022-03-27,Gujarat,399,1,396,4807,1353,1069,8.3,2,71.5,642496,5254,638954,1.89,1.5,0.06723076923076923,0.82,99.45
2022-03-28,Gujarat,1241,5,1241,15565,1288,420,7.97,0,71.5,643737,5259,640195,1.8,0.59,0.21769230769230768,0.82,99.45
2022-03-29,Gujarat,662,6,657,8843,276,232,7.49,0,71.5,644399,5265,640852,0.39,0.32,0.12367832167832168,0.82,99.45
2022-03-30,Gujarat,418,5,411,5000,2020,283,8.36,2,71.5,644817,5270,641263,2.83,0.4,0.06993006993006994,0.82,99.45
2022-03-31,Gujarat,959,5,951,11938,3087,877,8.03,3,71.5,645776,5275,642214,4.32,1.23,0.16696503496503495,0.82,99.45
2022-04-01,Gujarat,1234,10,1230,15566,2111,136,7.93,0,71.5,647010,5285,643444,2.95,0.19,0.2177062937062937,0.82,99.45
2022-04-02,Gujarat,318,1,316,3760,38,11,8.46,1,71.5,647328,5286,643760,0.05,0.02,0.05258741258741259,0.82,99.45
2022-04-03,Gujarat,310,1,304,4056,2293,599,7.64,5,71.5,647638,5287,644064,3.21,0.84,0.05672727272727273,0.82,99.45
2022-04-04,Gujarat,1554,18,1547,19489,3343,2128,7.97,0,71.5,649192,5305,645611,4.68,2.98,0.2725734265734266,0.82,99.45
2022-04-05,Gujarat,869,12,860,10591,2658,2425,8.21,0,71.5,650061,5317,646471,3.72,3.39,0.14812587412587414,0.82,99.45
2022-04-06,Gujarat,245,1,238,3600,4877,4852,6.81,6,71.5,650306,5318,646709,6.82,6.79,0.05034965034965035,0.82,99.45
2022-04-07,Gujarat,934,3,928,11923,295,103,7.83,3,71.5,651240,5321,647637,0.41,0.14,0.16675524475524475,0.82,99.45
2022-04-08,Gujarat,644,9,643,7953,3255,131,8.1,0,71.5,651884,5330,648280,4.55,0.18,0.11123076923076923,0.82,99.45
2022-04-09,Gujarat,1003,6,998,12280,386,194,8.17,0,71.5,652887,5336,649278,0.54,0.27,0.17174825174825176,0.82,99.45
2022-04-10,Gujarat,841,10,838,10629,508,265,7.91,0,71.5,653728,5346,650116,0.71,0.37,0.14865734265734265,0.82,99.45
2022-04-11,Gujarat,266,2,258,3517,4794,1519,7.56,6,71.5,653994,5348,650374,6.7,2.12,0.04918881118881119,0.82,99.45
2022-04-12,Gujarat,216,1,207,2495,1082,770,8.66,8,71.5,654210,5349,650581,1.51,1.08,0.034895104895104896,0.82,99.45
2022-04-13,Gujarat,1443,9,1440,18178,1044,229,7.94,0,71.5,655653,5358,652021,1.46,0.32,0.25423776223776223,0.82,99.45
2022-04-14,Gujarat,852,11,847,10252,1402,764,8.31,0,71.5,656505,5369,652868,1.96,1.07,0.1433846153846154,0.82,99.45
2022-04-15,Gujarat,751,5,745,9890,2407,1486,7.59,1,71.5,657256,5374,653613,3.37,2.08,0.13832167832167833,0.82,99.45
2022-04-16,Gujarat,1121,12,1117,14058,2996,1713,7.97,0,71.5,658377,5386,654730,4.19,2.4,0.1966153846153846,0.82,99.45
2022-04-17,Gujarat,471,1,463,5914,2712,562,7.96,7,71.5,658848,5387,655193,3.79,0.79,0.08271328671328672,0.82,99.45
2022-04-18,Gujarat,360,4,359,3976,885,562,9.05,0,71.5,659208,5391,655552,1.24,0.79,0.05560839160839161,0.82,99.45
2022-04-19,Gujarat,653,4,651,8258,4372,337,7.91,0,71.5,659861,5395,656203,6.11,0.47,0.11549650349650349,0.82,99.45
2022-04-20,Gujarat,1224,5,1217,15694,3929,177,7.8,2,71.5,661085,5400,657420,5.5,0.25,0.2194965034965035,0.82,99.45
2022-04-21,Gujarat,1003,7,1001,12533,4585,2166,8.0,0,71.5,662088,5407,658421,6.41,3.03,0.17528671328671327,0.82,99.45
2022-04-22,Gujarat,875,3,875,10744,2504,2248,8.14,0,71.5,662963,5410,659296,3.5,3.14,0.15026573426573425,0.82,99.45
2022-04-23,Gujarat,1325,15,1318,16549,16,14,8.01,0,71.5,664288,5425,660614,0.02,0.02,0.23145454545454547,0.82,99.45
2022-04-24,Gujarat,1480,20,1471,18493,2870,2154,8.0,0,71.5,665768,5445,662085,4.01,3.01,0.25864335664335664,0.82,99.45
2022-04-25,Gujarat,739,5,738,9038,1235,482,8.18,0,71.5,666507,5450,662823,1.73,0.67,0.1264055944055944,0.82,99.45
2022-04-26,Gujarat,298,2,290,3792,2966,2387,7.86,6,71.5,666805,5452,663113,4.15,3.34,0.053034965034965034,0.82,99.45
2022-04-27,Gujarat,732,4,731,9098,219,153,8.05,0,71.5,667537,5456,663844,0.31,0.21,0.12724475524475523,0.82,99.45
2022-04-28,Gujarat,332,2,332,4054,382,233,8.19,0,71.5,667869,5458,664176,0.53,0.33,0.0566993006993007,0.82,99.45
2022-04-29,Gujarat,699,7,690,8462,4519,2673,8.26,2,71.5,668568,5465,664866,6.32,3.74,0.11834965034965035,0.82,99.45
2022-04-30,Gujarat,768,2,764,9728,1378,1372,7.89,2,71.5,669336,5467,665630,1.93,1.92,0.13605594405594407,0.82,99.45
2022-05-01,Gujarat,211,1,210,2385,4856,2194,8.85,0,71.5,669547,5468,665840,6.79,3.07,0.03335664335664336,0.82,99.45
2022-05-02,Gujarat,387,4,378,4870,994,907,7.95,5,71.5,669934,5472,666218,1.39,1.27,0.0681118881118881,0.82,99.45
2022-05-03,Gujarat,1321,7,1314,16775,806,284,7.87,0,71.5,671255,5479,667532,1.13,0.4,0.23461538461538461,0.82,99.45
2022-05-04,Gujarat,1393,16,1391,17174,2914,767,8.11,0,71.5,672648,5495,668923,4.08,1.07,0.2401958041958042,0.82,99.45
2022-05-05,Gujarat,36,0,31,761,334,72,4.73,5,71.5,672684,5495,668954,0.47,0.1,0.010643356643356644,0.82,99.45
2022-05-06,Gujarat,668,4,661,8256,4050,2221,8.09,3,71.5,673352,5499,669615,5.66,3.11,0.11546853146853146,0.82,99.45
2022-05-07,Gujarat,1169,6,1160,14634,1787,268,7.99,3,71.5,674521,5505,670775,2.5,0.37,0.20467132867132867,0.82,99.44
2022-05-08,Gujarat,503,4,503,6432,1495,1353,7.82,0,71.5,675024,5509,671278,2.09,1.89,0.08995804195804195,0.82,99.45
2022-05-09,Gujarat,991,11,988,12462,682,559,7.95,0,71.5,676015,5520,672266,0.95,0.78,0.1742937062937063,0.82,99.45
2022-05-10,Gujarat,1374,7,1367,17237,3396,2933,7.97,0,71.5,677389,5527,673633,4.75,4.1,0.24107692307692308,0.82,99.45
2022-05-11,Gujarat,232,1,230,2879,2209,1071,8.06,1,71.5,677621,5528,673863,3.09,1.5,0.040265734265734265,0.82,99.45
2022-05-12,Gujarat,1169,7,1163,14913,3733,3266,7.84,0,71.5,678790,5535,675026,5.22,4.57,0.20857342657342656,0.82,99.45
2022-05-13,Gujarat,309,4,305,3954,1505,130,7.81,0,71.5,679099,5539,675331,2.1,0.18,0.0553006993006993,0.82,99.45
2022-05-14,Gujarat,1332,10,1332,16363,1585,842,8.14,0,71.5,680431,5549,676663,2.22,1.18,0.22885314685314687,0.82,99.45
2022-05-15,Gujarat,285,2,278,3291,1054,515,8.66,5,71.5,680716,5551,676941,1.47,0.72,0.04602797202797203,0.82,99.45
2022-05-16,Gujarat,415,2,413,5090,3913,1289,8.15,0,71.5,681131,5553,677354,5.47,1.8,0.0711888111888112,0.82,99.45
2022-05-17,Gujarat,372,1,368,4735,2959,1953,7.86,3,71.5,681503,5554,677722,4.14,2.73,0.06622377622377622,0.81,99.45
2022-05-18,Gujarat,734,4,730,9287,2752,2550,7.9,0,71.5,682237,5558,678452,3.85,3.57,0.1298881118881119,0.81,99.45
2022-05-19,Gujarat,491,3,490,6069,811,416,8.09,0,71.5,682728,5561,678942,1.13,0.58,0.08488111888111888,0.81,99.45
2022-05-20,Gujarat,1226,14,1223,15123,4572,3928,8.11,0,71.5,683954,5575,680165,6.39,5.49,0.2115104895104895,0.82,99.45
2022-05-21,Gujarat,1181,10,1178,14450,1514,1362,8.17,0,71.5,685135,5585,681343,2.12,1.9,0.2020979020979021,0.82,99.45
2022-05-22,Gujarat,995,10,995,12526,1799,567,7.94,0,71.5,686130,5595,682338,2.52,0.79,0.1751888111888112,0.82,99.45
2022-05-23,Gujarat,256,3,248,3075,1432,585,8.33,5,71.5,686386,5598,682586,2.0,0.82,0.043006993006993004,0.82,99.45
2022-05-24,Gujarat,1294,13,1285,16081,1825,1270,8.05,0,71.5,687680,5611,683871,2.55,1.78,0.22490909090909092,0.82,99.45
2022-05-25,Gujarat,1173,13,1173,14706,4972,2070,7.98,0,71.5,688853,5624,685044,6.95,2.9,0.20567832167832167,0.82,99.45
2022-05-26,Gujarat,404,5,397,5382,2802,1368,7.51,2,71.5,689257,5629,685441,3.92,1.91,0.07527272727272727,0.82,99.45
2022-05-27,Gujarat,1294,13,1285,16190,423,199,7.99,0,71.5,690551,5642,686726,0.59,0.28,0.22643356643356644,0.82,99.45
2022-05-28,Gujarat,1024,15,1021,12618,1940,1806,8.12,0,71.5,691575,5657,687747,2.71,2.53,0.17647552447552448,0.82,99.45
2022-05-29,Gujarat,485,3,480,6282,2477,1963,7.72,2,71.5,692060,5660,688227,3.46,2.75,0.08786013986013987,0.82,99.45
2022-05-30,Gujarat,592,8,591,7493,791,92,7.9,0,71.5,692652,5668,688818,1.11,0.13,0.1047972027972028,0.82,99.45
2022-05-31,Gujarat,755,6,749,9502,3583,1606,7.95,0,71.5,693407,5674,689567,5.01,2.25,0.1328951048951049,0.82,99.45
2022-06-01,Gujarat,132,0,123,1481,1132,297,8.91,9,71.5,693539,5674,689690,1.58,0.42,0.020713286713286712,0.82,99.45
2022-06-02,Gujarat,596,4,590,7273,2842,900,8.19,2,71.5,694135,5678,690280,3.97,1.26,0.10172027972027972,0.82,99.44
2022-06-03,Gujarat,789,10,788,9672,1548,917,8.16,0,71.5,694924,5688,691068,2.17,1.28,0.13527272727272727,0.82,99.45
2022-06-04,Gujarat,1275,7,1266,15992,1308,83,7.97,2,71.5,696199,5695,692334,1.83,0.12,0.22366433566433566,0.82,99.44
2022-06-05,Gujarat,417,4,413,5359,763,127,7.78,0,71.5,696616,5699,692747,1.07,0.18,0.07495104895104895,0.82,99.44
2022-06-06,Gujarat,142,2,133,2114,1424,873,6.72,7,71.5,696758,5701,692880,1.99,1.22,0.029566433566433566,0.82,99.44
2022-06-07,Gujarat,1074,15,1067,13957,4775,2282,7.7,0,71.5,697832,5716,693947,6.68,3.19,0.1952027972027972,0.82,99.44
2022-06-08,Gujarat,1200,10,1193,15069,3297,2800,7.96,0,71.5,699032,5726,695140,4.61,3.92,0.21075524475524476,0.82,99.44
2022-06-09,Gujarat,529,4,528,6761,3306,910,7.82,0,71.5,699561,5730,695668,4.62,1.27,0.09455944055944056,0.82,99.44
2022-06-10,Gujarat,1319,5,1315,16597,647,480,7.95,0,71.5,700880,5735,696983,0.9,0.67,0.23212587412587413,0.82,99.44
2022-06-11,Gujarat,1438,21,1431,17962,2823,1335,8.01,0,71.5,702318,5756,698414,3.95,1.87,0.2512167832167832,0.82,99.44
2022-06-12,Gujarat,1129,8,1121,13993,4245,2015,8.07,0,71.5,703447,5764,699535,5.94,2.82,0.1957062937062937,0.82,99.44
2022-06-13,Gujarat,1276,8,1269,16191,458,255,7.88,0,71.5,704723,5772,700804,0.64,0.36,0.22644755244755244,0.82,99.44
2022-06-14,Gujarat,1173,15,1166,14510,921,799,8.08,0,71.5,705896,5787,701970,1.29,1.12,0.20293706293706293,0.82,99.44
2022-06-15,Gujarat,1154,6,1147,14674,4295,3288,7.86,1,71.5,707050,5793,703117,6.01,4.6,0.20523076923076924,0.82,99.44
2022-06-16,Gujarat,1400,17,1396,17850,4801,2924,7.84,0,71.5,708450,5810,704513,6.71,4.09,0.24965034965034966,0.82,99.44
2022-06-17,Gujarat,659,5,652,7987,4782,2932,8.25,2,71.5,709109,5815,705165,6.69,4.1,0.1117062937062937,0.82,99.44
2022-06-18,Gujarat,904,4,903,11170,70,5,8.09,0,71.5,710013,5819,706068,0.1,0.01,0.15622377622377623,0.82,99.44
2022-06-19,Gujarat,906,11,903,11375,3944,2956,7.96,0,71.5,710919,5830,706971,5.52,4.13,0.1590909090909091,0.82,99.44
2022-06-20,Gujarat,829,4,820,10479,2909,2853,7.91,5,71.5,711748,5834,707791,4.07,3.99,0.14655944055944056,0.82,99.44
2022-06-21,Gujarat,1016,13,1010,12626,3491,3293,8.05,0,71.5,712764,5847,708801,4.88,4.61,0.1765874125874126,0.82,99.44
2022-06-22,Gujarat,506,6,499,6478,2221,530,7.81,1,71.5,713270,5853,709300,3.11,0.74,0.0906013986013986,0.82,99.44
2022-06-23,Gujarat,1515,15,1510,18884,4419,596,8.02,0,71.5,714785,5868,710810,6.18,0.83,0.2641118881118881,0.82,99.44
2022-06-24,Gujarat,51,0,51,746,4290,3444,6.84,0,71.5,714836,5868,710861,6.0,4.82,0.010433566433566433,0.82,99.44
2022-06-25,Gujarat,1181,6,1177,15007,4182,109,7.87,0,71.5,716017,5874,712038,5.85,0.15,0.20988811188811188,0.82,99.44
2022-06-26,Gujarat,155,1,155,1921,3096,1047,8.07,0,71.5,716172,5875,712193,4.33,1.46,0.026867132867132867,0.82,99.44
2022-06-27,Gujarat,1408,7,1399,17516,1253,6,8.04,2,71.5,717580,5882,713592,1.75,0.01,0.24497902097902097,0.82,99.44
2022-06-28,Gujarat,741,3,737,9105,1901,1218,8.14,1,71.5,718321,5885,714329,2.66,1.7,0.12734265734265734,0.82,99.44
2022-06-29,Gujarat,269,1,262,3279,1720,1360,8.2,6,71.5,718590,5886,714591,2.41,1.9,0.04586013986013986,0.82,99.44
2022-06-30,Gujarat,430,1,430,5381,3224,926,7.99,0,71.5,719020,5887,715021,4.51,1.3,0.07525874125874125,0.82,99.44
2022-07-01,Gujarat,1130,5,1123,14082,796,601,8.02,2,71.5,720150,5892,716144,1.11,0.84,0.19695104895104895,0.82,99.44
2022-07-02,Gujarat,625,6,622,7640,4621,1448,8.18,0,71.5,720775,5898,716766,6.46,2.03,0.10685314685314685,0.82,99.44
2022-07-03,Gujarat,187,1,181,2157,2397,1712,8.67,5,71.5,720962,5899,716947,3.35,2.39,0.030167832167832167,0.82,99.44
2022-07-04,Gujarat,1187,10,1186,15131,1644,343,7.84,0,71.5,722149,5909,718133,2.3,0.48,0.21162237762237762,0.82,99.44
2022-07-05,Gujarat,718,8,711,8938,2414,1137,8.03,0,71.5,722867,5917,718844,3.38,1.59,0.125006993006993,0.82,99.44
2022-07-06,Gujarat,1257,13,1251,15257,4076,462,8.24,0,71.5,724124,5930,720095,5.7,0.65,0.2133846153846154,0.82,99.44
2022-07-07,Gujarat,771,9,765,9562,1937,1152,8.06,0,71.5,724895,5939,720860,2.71,1.61,0.13373426573426572,0.82,99.44
2022-07-08,Gujarat,898,7,893,11184,2798,1883,8.03,0,71.5,725793,5946,721753,3.91,2.63,0.15641958041958043,0.82,99.44
2022-07-09,Gujarat,696,9,693,8609,3172,210,8.08,0,71.5,726489,5955,722446,4.44,0.29,0.12040559440559441,0.82,99.44
2022-07-10,Gujarat,573,8,573,7520,723,568,7.62,0,71.5,727062,5963,723019,1.01,0.79,0.10517482517482518,0.82,99.44
2022-07-11,Gujarat,1147,16,1138,14569,4201,1649,7.87,0,71.5,728209,5979,724157,5.88,2.31,0.20376223776223776,0.82,99.44
2022-07-12,Gujarat,1361,13,1354,17492,3213,1677,7.78,0,71.5,729570,5992,725511,4.49,2.35,0.24464335664335665,0.82,99.44
2022-07-13,Gujarat,1027,15,1019,12967,4132,183,7.92,0,71.5,730597,6007,726530,5.78,0.26,0.18135664335664337,0.82,99.44
2022-07-14,Gujarat,1466,14,1463,18608,941,335,7.88,0,71.5,732063,6021,727993,1.32,0.47,0.26025174825174824,0.82,99.44
2022-07-15,Gujarat,879,8,872,11348,4704,2693,7.75,0,71.5,732942,6029,728865,6.58,3.77,0.15871328671328672,0.82,99.44
2022-07-16,Gujarat,237,1,228,2884,1970,1222,8.22,8,71.5,733179,6030,729093,2.76,1.71,0.04033566433566434,0.82,99.44
2022-07-17,Gujarat,560,5,556,7040,3693,3188,7.95,0,71.5,733739,6035,729649,5.17,4.46,0.09846153846153846,0.82,99.44
2022-07-18,Gujarat,274,1,267,3206,786,741,8.55,6,71.5,734013,6036,729916,1.1,1.04,0.04483916083916084,0.82,99.44
2022-07-19,Gujarat,410,5,410,5023,299,0,8.16,0,71.5,734423,6041,730326,0.42,0.0,0.07025174825174825,0.82,99.44
2022-07-20,Gujarat,1476,19,1469,18536,562,471,7.96,0,71.5,735899,6060,731795,0.79,0.66,0.25924475524475527,0.82,99.44
2022-07-21,Gujarat,571,8,568,6947,1362,35,8.22,0,71.5,736470,6068,732363,1.9,0.05,0.09716083916083916,0.82,99.44
2022-07-22,Gujarat,615,2,609,7328,4444,1555,8.39,4,71.5,737085,6070,732972,6.22,2.17,0.1024895104895105,0.82,99.44
2022-07-23,Gujarat,395,5,391,5093,3757,2950,7.76,0,71.5,737480,6075,733363,5.25,4.13,0.07123076923076924,0.82,99.44
2022-07-24,Gujarat,330,4,330,3907,3250,1093,8.45,0,71.5,737810,6079,733693,4.55,1.53,0.05464335664335664,0.82,99.44
2022-07-25,Gujarat,755,8,753,9463,3461,2185,7.98,0,71.5,738565,6087,734446,4.84,3.06,0.13234965034965035,0.82,99.44
2022-07-26,Gujarat,256,2,248,2908,3576,3432,8.8,6,71.5,738821,6089,734694,5.0,4.8,0.04067132867132867,0.82,99.44
2022-07-27,Gujarat,1587,23,1579,19764,2588,2527,8.03,0,71.5,740408,6112,736273,3.62,3.53,0.2764195804195804,0.83,99.44
2022-07-28,Gujarat,622,3,620,8115,1315,923,7.66,0,71.5,741030,6115,736893,1.84,1.29,0.11349650349650349,0.83,99.44
2022-07-29,Gujarat,335,1,330,4261,217,128,7.86,4,71.5,741365,6116,737223,0.3,0.18,0.0595944055944056,0.82,99.44
2022-07-30,Gujarat,832,2,827,10168,1165,90,8.18,3,71.5,742197,6118,738050,1.63,0.13,0.14220979020979022,0.82,99.44
2022-07-31,Gujarat,1119,8,1110,13936,2261,1810,8.03,1,71.5,743316,6126,739160,3.16,2.53,0.19490909090909092,0.82,99.44
2022-08-01,Gujarat,780,3,773,9603,1746,1685,8.12,4,71.5,744096,6129,739933,2.44,2.36,0.1343076923076923,0.82,99.44
2022-08-02,Gujarat,1233,8,1224,15345,2490,2230,8.04,1,71.5,745329,6137,741157,3.48,3.12,0.21461538461538462,0.82,99.44
2022-08-03,Gujarat,171,2,170,2264,3499,2555,7.55,0,71.5,745500,6139,741327,4.89,3.57,0.031664335664335665,0.82,99.44
2022-08-04,Gujarat,604,7,603,7613,4622,2763,7.93,0,71.5,746104,6146,741930,6.46,3.86,0.10647552447552447,0.82,99.44
2022-08-05,Gujarat,307,2,302,3480,4469,582,8.82,3,71.5,746411,6148,742232,6.25,0.81,0.04867132867132867,0.82,99.44
2022-08-06,Gujarat,1094,15,1091,13664,2101,1056,8.01,0,71.5,747505,6163,743323,2.94,1.48,0.19110489510489512,0.82,99.44
2022-08-07,Gujarat,163,0,160,2300,3521,1553,7.09,3,71.5,747668,6163,743483,4.92,2.17,0.032167832167832165,0.82,99.44
2022-08-08,Gujarat,1437,21,1432,18447,976,508,7.79,0,71.5,749105,6184,744915,1.37,0.71,0.258,0.83,99.44
2022-08-09,Gujarat,493,5,492,6050,2579,2003,8.15,0,71.5,749598,6189,745407,3.61,2.8,0.08461538461538462,0.83,99.44
2022-08-10,Gujarat,576,3,576,7493,3358,2818,7.69,0,71.5,750174,6192,745983,4.7,3.94,0.1047972027972028,0.83,99.44
2022-08-11,Gujarat,1436,12,1429,18139,3596,1751,7.92,0,71.5,751610,6204,747412,5.03,2.45,0.2536923076923077,0.83,99.44
2022-08-12,Gujarat,107,0,103,1515,1981,621,7.06,4,71.5,751717,6204,747515,2.77,0.87,0.021188811188811187,0.83,99.44
2022-08-13,Gujarat,1612,6,1609,19645,4246,2761,8.21,0,71.5,753329,6210,749124,5.94,3.86,0.27475524475524477,0.82,99.44
2022-08-14,Gujarat,648,4,647,8093,4091,3723,8.01,0,71.5,753977,6214,749771,5.72,5.21,0.11318881118881119,0.82,99.44
2022-08-15,Gujarat,405,5,405,4801,3410,815,8.44,0,71.5,754382,6219,750176,4.77,1.14,0.06714685314685315,0.82,99.44
2022-08-16,Gujarat,972,8,965,12052,2950,19,8.07,0,71.5,755354,6227,751141,4.13,0.03,0.16855944055944055,0.82,99.44
2022-08-17,Gujarat,1244,7,1236,15201,1241,855,8.18,1,71.5,756598,6234,752377,1.74,1.2,0.2126013986013986,0.82,99.44
2022-08-18,Gujarat,432,5,429,5397,90,74,8.0,0,71.5,757030,6239,752806,0.13,0.1,0.07548251748251748,0.82,99.44
2022-08-19,Gujarat,1317,12,1315,16444,1638,1638,8.01,0,71.5,758347,6251,754121,2.29,2.29,0.22998601398601398,0.82,99.44
2022-08-20,Gujarat,527,6,526,6677,2567,1448,7.89,0,71.5,758874,6257,754647,3.59,2.03,0.09338461538461539,0.82,99.44
2022-08-21,Gujarat,792,8,783,10119,4457,3354,7.83,1,71.5,759666,6265,755430,6.23,4.69,0.14152447552447553,0.82,99.44
2022-08-22,Gujarat,457,3,451,6192,2695,2232,7.38,3,71.5,760123,6268,755881,3.77,3.12,0.08660139860139861,0.82,99.44
2022-08-23,Gujarat,516,2,510,6271,3409,3248,8.23,4,71.5,760639,6270,756391,4.77,4.54,0.08770629370629371,0.82,99.44
2022-08-24,Gujarat,1105,5,1099,13761,1649,730,8.03,1,71.5,761744,6275,757490,2.31,1.02,0.19246153846153846,0.82,99.44
2022-08-25,Gujarat,1208,14,1202,15128,3801,2949,7.99,0,71.5,762952,6289,758692,5.32,4.12,0.2115804195804196,0.82,99.44
2022-08-26,Gujarat,468,2,465,5764,2628,830,8.12,1,71.5,763420,6291,759157,3.68,1.16,0.08061538461538462,0.82,99.44
2022-08-27,Gujarat,1527,10,1519,19193,182,178,7.96,0,71.5,764947,6301,760676,0.25,0.25,0.2684335664335664,0.82,99.44
2022-08-28,Gujarat,1124,6,1118,14086,2218,1713,7.98,0,71.5,766071,6307,761794,3.1,2.4,0.197006993006993,0.82,99.44
2022-08-29,Gujarat,1108,11,1105,13795,4141,1625,8.03,0,71.5,767179,6318,762899,5.79,2.27,0.19293706293706295,0.82,99.44
2022-08-30,Gujarat,57,0,57,873,1899,1225,6.53,0,71.5,767236,6318,762956,2.66,1.71,0.01220979020979021,0.82,99.44
2022-08-31,Gujarat,1186,11,1183,14793,3436,1994,8.02,0,71.5,768422,6329,764139,4.81,2.79,0.2068951048951049,0.82,99.44
2022-09-01,Gujarat,1217,15,1211,15130,4985,2619,8.04,0,71.5,769639,6344,765350,6.97,3.66,0.21160839160839162,0.82,99.44
2022-09-02,Gujarat,255,2,251,2719,1760,15,9.38,2,71.5,769894,6346,765601,2.46,0.02,0.03802797202797203,0.82,99.44
2022-09-03,Gujarat,157,2,154,1895,619,231,8.28,1,71.5,770051,6348,765755,0.87,0.32,0.026503496503496503,0.82,99.44
2022-09-04,Gujarat,13,0,13,505,4418,2698,2.57,0,71.5,770064,6348,765768,6.18,3.77,0.007062937062937063,0.82,99.44
2022-09-05,Gujarat,671,7,664,8459,1057,935,7.93,0,71.5,770735,6355,766432,1.48,1.31,0.11830769230769231,0.82,99.44
2022-09-06,Gujarat,1028,9,1019,13124,2499,172,7.83,0,71.5,771763,6364,767451,3.5,0.24,0.18355244755244754,0.82,99.44
2022-09-07,Gujarat,381,5,379,4862,4813,3284,7.84,0,71.5,772144,6369,767830,6.73,4.59,0.068,0.82,99.44
2022-09-08,Gujarat,1278,5,1271,15424,4263,1885,8.29,2,71.5,773422,6374,769101,5.96,2.64,0.2157202797202797,0.82,99.44
2022-09-09,Gujarat,413,1,406,5556,4572,3309,7.43,6,71.5,773835,6375,769507,6.39,4.63,0.0777062937062937,0.82,99.44
2022-09-10,Gujarat,881,8,876,10915,2239,574,8.07,0,71.5,774716,6383,770383,3.13,0.8,0.15265734265734265,0.82,99.44
2022-09-11,Gujarat,353,4,352,4677,3976,1468,7.55,0,71.5,775069,6387,770735,5.56,2.05,0.06541258741258742,0.82,99.44
2022-09-12,Gujarat,546,5,539,7072,2632,1434,7.72,2,71.5,775615,6392,771274,3.68,2.01,0.0989090909090909,0.82,99.44
2022-09-13,Gujarat,558,2,550,6623,4620,3743,8.43,6,71.5,776173,6394,771824,6.46,5.23,0.09262937062937063,0.82,99.44
2022-09-14,Gujarat,637,8,633,7596,3672,1141,8.39,0,71.5,776810,6402,772457,5.14,1.6,0.10623776223776224,0.82,99.44
2022-09-15,Gujarat,1559,14,1559,19389,2898,1810,8.04,0,71.5,778369,6416,774016,4.05,2.53,0.27117482517482516,0.82,99.44
2022-09-16,Gujarat,1122,11,1118,14130,2602,999,7.94,0,71.5,779491,6427,775134,3.64,1.4,0.1976223776223776,0.82,99.44
2022-09-17,Gujarat,471,5,462,5852,4387,913,8.05,4,71.5,779962,6432,775596,6.14,1.28,0.08184615384615385,0.82,99.44
2022-09-18,Gujarat,1005,13,998,12850,4183,3672,7.82,0,71.5,780967,6445,776594,5.85,5.14,0.1797202797202797,0.83,99.44
2022-09-19,Gujarat,79,0,75,691,4437,1850,11.43,4,71.5,781046,6445,776669,6.21,2.59,0.009664335664335664,0.83,99.44
2022-09-20,Gujarat,257,0,250,2961,4924,4666,8.68,7,71.5,781303,6445,776919,6.89,6.53,0.04141258741258741,0.82,99.44
2022-09-21,Gujarat,1422,20,1422,18056,4333,1887,7.88,0,71.5,782725,6465,778341,6.06,2.64,0.2525314685314685,0.83,99.44
2022-09-22,Gujarat,172,1,168,2200,1641,617,7.82,3,71.5,782897,6466,778509,2.3,0.86,0.03076923076923077,0.83,99.44
2022-09-23,Gujarat,441,6,436,5627,3688,2252,7.84,0,71.5,783338,6472,778945,5.16,3.15,0.0786993006993007,0.83,99.44
2022-09-24,Gujarat,652,7,647,8003,3954,1959,8.15,0,71.5,783990,6479,779592,5.53,2.74,0.11193006993006993,0.83,99.44
2022-09-25,Gujarat,737,5,733,9163,3083,2241,8.04,0,71.5,784727,6484,780325,4.31,3.13,0.12815384615384615,0.83,99.44
2022-09-26,Gujarat,405,1,400,4641,4166,2016,8.73,4,71.5,785132,6485,780725,5.83,2.82,0.0649090909090909,0.83,99.44
2022-09-27,Gujarat,1013,4,1009,12354,4603,3569,8.2,0,71.5,786145,6489,781734,6.44,4.99,0.1727832167832168,0.83,99.44
2022-09-28,Gujarat,597,7,590,7102,4789,4100,8.41,0,71.5,786742,6496,782324,6.7,5.73,0.09932867132867133,0.83,99.44
2022-09-29,Gujarat,874,11,869,11081,4297,3210,7.89,0,71.5,787616,6507,783193,6.01,4.49,0.15497902097902097,0.83,99.44
2022-09-30,Gujarat,738,7,738,9024,1510,240,8.18,0,71.5,788354,6514,783931,2.11,0.34,0.1262097902097902,0.83,99.44
2022-10-01,Gujarat,1452,12,1452,18135,4938,1844,8.01,0,71.5,789806,6526,785383,6.91,2.58,0.25363636363636366,0.83,99.44
2022-10-02,Gujarat,739,5,731,8994,3694,2755,8.22,3,71.5,790545,6531,786114,5.17,3.85,0.1257902097902098,0.83,99.44
2022-10-03,Gujarat,765,9,765,10098,899,579,7.58,0,71.5,791310,6540,786879,1.26,0.81,0.14123076923076924,0.83,99.44
2022-10-04,Gujarat,1415,21,1406,17548,3882,1833,8.06,0,71.5,792725,6561,788285,5.43,2.56,0.24542657342657342,0.83,99.44
2022-10-05,Gujarat,876,5,873,11322,3079,982,7.74,0,71.5,793601,6566,789158,4.31,1.37,0.15834965034965034,0.83,99.44
2022-10-06,Gujarat,724,9,720,9620,233,27,7.53,0,71.5,794325,6575,789878,0.33,0.04,0.13454545454545455,0.83,99.44
2022-10-07,Gujarat,1342,7,1333,16926,4599,66,7.93,2,71.5,795667,6582,791211,6.43,0.09,0.23672727272727273,0.83,99.44
2022-10-08,Gujarat,393,1,391,4895,1058,369,8.03,1,71.5,796060,6583,791602,1.48,0.52,0.06846153846153846,0.83,99.44
2022-10-09,Gujarat,442,5,441,5760,1502,915,7.67,0,71.5,796502,6588,792043,2.1,1.28,0.08055944055944056,0.83,99.44
2022-10-10,Gujarat,743,4,740,9458,3736,3048,7.86,0,71.5,797245,6592,792783,5.23,4.26,0.1322797202797203,0.83,99.44
2022-10-11,Gujarat,258,0,252,3302,549,54,7.81,6,71.5,797503,6592,793035,0.77,0.08,0.046181818181818185,0.83,99.44
2022-10-12,Gujarat,1107,5,1102,13630,267,11,8.12,0,71.5,798610,6597,794137,0.37,0.02,0.19062937062937063,0.83,99.44
2022-10-13,Gujarat,424,3,417,5288,610,488,8.02,4,71.5,799034,6600,794554,0.85,0.68,0.07395804195804195,0.83,99.44
2022-10-14,Gujarat,754,8,750,9664,2512,230,7.8,0,71.5,799788,6608,795304,3.51,0.32,0.13516083916083915,0.83,99.44
2022-10-15,Gujarat,145,0,141,1628,4822,4402,8.91,4,71.5,799933,6608,795445,6.74,6.16,0.02276923076923077,0.83,99.44
2022-10-16,Gujarat,679,8,677,8635,640,610,7.86,0,71.5,800612,6616,796122,0.9,0.85,0.12076923076923077,0.83,99.44
2022-10-17,Gujarat,594,7,592,7709,406,143,7.71,0,71.5,801206,6623,796714,0.57,0.2,0.10781818181818181,0.83,99.44
2022-10-18,Gujarat,1014,3,1006,12649,529,92,8.02,5,71.5,802220,6626,797720,0.74,0.13,0.1769090909090909,0.83,99.44
2022-10-19,Gujarat,1265,17,1264,15384,147,33,8.22,0,71.5,803485,6643,798984,0.21,0.05,0.21516083916083917,0.83,99.44
2022-10-20,Gujarat,210,1,209,2697,4817,1551,7.79,0,71.5,803695,6644,799193,6.74,2.17,0.03772027972027972,0.83,99.44
2022-10-21,Gujarat,264,2,261,3848,4924,4097,6.86,1,71.5,803959,6646,799454,6.89,5.73,0.05381818181818182,0.83,99.44
2022-10-22,Gujarat,974,11,974,12194,1423,718,7.99,0,71.5,804933,6657,800428,1.99,1.0,0.17054545454545456,0.83,99.44
2022-10-23,Gujarat,1079,4,1071,13291,823,114,8.12,4,71.5,806012,6661,801499,1.15,0.16,0.18588811188811188,0.83,99.44
2022-10-24,Gujarat,1180,8,1176,14895,3875,2759,7.92,0,71.5,807192,6669,802675,5.42,3.86,0.20832167832167833,0.83,99.44
2022-10-25,Gujarat,157,1,149,2154,463,211,7.29,7,71.5,807349,6670,802824,0.65,0.3,0.030125874125874127,0.83,99.44
2022-10-26,Gujarat,438,1,429,5892,2770,2307,7.43,8,71.5,807787,6671,803253,3.87,3.23,0.0824055944055944,0.83,99.44
2022-10-27,Gujarat,778,2,769,9888,693,281,7.87,7,71.5,808565,6673,804022,0.97,0.39,0.1382937062937063,0.83,99.44
2022-10-28,Gujarat,857,8,856,10588,615,40,8.09,0,71.5,809422,6681,804878,0.86,0.06,0.14808391608391608,0.83,99.44
2022-10-29,Gujarat,1400,6,1391,17272,148,9,8.11,3,71.5,810822,6687,806269,0.21,0.01,0.24156643356643356,0.82,99.44
2022-10-30,Gujarat,140,1,140,1792,3380,2956,7.81,0,71.5,810962,6688,806409,4.73,4.13,0.025062937062937062,0.82,99.44
2022-10-31,Gujarat,1608,8,1604,19928,2719,2494,8.07,0,71.5,812570,6696,808013,3.8,3.49,0.2787132867132867,0.82,99.44
2022-11-01,Gujarat,1426,10,1417,17808,1880,1218,8.01,0,71.5,813996,6706,809430,2.63,1.7,0.24906293706293706,0.82,99.44
2022-11-02,Gujarat,653,2,652,7948,328,103,8.22,0,71.5,814649,6708,810082,0.46,0.14,0.11116083916083916,0.82,99.44
2022-11-03,Gujarat,1404,20,1402,17927,3026,1165,7.83,0,71.5,816053,6728,811484,4.23,1.63,0.25072727272727274,0.82,99.44
2022-11-04,Gujarat,1476,13,1468,18670,3169,72,7.91,0,71.5,817529,6741,812952,4.43,0.1,0.2611188811188811,0.82,99.44
2022-11-05,Gujarat,1044,6,1041,12841,248,141,8.13,0,71.5,818573,6747,813993,0.35,0.2,0.1795944055944056,0.82,99.44
2022-11-06,Gujarat,1524,10,1517,18567,716,510,8.21,0,71.5,820097,6757,815510,1.0,0.71,0.25967832167832167,0.82,99.44
2022-11-07,Gujarat,984,12,977,12492,3520,1408,7.88,0,71.5,821081,6769,816487,4.92,1.97,0.1747132867132867,0.82,99.44
2022-11-08,Gujarat,803,4,798,10076,1149,1147,7.97,1,71.5,821884,6773,817285,1.61,1.6,0.14092307692307693,0.82,99.44
2022-11-09,Gujarat,1484,16,1476,18112,1846,574,8.19,0,71.5,823368,6789,818761,2.58,0.8,0.2533146853146853,0.82,99.44
2022-11-10,Gujarat,404,4,403,4774,4125,2784,8.46,0,71.5,823772,6793,819164,5.77,3.89,0.06676923076923078,0.82,99.44
2022-11-11,Gujarat,274,0,267,3493,4812,3458,7.84,7,71.5,824046,6793,819431,6.73,4.84,0.04885314685314685,0.82,99.44
2022-11-12,Gujarat,498,1,490,6011,958,452,8.28,7,71.5,824544,6794,819921,1.34,0.63,0.08406993006993008,0.82,99.44
2022-11-13,Gujarat,1242,5,1235,15316,4327,379,8.11,2,71.5,825786,6799,821156,6.05,0.53,0.2142097902097902,0.82,99.44
2022-11-14,Gujarat,520,6,518,6110,3300,2082,8.51,0,71.5,826306,6805,821674,4.62,2.91,0.08545454545454545,0.82,99.44
2022-11-15,Gujarat,1300,14,1295,16267,3773,2730,7.99,0,71.5,827606,6819,822969,5.28,3.82,0.22751048951048952,0.82,99.44
2022-11-16,Gujarat,1346,8,1343,16736,2766,593,8.04,0,71.5,828952,6827,824312,3.87,0.83,0.23406993006993007,0.82,99.44
2022-11-17,Gujarat,1374,17,1370,16999,3153,2780,8.08,0,71.5,830326,6844,825682,4.41,3.89,0.23774825174825176,0.82,99.44
2022-11-18,Gujarat,149,1,142,1890,1381,617,7.88,6,71.5,830475,6845,825824,1.93,0.86,0.026433566433566435,0.82,99.44
2022-11-19,Gujarat,1144,14,1140,13935,3851,719,8.21,0,71.5,831619,6859,826964,5.39,1.01,0.1948951048951049,0.82,99.44
2022-11-20,Gujarat,75,0,71,924,327,96,8.12,4,71.5,831694,6859,827035,0.46,0.13,0.012923076923076923,0.82,99.44
2022-11-21,Gujarat,717,8,712,9071,3596,1645,7.9,0,71.5,832411,6867,827747,5.03,2.3,0.12686713286713286,0.82,99.44
2022-11-22,Gujarat,180,2,174,2376,15,3,7.58,4,71.5,832591,6869,827921,0.02,0.0,0.03323076923076923,0.83,99.44
2022-11-23,Gujarat,231,1,227,3241,1860,804,7.13,3,71.5,832822,6870,828148,2.6,1.12,0.04532867132867133,0.82,99.44
2022-11-24,Gujarat,1518,21,1514,19055,109,103,7.97,0,71.5,834340,6891,829662,0.15,0.14,0.26650349650349653,0.83,99.44
2022-11-25,Gujarat,776,7,767,9732,4528,1138,7.97,2,71.5,835116,6898,830429,6.33,1.59,0.13611188811188812,0.83,99.44
2022-11-26,Gujarat,832,6,832,10449,1210,916,7.96,0,71.5,835948,6904,831261,1.69,1.28,0.14613986013986013,0.83,99.44
2022-11-27,Gujarat,527,2,521,6711,1652,1570,7.85,4,71.5,836475,6906,831782,2.31,2.2,0.09386013986013986,0.83,99.44
2022-11-28,Gujarat,905,7,896,11524,1513,844,7.85,2,71.5,837380,6913,832678,2.12,1.18,0.16117482517482518,0.83,99.44
2022-11-29,Gujarat,412,4,405,4945,285,283,8.33,3,71.5,837792,6917,833083,0.4,0.4,0.06916083916083916,0.83,99.44
2022-11-30,Gujarat,1124,10,1124,13836,2251,991,8.12,0,71.5,838916,6927,834207,3.15,1.39,0.19351048951048952,0.83,99.44
2022-12-01,Gujarat,433,1,433,5511,392,132,7.86,0,71.5,839349,6928,834640,0.55,0.18,0.07707692307692307,0.83,99.44
2022-12-02,Gujarat,731,5,730,9375,4051,429,7.8,0,71.5,840080,6933,835370,5.67,0.6,0.13111888111888112,0.83,99.44
2022-12-03,Gujarat,978,2,976,12277,2776,2361,7.97,0,71.5,841058,6935,836346,3.88,3.3,0.1717062937062937,0.82,99.44
2022-12-04,Gujarat,1583,21,1582,19829,1087,687,7.98,0,71.5,842641,6956,837928,1.52,0.96,0.27732867132867134,0.83,99.44
2022-12-05,Gujarat,1330,11,1321,16346,3941,3608,8.14,0,71.5,843971,6967,839249,5.51,5.05,0.2286153846153846,0.83,99.44
2022-12-06,Gujarat,667,7,667,8297,4624,2031,8.04,0,71.5,844638,6974,839916,6.47,2.84,0.11604195804195805,0.83,99.44
2022-12-07,Gujarat,607,2,606,7609,4654,1523,7.98,0,71.5,845245,6976,840522,6.51,2.13,0.10641958041958043,0.83,99.44
2022-12-08,Gujarat,139,1,133,1830,164,159,7.6,5,71.5,845384,6977,840655,0.23,0.22,0.025594405594405595,0.83,99.44
2022-12-09,Gujarat,1032,13,1030,12887,2967,1152,8.01,0,71.5,846416,6990,841685,4.15,1.61,0.18023776223776225,0.83,99.44
2022-12-10,Gujarat,168,1,160,2156,2289,1334,7.79,7,71.5,846584,6991,841845,3.2,1.87,0.030153846153846153,0.83,99.44
2022-12-11,Gujarat,289,2,284,3650,2957,2567,7.92,3,71.5,846873,6993,842129,4.14,3.59,0.05104895104895105,0.83,99.44
2022-12-12,Gujarat,803,3,794,9942,3342,1539,8.08,6,71.5,847676,6996,842923,4.67,2.15,0.13904895104895104,0.83,99.44
2022-12-13,Gujarat,73,0,71,902,3508,119,8.09,2,71.5,847749,6996,842994,4.91,0.17,0.012615384615384615,0.83,99.44
2022-12-14,Gujarat,955,5,953,11823,3421,3072,8.08,0,71.5,848704,7001,843947,4.78,4.3,0.16535664335664335,0.82,99.44
2022-12-15,Gujarat,1471,15,1470,18199,2046,1189,8.08,0,71.5,850175,7016,845417,2.86,1.66,0.2545314685314685,0.83,99.44
2022-12-16,Gujarat,1296,5,1287,16229,3699,2037,7.99,4,71.5,851471,7021,846704,5.17,2.85,0.22697902097902098,0.82,99.44
2022-12-17,Gujarat,1556,6,1550,19349,2608,1928,8.04,0,71.5,853027,7027,848254,3.65,2.7,0.2706153846153846,0.82,99.44
2022-12-18,Gujarat,230,1,223,2800,1697,762,8.21,6,71.5,853257,7028,848477,2.37,1.07,0.039160839160839164,0.82,99.44
2022-12-19,Gujarat,789,3,787,10073,4557,1651,7.83,0,71.5,854046,7031,849264,6.37,2.31,0.14088111888111887,0.82,99.44
2022-12-20,Gujarat,11,0,2,676,4528,3723,1.63,9,71.5,854057,7031,849266,6.33,5.21,0.009454545454545455,0.82,99.44
2022-12-21,Gujarat,310,3,301,4064,1860,588,7.63,6,71.5,854367,7034,849567,2.6,0.82,0.05683916083916084,0.82,99.44
2022-12-22,Gujarat,1052,7,1051,13982,4145,3305,7.52,0,71.5,855419,7041,850618,5.8,4.62,0.19555244755244755,0.82,99.44
2022-12-23,Gujarat,1358,15,1354,17225,549,61,7.88,0,71.5,856777,7056,851972,0.77,0.09,0.2409090909090909,0.82,99.44
2022-12-24,Gujarat,1092,5,1089,13325,3799,1802,8.2,0,71.5,857869,7061,853061,5.31,2.52,0.18636363636363637,0.82,99.44
2022-12-25,Gujarat,1082,15,1081,13789,772,442,7.85,0,71.5,858951,7076,854142,1.08,0.62,0.19285314685314686,0.82,99.44
2022-12-26,Gujarat,774,8,772,9842,3308,1718,7.86,0,71.5,859725,7084,854914,4.63,2.4,0.13765034965034964,0.82,99.44
2022-12-27,Gujarat,577,6,570,7366,1302,426,7.83,1,71.5,860302,7090,855484,1.82,0.6,0.10302097902097902,0.82,99.44
2022-12-28,Gujarat,1158,14,1154,14326,2744,1263,8.08,0,71.5,861460,7104,856638,3.84,1.77,0.20036363636363635,0.82,99.44
2022-12-29,Gujarat,570,7,565,6832,4527,2761,8.34,0,71.5,862030,7111,857203,6.33,3.86,0.09555244755244756,0.82,99.44
2022-12-30,Gujarat,1047,8,1042,12827,1490,352,8.16,0,71.5,863077,7119,858245,2.08,0.49,0.1793986013986014,0.82,99.44
2022-12-31,Gujarat,230,1,230,3100,1056,479,7.42,0,71.5,863307,7120,858475,1.48,0.67,0.043356643356643354,0.82,99.44
2020-01-01,Haryana,43,0,34,1232,3462,3096,3.49,9,29.4,43,0,34,11.78,10.53,0.0419047619047619,0.0,79.07
2020-01-02,Haryana,438,2,430,5299,4222,756,8.27,6,29.4,481,2,464,14.36,2.57,0.18023809523809523,0.42,96.47
2020-01-03,Haryana,524,7,521,6219,4266,3464,8.43,0,29.4,1005,9,985,14.51,11.78,0.21153061224489797,0.9,98.01
2020-01-04,Haryana,322,3,321,4031,298,117,7.99,0,29.4,1327,12,1306,1.01,0.4,0.13710884353741495,0.9,98.42
2020-01-05,Haryana,764,7,762,9439,776,500,8.09,0,29.4,2091,19,2068,2.64,1.7,0.32105442176870747,0.91,98.9
2020-01-06,Haryana,1513,4,1510,19040,3477,829,7.95,0,29.4,3604,23,3578,11.83,2.82,0.6476190476190476,0.64,99.28
2020-01-07,Haryana,754,3,748,9364,2120,1155,8.05,3,29.4,4358,26,4326,7.21,3.93,0.3185034013605442,0.6,99.27
2020-01-08,Haryana,820,2,820,10589,4558,2840,7.74,0,29.4,5178,28,5146,15.5,9.66,0.3601700680272109,0.54,99.38
2020-01-09,Haryana,1112,14,1112,13649,947,880,8.15,0,29.4,6290,42,6258,3.22,2.99,0.4642517006802721,0.67,99.49
2020-01-10,Haryana,947,13,943,11927,2387,969,7.94,0,29.4,7237,55,7201,8.12,3.3,0.40568027210884355,0.76,99.5
2020-01-11,Haryana,343,3,336,4253,3443,37,8.06,4,29.4,7580,58,7537,11.71,0.13,0.14465986394557823,0.77,99.43
2020-01-12,Haryana,1500,7,1499,18526,2430,1172,8.1,0,29.4,9080,65,9036,8.27,3.99,0.6301360544217687,0.72,99.52
2020-01-13,Haryana,296,2,293,3905,1785,843,7.58,1,29.4,9376,67,9329,6.07,2.87,0.13282312925170067,0.71,99.5
2020-01-14,Haryana,955,8,950,11585,810,229,8.24,0,29.4,10331,75,10279,2.76,0.78,0.39404761904761904,0.73,99.5
2020-01-15,Haryana,1319,16,1310,16465,4863,2634,8.01,0,29.4,11650,91,11589,16.54,8.96,0.5600340136054421,0.78,99.48
2020-01-16,Haryana,435,6,429,5426,590,524,8.02,0,29.4,12085,97,12018,2.01,1.78,0.1845578231292517,0.8,99.45
2020-01-17,Haryana,1426,8,1424,18104,3658,1018,7.88,0,29.4,13511,105,13442,12.44,3.46,0.61578231292517,0.78,99.49
2020-01-18,Haryana,547,5,543,6915,299,119,7.91,0,29.4,14058,110,13985,1.02,0.4,0.23520408163265305,0.78,99.48
2020-01-19,Haryana,1002,12,999,12849,3884,471,7.8,0,29.4,15060,122,14984,13.21,1.6,0.43704081632653063,0.81,99.5
2020-01-20,Haryana,665,8,658,7601,3198,1251,8.75,0,29.4,15725,130,15642,10.88,4.26,0.25853741496598637,0.83,99.47
2020-01-21,Haryana,1463,12,1463,18627,4574,3236,7.85,0,29.4,17188,142,17105,15.56,11.01,0.6335714285714286,0.83,99.52
2020-01-22,Haryana,131,1,124,1631,4179,1394,8.03,6,29.4,17319,143,17229,14.21,4.74,0.05547619047619048,0.83,99.48
2020-01-23,Haryana,1096,8,1091,13659,3935,543,8.02,0,29.4,18415,151,18320,13.38,1.85,0.4645918367346939,0.82,99.48
2020-01-24,Haryana,1170,11,1167,15142,1603,698,7.73,0,29.4,19585,162,19487,5.45,2.37,0.5150340136054422,0.83,99.5
2020-01-25,Haryana,447,5,445,6029,4872,1802,7.41,0,29.4,20032,167,19932,16.57,6.13,0.20506802721088435,0.83,99.5
2020-01-26,Haryana,835,6,826,10094,3510,811,8.27,3,29.4,20867,173,20758,11.94,2.76,0.3433333333333333,0.83,99.48
2020-01-27,Haryana,1485,14,1485,18791,4974,4712,7.9,0,29.4,22352,187,22243,16.92,16.03,0.6391496598639456,0.84,99.51
2020-01-28,Haryana,699,7,690,8949,1410,751,7.81,2,29.4,23051,194,22933,4.8,2.55,0.3043877551020408,0.84,99.49
2020-01-29,Haryana,592,6,591,7639,2646,806,7.75,0,29.4,23643,200,23524,9.0,2.74,0.25982993197278914,0.85,99.5
2020-01-30,Haryana,1453,17,1444,18383,4478,3808,7.9,0,29.4,25096,217,24968,15.23,12.95,0.6252721088435375,0.86,99.49
2020-01-31,Haryana,1066,10,1066,13038,1323,1320,8.18,0,29.4,26162,227,26034,4.5,4.49,0.44346938775510203,0.87,99.51
2020-02-01,Haryana,1225,5,1224,15228,887,566,8.04,0,29.4,27387,232,27258,3.02,1.93,0.5179591836734694,0.85,99.53
2020-02-02,Haryana,1550,16,1549,19104,3787,539,8.11,0,29.4,28937,248,28807,12.88,1.83,0.649795918367347,0.86,99.55
2020-02-03,Haryana,1275,16,1271,15816,1776,743,8.06,0,29.4,30212,264,30078,6.04,2.53,0.5379591836734694,0.87,99.56
2020-02-04,Haryana,754,9,747,9825,3459,2134,7.67,0,29.4,30966,273,30825,11.77,7.26,0.33418367346938777,0.88,99.54
2020-02-05,Haryana,1389,8,1385,17643,639,40,7.87,0,29.4,32355,281,32210,2.17,0.14,0.6001020408163266,0.87,99.55
2020-02-06,Haryana,849,4,848,10656,1557,1219,7.97,0,29.4,33204,285,33058,5.3,4.15,0.36244897959183675,0.86,99.56
2020-02-07,Haryana,1115,14,1107,13618,928,158,8.19,0,29.4,34319,299,34165,3.16,0.54,0.46319727891156465,0.87,99.55
2020-02-08,Haryana,1330,9,1323,16862,4572,2325,7.89,0,29.4,35649,308,35488,15.55,7.91,0.5735374149659864,0.86,99.55
2020-02-09,Haryana,102,0,98,1280,497,110,7.97,4,29.4,35751,308,35586,1.69,0.37,0.04353741496598639,0.86,99.54
2020-02-10,Haryana,380,2,372,4551,4237,379,8.35,6,29.4,36131,310,35958,14.41,1.29,0.15479591836734694,0.86,99.52
2020-02-11,Haryana,668,6,667,8155,2476,707,8.19,0,29.4,36799,316,36625,8.42,2.4,0.2773809523809524,0.86,99.53
2020-02-12,Haryana,1415,11,1408,17494,820,745,8.09,0,29.4,38214,327,38033,2.79,2.53,0.5950340136054422,0.86,99.53
2020-02-13,Haryana,481,4,477,6015,1549,52,8.0,0,29.4,38695,331,38510,5.27,0.18,0.2045918367346939,0.86,99.52
2020-02-14,Haryana,1430,9,1429,17745,1016,570,8.06,0,29.4,40125,340,39939,3.46,1.94,0.6035714285714285,0.85,99.54
2020-02-15,Haryana,282,2,277,3352,1114,70,8.41,3,29.4,40407,342,40216,3.79,0.24,0.11401360544217687,0.85,99.53
2020-02-16,Haryana,645,6,636,8417,3943,3047,7.66,3,29.4,41052,348,40852,13.41,10.36,0.2862925170068027,0.85,99.51
2020-02-17,Haryana,1421,7,1413,17977,1663,473,7.9,1,29.4,42473,355,42265,5.66,1.61,0.6114625850340136,0.84,99.51
2020-02-18,Haryana,774,5,769,9566,1284,815,8.09,0,29.4,43247,360,43034,4.37,2.77,0.32537414965986394,0.83,99.51
2020-02-19,Haryana,1142,4,1141,14510,3078,300,7.87,0,29.4,44389,364,44175,10.47,1.02,0.4935374149659864,0.82,99.52
2020-02-20,Haryana,236,1,228,2652,2766,53,8.9,7,29.4,44625,365,44403,9.41,0.18,0.09020408163265306,0.82,99.5
2020-02-21,Haryana,233,3,225,3350,2078,266,6.96,5,29.4,44858,368,44628,7.07,0.9,0.11394557823129252,0.82,99.49
2020-02-22,Haryana,320,1,312,3992,1566,1117,8.02,7,29.4,45178,369,44940,5.33,3.8,0.13578231292517007,0.82,99.47
2020-02-23,Haryana,511,3,511,6548,395,31,7.8,0,29.4,45689,372,45451,1.34,0.11,0.22272108843537414,0.81,99.48
2020-02-24,Haryana,248,3,239,3015,4367,1565,8.23,6,29.4,45937,375,45690,14.85,5.32,0.10255102040816326,0.82,99.46
2020-02-25,Haryana,266,3,260,3295,929,664,8.07,3,29.4,46203,378,45950,3.16,2.26,0.11207482993197279,0.82,99.45
2020-02-26,Haryana,1408,16,1408,17500,263,19,8.05,0,29.4,47611,394,47358,0.89,0.06,0.5952380952380952,0.83,99.47
2020-02-27,Haryana,513,4,512,6273,2667,2448,8.18,0,29.4,48124,398,47870,9.07,8.33,0.21336734693877552,0.83,99.47
2020-02-28,Haryana,74,0,68,1103,1266,1123,6.71,6,29.4,48198,398,47938,4.31,3.82,0.03751700680272109,0.83,99.46
2020-02-29,Haryana,559,7,558,6767,2509,777,8.26,0,29.4,48757,405,48496,8.53,2.64,0.23017006802721088,0.83,99.46
2020-03-01,Haryana,896,10,889,10972,1289,1168,8.17,0,29.4,49653,415,49385,4.38,3.97,0.3731972789115646,0.84,99.46
2020-03-02,Haryana,1531,20,1530,18881,4958,3981,8.11,0,29.4,51184,435,50915,16.86,13.54,0.6422108843537415,0.85,99.47
2020-03-03,Haryana,620,9,617,7833,4216,2635,7.92,0,29.4,51804,444,51532,14.34,8.96,0.2664285714285714,0.86,99.47
2020-03-04,Haryana,376,3,374,4904,728,406,7.67,0,29.4,52180,447,51906,2.48,1.38,0.16680272108843539,0.86,99.47
2020-03-05,Haryana,1058,14,1053,13238,3123,697,7.99,0,29.4,53238,461,52959,10.62,2.37,0.4502721088435374,0.87,99.48
2020-03-06,Haryana,432,2,428,5569,4652,2398,7.76,2,29.4,53670,463,53387,15.82,8.16,0.189421768707483,0.86,99.47
2020-03-07,Haryana,804,6,801,10280,3803,3383,7.82,0,29.4,54474,469,54188,12.94,11.51,0.34965986394557824,0.86,99.47
2020-03-08,Haryana,75,0,67,1229,4492,3649,6.1,8,29.4,54549,469,54255,15.28,12.41,0.04180272108843537,0.86,99.46
2020-03-09,Haryana,1102,15,1100,13533,3803,399,8.14,0,29.4,55651,484,55355,12.94,1.36,0.4603061224489796,0.87,99.47
2020-03-10,Haryana,1004,3,996,12682,791,13,7.92,5,29.4,56655,487,56351,2.69,0.04,0.43136054421768705,0.86,99.46
2020-03-11,Haryana,639,3,636,7672,1311,598,8.33,0,29.4,57294,490,56987,4.46,2.03,0.26095238095238094,0.86,99.46
2020-03-12,Haryana,1115,16,1111,13948,4393,3114,7.99,0,29.4,58409,506,58098,14.94,10.59,0.474421768707483,0.87,99.47
2020-03-13,Haryana,313,1,305,3851,864,510,8.13,7,29.4,58722,507,58403,2.94,1.73,0.13098639455782313,0.86,99.46
2020-03-14,Haryana,368,2,360,4588,3587,766,8.02,6,29.4,59090,509,58763,12.2,2.61,0.15605442176870749,0.86,99.45
2020-03-15,Haryana,893,11,891,11315,3755,2349,7.89,0,29.4,59983,520,59654,12.77,7.99,0.3848639455782313,0.87,99.45
2020-03-16,Haryana,568,2,566,7102,1471,1359,8.0,0,29.4,60551,522,60220,5.0,4.62,0.24156462585034014,0.86,99.45
2020-03-17,Haryana,605,6,596,7993,3288,11,7.57,3,29.4,61156,528,60816,11.18,0.04,0.27187074829931973,0.86,99.44
2020-03-18,Haryana,232,1,232,3139,2014,591,7.39,0,29.4,61388,529,61048,6.85,2.01,0.10676870748299319,0.86,99.45
2020-03-19,Haryana,685,7,685,8461,4430,1691,8.1,0,29.4,62073,536,61733,15.07,5.75,0.28778911564625853,0.86,99.45
2020-03-20,Haryana,1544,6,1535,18965,2272,1235,8.14,3,29.4,63617,542,63268,7.73,4.2,0.6450680272108843,0.85,99.45
2020-03-21,Haryana,721,8,713,8876,228,26,8.12,0,29.4,64338,550,63981,0.78,0.09,0.3019047619047619,0.85,99.45
2020-03-22,Haryana,278,2,271,3904,952,582,7.12,5,29.4,64616,552,64252,3.24,1.98,0.1327891156462585,0.85,99.44
2020-03-23,Haryana,713,6,706,8898,4804,2483,8.01,1,29.4,65329,558,64958,16.34,8.45,0.3026530612244898,0.85,99.43
2020-03-24,Haryana,655,7,647,8384,346,335,7.81,1,29.4,65984,565,65605,1.18,1.14,0.2851700680272109,0.86,99.43
2020-03-25,Haryana,193,1,189,2746,822,190,7.03,3,29.4,66177,566,65794,2.8,0.65,0.09340136054421769,0.86,99.42
2020-03-26,Haryana,1339,9,1332,16560,121,99,8.09,0,29.4,67516,575,67126,0.41,0.34,0.563265306122449,0.85,99.42
2020-03-27,Haryana,1543,9,1534,19462,3477,384,7.93,0,29.4,69059,584,68660,11.83,1.31,0.6619727891156463,0.85,99.42
2020-03-28,Haryana,1259,11,1253,15262,1922,721,8.25,0,29.4,70318,595,69913,6.54,2.45,0.5191156462585034,0.85,99.42
2020-03-29,Haryana,1372,13,1370,16909,4267,1787,8.11,0,29.4,71690,608,71283,14.51,6.08,0.5751360544217687,0.85,99.43
2020-03-30,Haryana,1414,18,1411,17490,201,65,8.08,0,29.4,73104,626,72694,0.68,0.22,0.5948979591836735,0.86,99.44
2020-03-31,Haryana,1203,6,1202,14956,3410,1403,8.04,0,29.4,74307,632,73896,11.6,4.77,0.5087074829931972,0.85,99.45
2020-04-01,Haryana,114,1,105,2029,3466,1891,5.62,8,29.4,74421,633,74001,11.79,6.43,0.06901360544217687,0.85,99.44
2020-04-02,Haryana,860,7,855,10854,2269,123,7.92,0,29.4,75281,640,74856,7.72,0.42,0.36918367346938774,0.85,99.44
2020-04-03,Haryana,1462,21,1462,18305,178,56,7.99,0,29.4,76743,661,76318,0.61,0.19,0.6226190476190476,0.86,99.45
2020-04-04,Haryana,14,0,7,698,2246,2217,2.01,7,29.4,76757,661,76325,7.64,7.54,0.023741496598639455,0.86,99.44
2020-04-05,Haryana,1298,11,1291,15912,2566,1475,8.16,0,29.4,78055,672,77616,8.73,5.02,0.5412244897959184,0.86,99.44
2020-04-06,Haryana,1576,6,1567,19848,1517,242,7.94,3,29.4,79631,678,79183,5.16,0.82,0.6751020408163265,0.85,99.44
2020-04-07,Haryana,939,5,933,12463,3975,1191,7.53,1,29.4,80570,683,80116,13.52,4.05,0.42391156462585033,0.85,99.44
2020-04-08,Haryana,1308,13,1305,16347,1107,74,8.0,0,29.4,81878,696,81421,3.77,0.25,0.5560204081632653,0.85,99.44
2020-04-09,Haryana,1151,5,1146,14357,2261,1466,8.02,0,29.4,83029,701,82567,7.69,4.99,0.48833333333333334,0.84,99.44
2020-04-10,Haryana,722,3,719,9247,2054,635,7.81,0,29.4,83751,704,83286,6.99,2.16,0.31452380952380954,0.84,99.44
2020-04-11,Haryana,1602,5,1598,19997,4317,3655,8.01,0,29.4,85353,709,84884,14.68,12.43,0.6801700680272109,0.83,99.45
2020-04-12,Haryana,467,5,461,5578,539,435,8.37,1,29.4,85820,714,85345,1.83,1.48,0.18972789115646257,0.83,99.45
2020-04-13,Haryana,1123,9,1122,14092,3163,1213,7.97,0,29.4,86943,723,86467,10.76,4.13,0.47931972789115646,0.83,99.45
2020-04-14,Haryana,898,8,891,10906,605,151,8.23,0,29.4,87841,731,87358,2.06,0.51,0.370952380952381,0.83,99.45
2020-04-15,Haryana,557,5,557,6688,3538,367,8.33,0,29.4,88398,736,87915,12.03,1.25,0.2274829931972789,0.83,99.45
2020-04-16,Haryana,386,2,377,5093,539,147,7.58,7,29.4,88784,738,88292,1.83,0.5,0.1732312925170068,0.83,99.45
2020-04-17,Haryana,1425,13,1418,17844,4586,3421,7.99,0,29.4,90209,751,89710,15.6,11.64,0.606938775510204,0.83,99.45
2020-04-18,Haryana,1016,3,1013,13175,2376,100,7.71,0,29.4,91225,754,90723,8.08,0.34,0.4481292517006803,0.83,99.45
2020-04-19,Haryana,1086,15,1082,13529,4472,1242,8.03,0,29.4,92311,769,91805,15.21,4.22,0.4601700680272109,0.83,99.45
2020-04-20,Haryana,964,11,956,11874,3279,3010,8.12,0,29.4,93275,780,92761,11.15,10.24,0.4038775510204082,0.84,99.45
2020-04-21,Haryana,175,1,172,2353,2450,703,7.44,2,29.4,93450,781,92933,8.33,2.39,0.08003401360544218,0.84,99.45
2020-04-22,Haryana,1329,11,1323,16202,3605,1896,8.2,0,29.4,94779,792,94256,12.26,6.45,0.5510884353741496,0.84,99.45
2020-04-23,Haryana,664,2,656,8275,887,174,8.02,6,29.4,95443,794,94912,3.02,0.59,0.2814625850340136,0.83,99.44
2020-04-24,Haryana,1077,8,1072,13591,4858,2059,7.92,0,29.4,96520,802,95984,16.52,7.0,0.46227891156462586,0.83,99.44
2020-04-25,Haryana,1471,16,1471,18057,3895,75,8.15,0,29.4,97991,818,97455,13.25,0.26,0.6141836734693877,0.83,99.45
2020-04-26,Haryana,397,4,390,4786,2145,1895,8.3,3,29.4,98388,822,97845,7.3,6.45,0.1627891156462585,0.84,99.45
2020-04-27,Haryana,118,0,117,1758,2518,729,6.71,1,29.4,98506,822,97962,8.56,2.48,0.05979591836734694,0.83,99.45
2020-04-28,Haryana,1517,15,1517,18747,1520,78,8.09,0,29.4,100023,837,99479,5.17,0.27,0.6376530612244898,0.84,99.46
2020-04-29,Haryana,1155,8,1152,14512,790,48,7.96,0,29.4,101178,845,100631,2.69,0.16,0.49360544217687075,0.84,99.46
2020-04-30,Haryana,212,2,203,3307,3216,545,6.41,7,29.4,101390,847,100834,10.94,1.85,0.1124829931972789,0.84,99.45
2020-05-01,Haryana,217,2,210,2637,4910,1049,8.23,5,29.4,101607,849,101044,16.7,3.57,0.08969387755102042,0.84,99.45
2020-05-02,Haryana,294,2,290,3479,4754,765,8.45,2,29.4,101901,851,101334,16.17,2.6,0.11833333333333333,0.84,99.44
2020-05-03,Haryana,174,0,165,2113,4814,3895,8.23,9,29.4,102075,851,101499,16.37,13.25,0.07187074829931973,0.83,99.44
2020-05-04,Haryana,1550,5,1545,19152,1396,1224,8.09,0,29.4,103625,856,103044,4.75,4.16,0.6514285714285715,0.83,99.44
2020-05-05,Haryana,1547,14,1539,19562,4945,3084,7.91,0,29.4,105172,870,104583,16.82,10.49,0.665374149659864,0.83,99.44
2020-05-06,Haryana,1198,13,1191,14895,16,10,8.04,0,29.4,106370,883,105774,0.05,0.03,0.5066326530612245,0.83,99.44
2020-05-07,Haryana,295,3,288,3648,4558,3312,8.09,4,29.4,106665,886,106062,15.5,11.27,0.12408163265306123,0.83,99.43
2020-05-08,Haryana,243,1,241,2937,1083,166,8.27,1,29.4,106908,887,106303,3.68,0.56,0.09989795918367347,0.83,99.43
2020-05-09,Haryana,513,3,507,6459,4399,502,7.94,3,29.4,107421,890,106810,14.96,1.71,0.2196938775510204,0.83,99.43
2020-05-10,Haryana,835,12,828,10422,160,110,8.01,0,29.4,108256,902,107638,0.54,0.37,0.3544897959183673,0.83,99.43
2020-05-11,Haryana,31,0,29,593,616,614,5.23,2,29.4,108287,902,107667,2.1,2.09,0.020170068027210886,0.83,99.43
2020-05-12,Haryana,723,8,715,8959,1283,122,8.07,0,29.4,109010,910,108382,4.36,0.41,0.3047278911564626,0.83,99.42
2020-05-13,Haryana,215,0,206,2668,2409,1783,8.06,9,29.4,109225,910,108588,8.19,6.06,0.09074829931972789,0.83,99.42
2020-05-14,Haryana,670,7,669,8641,3781,1025,7.75,0,29.4,109895,917,109257,12.86,3.49,0.29391156462585033,0.83,99.42
2020-05-15,Haryana,1325,9,1320,16771,4751,1727,7.9,0,29.4,111220,926,110577,16.16,5.87,0.5704421768707483,0.83,99.42
2020-05-16,Haryana,349,3,345,5045,2938,2499,6.92,1,29.4,111569,929,110922,9.99,8.5,0.17159863945578233,0.83,99.42
2020-05-17,Haryana,1028,11,1021,13022,3958,1351,7.89,0,29.4,112597,940,111943,13.46,4.6,0.44292517006802723,0.83,99.42
2020-05-18,Haryana,844,4,840,9983,2036,1296,8.45,0,29.4,113441,944,112783,6.93,4.41,0.3395578231292517,0.83,99.42
2020-05-19,Haryana,872,9,865,11014,3492,2537,7.92,0,29.4,114313,953,113648,11.88,8.63,0.37462585034013607,0.83,99.42
2020-05-20,Haryana,1072,12,1065,13665,2045,465,7.84,0,29.4,115385,965,114713,6.96,1.58,0.46479591836734696,0.84,99.42
2020-05-21,Haryana,749,7,747,8795,1635,179,8.52,0,29.4,116134,972,115460,5.56,0.61,0.2991496598639456,0.84,99.42
2020-05-22,Haryana,1547,10,1539,19263,1260,598,8.03,0,29.4,117681,982,116999,4.29,2.03,0.6552040816326531,0.83,99.42
2020-05-23,Haryana,1200,14,1196,14466,4891,4300,8.3,0,29.4,118881,996,118195,16.64,14.63,0.49204081632653063,0.84,99.42
2020-05-24,Haryana,894,9,892,11190,1287,175,7.99,0,29.4,119775,1005,119087,4.38,0.6,0.3806122448979592,0.84,99.43
2020-05-25,Haryana,917,6,914,11671,192,32,7.86,0,29.4,120692,1011,120001,0.65,0.11,0.39697278911564626,0.84,99.43
2020-05-26,Haryana,168,0,166,2118,1109,965,7.93,2,29.4,120860,1011,120167,3.77,3.28,0.07204081632653062,0.84,99.43
2020-05-27,Haryana,619,5,619,8109,3683,1541,7.63,0,29.4,121479,1016,120786,12.53,5.24,0.2758163265306122,0.84,99.43
2020-05-28,Haryana,739,8,735,9021,2219,1424,8.19,0,29.4,122218,1024,121521,7.55,4.84,0.30683673469387757,0.84,99.43
2020-05-29,Haryana,270,1,262,3313,1379,675,8.15,7,29.4,122488,1025,121783,4.69,2.3,0.11268707482993197,0.84,99.42
2020-05-30,Haryana,1338,9,1333,16309,27,7,8.2,0,29.4,123826,1034,123116,0.09,0.02,0.5547278911564626,0.84,99.43
2020-05-31,Haryana,1214,17,1205,15363,3592,507,7.9,0,29.4,125040,1051,124321,12.22,1.72,0.5225510204081633,0.84,99.42
2020-06-01,Haryana,308,2,305,3559,3674,2637,8.65,1,29.4,125348,1053,124626,12.5,8.97,0.12105442176870748,0.84,99.42
2020-06-02,Haryana,942,5,941,11474,510,179,8.21,0,29.4,126290,1058,125567,1.73,0.61,0.3902721088435374,0.84,99.43
2020-06-03,Haryana,1205,14,1198,14969,4018,2000,8.05,0,29.4,127495,1072,126765,13.67,6.8,0.5091496598639456,0.84,99.43
2020-06-04,Haryana,1447,8,1440,18148,1835,1339,7.97,0,29.4,128942,1080,128205,6.24,4.55,0.6172789115646259,0.84,99.43
2020-06-05,Haryana,1374,6,1373,17285,4962,1383,7.95,0,29.4,130316,1086,129578,16.88,4.7,0.5879251700680272,0.83,99.43
2020-06-06,Haryana,1458,16,1451,17980,4126,748,8.11,0,29.4,131774,1102,131029,14.03,2.54,0.6115646258503401,0.84,99.43
2020-06-07,Haryana,1377,8,1377,17093,1242,781,8.06,0,29.4,133151,1110,132406,4.22,2.66,0.5813945578231292,0.83,99.44
2020-06-08,Haryana,74,0,73,768,1669,1056,9.64,1,29.4,133225,1110,132479,5.68,3.59,0.026122448979591838,0.83,99.44
2020-06-09,Haryana,986,3,978,12098,2202,2079,8.15,5,29.4,134211,1113,133457,7.49,7.07,0.41149659863945576,0.83,99.44
2020-06-10,Haryana,773,4,770,9672,295,136,7.99,0,29.4,134984,1117,134227,1.0,0.46,0.3289795918367347,0.83,99.44
2020-06-11,Haryana,925,12,920,11353,4932,3722,8.15,0,29.4,135909,1129,135147,16.78,12.66,0.386156462585034,0.83,99.44
2020-06-12,Haryana,335,2,334,4458,3392,3045,7.51,0,29.4,136244,1131,135481,11.54,10.36,0.15163265306122448,0.83,99.44
2020-06-13,Haryana,28,0,24,694,3071,2819,4.03,4,29.4,136272,1131,135505,10.45,9.59,0.023605442176870748,0.83,99.44
2020-06-14,Haryana,379,3,376,5112,4628,2778,7.41,0,29.4,136651,1134,135881,15.74,9.45,0.17387755102040817,0.83,99.44
2020-06-15,Haryana,913,4,911,11843,1665,1197,7.71,0,29.4,137564,1138,136792,5.66,4.07,0.40282312925170066,0.83,99.44
2020-06-16,Haryana,1319,17,1317,16373,4736,1889,8.06,0,29.4,138883,1155,138109,16.11,6.43,0.5569047619047619,0.83,99.44
2020-06-17,Haryana,867,3,867,10828,4784,4393,8.01,0,29.4,139750,1158,138976,16.27,14.94,0.36829931972789115,0.83,99.45
2020-06-18,Haryana,955,5,946,12032,2868,284,7.94,4,29.4,140705,1163,139922,9.76,0.97,0.4092517006802721,0.83,99.44
2020-06-19,Haryana,824,7,821,10478,1700,351,7.86,0,29.4,141529,1170,140743,5.78,1.19,0.35639455782312923,0.83,99.44
2020-06-20,Haryana,1123,12,1114,14235,3682,1213,7.89,0,29.4,142652,1182,141857,12.52,4.13,0.48418367346938773,0.83,99.44
2020-06-21,Haryana,204,1,201,2661,1506,1477,7.67,2,29.4,142856,1183,142058,5.12,5.02,0.09051020408163266,0.83,99.44
2020-06-22,Haryana,166,2,161,1994,451,75,8.32,3,29.4,143022,1185,142219,1.53,0.26,0.06782312925170068,0.83,99.44
2020-06-23,Haryana,432,5,427,5199,782,133,8.31,0,29.4,143454,1190,142646,2.66,0.45,0.17683673469387756,0.83,99.44
2020-06-24,Haryana,1281,10,1278,15483,2980,2680,8.27,0,29.4,144735,1200,143924,10.14,9.12,0.5266326530612245,0.83,99.44
2020-06-25,Haryana,826,4,824,10130,2613,1830,8.15,0,29.4,145561,1204,144748,8.89,6.22,0.3445578231292517,0.83,99.44
2020-06-26,Haryana,70,0,67,697,4617,2655,10.04,3,29.4,145631,1204,144815,15.7,9.03,0.02370748299319728,0.83,99.44
2020-06-27,Haryana,1042,14,1040,13103,178,136,7.95,0,29.4,146673,1218,145855,0.61,0.46,0.44568027210884353,0.83,99.44
2020-06-28,Haryana,649,9,646,8251,691,151,7.87,0,29.4,147322,1227,146501,2.35,0.51,0.28064625850340136,0.83,99.44
2020-06-29,Haryana,1413,8,1411,17343,591,42,8.15,0,29.4,148735,1235,147912,2.01,0.14,0.5898979591836735,0.83,99.45
2020-06-30,Haryana,1135,9,1130,14291,2200,1987,7.94,0,29.4,149870,1244,149042,7.48,6.76,0.48608843537414964,0.83,99.45
2020-07-01,Haryana,412,4,409,5006,69,53,8.23,0,29.4,150282,1248,149451,0.23,0.18,0.1702721088435374,0.83,99.45
2020-07-02,Haryana,210,1,207,2543,3172,947,8.26,2,29.4,150492,1249,149658,10.79,3.22,0.08649659863945579,0.83,99.45
2020-07-03,Haryana,716,7,712,9128,4076,3763,7.84,0,29.4,151208,1256,150370,13.86,12.8,0.31047619047619046,0.83,99.45
2020-07-04,Haryana,580,3,574,7172,1724,1204,8.09,3,29.4,151788,1259,150944,5.86,4.1,0.2439455782312925,0.83,99.44
2020-07-05,Haryana,411,3,404,5153,2526,1371,7.98,4,29.4,152199,1262,151348,8.59,4.66,0.17527210884353742,0.83,99.44
2020-07-06,Haryana,1518,8,1510,18735,903,222,8.1,0,29.4,153717,1270,152858,3.07,0.76,0.6372448979591837,0.83,99.44
2020-07-07,Haryana,1112,13,1107,14137,4934,4306,7.87,0,29.4,154829,1283,153965,16.78,14.65,0.48085034013605443,0.83,99.44
2020-07-08,Haryana,396,4,392,4888,4773,3055,8.1,0,29.4,155225,1287,154357,16.23,10.39,0.16625850340136056,0.83,99.44
2020-07-09,Haryana,828,6,824,10462,11,7,7.91,0,29.4,156053,1293,155181,0.04,0.02,0.35585034013605443,0.83,99.44
2020-07-10,Haryana,277,1,275,3793,72,13,7.3,1,29.4,156330,1294,155456,0.24,0.04,0.12901360544217688,0.83,99.44
2020-07-11,Haryana,393,2,387,4701,351,11,8.36,4,29.4,156723,1296,155843,1.19,0.04,0.15989795918367347,0.83,99.44
2020-07-12,Haryana,255,2,254,3319,669,129,7.68,0,29.4,156978,1298,156097,2.28,0.44,0.11289115646258503,0.83,99.44
2020-07-13,Haryana,683,6,682,8441,2395,1691,8.09,0,29.4,157661,1304,156779,8.15,5.75,0.28710884353741495,0.83,99.44
2020-07-14,Haryana,331,2,331,3939,1777,286,8.4,0,29.4,157992,1306,157110,6.04,0.97,0.1339795918367347,0.83,99.44
2020-07-15,Haryana,118,1,113,914,1366,1181,12.91,4,29.4,158110,1307,157223,4.65,4.02,0.03108843537414966,0.83,99.44
2020-07-16,Haryana,610,7,610,7890,3377,1693,7.73,0,29.4,158720,1314,157833,11.49,5.76,0.2683673469387755,0.83,99.44
2020-07-17,Haryana,1089,5,1080,13478,871,679,8.08,4,29.4,159809,1319,158913,2.96,2.31,0.45843537414965985,0.83,99.44
2020-07-18,Haryana,847,9,847,10735,2458,95,7.89,0,29.4,160656,1328,159760,8.36,0.32,0.3651360544217687,0.83,99.44
2020-07-19,Haryana,295,2,288,3340,2979,1896,8.83,5,29.4,160951,1330,160048,10.13,6.45,0.11360544217687076,0.83,99.44
2020-07-20,Haryana,406,2,398,5405,4695,1446,7.51,6,29.4,161357,1332,160446,15.97,4.92,0.18384353741496598,0.83,99.44
2020-07-21,Haryana,792,9,791,9800,2581,1809,8.08,0,29.4,162149,1341,161237,8.78,6.15,0.3333333333333333,0.83,99.44
2020-07-22,Haryana,496,1,491,5955,2596,1844,8.33,4,29.4,162645,1342,161728,8.83,6.27,0.20255102040816325,0.83,99.44
2020-07-23,Haryana,433,3,425,5619,2613,1569,7.71,5,29.4,163078,1345,162153,8.89,5.34,0.19112244897959182,0.82,99.43
2020-07-24,Haryana,801,10,793,9736,2219,1128,8.23,0,29.4,163879,1355,162946,7.55,3.84,0.331156462585034,0.83,99.43
2020-07-25,Haryana,348,2,341,3995,1891,96,8.71,5,29.4,164227,1357,163287,6.43,0.33,0.1358843537414966,0.83,99.43
2020-07-26,Haryana,869,10,869,10522,4058,3055,8.26,0,29.4,165096,1367,164156,13.8,10.39,0.357891156462585,0.83,99.43
2020-07-27,Haryana,716,7,712,8439,2489,389,8.48,0,29.4,165812,1374,164868,8.47,1.32,0.2870408163265306,0.83,99.43
2020-07-28,Haryana,1566,8,1560,19677,3707,2188,7.96,0,29.4,167378,1382,166428,12.61,7.44,0.6692857142857143,0.83,99.43
2020-07-29,Haryana,1325,10,1324,16716,3875,1010,7.93,0,29.4,168703,1392,167752,13.18,3.44,0.5685714285714286,0.83,99.44
2020-07-30,Haryana,77,0,69,995,559,434,7.74,8,29.4,168780,1392,167821,1.9,1.48,0.033843537414965985,0.82,99.43
2020-07-31,Haryana,1142,10,1137,14279,3462,3316,8.0,0,29.4,169922,1402,168958,11.78,11.28,0.4856802721088435,0.83,99.43
2020-08-01,Haryana,886,3,886,11232,316,242,7.89,0,29.4,170808,1405,169844,1.07,0.82,0.3820408163265306,0.82,99.44
2020-08-02,Haryana,331,1,329,4110,3619,398,8.05,1,29.4,171139,1406,170173,12.31,1.35,0.13979591836734695,0.82,99.44
2020-08-03,Haryana,620,7,611,8065,3999,2572,7.69,2,29.4,171759,1413,170784,13.6,8.75,0.27431972789115644,0.82,99.43
2020-08-04,Haryana,804,5,798,10687,4244,2088,7.52,1,29.4,172563,1418,171582,14.44,7.1,0.3635034013605442,0.82,99.43
2020-08-05,Haryana,1315,16,1306,16391,4546,1017,8.02,0,29.4,173878,1434,172888,15.46,3.46,0.5575170068027211,0.82,99.43
2020-08-06,Haryana,970,10,966,12325,435,426,7.87,0,29.4,174848,1444,173854,1.48,1.45,0.4192176870748299,0.83,99.43
2020-08-07,Haryana,693,4,692,8548,519,140,8.11,0,29.4,175541,1448,174546,1.77,0.48,0.2907482993197279,0.82,99.43
2020-08-08,Haryana,1277,12,1274,15734,3422,2365,8.12,0,29.4,176818,1460,175820,11.64,8.04,0.5351700680272109,0.83,99.44
2020-08-09,Haryana,1033,13,1031,12995,4011,2325,7.95,0,29.4,177851,1473,176851,13.64,7.91,0.44200680272108844,0.83,99.44
2020-08-10,Haryana,598,4,590,7838,2540,2309,7.63,4,29.4,178449,1477,177441,8.64,7.85,0.2665986394557823,0.83,99.44
2020-08-11,Haryana,565,8,564,7151,4494,4353,7.9,0,29.4,179014,1485,178005,15.29,14.81,0.24323129251700681,0.83,99.44
2020-08-12,Haryana,1473,22,1464,18508,3797,3075,7.96,0,29.4,180487,1507,179469,12.91,10.46,0.6295238095238095,0.83,99.44
2020-08-13,Haryana,113,1,107,1507,5,1,7.5,5,29.4,180600,1508,179576,0.02,0.0,0.051258503401360546,0.83,99.43
2020-08-14,Haryana,714,3,713,8859,3235,2612,8.06,0,29.4,181314,1511,180289,11.0,8.88,0.3013265306122449,0.83,99.43
2020-08-15,Haryana,750,10,749,9173,1416,323,8.18,0,29.4,182064,1521,181038,4.82,1.1,0.31200680272108844,0.84,99.44
2020-08-16,Haryana,953,12,944,11775,4483,4062,8.09,0,29.4,183017,1533,181982,15.25,13.82,0.4005102040816326,0.84,99.43
2020-08-17,Haryana,885,5,878,11375,3059,1962,7.78,2,29.4,183902,1538,182860,10.4,6.67,0.3869047619047619,0.84,99.43
2020-08-18,Haryana,1030,9,1030,12708,2851,1678,8.11,0,29.4,184932,1547,183890,9.7,5.71,0.4322448979591837,0.84,99.44
2020-08-19,Haryana,1239,14,1238,15691,4528,1471,7.9,0,29.4,186171,1561,185128,15.4,5.0,0.5337074829931973,0.84,99.44
2020-08-20,Haryana,1402,13,1398,17362,1822,1187,8.08,0,29.4,187573,1574,186526,6.2,4.04,0.5905442176870749,0.84,99.44
2020-08-21,Haryana,1224,5,1224,14892,1441,924,8.22,0,29.4,188797,1579,187750,4.9,3.14,0.5065306122448979,0.84,99.45
2020-08-22,Haryana,639,6,633,7884,399,169,8.11,0,29.4,189436,1585,188383,1.36,0.57,0.26816326530612244,0.84,99.44
2020-08-23,Haryana,904,10,900,11085,2735,374,8.16,0,29.4,190340,1595,189283,9.3,1.27,0.37704081632653064,0.84,99.44
2020-08-24,Haryana,1532,20,1532,18735,3156,3054,8.18,0,29.4,191872,1615,190815,10.73,10.39,0.6372448979591837,0.84,99.45
2020-08-25,Haryana,742,6,740,9355,827,468,7.93,0,29.4,192614,1621,191555,2.81,1.59,0.31819727891156463,0.84,99.45
2020-08-26,Haryana,818,3,812,10189,317,117,8.03,3,29.4,193432,1624,192367,1.08,0.4,0.34656462585034015,0.84,99.45
2020-08-27,Haryana,286,3,279,3096,1410,29,9.24,4,29.4,193718,1627,192646,4.8,0.1,0.10530612244897959,0.84,99.45
2020-08-28,Haryana,1535,6,1531,18833,4193,4033,8.15,0,29.4,195253,1633,194177,14.26,13.72,0.640578231292517,0.84,99.45
2020-08-29,Haryana,861,9,855,10568,2221,216,8.15,0,29.4,196114,1642,195032,7.55,0.73,0.3594557823129252,0.84,99.45
2020-08-30,Haryana,258,3,258,3098,1322,26,8.33,0,29.4,196372,1645,195290,4.5,0.09,0.10537414965986394,0.84,99.45
2020-08-31,Haryana,759,9,755,9380,2562,2194,8.09,0,29.4,197131,1654,196045,8.71,7.46,0.319047619047619,0.84,99.45
2020-09-01,Haryana,1129,3,1126,14364,2831,1757,7.86,0,29.4,198260,1657,197171,9.63,5.98,0.48857142857142855,0.84,99.45
2020-09-02,Haryana,1429,15,1427,17461,1121,226,8.18,0,29.4,199689,1672,198598,3.81,0.77,0.5939115646258504,0.84,99.45
2020-09-03,Haryana,348,4,343,4017,4978,4955,8.66,1,29.4,200037,1676,198941,16.93,16.85,0.1366326530612245,0.84,99.45
2020-09-04,Haryana,957,11,951,11890,2603,738,8.05,0,29.4,200994,1687,199892,8.85,2.51,0.404421768707483,0.84,99.45
2020-09-05,Haryana,579,2,573,6726,2866,584,8.61,4,29.4,201573,1689,200465,9.75,1.99,0.22877551020408163,0.84,99.45
2020-09-06,Haryana,733,2,729,8803,2128,275,8.33,2,29.4,202306,1691,201194,7.24,0.94,0.299421768707483,0.84,99.45
2020-09-07,Haryana,133,1,132,1196,3454,555,11.12,0,29.4,202439,1692,201326,11.75,1.89,0.040680272108843535,0.84,99.45
2020-09-08,Haryana,827,11,820,10537,1399,1291,7.85,0,29.4,203266,1703,202146,4.76,4.39,0.3584013605442177,0.84,99.45
2020-09-09,Haryana,1190,5,1184,14943,2554,425,7.96,1,29.4,204456,1708,203330,8.69,1.45,0.508265306122449,0.84,99.45
2020-09-10,Haryana,863,3,857,10440,2535,287,8.27,3,29.4,205319,1711,204187,8.62,0.98,0.3551020408163265,0.83,99.45
2020-09-11,Haryana,1425,5,1425,17968,3654,1950,7.93,0,29.4,206744,1716,205612,12.43,6.63,0.611156462585034,0.83,99.45
2020-09-12,Haryana,147,1,147,1898,1694,1333,7.74,0,29.4,206891,1717,205759,5.76,4.53,0.0645578231292517,0.83,99.45
2020-09-13,Haryana,566,5,558,6961,377,98,8.13,3,29.4,207457,1722,206317,1.28,0.33,0.2367687074829932,0.83,99.45
2020-09-14,Haryana,1129,7,1125,14119,540,44,8.0,0,29.4,208586,1729,207442,1.84,0.15,0.48023809523809524,0.83,99.45
2020-09-15,Haryana,981,5,975,11931,1669,191,8.22,1,29.4,209567,1734,208417,5.68,0.65,0.4058163265306122,0.83,99.45
2020-09-16,Haryana,557,2,550,7098,483,165,7.85,5,29.4,210124,1736,208967,1.64,0.56,0.24142857142857144,0.83,99.45
2020-09-17,Haryana,1449,8,1441,18393,2463,1570,7.88,0,29.4,211573,1744,210408,8.38,5.34,0.6256122448979592,0.82,99.45
2020-09-18,Haryana,79,0,70,1675,1821,1233,4.72,9,29.4,211652,1744,210478,6.19,4.19,0.05697278911564626,0.82,99.45
2020-09-19,Haryana,869,5,864,11290,2307,1465,7.7,0,29.4,212521,1749,211342,7.85,4.98,0.3840136054421769,0.82,99.45
2020-09-20,Haryana,758,11,753,9233,2686,713,8.21,0,29.4,213279,1760,212095,9.14,2.43,0.314047619047619,0.83,99.44
2020-09-21,Haryana,1111,8,1104,13742,2807,462,8.08,0,29.4,214390,1768,213199,9.55,1.57,0.46741496598639454,0.82,99.44
2020-09-22,Haryana,741,8,736,9566,3337,891,7.75,0,29.4,215131,1776,213935,11.35,3.03,0.32537414965986394,0.83,99.44
2020-09-23,Haryana,869,12,864,10650,143,107,8.16,0,29.4,216000,1788,214799,0.49,0.36,0.3622448979591837,0.83,99.44
2020-09-24,Haryana,202,2,202,2630,4873,4145,7.68,0,29.4,216202,1790,215001,16.57,14.1,0.08945578231292517,0.83,99.44
2020-09-25,Haryana,556,7,548,6871,2036,1222,8.09,1,29.4,216758,1797,215549,6.93,4.16,0.23370748299319727,0.83,99.44
2020-09-26,Haryana,267,3,267,3166,3561,1948,8.43,0,29.4,217025,1800,215816,12.11,6.63,0.10768707482993198,0.83,99.44
2020-09-27,Haryana,1191,6,1191,14644,2525,963,8.13,0,29.4,218216,1806,217007,8.59,3.28,0.4980952380952381,0.83,99.45
2020-09-28,Haryana,629,1,626,7961,500,233,7.9,2,29.4,218845,1807,217633,1.7,0.79,0.2707823129251701,0.83,99.45
2020-09-29,Haryana,1570,11,1561,19370,2699,2261,8.11,0,29.4,220415,1818,219194,9.18,7.69,0.658843537414966,0.82,99.45
2020-09-30,Haryana,1116,14,1114,14074,780,735,7.93,0,29.4,221531,1832,220308,2.65,2.5,0.47870748299319726,0.83,99.45
2020-10-01,Haryana,892,10,890,11228,2273,116,7.94,0,29.4,222423,1842,221198,7.73,0.39,0.3819047619047619,0.83,99.45
2020-10-02,Haryana,598,6,592,7617,3538,1219,7.85,0,29.4,223021,1848,221790,12.03,4.15,0.2590816326530612,0.83,99.45
2020-10-03,Haryana,644,3,639,7705,2996,231,8.36,2,29.4,223665,1851,222429,10.19,0.79,0.2620748299319728,0.83,99.45
2020-10-04,Haryana,488,3,482,6307,1579,454,7.74,3,29.4,224153,1854,222911,5.37,1.54,0.21452380952380953,0.83,99.45
2020-10-05,Haryana,1451,18,1447,17951,2149,1328,8.08,0,29.4,225604,1872,224358,7.31,4.52,0.610578231292517,0.83,99.45
2020-10-06,Haryana,1563,17,1555,19957,1013,78,7.83,0,29.4,227167,1889,225913,3.45,0.27,0.6788095238095239,0.83,99.45
2020-10-07,Haryana,357,4,354,4546,3319,833,7.85,0,29.4,227524,1893,226267,11.29,2.83,0.15462585034013607,0.83,99.45
2020-10-08,Haryana,797,5,789,9856,3544,1844,8.09,3,29.4,228321,1898,227056,12.05,6.27,0.3352380952380952,0.83,99.45
2020-10-09,Haryana,972,14,964,12303,873,656,7.9,0,29.4,229293,1912,228020,2.97,2.23,0.41846938775510206,0.83,99.44
2020-10-10,Haryana,1451,10,1442,18302,457,262,7.93,0,29.4,230744,1922,229462,1.55,0.89,0.622517006802721,0.83,99.44
2020-10-11,Haryana,89,1,80,744,3766,841,11.96,8,29.4,230833,1923,229542,12.81,2.86,0.025306122448979593,0.83,99.44
2020-10-12,Haryana,1122,6,1113,14383,1722,816,7.8,3,29.4,231955,1929,230655,5.86,2.78,0.48921768707482993,0.83,99.44
2020-10-13,Haryana,1370,16,1361,17249,959,210,7.94,0,29.4,233325,1945,232016,3.26,0.71,0.5867006802721089,0.83,99.44
2020-10-14,Haryana,956,13,955,11803,4095,3124,8.1,0,29.4,234281,1958,232971,13.93,10.63,0.4014625850340136,0.84,99.44
2020-10-15,Haryana,1020,14,1015,12693,2401,51,8.04,0,29.4,235301,1972,233986,8.17,0.17,0.43173469387755103,0.84,99.44
2020-10-16,Haryana,186,1,185,1895,3107,1802,9.82,0,29.4,235487,1973,234171,10.57,6.13,0.06445578231292518,0.84,99.44
2020-10-17,Haryana,1081,3,1080,13439,570,204,8.04,0,29.4,236568,1976,235251,1.94,0.69,0.457108843537415,0.84,99.44
2020-10-18,Haryana,132,1,126,1658,1434,296,7.96,5,29.4,236700,1977,235377,4.88,1.01,0.05639455782312925,0.84,99.44
2020-10-19,Haryana,1493,21,1491,18711,1994,12,7.98,0,29.4,238193,1998,236868,6.78,0.04,0.6364285714285715,0.84,99.44
2020-10-20,Haryana,1185,15,1178,14638,2011,533,8.1,0,29.4,239378,2013,238046,6.84,1.81,0.497891156462585,0.84,99.44
2020-10-21,Haryana,1306,8,1297,16455,4781,1445,7.94,1,29.4,240684,2021,239343,16.26,4.91,0.5596938775510204,0.84,99.44
2020-10-22,Haryana,23,0,19,593,1147,941,3.88,4,29.4,240707,2021,239362,3.9,3.2,0.020170068027210886,0.84,99.44
2020-10-23,Haryana,970,14,965,12518,3238,2945,7.75,0,29.4,241677,2035,240327,11.01,10.02,0.42578231292517005,0.84,99.44
2020-10-24,Haryana,1351,13,1343,16863,748,588,8.01,0,29.4,243028,2048,241670,2.54,2.0,0.5735714285714286,0.84,99.44
2020-10-25,Haryana,123,1,123,1661,2976,2294,7.41,0,29.4,243151,2049,241793,10.12,7.8,0.05649659863945578,0.84,99.44
2020-10-26,Haryana,1214,17,1206,14788,413,168,8.21,0,29.4,244365,2066,242999,1.4,0.57,0.5029931972789116,0.85,99.44
2020-10-27,Haryana,822,9,820,10083,1662,9,8.15,0,29.4,245187,2075,243819,5.65,0.03,0.3429591836734694,0.85,99.44
2020-10-28,Haryana,462,3,461,6158,4098,3647,7.5,0,29.4,245649,2078,244280,13.94,12.4,0.20945578231292517,0.85,99.44
2020-10-29,Haryana,1138,14,1130,14274,1194,1158,7.97,0,29.4,246787,2092,245410,4.06,3.94,0.48551020408163265,0.85,99.44
2020-10-30,Haryana,611,3,603,7870,4011,268,7.76,5,29.4,247398,2095,246013,13.64,0.91,0.267687074829932,0.85,99.44
2020-10-31,Haryana,889,5,882,10782,42,42,8.25,2,29.4,248287,2100,246895,0.14,0.14,0.36673469387755103,0.85,99.44
2020-11-01,Haryana,967,13,963,12182,2122,530,7.94,0,29.4,249254,2113,247858,7.22,1.8,0.41435374149659865,0.85,99.44
2020-11-02,Haryana,824,6,820,10484,1127,755,7.86,0,29.4,250078,2119,248678,3.83,2.57,0.3565986394557823,0.85,99.44
2020-11-03,Haryana,936,7,934,11715,1204,214,7.99,0,29.4,251014,2126,249612,4.1,0.73,0.39846938775510204,0.85,99.44
2020-11-04,Haryana,185,0,184,2251,930,884,8.22,1,29.4,251199,2126,249796,3.16,3.01,0.07656462585034014,0.85,99.44
2020-11-05,Haryana,634,5,629,7850,3154,1103,8.08,0,29.4,251833,2131,250425,10.73,3.75,0.26700680272108845,0.85,99.44
2020-11-06,Haryana,864,9,863,10712,1447,1179,8.07,0,29.4,252697,2140,251288,4.92,4.01,0.36435374149659866,0.85,99.44
2020-11-07,Haryana,308,3,300,3850,1377,1292,8.0,5,29.4,253005,2143,251588,4.68,4.39,0.13095238095238096,0.85,99.44
2020-11-08,Haryana,525,6,517,6667,3263,472,7.87,2,29.4,253530,2149,252105,11.1,1.61,0.2267687074829932,0.85,99.44
2020-11-09,Haryana,299,1,291,3899,4904,3769,7.67,7,29.4,253829,2150,252396,16.68,12.82,0.1326190476190476,0.85,99.44
2020-11-10,Haryana,1476,15,1470,18681,4786,2124,7.9,0,29.4,255305,2165,253866,16.28,7.22,0.6354081632653061,0.85,99.44
2020-11-11,Haryana,152,1,146,1823,901,355,8.34,5,29.4,255457,2166,254012,3.06,1.21,0.06200680272108844,0.85,99.43
2020-11-12,Haryana,1409,12,1405,17407,1763,506,8.09,0,29.4,256866,2178,255417,6.0,1.72,0.5920748299319728,0.85,99.44
2020-11-13,Haryana,580,6,580,7577,4631,980,7.65,0,29.4,257446,2184,255997,15.75,3.33,0.25772108843537417,0.85,99.44
2020-11-14,Haryana,1027,6,1024,12741,4156,3207,8.06,0,29.4,258473,2190,257021,14.14,10.91,0.4333673469387755,0.85,99.44
2020-11-15,Haryana,1580,20,1578,19837,4860,3610,7.96,0,29.4,260053,2210,258599,16.53,12.28,0.6747278911564626,0.85,99.44
2020-11-16,Haryana,928,3,919,11882,2599,1934,7.81,6,29.4,260981,2213,259518,8.84,6.58,0.4041496598639456,0.85,99.44
2020-11-17,Haryana,637,5,635,8331,3473,1299,7.65,0,29.4,261618,2218,260153,11.81,4.42,0.2833673469387755,0.85,99.44
2020-11-18,Haryana,1437,15,1436,17732,2040,553,8.1,0,29.4,263055,2233,261589,6.94,1.88,0.6031292517006803,0.85,99.44
2020-11-19,Haryana,1304,9,1302,16421,4530,2748,7.94,0,29.4,264359,2242,262891,15.41,9.35,0.5585374149659864,0.85,99.44
2020-11-20,Haryana,741,8,735,8943,809,570,8.29,0,29.4,265100,2250,263626,2.75,1.94,0.30418367346938774,0.85,99.44
2020-11-21,Haryana,1239,6,1239,15392,302,34,8.05,0,29.4,266339,2256,264865,1.03,0.12,0.5235374149659864,0.85,99.45
2020-11-22,Haryana,372,5,365,4567,3054,2931,8.15,2,29.4,266711,2261,265230,10.39,9.97,0.15534013605442176,0.85,99.44
2020-11-23,Haryana,1063,3,1061,12911,3342,1754,8.23,0,29.4,267774,2264,266291,11.37,5.97,0.43914965986394555,0.85,99.45
2020-11-24,Haryana,852,7,849,10902,3354,231,7.82,0,29.4,268626,2271,267140,11.41,0.79,0.37081632653061225,0.85,99.45
2020-11-25,Haryana,1458,16,1452,17996,3026,5,8.1,0,29.4,270084,2287,268592,10.29,0.02,0.612108843537415,0.85,99.45
2020-11-26,Haryana,954,4,948,11421,4068,308,8.35,2,29.4,271038,2291,269540,13.84,1.05,0.38846938775510204,0.85,99.45
2020-11-27,Haryana,1237,11,1237,15220,4689,2311,8.13,0,29.4,272275,2302,270777,15.95,7.86,0.5176870748299319,0.85,99.45
2020-11-28,Haryana,1130,8,1130,14094,4607,1793,8.02,0,29.4,273405,2310,271907,15.67,6.1,0.4793877551020408,0.84,99.45
2020-11-29,Haryana,685,5,681,8720,1217,958,7.86,0,29.4,274090,2315,272588,4.14,3.26,0.2965986394557823,0.84,99.45
2020-11-30,Haryana,1033,6,1028,12984,1064,479,7.96,0,29.4,275123,2321,273616,3.62,1.63,0.4416326530612245,0.84,99.45
2020-12-01,Haryana,45,0,36,631,3749,630,7.13,9,29.4,275168,2321,273652,12.75,2.14,0.021462585034013604,0.84,99.45
2020-12-02,Haryana,909,10,902,11110,58,53,8.18,0,29.4,276077,2331,274554,0.2,0.18,0.37789115646258503,0.84,99.45
2020-12-03,Haryana,1055,10,1049,13261,3322,647,7.96,0,29.4,277132,2341,275603,11.3,2.2,0.45105442176870747,0.84,99.45
2020-12-04,Haryana,1275,6,1267,16096,1595,1101,7.92,2,29.4,278407,2347,276870,5.43,3.74,0.5474829931972789,0.84,99.45
2020-12-05,Haryana,163,1,155,2026,3732,1402,8.05,7,29.4,278570,2348,277025,12.69,4.77,0.06891156462585034,0.84,99.45
2020-12-06,Haryana,424,4,420,5250,1462,117,8.08,0,29.4,278994,2352,277445,4.97,0.4,0.17857142857142858,0.84,99.44
2020-12-07,Haryana,647,3,639,8441,2852,1538,7.66,5,29.4,279641,2355,278084,9.7,5.23,0.28710884353741495,0.84,99.44
2020-12-08,Haryana,1225,9,1220,14910,4537,4207,8.22,0,29.4,280866,2364,279304,15.43,14.31,0.5071428571428571,0.84,99.44
2020-12-09,Haryana,257,1,252,3453,536,364,7.44,4,29.4,281123,2365,279556,1.82,1.24,0.11744897959183674,0.84,99.44
2020-12-10,Haryana,872,7,872,10628,2376,437,8.2,0,29.4,281995,2372,280428,8.08,1.49,0.36149659863945577,0.84,99.44
2020-12-11,Haryana,636,6,634,7288,2149,1191,8.73,0,29.4,282631,2378,281062,7.31,4.05,0.24789115646258503,0.84,99.44
2020-12-12,Haryana,577,3,575,7134,4879,4791,8.09,0,29.4,283208,2381,281637,16.6,16.3,0.2426530612244898,0.84,99.45
2020-12-13,Haryana,1436,14,1431,18140,1353,81,7.92,0,29.4,284644,2395,283068,4.6,0.28,0.6170068027210884,0.84,99.45
2020-12-14,Haryana,585,3,577,7493,2155,1990,7.81,5,29.4,285229,2398,283645,7.33,6.77,0.2548639455782313,0.84,99.44
2020-12-15,Haryana,373,4,365,4418,3480,696,8.44,4,29.4,285602,2402,284010,11.84,2.37,0.15027210884353742,0.84,99.44
2020-12-16,Haryana,70,0,70,1231,2625,242,5.69,0,29.4,285672,2402,284080,8.93,0.82,0.04187074829931973,0.84,99.44
2020-12-17,Haryana,1251,16,1247,15488,2301,1452,8.08,0,29.4,286923,2418,285327,7.83,4.94,0.5268027210884354,0.84,99.44
2020-12-18,Haryana,568,6,563,7044,4393,216,8.06,0,29.4,287491,2424,285890,14.94,0.73,0.23959183673469386,0.84,99.44
2020-12-19,Haryana,1221,4,1218,15559,2600,551,7.85,0,29.4,288712,2428,287108,8.84,1.87,0.52921768707483,0.84,99.44
2020-12-20,Haryana,280,1,274,3835,1785,399,7.3,5,29.4,288992,2429,287382,6.07,1.36,0.1304421768707483,0.84,99.44
2020-12-21,Haryana,328,1,327,4134,3852,1386,7.93,0,29.4,289320,2430,287709,13.1,4.71,0.14061224489795918,0.84,99.44
2020-12-22,Haryana,102,0,94,1434,2335,260,7.11,8,29.4,289422,2430,287803,7.94,0.88,0.048775510204081635,0.84,99.44
2020-12-23,Haryana,761,5,760,9689,2396,2158,7.85,0,29.4,290183,2435,288563,8.15,7.34,0.3295578231292517,0.84,99.44
2020-12-24,Haryana,329,2,325,4301,3132,1942,7.65,2,29.4,290512,2437,288888,10.65,6.61,0.1462925170068027,0.84,99.44
2020-12-25,Haryana,1477,22,1476,18687,3168,3163,7.9,0,29.4,291989,2459,290364,10.78,10.76,0.6356122448979592,0.84,99.44
2020-12-26,Haryana,954,13,948,11890,588,536,8.02,0,29.4,292943,2472,291312,2.0,1.82,0.404421768707483,0.84,99.44
2020-12-27,Haryana,970,11,966,12277,2253,2042,7.9,0,29.4,293913,2483,292278,7.66,6.95,0.4175850340136054,0.84,99.44
2020-12-28,Haryana,767,6,766,9000,2327,1995,8.52,0,29.4,294680,2489,293044,7.91,6.79,0.30612244897959184,0.84,99.44
2020-12-29,Haryana,1025,7,1024,12979,1116,693,7.9,0,29.4,295705,2496,294068,3.8,2.36,0.4414625850340136,0.84,99.45
2020-12-30,Haryana,1493,15,1488,18926,3209,1992,7.89,0,29.4,297198,2511,295556,10.91,6.78,0.6437414965986394,0.84,99.45
2020-12-31,Haryana,1447,7,1445,17859,4120,2744,8.1,0,29.4,298645,2518,297001,14.01,9.33,0.6074489795918367,0.84,99.45
2021-01-01,Haryana,575,7,566,7306,4301,1733,7.87,2,29.4,299220,2525,297567,14.63,5.89,0.24850340136054422,0.84,99.45
2021-01-02,Haryana,1425,13,1417,17981,174,36,7.93,0,29.4,300645,2538,298984,0.59,0.12,0.6115986394557823,0.84,99.45
2021-01-03,Haryana,1061,9,1057,13233,3796,3514,8.02,0,29.4,301706,2547,300041,12.91,11.95,0.45010204081632654,0.84,99.45
2021-01-04,Haryana,462,5,460,5468,1999,596,8.45,0,29.4,302168,2552,300501,6.8,2.03,0.18598639455782312,0.84,99.45
2021-01-05,Haryana,1535,12,1527,19647,1050,425,7.81,0,29.4,303703,2564,302028,3.57,1.45,0.6682653061224489,0.84,99.45
2021-01-06,Haryana,377,4,376,5029,1049,141,7.5,0,29.4,304080,2568,302404,3.57,0.48,0.17105442176870747,0.84,99.45
2021-01-07,Haryana,1357,10,1350,17166,2058,1235,7.91,0,29.4,305437,2578,303754,7.0,4.2,0.5838775510204082,0.84,99.45
2021-01-08,Haryana,42,0,33,504,4982,3623,8.33,9,29.4,305479,2578,303787,16.95,12.32,0.017142857142857144,0.84,99.45
2021-01-09,Haryana,1402,19,1393,17205,4750,2411,8.15,0,29.4,306881,2597,305180,16.16,8.2,0.585204081632653,0.85,99.45
2021-01-10,Haryana,597,2,592,7150,1444,1179,8.35,3,29.4,307478,2599,305772,4.91,4.01,0.24319727891156462,0.85,99.45
2021-01-11,Haryana,1065,11,1065,13457,4057,2049,7.91,0,29.4,308543,2610,306837,13.8,6.97,0.4577210884353741,0.85,99.45
2021-01-12,Haryana,880,10,871,11050,2540,550,7.96,0,29.4,309423,2620,307708,8.64,1.87,0.3758503401360544,0.85,99.45
2021-01-13,Haryana,1480,12,1473,18790,3324,615,7.88,0,29.4,310903,2632,309181,11.31,2.09,0.6391156462585034,0.85,99.45
2021-01-14,Haryana,1021,14,1012,12966,4595,979,7.87,0,29.4,311924,2646,310193,15.63,3.33,0.4410204081632653,0.85,99.45
2021-01-15,Haryana,1364,4,1360,16989,2504,1093,8.03,0,29.4,313288,2650,311553,8.52,3.72,0.5778571428571428,0.85,99.45
2021-01-16,Haryana,769,7,767,9809,1046,563,7.84,0,29.4,314057,2657,312320,3.56,1.91,0.3336394557823129,0.85,99.45
2021-01-17,Haryana,1445,15,1437,18063,486,309,8.0,0,29.4,315502,2672,313757,1.65,1.05,0.6143877551020408,0.85,99.45
2021-01-18,Haryana,596,3,592,7423,4372,1946,8.03,1,29.4,316098,2675,314349,14.87,6.62,0.2524829931972789,0.85,99.45
2021-01-19,Haryana,302,3,302,3857,628,409,7.83,0,29.4,316400,2678,314651,2.14,1.39,0.1311904761904762,0.85,99.45
2021-01-20,Haryana,1528,22,1526,19304,4649,2379,7.92,0,29.4,317928,2700,316177,15.81,8.09,0.6565986394557823,0.85,99.45
2021-01-21,Haryana,1383,17,1376,17270,4077,1815,8.01,0,29.4,319311,2717,317553,13.87,6.17,0.5874149659863945,0.85,99.45
2021-01-22,Haryana,1322,16,1314,16607,2640,1267,7.96,0,29.4,320633,2733,318867,8.98,4.31,0.5648639455782313,0.85,99.45
2021-01-23,Haryana,1231,7,1225,14925,3041,2502,8.25,0,29.4,321864,2740,320092,10.34,8.51,0.5076530612244898,0.85,99.45
2021-01-24,Haryana,636,8,636,8200,1275,400,7.76,0,29.4,322500,2748,320728,4.34,1.36,0.2789115646258503,0.85,99.45
2021-01-25,Haryana,934,7,926,11888,3535,2167,7.86,1,29.4,323434,2755,321654,12.02,7.37,0.40435374149659864,0.85,99.45
2021-01-26,Haryana,1358,6,1352,17329,1241,178,7.84,0,29.4,324792,2761,323006,4.22,0.61,0.589421768707483,0.85,99.45
2021-01-27,Haryana,1322,8,1318,16451,3864,1006,8.04,0,29.4,326114,2769,324324,13.14,3.42,0.5595578231292517,0.85,99.45
2021-01-28,Haryana,643,4,642,7515,2374,263,8.56,0,29.4,326757,2773,324966,8.07,0.89,0.2556122448979592,0.85,99.45
2021-01-29,Haryana,688,7,680,8488,1995,855,8.11,1,29.4,327445,2780,325646,6.79,2.91,0.28870748299319726,0.85,99.45
2021-01-30,Haryana,113,0,109,1314,1072,912,8.6,4,29.4,327558,2780,325755,3.65,3.1,0.04469387755102041,0.85,99.45
2021-01-31,Haryana,1170,11,1170,14598,4597,4059,8.01,0,29.4,328728,2791,326925,15.64,13.81,0.496530612244898,0.85,99.45
2021-02-01,Haryana,571,2,570,6943,4634,2783,8.22,0,29.4,329299,2793,327495,15.76,9.47,0.236156462585034,0.85,99.45
2021-02-02,Haryana,520,6,515,6669,4605,3874,7.8,0,29.4,329819,2799,328010,15.66,13.18,0.22683673469387755,0.85,99.45
2021-02-03,Haryana,1019,7,1017,12557,4985,650,8.11,0,29.4,330838,2806,329027,16.96,2.21,0.42710884353741496,0.85,99.45
2021-02-04,Haryana,1137,13,1137,13981,3935,3665,8.13,0,29.4,331975,2819,330164,13.38,12.47,0.47554421768707483,0.85,99.45
2021-02-05,Haryana,488,2,485,5725,1490,1181,8.52,1,29.4,332463,2821,330649,5.07,4.02,0.19472789115646258,0.85,99.45
2021-02-06,Haryana,568,3,567,7048,3497,579,8.06,0,29.4,333031,2824,331216,11.89,1.97,0.2397278911564626,0.85,99.46
2021-02-07,Haryana,1018,14,1013,12706,313,31,8.01,0,29.4,334049,2838,332229,1.06,0.11,0.4321768707482993,0.85,99.46
2021-02-08,Haryana,505,4,501,5930,4433,1506,8.52,0,29.4,334554,2842,332730,15.08,5.12,0.20170068027210886,0.85,99.45
2021-02-09,Haryana,877,8,868,10902,1114,34,8.04,1,29.4,335431,2850,333598,3.79,0.12,0.37081632653061225,0.85,99.45
2021-02-10,Haryana,1047,14,1046,13474,3955,1181,7.77,0,29.4,336478,2864,334644,13.45,4.02,0.4582993197278912,0.85,99.45
2021-02-11,Haryana,1534,14,1534,18982,1588,719,8.08,0,29.4,338012,2878,336178,5.4,2.45,0.6456462585034014,0.85,99.46
2021-02-12,Haryana,1540,6,1531,18973,2489,302,8.12,3,29.4,339552,2884,337709,8.47,1.03,0.6453401360544218,0.85,99.46
2021-02-13,Haryana,1047,15,1038,13265,3861,3818,7.89,0,29.4,340599,2899,338747,13.13,12.99,0.4511904761904762,0.85,99.46
2021-02-14,Haryana,1050,3,1046,13035,4052,1031,8.06,1,29.4,341649,2902,339793,13.78,3.51,0.4433673469387755,0.85,99.46
2021-02-15,Haryana,416,2,408,5698,3181,728,7.3,6,29.4,342065,2904,340201,10.82,2.48,0.19380952380952382,0.85,99.46
2021-02-16,Haryana,473,2,465,6054,3001,1513,7.81,6,29.4,342538,2906,340666,10.21,5.15,0.20591836734693877,0.85,99.45
2021-02-17,Haryana,929,11,929,11770,83,30,7.89,0,29.4,343467,2917,341595,0.28,0.1,0.40034013605442176,0.85,99.45
2021-02-18,Haryana,1429,16,1428,17878,1922,1273,7.99,0,29.4,344896,2933,343023,6.54,4.33,0.6080952380952381,0.85,99.46
2021-02-19,Haryana,1193,7,1193,14921,2589,1505,8.0,0,29.4,346089,2940,344216,8.81,5.12,0.507517006802721,0.85,99.46
2021-02-20,Haryana,106,0,97,1091,3221,794,9.72,9,29.4,346195,2940,344313,10.96,2.7,0.03710884353741497,0.85,99.46
2021-02-21,Haryana,1068,6,1064,13219,3360,1006,8.08,0,29.4,347263,2946,345377,11.43,3.42,0.4496258503401361,0.85,99.46
2021-02-22,Haryana,415,4,415,4797,1820,1126,8.65,0,29.4,347678,2950,345792,6.19,3.83,0.16316326530612246,0.85,99.46
2021-02-23,Haryana,1145,4,1139,14218,2447,1230,8.05,2,29.4,348823,2954,346931,8.32,4.18,0.48360544217687074,0.85,99.46
2021-02-24,Haryana,303,1,303,3813,262,7,7.95,0,29.4,349126,2955,347234,0.89,0.02,0.1296938775510204,0.85,99.46
2021-02-25,Haryana,850,8,843,10184,1352,454,8.35,0,29.4,349976,2963,348077,4.6,1.54,0.3463945578231293,0.85,99.46
2021-02-26,Haryana,855,11,854,10462,2971,2907,8.17,0,29.4,350831,2974,348931,10.11,9.89,0.35585034013605443,0.85,99.46
2021-02-27,Haryana,847,11,839,10536,3939,1554,8.04,0,29.4,351678,2985,349770,13.4,5.29,0.35836734693877553,0.85,99.46
2021-02-28,Haryana,145,1,145,1812,2549,1549,8.0,0,29.4,351823,2986,349915,8.67,5.27,0.061632653061224486,0.85,99.46
2021-03-01,Haryana,630,3,625,7678,3447,1160,8.21,2,29.4,352453,2989,350540,11.72,3.95,0.261156462585034,0.85,99.46
2021-03-02,Haryana,404,2,397,5086,4455,649,7.94,5,29.4,352857,2991,350937,15.15,2.21,0.17299319727891158,0.85,99.46
2021-03-03,Haryana,417,5,412,4972,421,18,8.39,0,29.4,353274,2996,351349,1.43,0.06,0.1691156462585034,0.85,99.46
2021-03-04,Haryana,806,10,799,10429,4823,1556,7.73,0,29.4,354080,3006,352148,16.4,5.29,0.3547278911564626,0.85,99.45
2021-03-05,Haryana,764,10,762,9427,2399,145,8.1,0,29.4,354844,3016,352910,8.16,0.49,0.32064625850340134,0.85,99.45
2021-03-06,Haryana,858,4,856,10619,2683,2420,8.08,0,29.4,355702,3020,353766,9.13,8.23,0.3611904761904762,0.85,99.46
2021-03-07,Haryana,1259,6,1258,16067,3074,1955,7.84,0,29.4,356961,3026,355024,10.46,6.65,0.5464965986394558,0.85,99.46
2021-03-08,Haryana,750,9,748,9432,2817,1625,7.95,0,29.4,357711,3035,355772,9.58,5.53,0.32081632653061226,0.85,99.46
2021-03-09,Haryana,384,5,378,4783,3088,3074,8.03,1,29.4,358095,3040,356150,10.5,10.46,0.16268707482993197,0.85,99.46
2021-03-10,Haryana,452,6,446,5868,1667,1224,7.7,0,29.4,358547,3046,356596,5.67,4.16,0.19959183673469388,0.85,99.46
2021-03-11,Haryana,1432,15,1425,17828,814,582,8.03,0,29.4,359979,3061,358021,2.77,1.98,0.6063945578231292,0.85,99.46
2021-03-12,Haryana,1128,4,1127,14471,3934,2338,7.79,0,29.4,361107,3065,359148,13.38,7.95,0.4922108843537415,0.85,99.46
2021-03-13,Haryana,1398,6,1391,17010,43,22,8.22,1,29.4,362505,3071,360539,0.15,0.07,0.5785714285714286,0.85,99.46
2021-03-14,Haryana,1243,12,1236,15733,3754,3183,7.9,0,29.4,363748,3083,361775,12.77,10.83,0.5351360544217687,0.85,99.46
2021-03-15,Haryana,1323,9,1322,15884,2141,371,8.33,0,29.4,365071,3092,363097,7.28,1.26,0.5402721088435374,0.85,99.46
2021-03-16,Haryana,264,1,259,3028,2103,170,8.72,4,29.4,365335,3093,363356,7.15,0.58,0.10299319727891157,0.85,99.46
2021-03-17,Haryana,233,0,229,3285,4743,437,7.09,4,29.4,365568,3093,363585,16.13,1.49,0.11173469387755101,0.85,99.46
2021-03-18,Haryana,1396,5,1392,17334,1491,148,8.05,0,29.4,366964,3098,364977,5.07,0.5,0.5895918367346938,0.84,99.46
2021-03-19,Haryana,1550,21,1542,19084,3831,3626,8.12,0,29.4,368514,3119,366519,13.03,12.33,0.6491156462585034,0.85,99.46
2021-03-20,Haryana,952,10,945,11682,4835,3285,8.15,0,29.4,369466,3129,367464,16.45,11.17,0.3973469387755102,0.85,99.46
2021-03-21,Haryana,423,4,422,5760,1506,1402,7.34,0,29.4,369889,3133,367886,5.12,4.77,0.19591836734693877,0.85,99.46
2021-03-22,Haryana,195,1,195,2764,3332,1810,7.05,0,29.4,370084,3134,368081,11.33,6.16,0.09401360544217686,0.85,99.46
2021-03-23,Haryana,494,3,488,6249,2469,260,7.91,3,29.4,370578,3137,368569,8.4,0.88,0.21255102040816326,0.85,99.46
2021-03-24,Haryana,603,8,594,7624,3619,3407,7.91,1,29.4,371181,3145,369163,12.31,11.59,0.2593197278911565,0.85,99.46
2021-03-25,Haryana,1161,16,1156,14362,3897,3384,8.08,0,29.4,372342,3161,370319,13.26,11.51,0.4885034013605442,0.85,99.46
2021-03-26,Haryana,874,7,870,11263,4256,2546,7.76,0,29.4,373216,3168,371189,14.48,8.66,0.3830952380952381,0.85,99.46
2021-03-27,Haryana,1498,8,1494,18866,3705,2668,7.94,0,29.4,374714,3176,372683,12.6,9.07,0.6417006802721088,0.85,99.46
2021-03-28,Haryana,619,7,612,7698,635,567,8.04,0,29.4,375333,3183,373295,2.16,1.93,0.2618367346938775,0.85,99.46
2021-03-29,Haryana,1079,5,1077,13460,2913,324,8.02,0,29.4,376412,3188,374372,9.91,1.1,0.45782312925170066,0.85,99.46
2021-03-30,Haryana,1295,9,1294,16578,4751,961,7.81,0,29.4,377707,3197,375666,16.16,3.27,0.5638775510204082,0.85,99.46
2021-03-31,Haryana,808,6,804,9900,4969,793,8.16,0,29.4,378515,3203,376470,16.9,2.7,0.336734693877551,0.85,99.46
2021-04-01,Haryana,502,6,499,6697,2262,1470,7.5,0,29.4,379017,3209,376969,7.69,5.0,0.2277891156462585,0.85,99.46
2021-04-02,Haryana,1086,3,1080,13569,2899,2478,8.0,3,29.4,380103,3212,378049,9.86,8.43,0.46153061224489794,0.85,99.46
2021-04-03,Haryana,937,9,937,11759,1148,163,7.97,0,29.4,381040,3221,378986,3.9,0.55,0.3999659863945578,0.85,99.46
2021-04-04,Haryana,701,3,695,8906,4943,3419,7.87,3,29.4,381741,3224,379681,16.81,11.63,0.3029251700680272,0.84,99.46
2021-04-05,Haryana,591,2,584,7946,4068,670,7.44,5,29.4,382332,3226,380265,13.84,2.28,0.2702721088435374,0.84,99.46
2021-04-06,Haryana,526,2,525,6504,4285,2129,8.09,0,29.4,382858,3228,380790,14.57,7.24,0.22122448979591836,0.84,99.46
2021-04-07,Haryana,1518,18,1510,19125,4377,497,7.94,0,29.4,384376,3246,382300,14.89,1.69,0.6505102040816326,0.84,99.46
2021-04-08,Haryana,657,4,656,8393,4508,2478,7.83,0,29.4,385033,3250,382956,15.33,8.43,0.2854761904761905,0.84,99.46
2021-04-09,Haryana,1435,6,1426,18624,50,39,7.71,3,29.4,386468,3256,384382,0.17,0.13,0.6334693877551021,0.84,99.46
2021-04-10,Haryana,1078,7,1072,13581,1980,1530,7.94,0,29.4,387546,3263,385454,6.73,5.2,0.46193877551020407,0.84,99.46
2021-04-11,Haryana,276,3,267,3604,4496,401,7.66,6,29.4,387822,3266,385721,15.29,1.36,0.12258503401360545,0.84,99.46
2021-04-12,Haryana,204,1,197,2481,62,15,8.22,6,29.4,388026,3267,385918,0.21,0.05,0.08438775510204082,0.84,99.46
2021-04-13,Haryana,1362,7,1354,16740,1911,33,8.14,1,29.4,389388,3274,387272,6.5,0.11,0.5693877551020409,0.84,99.46
2021-04-14,Haryana,1492,5,1491,18601,370,342,8.02,0,29.4,390880,3279,388763,1.26,1.16,0.632687074829932,0.84,99.46
2021-04-15,Haryana,34,0,30,516,4606,16,6.59,4,29.4,390914,3279,388793,15.67,0.05,0.017551020408163264,0.84,99.46
2021-04-16,Haryana,809,10,804,10344,614,131,7.82,0,29.4,391723,3289,389597,2.09,0.45,0.35183673469387755,0.84,99.46
2021-04-17,Haryana,177,1,174,2289,2314,116,7.73,2,29.4,391900,3290,389771,7.87,0.39,0.07785714285714286,0.84,99.46
2021-04-18,Haryana,838,9,838,10499,1977,1590,7.98,0,29.4,392738,3299,390609,6.72,5.41,0.35710884353741496,0.84,99.46
2021-04-19,Haryana,181,1,175,2493,1054,282,7.26,5,29.4,392919,3300,390784,3.59,0.96,0.08479591836734694,0.84,99.46
2021-04-20,Haryana,628,2,625,7823,43,7,8.03,1,29.4,393547,3302,391409,0.15,0.02,0.26608843537414967,0.84,99.46
2021-04-21,Haryana,268,1,265,3260,2428,1372,8.22,2,29.4,393815,3303,391674,8.26,4.67,0.1108843537414966,0.84,99.46
2021-04-22,Haryana,638,6,637,7754,1305,331,8.23,0,29.4,394453,3309,392311,4.44,1.13,0.26374149659863944,0.84,99.46
2021-04-23,Haryana,1585,20,1582,19584,4169,271,8.09,0,29.4,396038,3329,393893,14.18,0.92,0.6661224489795918,0.84,99.46
2021-04-24,Haryana,1110,10,1105,13927,2234,2069,7.97,0,29.4,397148,3339,394998,7.6,7.04,0.47370748299319726,0.84,99.46
2021-04-25,Haryana,311,3,306,4093,763,434,7.6,2,29.4,397459,3342,395304,2.6,1.48,0.13921768707482993,0.84,99.46
2021-04-26,Haryana,245,2,241,2893,4376,3413,8.47,2,29.4,397704,3344,395545,14.88,11.61,0.09840136054421769,0.84,99.46
2021-04-27,Haryana,1090,9,1085,13633,488,311,8.0,0,29.4,398794,3353,396630,1.66,1.06,0.4637074829931973,0.84,99.46
2021-04-28,Haryana,82,0,79,1095,3516,3501,7.49,3,29.4,398876,3353,396709,11.96,11.91,0.037244897959183676,0.84,99.46
2021-04-29,Haryana,1189,5,1187,14827,1087,34,8.02,0,29.4,400065,3358,397896,3.7,0.12,0.5043197278911564,0.84,99.46
2021-04-30,Haryana,1583,11,1579,19898,1627,1098,7.96,0,29.4,401648,3369,399475,5.53,3.73,0.6768027210884354,0.84,99.46
2021-05-01,Haryana,1078,6,1070,13133,3384,805,8.21,2,29.4,402726,3375,400545,11.51,2.74,0.44670068027210885,0.84,99.46
2021-05-02,Haryana,1513,6,1513,18910,934,922,8.0,0,29.4,404239,3381,402058,3.18,3.14,0.6431972789115646,0.84,99.46
2021-05-03,Haryana,874,7,870,10862,3144,2877,8.05,0,29.4,405113,3388,402928,10.69,9.79,0.3694557823129252,0.84,99.46
2021-05-04,Haryana,871,9,864,11210,2083,1421,7.77,0,29.4,405984,3397,403792,7.09,4.83,0.3812925170068027,0.84,99.46
2021-05-05,Haryana,1520,19,1520,19183,3677,1285,7.92,0,29.4,407504,3416,405312,12.51,4.37,0.6524829931972789,0.84,99.46
2021-05-06,Haryana,399,2,399,5044,3773,2599,7.91,0,29.4,407903,3418,405711,12.83,8.84,0.17156462585034013,0.84,99.46
2021-05-07,Haryana,184,1,180,1974,622,184,9.32,3,29.4,408087,3419,405891,2.12,0.63,0.06714285714285714,0.84,99.46
2021-05-08,Haryana,588,6,586,7609,3195,2352,7.73,0,29.4,408675,3425,406477,10.87,8.0,0.2588095238095238,0.84,99.46
2021-05-09,Haryana,783,4,781,10167,371,220,7.7,0,29.4,409458,3429,407258,1.26,0.75,0.34581632653061223,0.84,99.46
2021-05-10,Haryana,116,0,112,1518,4246,1136,7.64,4,29.4,409574,3429,407370,14.44,3.86,0.05163265306122449,0.84,99.46
2021-05-11,Haryana,941,6,934,11639,2311,2130,8.08,1,29.4,410515,3435,408304,7.86,7.24,0.3958843537414966,0.84,99.46
2021-05-12,Haryana,781,11,776,9333,1675,375,8.37,0,29.4,411296,3446,409080,5.7,1.28,0.3174489795918367,0.84,99.46
2021-05-13,Haryana,907,8,906,11628,2611,2455,7.8,0,29.4,412203,3454,409986,8.88,8.35,0.3955102040816327,0.84,99.46
2021-05-14,Haryana,185,2,178,2445,2639,77,7.57,5,29.4,412388,3456,410164,8.98,0.26,0.08316326530612245,0.84,99.46
2021-05-15,Haryana,1265,7,1264,16418,2528,1924,7.7,0,29.4,413653,3463,411428,8.6,6.54,0.5584353741496598,0.84,99.46
2021-05-16,Haryana,488,2,487,6129,2738,1497,7.96,0,29.4,414141,3465,411915,9.31,5.09,0.20846938775510204,0.84,99.46
2021-05-17,Haryana,760,6,759,9582,4002,2750,7.93,0,29.4,414901,3471,412674,13.61,9.35,0.3259183673469388,0.84,99.46
2021-05-18,Haryana,1424,8,1417,17974,893,560,7.92,0,29.4,416325,3479,414091,3.04,1.9,0.611360544217687,0.84,99.46
2021-05-19,Haryana,1062,3,1061,12940,4258,150,8.21,0,29.4,417387,3482,415152,14.48,0.51,0.44013605442176873,0.83,99.46
2021-05-20,Haryana,233,1,227,3077,796,11,7.57,5,29.4,417620,3483,415379,2.71,0.04,0.10465986394557823,0.83,99.46
2021-05-21,Haryana,515,3,509,6321,2299,1571,8.15,3,29.4,418135,3486,415888,7.82,5.34,0.215,0.83,99.46
2021-05-22,Haryana,1215,17,1211,15137,82,13,8.03,0,29.4,419350,3503,417099,0.28,0.04,0.5148639455782313,0.84,99.46
2021-05-23,Haryana,562,7,561,7055,1377,1229,7.97,0,29.4,419912,3510,417660,4.68,4.18,0.23996598639455782,0.84,99.46
2021-05-24,Haryana,458,3,452,6170,4045,1482,7.42,3,29.4,420370,3513,418112,13.76,5.04,0.2098639455782313,0.84,99.46
2021-05-25,Haryana,1430,12,1421,18112,836,318,7.9,0,29.4,421800,3525,419533,2.84,1.08,0.6160544217687075,0.84,99.46
2021-05-26,Haryana,1366,6,1363,17092,4906,30,7.99,0,29.4,423166,3531,420896,16.69,0.1,0.5813605442176871,0.83,99.46
2021-05-27,Haryana,276,2,269,3409,4789,3818,8.1,5,29.4,423442,3533,421165,16.29,12.99,0.11595238095238095,0.83,99.46
2021-05-28,Haryana,1070,11,1064,13148,3958,2074,8.14,0,29.4,424512,3544,422229,13.46,7.05,0.4472108843537415,0.83,99.46
2021-05-29,Haryana,897,6,893,11396,4155,2676,7.87,0,29.4,425409,3550,423122,14.13,9.1,0.38761904761904764,0.83,99.46
2021-05-30,Haryana,323,4,323,3973,3540,3342,8.13,0,29.4,425732,3554,423445,12.04,11.37,0.1351360544217687,0.83,99.46
2021-05-31,Haryana,1519,18,1514,18983,1373,998,8.0,0,29.4,427251,3572,424959,4.67,3.39,0.6456802721088435,0.84,99.46
2021-06-01,Haryana,1398,13,1396,17566,393,58,7.96,0,29.4,428649,3585,426355,1.34,0.2,0.5974829931972789,0.84,99.46
2021-06-02,Haryana,838,11,831,10803,2490,571,7.76,0,29.4,429487,3596,427186,8.47,1.94,0.36744897959183676,0.84,99.46
2021-06-03,Haryana,806,6,800,9986,4759,3520,8.07,0,29.4,430293,3602,427986,16.19,11.97,0.33965986394557823,0.84,99.46
2021-06-04,Haryana,147,2,138,1705,3141,79,8.62,7,29.4,430440,3604,428124,10.68,0.27,0.057993197278911564,0.84,99.46
2021-06-05,Haryana,823,6,816,10397,2888,1810,7.92,1,29.4,431263,3610,428940,9.82,6.16,0.35363945578231293,0.84,99.46
2021-06-06,Haryana,265,3,257,3211,1368,456,8.25,5,29.4,431528,3613,429197,4.65,1.55,0.10921768707482993,0.84,99.46
2021-06-07,Haryana,264,1,263,3627,125,45,7.28,0,29.4,431792,3614,429460,0.43,0.15,0.1233673469387755,0.84,99.46
2021-06-08,Haryana,654,8,652,7802,4164,408,8.38,0,29.4,432446,3622,430112,14.16,1.39,0.26537414965986394,0.84,99.46
2021-06-09,Haryana,438,5,438,5390,4506,2107,8.13,0,29.4,432884,3627,430550,15.33,7.17,0.18333333333333332,0.84,99.46
2021-06-10,Haryana,634,6,630,7867,132,85,8.06,0,29.4,433518,3633,431180,0.45,0.29,0.26758503401360545,0.84,99.46
2021-06-11,Haryana,868,9,863,11011,2601,1683,7.88,0,29.4,434386,3642,432043,8.85,5.72,0.37452380952380954,0.84,99.46
2021-06-12,Haryana,411,4,408,5573,3464,719,7.37,0,29.4,434797,3646,432451,11.78,2.45,0.1895578231292517,0.84,99.46
2021-06-13,Haryana,679,6,676,8417,153,47,8.07,0,29.4,435476,3652,433127,0.52,0.16,0.2862925170068027,0.84,99.46
2021-06-14,Haryana,98,0,93,795,1838,25,12.33,5,29.4,435574,3652,433220,6.25,0.09,0.027040816326530614,0.84,99.46
2021-06-15,Haryana,506,3,500,6335,2124,1290,7.99,3,29.4,436080,3655,433720,7.22,4.39,0.2154761904761905,0.84,99.46
2021-06-16,Haryana,1387,16,1378,17571,2162,632,7.89,0,29.4,437467,3671,435098,7.35,2.15,0.5976530612244898,0.84,99.46
2021-06-17,Haryana,390,5,386,4748,2575,164,8.21,0,29.4,437857,3676,435484,8.76,0.56,0.16149659863945579,0.84,99.46
2021-06-18,Haryana,1556,19,1553,19510,3293,299,7.98,0,29.4,439413,3695,437037,11.2,1.02,0.6636054421768708,0.84,99.46
2021-06-19,Haryana,1016,11,1008,12669,667,34,8.02,0,29.4,440429,3706,438045,2.27,0.12,0.4309183673469388,0.84,99.46
2021-06-20,Haryana,177,1,176,2406,2067,1303,7.36,0,29.4,440606,3707,438221,7.03,4.43,0.08183673469387755,0.84,99.46
2021-06-21,Haryana,740,3,732,9210,3976,2362,8.03,5,29.4,441346,3710,438953,13.52,8.03,0.31326530612244896,0.84,99.46
2021-06-22,Haryana,1289,19,1287,16009,1955,1394,8.05,0,29.4,442635,3729,440240,6.65,4.74,0.5445238095238095,0.84,99.46
2021-06-23,Haryana,1027,5,1022,12702,991,50,8.09,0,29.4,443662,3734,441262,3.37,0.17,0.43204081632653063,0.84,99.46
2021-06-24,Haryana,1477,8,1473,18585,2775,2336,7.95,0,29.4,445139,3742,442735,9.44,7.95,0.6321428571428571,0.84,99.46
2021-06-25,Haryana,1526,6,1522,19066,3226,36,8.0,0,29.4,446665,3748,444257,10.97,0.12,0.6485034013605442,0.84,99.46
2021-06-26,Haryana,1401,8,1395,17524,3845,1903,7.99,0,29.4,448066,3756,445652,13.08,6.47,0.5960544217687075,0.84,99.46
2021-06-27,Haryana,451,6,443,5643,1417,485,7.99,2,29.4,448517,3762,446095,4.82,1.65,0.19193877551020408,0.84,99.46
2021-06-28,Haryana,399,5,392,4936,1927,1068,8.08,2,29.4,448916,3767,446487,6.55,3.63,0.16789115646258504,0.84,99.46
2021-06-29,Haryana,539,6,538,6793,2603,492,7.93,0,29.4,449455,3773,447025,8.85,1.67,0.2310544217687075,0.84,99.46
2021-06-30,Haryana,105,1,104,1891,2352,561,5.55,0,29.4,449560,3774,447129,8.0,1.91,0.06431972789115646,0.84,99.46
2021-07-01,Haryana,1376,6,1370,17303,321,171,7.95,0,29.4,450936,3780,448499,1.09,0.58,0.5885374149659864,0.84,99.46
2021-07-02,Haryana,1180,9,1178,14821,2740,1628,7.96,0,29.4,452116,3789,449677,9.32,5.54,0.5041156462585034,0.84,99.46
2021-07-03,Haryana,152,1,149,1841,1363,680,8.26,2,29.4,452268,3790,449826,4.64,2.31,0.06261904761904762,0.84,99.46
2021-07-04,Haryana,249,0,242,3137,1913,1893,7.94,7,29.4,452517,3790,450068,6.51,6.44,0.10670068027210884,0.84,99.46
2021-07-05,Haryana,132,1,131,891,3944,3644,14.81,0,29.4,452649,3791,450199,13.41,12.39,0.03030612244897959,0.84,99.46
2021-07-06,Haryana,416,5,408,5164,1252,937,8.06,3,29.4,453065,3796,450607,4.26,3.19,0.17564625850340135,0.84,99.46
2021-07-07,Haryana,1506,5,1499,18565,509,288,8.11,2,29.4,454571,3801,452106,1.73,0.98,0.6314625850340136,0.84,99.46
2021-07-08,Haryana,359,5,350,4807,2006,1370,7.47,4,29.4,454930,3806,452456,6.82,4.66,0.16350340136054423,0.84,99.46
2021-07-09,Haryana,201,1,195,2431,3546,295,8.27,5,29.4,455131,3807,452651,12.06,1.0,0.08268707482993197,0.84,99.46
2021-07-10,Haryana,914,10,914,11358,3400,222,8.05,0,29.4,456045,3817,453565,11.56,0.76,0.3863265306122449,0.84,99.46
2021-07-11,Haryana,906,11,905,11241,2982,2304,8.06,0,29.4,456951,3828,454470,10.14,7.84,0.3823469387755102,0.84,99.46
2021-07-12,Haryana,1407,11,1404,17504,3476,3028,8.04,0,29.4,458358,3839,455874,11.82,10.3,0.5953741496598639,0.84,99.46
2021-07-13,Haryana,1437,20,1434,18101,1162,567,7.94,0,29.4,459795,3859,457308,3.95,1.93,0.6156802721088436,0.84,99.46
2021-07-14,Haryana,183,2,175,2202,677,64,8.31,6,29.4,459978,3861,457483,2.3,0.22,0.07489795918367347,0.84,99.46
2021-07-15,Haryana,440,5,440,5355,2683,530,8.22,0,29.4,460418,3866,457923,9.13,1.8,0.18214285714285713,0.84,99.46
2021-07-16,Haryana,931,11,930,11555,1697,1281,8.06,0,29.4,461349,3877,458853,5.77,4.36,0.3930272108843537,0.84,99.46
2021-07-17,Haryana,240,3,239,3243,3380,625,7.4,0,29.4,461589,3880,459092,11.5,2.13,0.1103061224489796,0.84,99.46
2021-07-18,Haryana,1017,9,1017,12703,3959,1537,8.01,0,29.4,462606,3889,460109,13.47,5.23,0.43207482993197277,0.84,99.46
2021-07-19,Haryana,499,3,495,6611,3427,2669,7.55,1,29.4,463105,3892,460604,11.66,9.08,0.2248639455782313,0.84,99.46
2021-07-20,Haryana,730,8,721,8879,539,309,8.22,1,29.4,463835,3900,461325,1.83,1.05,0.30200680272108843,0.84,99.46
2021-07-21,Haryana,1072,4,1065,13359,4288,201,8.02,3,29.4,464907,3904,462390,14.59,0.68,0.4543877551020408,0.84,99.46
2021-07-22,Haryana,1597,12,1593,19992,3994,2397,7.99,0,29.4,466504,3916,463983,13.59,8.15,0.68,0.84,99.46
2021-07-23,Haryana,659,8,658,8292,941,426,7.95,0,29.4,467163,3924,464641,3.2,1.45,0.2820408163265306,0.84,99.46
2021-07-24,Haryana,663,6,657,8297,3928,2303,7.99,0,29.4,467826,3930,465298,13.36,7.83,0.2822108843537415,0.84,99.46
2021-07-25,Haryana,1103,10,1095,13401,620,454,8.23,0,29.4,468929,3940,466393,2.11,1.54,0.45581632653061227,0.84,99.46
2021-07-26,Haryana,100,0,91,1390,4490,699,7.19,9,29.4,469029,3940,466484,15.27,2.38,0.04727891156462585,0.84,99.46
2021-07-27,Haryana,1427,9,1427,17873,1228,708,7.98,0,29.4,470456,3949,467911,4.18,2.41,0.6079251700680273,0.84,99.46
2021-07-28,Haryana,1264,7,1262,15880,4856,2616,7.96,0,29.4,471720,3956,469173,16.52,8.9,0.5401360544217687,0.84,99.46
2021-07-29,Haryana,945,11,942,11914,973,123,7.93,0,29.4,472665,3967,470115,3.31,0.42,0.40523809523809523,0.84,99.46
2021-07-30,Haryana,1034,14,1025,12686,4665,1764,8.15,0,29.4,473699,3981,471140,15.87,6.0,0.4314965986394558,0.84,99.46
2021-07-31,Haryana,467,4,461,5791,2238,1178,8.06,2,29.4,474166,3985,471601,7.61,4.01,0.19697278911564625,0.84,99.46
2021-08-01,Haryana,192,0,184,2787,4079,1428,6.89,8,29.4,474358,3985,471785,13.87,4.86,0.09479591836734694,0.84,99.46
2021-08-02,Haryana,865,8,856,10609,1383,545,8.15,1,29.4,475223,3993,472641,4.7,1.85,0.36085034013605444,0.84,99.46
2021-08-03,Haryana,1503,21,1501,18797,3360,2239,8.0,0,29.4,476726,4014,474142,11.43,7.62,0.6393537414965986,0.84,99.46
2021-08-04,Haryana,513,5,511,6521,3485,177,7.87,0,29.4,477239,4019,474653,11.85,0.6,0.22180272108843538,0.84,99.46
2021-08-05,Haryana,1099,12,1092,13522,2333,1160,8.13,0,29.4,478338,4031,475745,7.94,3.95,0.45993197278911563,0.84,99.46
2021-08-06,Haryana,1219,5,1216,15431,1143,338,7.9,0,29.4,479557,4036,476961,3.89,1.15,0.5248639455782312,0.84,99.46
2021-08-07,Haryana,682,8,681,8711,3304,1087,7.83,0,29.4,480239,4044,477642,11.24,3.7,0.2962925170068027,0.84,99.46
2021-08-08,Haryana,1106,9,1106,14090,3380,884,7.85,0,29.4,481345,4053,478748,11.5,3.01,0.4792517006802721,0.84,99.46
2021-08-09,Haryana,648,3,645,8140,3923,3540,7.96,0,29.4,481993,4056,479393,13.34,12.04,0.27687074829931974,0.84,99.46
2021-08-10,Haryana,100,1,100,1390,3197,593,7.19,0,29.4,482093,4057,479493,10.87,2.02,0.04727891156462585,0.84,99.46
2021-08-11,Haryana,1048,3,1041,13196,988,429,7.94,4,29.4,483141,4060,480534,3.36,1.46,0.44884353741496597,0.84,99.46
2021-08-12,Haryana,801,5,792,10226,2959,165,7.83,4,29.4,483942,4065,481326,10.06,0.56,0.34782312925170067,0.84,99.46
2021-08-13,Haryana,98,1,95,1523,4210,905,6.43,2,29.4,484040,4066,481421,14.32,3.08,0.05180272108843537,0.84,99.46
2021-08-14,Haryana,768,10,764,9479,3869,3570,8.1,0,29.4,484808,4076,482185,13.16,12.14,0.3224149659863946,0.84,99.46
2021-08-15,Haryana,619,5,612,7939,823,180,7.8,2,29.4,485427,4081,482797,2.8,0.61,0.27003401360544216,0.84,99.46
2021-08-16,Haryana,1565,7,1559,19754,489,22,7.92,0,29.4,486992,4088,484356,1.66,0.07,0.6719047619047619,0.84,99.46
2021-08-17,Haryana,686,7,686,8564,4151,1041,8.01,0,29.4,487678,4095,485042,14.12,3.54,0.2912925170068027,0.84,99.46
2021-08-18,Haryana,1149,4,1140,14144,1843,844,8.12,5,29.4,488827,4099,486182,6.27,2.87,0.48108843537414964,0.84,99.46
2021-08-19,Haryana,419,2,415,5481,4896,2015,7.64,2,29.4,489246,4101,486597,16.65,6.85,0.18642857142857142,0.84,99.46
2021-08-20,Haryana,234,2,229,3049,4810,2253,7.67,3,29.4,489480,4103,486826,16.36,7.66,0.10370748299319728,0.84,99.46
2021-08-21,Haryana,896,9,896,11684,4485,4456,7.67,0,29.4,490376,4112,487722,15.26,15.16,0.39741496598639453,0.84,99.46
2021-08-22,Haryana,254,2,252,3034,1407,413,8.37,0,29.4,490630,4114,487974,4.79,1.4,0.10319727891156463,0.84,99.46
2021-08-23,Haryana,834,9,828,10753,1358,568,7.76,0,29.4,491464,4123,488802,4.62,1.93,0.3657482993197279,0.84,99.46
2021-08-24,Haryana,978,8,969,12357,3054,71,7.91,1,29.4,492442,4131,489771,10.39,0.24,0.4203061224489796,0.84,99.46
2021-08-25,Haryana,1211,14,1205,15051,1573,1226,8.05,0,29.4,493653,4145,490976,5.35,4.17,0.5119387755102041,0.84,99.46
2021-08-26,Haryana,206,2,202,2844,4504,51,7.24,2,29.4,493859,4147,491178,15.32,0.17,0.09673469387755101,0.84,99.46
2021-08-27,Haryana,297,3,297,3762,3600,236,7.89,0,29.4,494156,4150,491475,12.24,0.8,0.1279591836734694,0.84,99.46
2021-08-28,Haryana,1591,7,1586,19851,530,319,8.01,0,29.4,495747,4157,493061,1.8,1.09,0.6752040816326531,0.84,99.46
2021-08-29,Haryana,1360,18,1354,16876,4944,769,8.06,0,29.4,497107,4175,494415,16.82,2.62,0.5740136054421768,0.84,99.46
2021-08-30,Haryana,1428,13,1426,18088,3703,1742,7.89,0,29.4,498535,4188,495841,12.6,5.93,0.6152380952380953,0.84,99.46
2021-08-31,Haryana,112,0,109,1607,3130,2453,6.97,3,29.4,498647,4188,495950,10.65,8.34,0.05465986394557823,0.84,99.46
2021-09-01,Haryana,476,6,475,5703,1700,20,8.35,0,29.4,499123,4194,496425,5.78,0.07,0.1939795918367347,0.84,99.46
2021-09-02,Haryana,1370,5,1367,17931,4898,4768,7.64,0,29.4,500493,4199,497792,16.66,16.22,0.6098979591836735,0.84,99.46
2021-09-03,Haryana,1495,17,1491,18766,1466,919,7.97,0,29.4,501988,4216,499283,4.99,3.13,0.6382993197278911,0.84,99.46
2021-09-04,Haryana,797,7,792,9968,1495,591,8.0,0,29.4,502785,4223,500075,5.09,2.01,0.33904761904761904,0.84,99.46
2021-09-05,Haryana,140,1,138,1785,2179,1420,7.84,1,29.4,502925,4224,500213,7.41,4.83,0.060714285714285714,0.84,99.46
2021-09-06,Haryana,1312,7,1305,16824,119,65,7.8,0,29.4,504237,4231,501518,0.4,0.22,0.5722448979591837,0.84,99.46
2021-09-07,Haryana,201,3,193,2451,2379,366,8.2,5,29.4,504438,4234,501711,8.09,1.24,0.08336734693877551,0.84,99.46
2021-09-08,Haryana,540,6,539,6598,4174,3315,8.18,0,29.4,504978,4240,502250,14.2,11.28,0.22442176870748298,0.84,99.46
2021-09-09,Haryana,885,3,878,11262,1223,590,7.86,4,29.4,505863,4243,503128,4.16,2.01,0.3830612244897959,0.84,99.46
2021-09-10,Haryana,1113,10,1110,14106,626,234,7.89,0,29.4,506976,4253,504238,2.13,0.8,0.4797959183673469,0.84,99.46
2021-09-11,Haryana,195,2,186,2709,679,534,7.2,7,29.4,507171,4255,504424,2.31,1.82,0.09214285714285714,0.84,99.46
2021-09-12,Haryana,741,10,735,9175,2459,280,8.08,0,29.4,507912,4265,505159,8.36,0.95,0.3120748299319728,0.84,99.46
2021-09-13,Haryana,1114,3,1106,13762,25,15,8.09,5,29.4,509026,4268,506265,0.09,0.05,0.4680952380952381,0.84,99.46
2021-09-14,Haryana,1285,11,1283,16218,615,538,7.92,0,29.4,510311,4279,507548,2.09,1.83,0.5516326530612244,0.84,99.46
2021-09-15,Haryana,1043,7,1034,12828,4379,2597,8.13,2,29.4,511354,4286,508582,14.89,8.83,0.4363265306122449,0.84,99.46
2021-09-16,Haryana,1608,16,1602,19798,2529,2431,8.12,0,29.4,512962,4302,510184,8.6,8.27,0.6734013605442177,0.84,99.46
2021-09-17,Haryana,847,7,843,10460,984,199,8.1,0,29.4,513809,4309,511027,3.35,0.68,0.35578231292517004,0.84,99.46
2021-09-18,Haryana,435,3,434,5131,1,1,8.48,0,29.4,514244,4312,511461,0.0,0.0,0.17452380952380953,0.84,99.46
2021-09-19,Haryana,813,4,811,9700,75,16,8.38,0,29.4,515057,4316,512272,0.26,0.05,0.3299319727891156,0.84,99.46
2021-09-20,Haryana,789,10,783,9765,62,54,8.08,0,29.4,515846,4326,513055,0.21,0.18,0.33214285714285713,0.84,99.46
2021-09-21,Haryana,616,8,615,7480,4484,4290,8.24,0,29.4,516462,4334,513670,15.25,14.59,0.254421768707483,0.84,99.46
2021-09-22,Haryana,764,4,757,9584,1578,1203,7.97,3,29.4,517226,4338,514427,5.37,4.09,0.32598639455782313,0.84,99.46
2021-09-23,Haryana,1039,5,1030,13268,977,359,7.83,4,29.4,518265,4343,515457,3.32,1.22,0.45129251700680273,0.84,99.46
2021-09-24,Haryana,786,3,778,9933,2968,1041,7.91,5,29.4,519051,4346,516235,10.1,3.54,0.33785714285714286,0.84,99.46
2021-09-25,Haryana,397,5,390,4801,686,175,8.27,2,29.4,519448,4351,516625,2.33,0.6,0.16329931972789116,0.84,99.46
2021-09-26,Haryana,96,0,95,699,3528,1173,13.73,1,29.4,519544,4351,516720,12.0,3.99,0.023775510204081633,0.84,99.46
2021-09-27,Haryana,1013,6,1008,13004,2027,1229,7.79,0,29.4,520557,4357,517728,6.89,4.18,0.44231292517006804,0.84,99.46
2021-09-28,Haryana,466,2,461,6123,296,34,7.61,3,29.4,521023,4359,518189,1.01,0.12,0.20826530612244898,0.84,99.46
2021-09-29,Haryana,565,5,560,6931,2288,161,8.15,0,29.4,521588,4364,518749,7.78,0.55,0.23574829931972788,0.84,99.46
2021-09-30,Haryana,778,5,775,9757,3729,1539,7.97,0,29.4,522366,4369,519524,12.68,5.23,0.33187074829931973,0.84,99.46
2021-10-01,Haryana,354,3,349,4370,1635,1448,8.1,2,29.4,522720,4372,519873,5.56,4.93,0.1486394557823129,0.84,99.46
2021-10-02,Haryana,209,1,206,2412,1568,1392,8.67,2,29.4,522929,4373,520079,5.33,4.73,0.08204081632653061,0.84,99.45
2021-10-03,Haryana,421,1,415,5292,1087,811,7.96,5,29.4,523350,4374,520494,3.7,2.76,0.18,0.84,99.45
2021-10-04,Haryana,964,5,956,12188,3356,1721,7.91,3,29.4,524314,4379,521450,11.41,5.85,0.4145578231292517,0.84,99.45
2021-10-05,Haryana,947,10,945,11532,1064,348,8.21,0,29.4,525261,4389,522395,3.62,1.18,0.39224489795918366,0.84,99.45
2021-10-06,Haryana,1150,10,1148,13899,4882,1146,8.27,0,29.4,526411,4399,523543,16.61,3.9,0.47275510204081633,0.84,99.46
2021-10-07,Haryana,143,1,135,2063,4820,3491,6.93,7,29.4,526554,4400,523678,16.39,11.87,0.07017006802721089,0.84,99.45
2021-10-08,Haryana,569,6,569,6714,3377,981,8.47,0,29.4,527123,4406,524247,11.49,3.34,0.2283673469387755,0.84,99.45
2021-10-09,Haryana,527,2,519,6809,2166,746,7.74,6,29.4,527650,4408,524766,7.37,2.54,0.23159863945578232,0.84,99.45
2021-10-10,Haryana,806,6,798,9644,2112,1071,8.36,2,29.4,528456,4414,525564,7.18,3.64,0.3280272108843537,0.84,99.45
2021-10-11,Haryana,1181,14,1175,14583,3726,3576,8.1,0,29.4,529637,4428,526739,12.67,12.16,0.4960204081632653,0.84,99.45
2021-10-12,Haryana,670,9,667,8746,1935,1607,7.66,0,29.4,530307,4437,527406,6.58,5.47,0.2974829931972789,0.84,99.45
2021-10-13,Haryana,1435,20,1435,17971,1087,93,7.99,0,29.4,531742,4457,528841,3.7,0.32,0.6112585034013606,0.84,99.45
2021-10-14,Haryana,1356,10,1353,16978,4867,4418,7.99,0,29.4,533098,4467,530194,16.55,15.03,0.5774829931972789,0.84,99.46
2021-10-15,Haryana,146,0,144,1503,1163,854,9.71,2,29.4,533244,4467,530338,3.96,2.9,0.05112244897959184,0.84,99.46
2021-10-16,Haryana,1029,12,1025,13265,2306,1897,7.76,0,29.4,534273,4479,531363,7.84,6.45,0.4511904761904762,0.84,99.46
2021-10-17,Haryana,1366,7,1365,17241,2587,1207,7.92,0,29.4,535639,4486,532728,8.8,4.11,0.5864285714285714,0.84,99.46
2021-10-18,Haryana,205,0,198,2422,2540,597,8.46,7,29.4,535844,4486,532926,8.64,2.03,0.08238095238095237,0.84,99.46
2021-10-19,Haryana,534,7,528,6429,2154,1808,8.31,0,29.4,536378,4493,533454,7.33,6.15,0.21867346938775512,0.84,99.45
2021-10-20,Haryana,515,4,509,6679,154,2,7.71,2,29.4,536893,4497,533963,0.52,0.01,0.22717687074829931,0.84,99.45
2021-10-21,Haryana,65,0,61,511,3377,2439,12.72,4,29.4,536958,4497,534024,11.49,8.3,0.017380952380952382,0.84,99.45
2021-10-22,Haryana,1082,14,1073,13423,3407,336,8.06,0,29.4,538040,4511,535097,11.59,1.14,0.45656462585034013,0.84,99.45
2021-10-23,Haryana,462,2,462,5997,618,379,7.7,0,29.4,538502,4513,535559,2.1,1.29,0.2039795918367347,0.84,99.45
2021-10-24,Haryana,996,4,991,12628,166,147,7.89,1,29.4,539498,4517,536550,0.56,0.5,0.42952380952380953,0.84,99.45
2021-10-25,Haryana,904,12,898,11671,515,91,7.75,0,29.4,540402,4529,537448,1.75,0.31,0.39697278911564626,0.84,99.45
2021-10-26,Haryana,1509,21,1506,18864,2497,2416,8.0,0,29.4,541911,4550,538954,8.49,8.22,0.6416326530612245,0.84,99.45
2021-10-27,Haryana,397,3,391,5323,1352,212,7.46,3,29.4,542308,4553,539345,4.6,0.72,0.18105442176870748,0.84,99.45
2021-10-28,Haryana,418,4,414,5657,961,852,7.39,0,29.4,542726,4557,539759,3.27,2.9,0.19241496598639457,0.84,99.45
2021-10-29,Haryana,508,2,502,5968,4571,1529,8.51,4,29.4,543234,4559,540261,15.55,5.2,0.20299319727891157,0.84,99.45
2021-10-30,Haryana,870,5,861,10836,1631,322,8.03,4,29.4,544104,4564,541122,5.55,1.1,0.36857142857142855,0.84,99.45
2021-10-31,Haryana,129,0,126,1689,1580,312,7.64,3,29.4,544233,4564,541248,5.37,1.06,0.05744897959183674,0.84,99.45
2021-11-01,Haryana,1264,10,1261,15667,1866,867,8.07,0,29.4,545497,4574,542509,6.35,2.95,0.532891156462585,0.84,99.45
2021-11-02,Haryana,1421,14,1415,17616,1758,295,8.07,0,29.4,546918,4588,543924,5.98,1.0,0.5991836734693877,0.84,99.45
2021-11-03,Haryana,347,1,347,4043,2339,1674,8.58,0,29.4,547265,4589,544271,7.96,5.69,0.13751700680272108,0.84,99.45
2021-11-04,Haryana,1009,3,1004,12558,3265,1313,8.03,2,29.4,548274,4592,545275,11.11,4.47,0.42714285714285716,0.84,99.45
2021-11-05,Haryana,321,4,314,4253,4293,821,7.55,3,29.4,548595,4596,545589,14.6,2.79,0.14465986394557823,0.84,99.45
2021-11-06,Haryana,951,11,945,11940,1647,484,7.96,0,29.4,549546,4607,546534,5.6,1.65,0.4061224489795918,0.84,99.45
2021-11-07,Haryana,742,6,734,8852,357,135,8.38,2,29.4,550288,4613,547268,1.21,0.46,0.30108843537414964,0.84,99.45
2021-11-08,Haryana,1218,10,1210,15337,4979,3000,7.94,0,29.4,551506,4623,548478,16.94,10.2,0.5216666666666666,0.84,99.45
2021-11-09,Haryana,328,2,328,4160,3584,3198,7.88,0,29.4,551834,4625,548806,12.19,10.88,0.1414965986394558,0.84,99.45
2021-11-10,Haryana,437,6,432,5575,4169,1733,7.84,0,29.4,552271,4631,549238,14.18,5.89,0.18962585034013604,0.84,99.45
2021-11-11,Haryana,1282,16,1278,15590,1299,954,8.22,0,29.4,553553,4647,550516,4.42,3.24,0.5302721088435374,0.84,99.45
2021-11-12,Haryana,628,4,628,7737,4973,1130,8.12,0,29.4,554181,4651,551144,16.91,3.84,0.26316326530612244,0.84,99.45
2021-11-13,Haryana,585,4,579,7720,3755,3422,7.58,2,29.4,554766,4655,551723,12.77,11.64,0.26258503401360545,0.84,99.45
2021-11-14,Haryana,189,1,181,2470,4493,944,7.65,7,29.4,554955,4656,551904,15.28,3.21,0.08401360544217687,0.84,99.45
2021-11-15,Haryana,1206,16,1204,15410,183,126,7.83,0,29.4,556161,4672,553108,0.62,0.43,0.5241496598639456,0.84,99.45
2021-11-16,Haryana,519,3,513,6374,1282,955,8.14,3,29.4,556680,4675,553621,4.36,3.25,0.21680272108843537,0.84,99.45
2021-11-17,Haryana,357,2,350,4446,121,45,8.03,5,29.4,557037,4677,553971,0.41,0.15,0.15122448979591838,0.84,99.45
2021-11-18,Haryana,1139,11,1132,13942,2395,167,8.17,0,29.4,558176,4688,555103,8.15,0.57,0.4742176870748299,0.84,99.45
2021-11-19,Haryana,1224,8,1219,15733,335,44,7.78,0,29.4,559400,4696,556322,1.14,0.15,0.5351360544217687,0.84,99.45
2021-11-20,Haryana,622,4,614,7906,1381,523,7.87,4,29.4,560022,4700,556936,4.7,1.78,0.26891156462585036,0.84,99.45
2021-11-21,Haryana,754,7,749,9096,4376,592,8.29,0,29.4,560776,4707,557685,14.88,2.01,0.3093877551020408,0.84,99.45
2021-11-22,Haryana,853,10,844,10922,1470,57,7.81,0,29.4,561629,4717,558529,5.0,0.19,0.3714965986394558,0.84,99.45
2021-11-23,Haryana,1484,15,1484,18618,110,27,7.97,0,29.4,563113,4732,560013,0.37,0.09,0.633265306122449,0.84,99.45
2021-11-24,Haryana,1089,5,1082,13863,4446,4184,7.86,2,29.4,564202,4737,561095,15.12,14.23,0.47153061224489795,0.84,99.45
2021-11-25,Haryana,1232,6,1231,15585,3225,1120,7.91,0,29.4,565434,4743,562326,10.97,3.81,0.5301020408163265,0.84,99.45
2021-11-26,Haryana,511,3,502,6307,1552,842,8.1,6,29.4,565945,4746,562828,5.28,2.86,0.21452380952380953,0.84,99.45
2021-11-27,Haryana,325,2,324,3988,3181,409,8.15,0,29.4,566270,4748,563152,10.82,1.39,0.13564625850340137,0.84,99.45
2021-11-28,Haryana,526,2,523,7097,490,108,7.41,1,29.4,566796,4750,563675,1.67,0.37,0.24139455782312924,0.84,99.45
2021-11-29,Haryana,949,3,941,12315,1769,507,7.71,5,29.4,567745,4753,564616,6.02,1.72,0.4188775510204082,0.84,99.45
2021-11-30,Haryana,1581,18,1575,19879,4636,2756,7.95,0,29.4,569326,4771,566191,15.77,9.37,0.676156462585034,0.84,99.45
2021-12-01,Haryana,488,4,486,5695,3372,1031,8.57,0,29.4,569814,4775,566677,11.47,3.51,0.1937074829931973,0.84,99.45
2021-12-02,Haryana,475,1,475,5486,2514,2121,8.66,0,29.4,570289,4776,567152,8.55,7.21,0.1865986394557823,0.84,99.45
2021-12-03,Haryana,262,2,253,3681,626,561,7.12,7,29.4,570551,4778,567405,2.13,1.91,0.12520408163265306,0.84,99.45
2021-12-04,Haryana,845,5,842,10758,216,7,7.85,0,29.4,571396,4783,568247,0.73,0.02,0.3659183673469388,0.84,99.45
2021-12-05,Haryana,1491,5,1482,18761,2561,1854,7.95,4,29.4,572887,4788,569729,8.71,6.31,0.6381292517006802,0.84,99.45
2021-12-06,Haryana,271,0,270,3095,4591,719,8.76,1,29.4,573158,4788,569999,15.62,2.45,0.10527210884353741,0.84,99.45
2021-12-07,Haryana,288,4,285,3319,283,7,8.68,0,29.4,573446,4792,570284,0.96,0.02,0.11289115646258503,0.84,99.45
2021-12-08,Haryana,1557,11,1549,19095,1382,665,8.15,0,29.4,575003,4803,571833,4.7,2.26,0.6494897959183673,0.84,99.45
2021-12-09,Haryana,951,10,945,11974,1950,654,7.94,0,29.4,575954,4813,572778,6.63,2.22,0.40727891156462587,0.84,99.45
2021-12-10,Haryana,668,3,668,8484,4004,363,7.87,0,29.4,576622,4816,573446,13.62,1.23,0.2885714285714286,0.84,99.45
2021-12-11,Haryana,1466,7,1464,18724,4131,1462,7.83,0,29.4,578088,4823,574910,14.05,4.97,0.6368707482993198,0.83,99.45
2021-12-12,Haryana,1273,4,1266,16048,3944,1512,7.93,3,29.4,579361,4827,576176,13.41,5.14,0.5458503401360544,0.83,99.45
2021-12-13,Haryana,944,9,938,11586,3680,3265,8.15,0,29.4,580305,4836,577114,12.52,11.11,0.39408163265306123,0.83,99.45
2021-12-14,Haryana,1262,5,1260,16002,149,127,7.89,0,29.4,581567,4841,578374,0.51,0.43,0.5442857142857143,0.83,99.45
2021-12-15,Haryana,237,2,237,2629,3118,237,9.01,0,29.4,581804,4843,578611,10.61,0.81,0.08942176870748299,0.83,99.45
2021-12-16,Haryana,1392,10,1385,16835,2170,213,8.27,0,29.4,583196,4853,579996,7.38,0.72,0.5726190476190476,0.83,99.45
2021-12-17,Haryana,823,6,823,10615,1624,183,7.75,0,29.4,584019,4859,580819,5.52,0.62,0.3610544217687075,0.83,99.45
2021-12-18,Haryana,632,4,624,7718,1948,169,8.19,4,29.4,584651,4863,581443,6.63,0.57,0.2625170068027211,0.83,99.45
2021-12-19,Haryana,630,2,621,8042,2956,1942,7.83,7,29.4,585281,4865,582064,10.05,6.61,0.2735374149659864,0.83,99.45
2021-12-20,Haryana,279,1,275,3354,97,91,8.32,3,29.4,585560,4866,582339,0.33,0.31,0.11408163265306122,0.83,99.45
2021-12-21,Haryana,528,4,525,6565,184,54,8.04,0,29.4,586088,4870,582864,0.63,0.18,0.22329931972789116,0.83,99.45
2021-12-22,Haryana,1148,10,1143,14498,353,342,7.92,0,29.4,587236,4880,584007,1.2,1.16,0.4931292517006803,0.83,99.45
2021-12-23,Haryana,1566,5,1565,19793,1795,399,7.91,0,29.4,588802,4885,585572,6.11,1.36,0.6732312925170068,0.83,99.45
2021-12-24,Haryana,316,4,314,3805,3135,2941,8.3,0,29.4,589118,4889,585886,10.66,10.0,0.12942176870748298,0.83,99.45
2021-12-25,Haryana,684,7,683,8574,3184,1428,7.98,0,29.4,589802,4896,586569,10.83,4.86,0.2916326530612245,0.83,99.45
2021-12-26,Haryana,1241,13,1233,15670,459,141,7.92,0,29.4,591043,4909,587802,1.56,0.48,0.5329931972789116,0.83,99.45
2021-12-27,Haryana,692,4,687,8452,4156,2515,8.19,1,29.4,591735,4913,588489,14.14,8.55,0.28748299319727894,0.83,99.45
2021-12-28,Haryana,949,6,948,12053,1622,1078,7.87,0,29.4,592684,4919,589437,5.52,3.67,0.40996598639455784,0.83,99.45
2021-12-29,Haryana,1093,14,1089,13801,2551,315,7.92,0,29.4,593777,4933,590526,8.68,1.07,0.469421768707483,0.83,99.45
2021-12-30,Haryana,866,3,864,10894,1915,223,7.95,0,29.4,594643,4936,591390,6.51,0.76,0.37054421768707485,0.83,99.45
2021-12-31,Haryana,1608,7,1599,19850,1580,1303,8.1,2,29.4,596251,4943,592989,5.37,4.43,0.6751700680272109,0.83,99.45
2022-01-01,Haryana,373,1,367,4612,3007,1809,8.09,5,29.4,596624,4944,593356,10.23,6.15,0.15687074829931974,0.83,99.45
2022-01-02,Haryana,209,2,207,2785,2789,1562,7.5,0,29.4,596833,4946,593563,9.49,5.31,0.09472789115646259,0.83,99.45
2022-01-03,Haryana,1373,12,1366,17056,981,96,8.05,0,29.4,598206,4958,594929,3.34,0.33,0.5801360544217687,0.83,99.45
2022-01-04,Haryana,1489,22,1489,18426,3663,830,8.08,0,29.4,599695,4980,596418,12.46,2.82,0.626734693877551,0.83,99.45
2022-01-05,Haryana,427,5,419,5322,2172,1075,8.02,3,29.4,600122,4985,596837,7.39,3.66,0.1810204081632653,0.83,99.45
2022-01-06,Haryana,693,4,688,8493,3335,831,8.16,1,29.4,600815,4989,597525,11.34,2.83,0.2888775510204082,0.83,99.45
2022-01-07,Haryana,921,11,913,11252,71,6,8.19,0,29.4,601736,5000,598438,0.24,0.02,0.38272108843537417,0.83,99.45
2022-01-08,Haryana,1003,12,995,12493,1093,235,8.03,0,29.4,602739,5012,599433,3.72,0.8,0.42493197278911565,0.83,99.45
2022-01-09,Haryana,1310,17,1304,16180,3645,618,8.1,0,29.4,604049,5029,600737,12.4,2.1,0.5503401360544218,0.83,99.45
2022-01-10,Haryana,1552,10,1549,19263,3706,3268,8.06,0,29.4,605601,5039,602286,12.61,11.12,0.6552040816326531,0.83,99.45
2022-01-11,Haryana,1360,13,1355,17136,3860,372,7.94,0,29.4,606961,5052,603641,13.13,1.27,0.5828571428571429,0.83,99.45
2022-01-12,Haryana,1281,16,1277,16101,4655,3212,7.96,0,29.4,608242,5068,604918,15.83,10.93,0.5476530612244898,0.83,99.45
2022-01-13,Haryana,1160,14,1152,14542,3398,1480,7.98,0,29.4,609402,5082,606070,11.56,5.03,0.49462585034013606,0.83,99.45
2022-01-14,Haryana,1381,9,1373,17565,4243,1281,7.86,0,29.4,610783,5091,607443,14.43,4.36,0.5974489795918367,0.83,99.45
2022-01-15,Haryana,817,5,809,10177,2509,2332,8.03,3,29.4,611600,5096,608252,8.53,7.93,0.346156462585034,0.83,99.45
2022-01-16,Haryana,1229,9,1226,15283,4175,2601,8.04,0,29.4,612829,5105,609478,14.2,8.85,0.5198299319727891,0.83,99.45
2022-01-17,Haryana,351,1,347,4537,3538,1517,7.74,3,29.4,613180,5106,609825,12.03,5.16,0.15431972789115647,0.83,99.45
2022-01-18,Haryana,1575,13,1567,19761,4730,4028,7.97,0,29.4,614755,5119,611392,16.09,13.7,0.6721428571428572,0.83,99.45
2022-01-19,Haryana,1010,11,1010,12661,1065,450,7.98,0,29.4,615765,5130,612402,3.62,1.53,0.4306462585034014,0.83,99.45
2022-01-20,Haryana,1279,16,1270,16309,2021,132,7.84,0,29.4,617044,5146,613672,6.87,0.45,0.5547278911564626,0.83,99.45
2022-01-21,Haryana,54,0,48,630,1057,381,8.57,6,29.4,617098,5146,613720,3.6,1.3,0.02142857142857143,0.83,99.45
2022-01-22,Haryana,319,1,319,3946,2958,180,8.08,0,29.4,617417,5147,614039,10.06,0.61,0.13421768707482992,0.83,99.45
2022-01-23,Haryana,1301,15,1295,16061,2909,1852,8.1,0,29.4,618718,5162,615334,9.89,6.3,0.5462925170068027,0.83,99.45
2022-01-24,Haryana,1120,5,1120,13615,4453,4013,8.23,0,29.4,619838,5167,616454,15.15,13.65,0.4630952380952381,0.83,99.45
2022-01-25,Haryana,1484,6,1475,18766,2469,324,7.91,3,29.4,621322,5173,617929,8.4,1.1,0.6382993197278911,0.83,99.45
2022-01-26,Haryana,298,2,289,3863,443,119,7.71,7,29.4,621620,5175,618218,1.51,0.4,0.13139455782312925,0.83,99.45
2022-01-27,Haryana,1114,14,1109,13556,632,116,8.22,0,29.4,622734,5189,619327,2.15,0.39,0.4610884353741497,0.83,99.45
2022-01-28,Haryana,1559,19,1550,19502,2561,348,7.99,0,29.4,624293,5208,620877,8.71,1.18,0.6633333333333333,0.83,99.45
2022-01-29,Haryana,1366,9,1359,17452,4600,710,7.83,0,29.4,625659,5217,622236,15.65,2.41,0.5936054421768707,0.83,99.45
2022-01-30,Haryana,433,4,427,5586,4891,2282,7.75,2,29.4,626092,5221,622663,16.64,7.76,0.19,0.83,99.45
2022-01-31,Haryana,1324,14,1319,16991,2572,422,7.79,0,29.4,627416,5235,623982,8.75,1.44,0.5779251700680272,0.83,99.45
2022-02-01,Haryana,1064,5,1056,13252,4274,3148,8.03,3,29.4,628480,5240,625038,14.54,10.71,0.4507482993197279,0.83,99.45
2022-02-02,Haryana,453,3,451,5537,158,95,8.18,0,29.4,628933,5243,625489,0.54,0.32,0.18833333333333332,0.83,99.45
2022-02-03,Haryana,486,5,478,5983,2782,1808,8.12,3,29.4,629419,5248,625967,9.46,6.15,0.2035034013605442,0.83,99.45
2022-02-04,Haryana,1014,8,1013,12761,3714,3683,7.95,0,29.4,630433,5256,626980,12.63,12.53,0.43404761904761907,0.83,99.45
2022-02-05,Haryana,101,0,97,1433,3367,449,7.05,4,29.4,630534,5256,627077,11.45,1.53,0.04874149659863945,0.83,99.45
2022-02-06,Haryana,529,7,524,6628,3752,41,7.98,0,29.4,631063,5263,627601,12.76,0.14,0.2254421768707483,0.83,99.45
2022-02-07,Haryana,590,5,589,7055,3508,2638,8.36,0,29.4,631653,5268,628190,11.93,8.97,0.23996598639455782,0.83,99.45
2022-02-08,Haryana,467,2,460,6097,100,56,7.66,5,29.4,632120,5270,628650,0.34,0.19,0.2073809523809524,0.83,99.45
2022-02-09,Haryana,514,4,507,6419,2862,673,8.01,3,29.4,632634,5274,629157,9.73,2.29,0.21833333333333332,0.83,99.45
2022-02-10,Haryana,1595,21,1590,19818,582,433,8.05,0,29.4,634229,5295,630747,1.98,1.47,0.6740816326530612,0.83,99.45
2022-02-11,Haryana,573,4,569,6545,3576,2565,8.75,0,29.4,634802,5299,631316,12.16,8.72,0.2226190476190476,0.83,99.45
2022-02-12,Haryana,278,2,272,3265,3807,50,8.51,4,29.4,635080,5301,631588,12.95,0.17,0.11105442176870749,0.83,99.45
2022-02-13,Haryana,1419,5,1410,17982,60,34,7.89,4,29.4,636499,5306,632998,0.2,0.12,0.6116326530612245,0.83,99.45
2022-02-14,Haryana,197,2,189,2948,794,363,6.68,6,29.4,636696,5308,633187,2.7,1.23,0.10027210884353742,0.83,99.45
2022-02-15,Haryana,1203,10,1197,15153,1142,733,7.94,0,29.4,637899,5318,634384,3.88,2.49,0.5154081632653061,0.83,99.45
2022-02-16,Haryana,1169,5,1165,14833,476,0,7.88,0,29.4,639068,5323,635549,1.62,0.0,0.5045238095238095,0.83,99.45
2022-02-17,Haryana,355,1,352,4312,4866,2056,8.23,2,29.4,639423,5324,635901,16.55,6.99,0.14666666666666667,0.83,99.45
2022-02-18,Haryana,1499,12,1494,18522,659,287,8.09,0,29.4,640922,5336,637395,2.24,0.98,0.63,0.83,99.45
2022-02-19,Haryana,601,2,598,7699,3803,1746,7.81,1,29.4,641523,5338,637993,12.94,5.94,0.2618707482993197,0.83,99.45
2022-02-20,Haryana,1536,4,1530,19136,963,157,8.03,2,29.4,643059,5342,639523,3.28,0.53,0.6508843537414966,0.83,99.45
2022-02-21,Haryana,581,4,577,7113,2063,211,8.17,0,29.4,643640,5346,640100,7.02,0.72,0.24193877551020407,0.83,99.45
2022-02-22,Haryana,293,2,285,3872,3432,1577,7.57,6,29.4,643933,5348,640385,11.67,5.36,0.13170068027210885,0.83,99.45
2022-02-23,Haryana,335,1,332,4086,4519,2923,8.2,2,29.4,644268,5349,640717,15.37,9.94,0.1389795918367347,0.83,99.45
2022-02-24,Haryana,733,3,731,9199,473,219,7.97,0,29.4,645001,5352,641448,1.61,0.74,0.31289115646258503,0.83,99.45
2022-02-25,Haryana,966,6,958,11867,89,7,8.14,2,29.4,645967,5358,642406,0.3,0.02,0.4036394557823129,0.83,99.45
2022-02-26,Haryana,1281,14,1276,15741,4149,801,8.14,0,29.4,647248,5372,643682,14.11,2.72,0.5354081632653062,0.83,99.45
2022-02-27,Haryana,467,5,460,5933,1023,818,7.87,2,29.4,647715,5377,644142,3.48,2.78,0.20180272108843536,0.83,99.45
2022-02-28,Haryana,1201,14,1196,14834,3007,256,8.1,0,29.4,648916,5391,645338,10.23,0.87,0.5045578231292517,0.83,99.45
2022-03-01,Haryana,853,6,851,10126,4363,1789,8.42,0,29.4,649769,5397,646189,14.84,6.09,0.344421768707483,0.83,99.45
2022-03-02,Haryana,596,8,593,7499,4167,3313,7.95,0,29.4,650365,5405,646782,14.17,11.27,0.25506802721088434,0.83,99.45
2022-03-03,Haryana,1134,4,1125,14050,555,95,8.07,5,29.4,651499,5409,647907,1.89,0.32,0.477891156462585,0.83,99.45
2022-03-04,Haryana,692,7,684,8271,4150,1008,8.37,1,29.4,652191,5416,648591,14.12,3.43,0.2813265306122449,0.83,99.45
2022-03-05,Haryana,996,4,991,13035,404,214,7.64,1,29.4,653187,5420,649582,1.37,0.73,0.4433673469387755,0.83,99.45
2022-03-06,Haryana,291,2,287,3866,4663,4548,7.53,2,29.4,653478,5422,649869,15.86,15.47,0.1314965986394558,0.83,99.45
2022-03-07,Haryana,338,2,335,3910,1559,1530,8.64,1,29.4,653816,5424,650204,5.3,5.2,0.13299319727891157,0.83,99.45
2022-03-08,Haryana,411,3,410,4928,35,16,8.34,0,29.4,654227,5427,650614,0.12,0.05,0.1676190476190476,0.83,99.45
2022-03-09,Haryana,1311,10,1302,16350,550,280,8.02,0,29.4,655538,5437,651916,1.87,0.95,0.5561224489795918,0.83,99.45
2022-03-10,Haryana,1033,12,1033,13084,4857,271,7.9,0,29.4,656571,5449,652949,16.52,0.92,0.4450340136054422,0.83,99.45
2022-03-11,Haryana,1151,16,1145,14606,114,48,7.88,0,29.4,657722,5465,654094,0.39,0.16,0.4968027210884354,0.83,99.45
2022-03-12,Haryana,722,9,721,8887,2808,1484,8.12,0,29.4,658444,5474,654815,9.55,5.05,0.30227891156462583,0.83,99.45
2022-03-13,Haryana,413,5,410,5156,2405,1704,8.01,0,29.4,658857,5479,655225,8.18,5.8,0.17537414965986395,0.83,99.45
2022-03-14,Haryana,1052,10,1050,13216,3107,1401,7.96,0,29.4,659909,5489,656275,10.57,4.77,0.44952380952380955,0.83,99.45
2022-03-15,Haryana,80,0,78,509,1945,1852,15.72,2,29.4,659989,5489,656353,6.62,6.3,0.017312925170068025,0.83,99.45
2022-03-16,Haryana,1101,9,1098,13645,2117,932,8.07,0,29.4,661090,5498,657451,7.2,3.17,0.4641156462585034,0.83,99.45
2022-03-17,Haryana,94,0,92,875,113,72,10.74,2,29.4,661184,5498,657543,0.38,0.24,0.02976190476190476,0.83,99.45
2022-03-18,Haryana,1269,11,1268,15570,2721,877,8.15,0,29.4,662453,5509,658811,9.26,2.98,0.5295918367346939,0.83,99.45
2022-03-19,Haryana,889,4,882,10869,3756,3647,8.18,3,29.4,663342,5513,659693,12.78,12.4,0.3696938775510204,0.83,99.45
2022-03-20,Haryana,956,11,947,12096,1055,785,7.9,0,29.4,664298,5524,660640,3.59,2.67,0.4114285714285714,0.83,99.45
2022-03-21,Haryana,1149,7,1141,13973,3,1,8.22,1,29.4,665447,5531,661781,0.01,0.0,0.47527210884353743,0.83,99.45
2022-03-22,Haryana,1257,16,1253,15154,2780,1440,8.29,0,29.4,666704,5547,663034,9.46,4.9,0.5154421768707483,0.83,99.45
2022-03-23,Haryana,590,3,585,7284,860,354,8.1,2,29.4,667294,5550,663619,2.93,1.2,0.24775510204081633,0.83,99.45
2022-03-24,Haryana,1391,16,1390,17697,489,291,7.86,0,29.4,668685,5566,665009,1.66,0.99,0.601938775510204,0.83,99.45
2022-03-25,Haryana,938,9,933,11785,1662,545,7.96,0,29.4,669623,5575,665942,5.65,1.85,0.4008503401360544,0.83,99.45
2022-03-26,Haryana,203,1,203,2694,756,745,7.54,0,29.4,669826,5576,666145,2.57,2.53,0.09163265306122449,0.83,99.45
2022-03-27,Haryana,1408,19,1402,17536,4264,887,8.03,0,29.4,671234,5595,667547,14.5,3.02,0.5964625850340136,0.83,99.45
2022-03-28,Haryana,1046,14,1039,13137,73,38,7.96,0,29.4,672280,5609,668586,0.25,0.13,0.4468367346938775,0.83,99.45
2022-03-29,Haryana,269,1,265,3497,392,347,7.69,3,29.4,672549,5610,668851,1.33,1.18,0.11894557823129252,0.83,99.45
2022-03-30,Haryana,900,12,893,11301,4849,3701,7.96,0,29.4,673449,5622,669744,16.49,12.59,0.3843877551020408,0.83,99.45
2022-03-31,Haryana,691,8,686,8630,4958,1293,8.01,0,29.4,674140,5630,670430,16.86,4.4,0.2935374149659864,0.84,99.45
2022-04-01,Haryana,1087,6,1087,13717,2879,1793,7.92,0,29.4,675227,5636,671517,9.79,6.1,0.46656462585034014,0.83,99.45
2022-04-02,Haryana,180,1,174,2583,3608,631,6.97,5,29.4,675407,5637,671691,12.27,2.15,0.08785714285714286,0.83,99.45
2022-04-03,Haryana,647,2,640,8563,4175,1722,7.56,5,29.4,676054,5639,672331,14.2,5.86,0.29125850340136056,0.83,99.45
2022-04-04,Haryana,828,8,827,10361,4235,2771,7.99,0,29.4,676882,5647,673158,14.4,9.43,0.35241496598639455,0.83,99.45
2022-04-05,Haryana,632,2,631,7868,448,179,8.03,0,29.4,677514,5649,673789,1.52,0.61,0.26761904761904765,0.83,99.45
2022-04-06,Haryana,242,1,235,2978,3731,1195,8.13,6,29.4,677756,5650,674024,12.69,4.06,0.10129251700680272,0.83,99.45
2022-04-07,Haryana,1089,14,1085,13436,4004,3817,8.11,0,29.4,678845,5664,675109,13.62,12.98,0.45700680272108846,0.83,99.45
2022-04-08,Haryana,539,5,539,6627,2260,2208,8.13,0,29.4,679384,5669,675648,7.69,7.51,0.22540816326530613,0.83,99.45
2022-04-09,Haryana,638,9,629,8309,2895,1812,7.68,0,29.4,680022,5678,676277,9.85,6.16,0.2826190476190476,0.83,99.45
2022-04-10,Haryana,434,4,432,5473,737,699,7.93,0,29.4,680456,5682,676709,2.51,2.38,0.18615646258503402,0.84,99.45
2022-04-11,Haryana,829,10,825,10086,1209,1171,8.22,0,29.4,681285,5692,677534,4.11,3.98,0.3430612244897959,0.84,99.45
2022-04-12,Haryana,1122,5,1119,14215,4491,1845,7.89,0,29.4,682407,5697,678653,15.28,6.28,0.4835034013605442,0.83,99.45
2022-04-13,Haryana,1155,4,1148,14486,3281,1977,7.97,3,29.4,683562,5701,679801,11.16,6.72,0.49272108843537415,0.83,99.45
2022-04-14,Haryana,1425,8,1422,17895,3616,651,7.96,0,29.4,684987,5709,681223,12.3,2.21,0.6086734693877551,0.83,99.45
2022-04-15,Haryana,218,1,211,2914,3051,2624,7.48,6,29.4,685205,5710,681434,10.38,8.93,0.0991156462585034,0.83,99.45
2022-04-16,Haryana,385,4,384,4806,1132,447,8.01,0,29.4,685590,5714,681818,3.85,1.52,0.16346938775510203,0.83,99.45
2022-04-17,Haryana,1059,12,1056,12990,1814,1230,8.15,0,29.4,686649,5726,682874,6.17,4.18,0.4418367346938776,0.83,99.45
2022-04-18,Haryana,1300,14,1291,16331,2127,755,7.96,0,29.4,687949,5740,684165,7.23,2.57,0.5554761904761905,0.83,99.45
2022-04-19,Haryana,1437,16,1436,18386,3215,2280,7.82,0,29.4,689386,5756,685601,10.94,7.76,0.6253741496598639,0.83,99.45
2022-04-20,Haryana,1210,15,1207,15177,3347,388,7.97,0,29.4,690596,5771,686808,11.38,1.32,0.5162244897959184,0.84,99.45
2022-04-21,Haryana,1010,9,1001,12406,4495,1911,8.14,0,29.4,691606,5780,687809,15.29,6.5,0.4219727891156463,0.84,99.45
2022-04-22,Haryana,1376,13,1373,17279,1956,1818,7.96,0,29.4,692982,5793,689182,6.65,6.18,0.5877210884353742,0.84,99.45
2022-04-23,Haryana,1419,12,1411,17579,3557,673,8.07,0,29.4,694401,5805,690593,12.1,2.29,0.5979251700680273,0.84,99.45
2022-04-24,Haryana,358,2,351,4426,937,859,8.09,5,29.4,694759,5807,690944,3.19,2.92,0.15054421768707482,0.84,99.45
2022-04-25,Haryana,567,7,559,6667,1653,1342,8.5,1,29.4,695326,5814,691503,5.62,4.56,0.2267687074829932,0.84,99.45
2022-04-26,Haryana,302,4,302,4007,4678,4067,7.54,0,29.4,695628,5818,691805,15.91,13.83,0.13629251700680273,0.84,99.45
2022-04-27,Haryana,317,3,311,4253,2045,436,7.45,3,29.4,695945,5821,692116,6.96,1.48,0.14465986394557823,0.84,99.45
2022-04-28,Haryana,644,4,642,7958,3539,1182,8.09,0,29.4,696589,5825,692758,12.04,4.02,0.27068027210884354,0.84,99.45
2022-04-29,Haryana,716,4,709,9473,2436,2199,7.56,3,29.4,697305,5829,693467,8.29,7.48,0.3222108843537415,0.84,99.45
2022-04-30,Haryana,467,2,460,6050,892,47,7.72,5,29.4,697772,5831,693927,3.03,0.16,0.20578231292517007,0.84,99.45
2022-05-01,Haryana,560,6,559,7279,1945,202,7.69,0,29.4,698332,5837,694486,6.62,0.69,0.24758503401360543,0.84,99.45
2022-05-02,Haryana,201,1,193,2735,2947,1353,7.35,7,29.4,698533,5838,694679,10.02,4.6,0.09302721088435374,0.84,99.45
2022-05-03,Haryana,1386,8,1383,16988,3313,2118,8.16,0,29.4,699919,5846,696062,11.27,7.2,0.5778231292517007,0.84,99.45
2022-05-04,Haryana,893,9,893,11392,3200,583,7.84,0,29.4,700812,5855,696955,10.88,1.98,0.3874829931972789,0.84,99.45
2022-05-05,Haryana,1287,7,1283,15739,4782,3296,8.18,0,29.4,702099,5862,698238,16.27,11.21,0.5353401360544218,0.83,99.45
2022-05-06,Haryana,443,6,443,5241,3518,2561,8.45,0,29.4,702542,5868,698681,11.97,8.71,0.17826530612244898,0.84,99.45
2022-05-07,Haryana,1092,14,1089,13843,3591,2906,7.89,0,29.4,703634,5882,699770,12.21,9.88,0.4708503401360544,0.84,99.45
2022-05-08,Haryana,522,4,518,6717,3880,898,7.77,0,29.4,704156,5886,700288,13.2,3.05,0.22846938775510203,0.84,99.45
2022-05-09,Haryana,1562,13,1554,19331,2625,2343,8.08,0,29.4,705718,5899,701842,8.93,7.97,0.6575170068027211,0.84,99.45
2022-05-10,Haryana,422,2,415,4543,2789,1591,9.29,5,29.4,706140,5901,702257,9.49,5.41,0.15452380952380954,0.84,99.45
2022-05-11,Haryana,555,3,549,7040,3852,3053,7.88,3,29.4,706695,5904,702806,13.1,10.38,0.23945578231292516,0.84,99.45
2022-05-12,Haryana,602,2,595,7154,1858,1157,8.41,5,29.4,707297,5906,703401,6.32,3.94,0.24333333333333335,0.84,99.45
2022-05-13,Haryana,1439,20,1439,17752,1371,680,8.11,0,29.4,708736,5926,704840,4.66,2.31,0.6038095238095238,0.84,99.45
2022-05-14,Haryana,1504,19,1497,18942,426,291,7.94,0,29.4,710240,5945,706337,1.45,0.99,0.6442857142857142,0.84,99.45
2022-05-15,Haryana,948,11,948,12014,4086,3498,7.89,0,29.4,711188,5956,707285,13.9,11.9,0.4086394557823129,0.84,99.45
2022-05-16,Haryana,606,3,600,7737,1117,354,7.83,3,29.4,711794,5959,707885,3.8,1.2,0.26316326530612244,0.84,99.45
2022-05-17,Haryana,721,9,713,9244,69,31,7.8,0,29.4,712515,5968,708598,0.23,0.11,0.314421768707483,0.84,99.45
2022-05-18,Haryana,507,6,500,6253,1495,1454,8.11,1,29.4,713022,5974,709098,5.09,4.95,0.21268707482993196,0.84,99.45
2022-05-19,Haryana,1576,12,1568,19769,33,32,7.97,0,29.4,714598,5986,710666,0.11,0.11,0.6724149659863946,0.84,99.45
2022-05-20,Haryana,494,2,490,6294,4196,2581,7.85,2,29.4,715092,5988,711156,14.27,8.78,0.21408163265306124,0.84,99.45
2022-05-21,Haryana,560,6,559,6882,4310,3363,8.14,0,29.4,715652,5994,711715,14.66,11.44,0.23408163265306123,0.84,99.45
2022-05-22,Haryana,1177,16,1170,15165,651,421,7.76,0,29.4,716829,6010,712885,2.21,1.43,0.5158163265306123,0.84,99.45
2022-05-23,Haryana,551,5,551,6579,3886,1671,8.38,0,29.4,717380,6015,713436,13.22,5.68,0.22377551020408162,0.84,99.45
2022-05-24,Haryana,137,0,132,1594,4466,2170,8.59,5,29.4,717517,6015,713568,15.19,7.38,0.054217687074829934,0.84,99.45
2022-05-25,Haryana,575,6,568,7155,1972,131,8.04,1,29.4,718092,6021,714136,6.71,0.45,0.24336734693877551,0.84,99.45
2022-05-26,Haryana,1059,10,1051,12961,1869,890,8.17,0,29.4,719151,6031,715187,6.36,3.03,0.4408503401360544,0.84,99.45
2022-05-27,Haryana,579,4,577,7058,3886,1174,8.2,0,29.4,719730,6035,715764,13.22,3.99,0.24006802721088435,0.84,99.45
2022-05-28,Haryana,318,4,313,4211,4090,1439,7.55,1,29.4,720048,6039,716077,13.91,4.89,0.1432312925170068,0.84,99.45
2022-05-29,Haryana,378,2,370,4352,1729,1589,8.69,6,29.4,720426,6041,716447,5.88,5.4,0.14802721088435375,0.84,99.45
2022-05-30,Haryana,1342,13,1340,17038,1547,576,7.88,0,29.4,721768,6054,717787,5.26,1.96,0.5795238095238096,0.84,99.45
2022-05-31,Haryana,1096,15,1096,13583,2786,14,8.07,0,29.4,722864,6069,718883,9.48,0.05,0.46200680272108846,0.84,99.45
2022-06-01,Haryana,1233,6,1231,15483,3685,430,7.96,0,29.4,724097,6075,720114,12.53,1.46,0.5266326530612245,0.84,99.45
2022-06-02,Haryana,1210,15,1201,14920,707,370,8.11,0,29.4,725307,6090,721315,2.4,1.26,0.507482993197279,0.84,99.45
2022-06-03,Haryana,1040,10,1033,13127,615,366,7.92,0,29.4,726347,6100,722348,2.09,1.24,0.4464965986394558,0.84,99.45
2022-06-04,Haryana,837,8,834,10632,3238,1690,7.87,0,29.4,727184,6108,723182,11.01,5.75,0.3616326530612245,0.84,99.45
2022-06-05,Haryana,373,2,364,4286,3762,1544,8.7,7,29.4,727557,6110,723546,12.8,5.25,0.14578231292517008,0.84,99.45
2022-06-06,Haryana,115,0,112,1597,4497,2893,7.2,3,29.4,727672,6110,723658,15.3,9.84,0.05431972789115646,0.84,99.45
2022-06-07,Haryana,668,8,660,8057,1704,83,8.29,0,29.4,728340,6118,724318,5.8,0.28,0.27404761904761904,0.84,99.45
2022-06-08,Haryana,787,6,786,9803,4763,2332,8.03,0,29.4,729127,6124,725104,16.2,7.93,0.33343537414965985,0.84,99.45
2022-06-09,Haryana,224,3,221,2868,4262,3646,7.81,0,29.4,729351,6127,725325,14.5,12.4,0.09755102040816327,0.84,99.45
2022-06-10,Haryana,319,3,319,3675,1796,296,8.68,0,29.4,729670,6130,725644,6.11,1.01,0.125,0.84,99.45
2022-06-11,Haryana,978,5,977,12178,338,19,8.03,0,29.4,730648,6135,726621,1.15,0.06,0.4142176870748299,0.84,99.45
2022-06-12,Haryana,720,10,720,8787,1106,288,8.19,0,29.4,731368,6145,727341,3.76,0.98,0.29887755102040814,0.84,99.45
2022-06-13,Haryana,1545,21,1540,19285,3359,2871,8.01,0,29.4,732913,6166,728881,11.43,9.77,0.655952380952381,0.84,99.45
2022-06-14,Haryana,1251,14,1251,15691,1073,142,7.97,0,29.4,734164,6180,730132,3.65,0.48,0.5337074829931973,0.84,99.45
2022-06-15,Haryana,1061,12,1058,12791,941,336,8.29,0,29.4,735225,6192,731190,3.2,1.14,0.43506802721088433,0.84,99.45
2022-06-16,Haryana,1312,17,1309,16463,4562,3552,7.97,0,29.4,736537,6209,732499,15.52,12.08,0.5599659863945579,0.84,99.45
2022-06-17,Haryana,1026,8,1025,12720,4643,3533,8.07,0,29.4,737563,6217,733524,15.79,12.02,0.4326530612244898,0.84,99.45
2022-06-18,Haryana,1330,15,1323,16646,4814,1197,7.99,0,29.4,738893,6232,734847,16.37,4.07,0.5661904761904762,0.84,99.45
2022-06-19,Haryana,1246,4,1245,15841,2267,1738,7.87,0,29.4,740139,6236,736092,7.71,5.91,0.5388095238095238,0.84,99.45
2022-06-20,Haryana,542,2,535,6893,587,223,7.86,5,29.4,740681,6238,736627,2.0,0.76,0.23445578231292516,0.84,99.45
2022-06-21,Haryana,946,12,940,11710,1964,299,8.08,0,29.4,741627,6250,737567,6.68,1.02,0.3982993197278912,0.84,99.45
2022-06-22,Haryana,1587,20,1578,19969,461,6,7.95,0,29.4,743214,6270,739145,1.57,0.02,0.6792176870748299,0.84,99.45
2022-06-23,Haryana,867,10,860,10644,2725,2450,8.15,0,29.4,744081,6280,740005,9.27,8.33,0.3620408163265306,0.84,99.45
2022-06-24,Haryana,1509,13,1503,19273,1444,905,7.83,0,29.4,745590,6293,741508,4.91,3.08,0.6555442176870748,0.84,99.45
2022-06-25,Haryana,703,5,696,8716,4736,1372,8.07,2,29.4,746293,6298,742204,16.11,4.67,0.2964625850340136,0.84,99.45
2022-06-26,Haryana,1212,13,1212,15470,1025,73,7.83,0,29.4,747505,6311,743416,3.49,0.25,0.5261904761904762,0.84,99.45
2022-06-27,Haryana,1199,17,1197,14528,1785,1735,8.25,0,29.4,748704,6328,744613,6.07,5.9,0.4941496598639456,0.85,99.45
2022-06-28,Haryana,1352,10,1352,16592,3935,161,8.15,0,29.4,750056,6338,745965,13.38,0.55,0.5643537414965987,0.85,99.45
2022-06-29,Haryana,993,10,989,12226,4996,1254,8.12,0,29.4,751049,6348,746954,16.99,4.27,0.41585034013605443,0.85,99.45
2022-06-30,Haryana,1209,12,1207,15259,1045,532,7.92,0,29.4,752258,6360,748161,3.55,1.81,0.5190136054421769,0.85,99.46
2022-07-01,Haryana,1319,9,1312,16716,8,3,7.89,0,29.4,753577,6369,749473,0.03,0.01,0.5685714285714286,0.85,99.46
2022-07-02,Haryana,819,7,817,10385,1613,1170,7.89,0,29.4,754396,6376,750290,5.49,3.98,0.3532312925170068,0.85,99.46
2022-07-03,Haryana,976,4,972,11841,4059,4043,8.24,0,29.4,755372,6380,751262,13.81,13.75,0.4027551020408163,0.84,99.46
2022-07-04,Haryana,170,0,164,1897,1634,1094,8.96,6,29.4,755542,6380,751426,5.56,3.72,0.06452380952380952,0.84,99.46
2022-07-05,Haryana,1341,5,1337,17415,1870,5,7.7,0,29.4,756883,6385,752763,6.36,0.02,0.5923469387755103,0.84,99.46
2022-07-06,Haryana,1189,3,1186,14915,4765,1288,7.97,0,29.4,758072,6388,753949,16.21,4.38,0.507312925170068,0.84,99.46
2022-07-07,Haryana,234,3,230,3231,3524,1200,7.24,1,29.4,758306,6391,754179,11.99,4.08,0.10989795918367347,0.84,99.46
2022-07-08,Haryana,793,5,784,9605,1269,810,8.26,4,29.4,759099,6396,754963,4.32,2.76,0.32670068027210886,0.84,99.46
2022-07-09,Haryana,401,3,401,4993,762,434,8.03,0,29.4,759500,6399,755364,2.59,1.48,0.16982993197278912,0.84,99.46
2022-07-10,Haryana,988,3,985,12186,2891,757,8.11,0,29.4,760488,6402,756349,9.83,2.57,0.4144897959183673,0.84,99.46
2022-07-11,Haryana,267,4,262,3008,3783,1919,8.88,1,29.4,760755,6406,756611,12.87,6.53,0.10231292517006803,0.84,99.46
2022-07-12,Haryana,420,5,411,5006,3139,1624,8.39,4,29.4,761175,6411,757022,10.68,5.52,0.1702721088435374,0.84,99.45
2022-07-13,Haryana,225,2,216,3332,2625,1667,6.75,7,29.4,761400,6413,757238,8.93,5.67,0.11333333333333333,0.84,99.45
2022-07-14,Haryana,643,8,637,8132,612,19,7.91,0,29.4,762043,6421,757875,2.08,0.06,0.27659863945578234,0.84,99.45
2022-07-15,Haryana,1044,7,1044,12849,1161,1089,8.13,0,29.4,763087,6428,758919,3.95,3.7,0.43704081632653063,0.84,99.45
2022-07-16,Haryana,674,9,667,8283,545,125,8.14,0,29.4,763761,6437,759586,1.85,0.43,0.281734693877551,0.84,99.45
2022-07-17,Haryana,1218,14,1212,15762,3091,819,7.73,0,29.4,764979,6451,760798,10.51,2.79,0.5361224489795918,0.84,99.45
2022-07-18,Haryana,171,1,164,1871,2056,90,9.14,6,29.4,765150,6452,760962,6.99,0.31,0.06363945578231292,0.84,99.45
2022-07-19,Haryana,1132,11,1130,13662,2853,438,8.29,0,29.4,766282,6463,762092,9.7,1.49,0.46469387755102043,0.84,99.45
2022-07-20,Haryana,1126,9,1121,14217,3793,1664,7.92,0,29.4,767408,6472,763213,12.9,5.66,0.4835714285714286,0.84,99.45
2022-07-21,Haryana,1518,12,1509,18577,115,114,8.17,0,29.4,768926,6484,764722,0.39,0.39,0.6318707482993198,0.84,99.45
2022-07-22,Haryana,1234,16,1228,15295,2986,2723,8.07,0,29.4,770160,6500,765950,10.16,9.26,0.5202380952380953,0.84,99.45
2022-07-23,Haryana,1200,3,1196,14674,3482,1512,8.18,1,29.4,771360,6503,767146,11.84,5.14,0.4991156462585034,0.84,99.45
2022-07-24,Haryana,544,3,539,6906,1127,814,7.88,2,29.4,771904,6506,767685,3.83,2.77,0.23489795918367348,0.84,99.45
2022-07-25,Haryana,644,7,637,8021,3629,152,8.03,0,29.4,772548,6513,768322,12.34,0.52,0.27282312925170066,0.84,99.45
2022-07-26,Haryana,1536,14,1533,19223,3917,2644,7.99,0,29.4,774084,6527,769855,13.32,8.99,0.653843537414966,0.84,99.45
2022-07-27,Haryana,1116,7,1113,13892,3494,494,8.03,0,29.4,775200,6534,770968,11.88,1.68,0.4725170068027211,0.84,99.45
2022-07-28,Haryana,710,8,709,8893,3107,2585,7.98,0,29.4,775910,6542,771677,10.57,8.79,0.3024829931972789,0.84,99.45
2022-07-29,Haryana,780,6,778,10108,2985,2439,7.72,0,29.4,776690,6548,772455,10.15,8.3,0.3438095238095238,0.84,99.45
2022-07-30,Haryana,1112,11,1107,13952,4721,3579,7.97,0,29.4,777802,6559,773562,16.06,12.17,0.4745578231292517,0.84,99.45
2022-07-31,Haryana,829,5,829,10047,3054,1851,8.25,0,29.4,778631,6564,774391,10.39,6.3,0.341734693877551,0.84,99.46
2022-08-01,Haryana,953,13,951,12076,2957,1999,7.89,0,29.4,779584,6577,775342,10.06,6.8,0.4107482993197279,0.84,99.46
2022-08-02,Haryana,78,0,71,810,634,483,9.63,7,29.4,779662,6577,775413,2.16,1.64,0.027551020408163266,0.84,99.46
2022-08-03,Haryana,1418,8,1415,17736,1288,484,8.0,0,29.4,781080,6585,776828,4.38,1.65,0.603265306122449,0.84,99.46
2022-08-04,Haryana,1411,16,1404,17645,4741,2488,8.0,0,29.4,782491,6601,778232,16.13,8.46,0.6001700680272108,0.84,99.46
2022-08-05,Haryana,949,8,943,11463,4662,2166,8.28,0,29.4,783440,6609,779175,15.86,7.37,0.3898979591836735,0.84,99.46
2022-08-06,Haryana,386,5,379,4848,1672,386,7.96,2,29.4,783826,6614,779554,5.69,1.31,0.16489795918367348,0.84,99.45
2022-08-07,Haryana,110,1,109,1511,4792,844,7.28,0,29.4,783936,6615,779663,16.3,2.87,0.05139455782312925,0.84,99.45
2022-08-08,Haryana,1013,12,1011,12302,615,202,8.23,0,29.4,784949,6627,780674,2.09,0.69,0.41843537414965987,0.84,99.46
2022-08-09,Haryana,872,4,866,10877,2733,60,8.02,2,29.4,785821,6631,781540,9.3,0.2,0.3699659863945578,0.84,99.46
2022-08-10,Haryana,672,7,664,8467,1787,607,7.94,1,29.4,786493,6638,782204,6.08,2.06,0.28799319727891154,0.84,99.45
2022-08-11,Haryana,690,6,687,8144,1835,53,8.47,0,29.4,787183,6644,782891,6.24,0.18,0.2770068027210884,0.84,99.45
2022-08-12,Haryana,469,6,468,5977,502,170,7.85,0,29.4,787652,6650,783359,1.71,0.58,0.20329931972789117,0.84,99.45
2022-08-13,Haryana,287,4,278,3765,1583,1540,7.62,5,29.4,787939,6654,783637,5.38,5.24,0.12806122448979593,0.84,99.45
2022-08-14,Haryana,822,3,814,10230,1309,882,8.04,5,29.4,788761,6657,784451,4.45,3.0,0.3479591836734694,0.84,99.45
2022-08-15,Haryana,1444,13,1435,17584,1037,1010,8.21,0,29.4,790205,6670,785886,3.53,3.44,0.5980952380952381,0.84,99.45
2022-08-16,Haryana,498,1,496,6021,1894,432,8.27,1,29.4,790703,6671,786382,6.44,1.47,0.20479591836734695,0.84,99.45
2022-08-17,Haryana,929,12,920,11210,4151,3426,8.29,0,29.4,791632,6683,787302,14.12,11.65,0.3812925170068027,0.84,99.45
2022-08-18,Haryana,947,9,941,11837,1993,1500,8.0,0,29.4,792579,6692,788243,6.78,5.1,0.4026190476190476,0.84,99.45
2022-08-19,Haryana,657,2,655,8075,2324,708,8.14,0,29.4,793236,6694,788898,7.9,2.41,0.27465986394557823,0.84,99.45
2022-08-20,Haryana,1107,15,1098,13939,2186,2056,7.94,0,29.4,794343,6709,789996,7.44,6.99,0.4741156462585034,0.84,99.45
2022-08-21,Haryana,464,6,463,5868,2455,44,7.91,0,29.4,794807,6715,790459,8.35,0.15,0.19959183673469388,0.84,99.45
2022-08-22,Haryana,122,1,116,1576,4763,3042,7.74,5,29.4,794929,6716,790575,16.2,10.35,0.05360544217687075,0.84,99.45
2022-08-23,Haryana,1051,4,1045,13304,4715,4142,7.9,2,29.4,795980,6720,791620,16.04,14.09,0.4525170068027211,0.84,99.45
2022-08-24,Haryana,548,5,542,6937,907,533,7.9,1,29.4,796528,6725,792162,3.09,1.81,0.23595238095238094,0.84,99.45
2022-08-25,Haryana,890,7,884,11387,1931,1778,7.82,0,29.4,797418,6732,793046,6.57,6.05,0.38731292517006805,0.84,99.45
2022-08-26,Haryana,982,9,981,12726,2594,80,7.72,0,29.4,798400,6741,794027,8.82,0.27,0.4328571428571429,0.84,99.45
2022-08-27,Haryana,782,3,779,10127,4592,3910,7.72,0,29.4,799182,6744,794806,15.62,13.3,0.3444557823129252,0.84,99.45
2022-08-28,Haryana,542,4,538,6909,1680,64,7.84,0,29.4,799724,6748,795344,5.71,0.22,0.235,0.84,99.45
2022-08-29,Haryana,694,9,685,8346,469,344,8.32,0,29.4,800418,6757,796029,1.6,1.17,0.2838775510204082,0.84,99.45
2022-08-30,Haryana,271,1,270,3475,3240,1272,7.8,0,29.4,800689,6758,796299,11.02,4.33,0.11819727891156463,0.84,99.45
2022-08-31,Haryana,67,0,58,1057,586,55,6.34,9,29.4,800756,6758,796357,1.99,0.19,0.03595238095238095,0.84,99.45
2022-09-01,Haryana,628,5,626,7551,3613,598,8.32,0,29.4,801384,6763,796983,12.29,2.03,0.2568367346938776,0.84,99.45
2022-09-02,Haryana,198,1,197,2591,4727,1147,7.64,0,29.4,801582,6764,797180,16.08,3.9,0.08812925170068027,0.84,99.45
2022-09-03,Haryana,964,2,959,12234,2146,374,7.88,3,29.4,802546,6766,798139,7.3,1.27,0.41612244897959183,0.84,99.45
2022-09-04,Haryana,788,4,784,9808,4659,556,8.03,0,29.4,803334,6770,798923,15.85,1.89,0.33360544217687077,0.84,99.45
2022-09-05,Haryana,1201,14,1194,14582,3180,1769,8.24,0,29.4,804535,6784,800117,10.82,6.02,0.4959863945578231,0.84,99.45
2022-09-06,Haryana,1209,4,1208,15438,4459,2134,7.83,0,29.4,805744,6788,801325,15.17,7.26,0.5251020408163265,0.84,99.45
2022-09-07,Haryana,527,7,523,6270,656,172,8.41,0,29.4,806271,6795,801848,2.23,0.59,0.21326530612244898,0.84,99.45
2022-09-08,Haryana,1490,18,1488,18155,2622,1214,8.21,0,29.4,807761,6813,803336,8.92,4.13,0.617517006802721,0.84,99.45
2022-09-09,Haryana,274,2,274,3649,2021,516,7.51,0,29.4,808035,6815,803610,6.87,1.76,0.1241156462585034,0.84,99.45
2022-09-10,Haryana,699,3,696,8820,2954,1970,7.93,0,29.4,808734,6818,804306,10.05,6.7,0.3,0.84,99.45
2022-09-11,Haryana,1314,19,1312,16347,3071,2023,8.04,0,29.4,810048,6837,805618,10.45,6.88,0.5560204081632653,0.84,99.45
2022-09-12,Haryana,420,5,414,5605,520,122,7.49,1,29.4,810468,6842,806032,1.77,0.41,0.19064625850340136,0.84,99.45
2022-09-13,Haryana,1198,6,1195,14707,3765,81,8.15,0,29.4,811666,6848,807227,12.81,0.28,0.5002380952380953,0.84,99.45
2022-09-14,Haryana,526,4,525,6828,2716,346,7.7,0,29.4,812192,6852,807752,9.24,1.18,0.23224489795918368,0.84,99.45
2022-09-15,Haryana,91,0,91,1331,3852,2668,6.84,0,29.4,812283,6852,807843,13.1,9.07,0.04527210884353741,0.84,99.45
2022-09-16,Haryana,528,6,527,6645,60,57,7.95,0,29.4,812811,6858,808370,0.2,0.19,0.2260204081632653,0.84,99.45
2022-09-17,Haryana,1344,17,1344,16654,1082,840,8.07,0,29.4,814155,6875,809714,3.68,2.86,0.5664625850340136,0.84,99.45
2022-09-18,Haryana,63,0,63,1357,1504,1301,4.64,0,29.4,814218,6875,809777,5.12,4.43,0.04615646258503402,0.84,99.45
2022-09-19,Haryana,721,5,716,8952,4809,1904,8.05,0,29.4,814939,6880,810493,16.36,6.48,0.30448979591836733,0.84,99.45
2022-09-20,Haryana,753,6,750,9389,1001,645,8.02,0,29.4,815692,6886,811243,3.4,2.19,0.3193537414965986,0.84,99.45
2022-09-21,Haryana,484,2,481,6170,1918,1510,7.84,1,29.4,816176,6888,811724,6.52,5.14,0.2098639455782313,0.84,99.45
2022-09-22,Haryana,381,5,380,5251,1380,93,7.26,0,29.4,816557,6893,812104,4.69,0.32,0.17860544217687074,0.84,99.45
2022-09-23,Haryana,657,3,656,8178,4074,1211,8.03,0,29.4,817214,6896,812760,13.86,4.12,0.27816326530612245,0.84,99.45
2022-09-24,Haryana,627,2,621,7933,1426,55,7.9,4,29.4,817841,6898,813381,4.85,0.19,0.2698299319727891,0.84,99.45
2022-09-25,Haryana,488,4,487,6020,1985,1315,8.11,0,29.4,818329,6902,813868,6.75,4.47,0.20476190476190476,0.84,99.45
2022-09-26,Haryana,393,5,390,5155,2149,1940,7.62,0,29.4,818722,6907,814258,7.31,6.6,0.17534013605442178,0.84,99.45
2022-09-27,Haryana,293,3,291,3781,1112,730,7.75,0,29.4,819015,6910,814549,3.78,2.48,0.12860544217687075,0.84,99.45
2022-09-28,Haryana,774,8,771,10152,1688,1657,7.62,0,29.4,819789,6918,815320,5.74,5.64,0.34530612244897957,0.84,99.45
2022-09-29,Haryana,470,2,463,6644,4106,2352,7.07,5,29.4,820259,6920,815783,13.97,8.0,0.22598639455782313,0.84,99.45
2022-09-30,Haryana,1233,4,1226,15636,4441,2915,7.89,3,29.4,821492,6924,817009,15.11,9.91,0.5318367346938776,0.84,99.45
2022-10-01,Haryana,1353,5,1350,17080,4938,2120,7.92,0,29.4,822845,6929,818359,16.8,7.21,0.580952380952381,0.84,99.45
2022-10-02,Haryana,809,8,805,9733,719,178,8.31,0,29.4,823654,6937,819164,2.45,0.61,0.3310544217687075,0.84,99.45
2022-10-03,Haryana,1181,6,1174,15011,3397,2335,7.87,1,29.4,824835,6943,820338,11.55,7.94,0.510578231292517,0.84,99.45
2022-10-04,Haryana,133,1,133,2171,404,234,6.13,0,29.4,824968,6944,820471,1.37,0.8,0.07384353741496599,0.84,99.45
2022-10-05,Haryana,841,6,838,10229,3666,658,8.22,0,29.4,825809,6950,821309,12.47,2.24,0.3479251700680272,0.84,99.46
2022-10-06,Haryana,325,2,316,4032,2810,2411,8.06,7,29.4,826134,6952,821625,9.56,8.2,0.13714285714285715,0.84,99.45
2022-10-07,Haryana,412,4,409,4951,3287,412,8.32,0,29.4,826546,6956,822034,11.18,1.4,0.1684013605442177,0.84,99.45
2022-10-08,Haryana,1395,9,1393,17265,4142,1482,8.08,0,29.4,827941,6965,823427,14.09,5.04,0.5872448979591837,0.84,99.45
2022-10-09,Haryana,651,8,646,8391,4692,2159,7.76,0,29.4,828592,6973,824073,15.96,7.34,0.2854081632653061,0.84,99.45
2022-10-10,Haryana,399,3,396,5051,27,24,7.9,0,29.4,828991,6976,824469,0.09,0.08,0.17180272108843536,0.84,99.45
2022-10-11,Haryana,748,2,748,9203,839,367,8.13,0,29.4,829739,6978,825217,2.85,1.25,0.31302721088435376,0.84,99.46
2022-10-12,Haryana,163,0,155,2148,938,739,7.59,8,29.4,829902,6978,825372,3.19,2.51,0.07306122448979592,0.84,99.45
2022-10-13,Haryana,1201,5,1196,15065,2864,194,7.97,0,29.4,831103,6983,826568,9.74,0.66,0.5124149659863946,0.84,99.45
2022-10-14,Haryana,408,2,407,5666,4086,53,7.2,0,29.4,831511,6985,826975,13.9,0.18,0.19272108843537414,0.84,99.45
2022-10-15,Haryana,744,6,736,9472,1120,571,7.85,2,29.4,832255,6991,827711,3.81,1.94,0.3221768707482993,0.84,99.45
2022-10-16,Haryana,1182,11,1177,14723,4899,3726,8.03,0,29.4,833437,7002,828888,16.66,12.67,0.5007823129251701,0.84,99.45
2022-10-17,Haryana,1494,6,1490,18691,1022,444,7.99,0,29.4,834931,7008,830378,3.48,1.51,0.6357482993197279,0.84,99.45
2022-10-18,Haryana,962,3,953,11827,3645,2863,8.13,6,29.4,835893,7011,831331,12.4,9.74,0.40227891156462586,0.84,99.45
2022-10-19,Haryana,300,1,296,3857,1388,472,7.78,3,29.4,836193,7012,831627,4.72,1.61,0.1311904761904762,0.84,99.45
2022-10-20,Haryana,1202,6,1193,14758,404,264,8.14,3,29.4,837395,7018,832820,1.37,0.9,0.5019727891156462,0.84,99.45
2022-10-21,Haryana,125,0,123,1165,2901,174,10.73,2,29.4,837520,7018,832943,9.87,0.59,0.039625850340136055,0.84,99.45
2022-10-22,Haryana,369,4,363,4508,3181,1881,8.19,2,29.4,837889,7022,833306,10.82,6.4,0.15333333333333332,0.84,99.45
2022-10-23,Haryana,518,4,515,6701,3804,1566,7.73,0,29.4,838407,7026,833821,12.94,5.33,0.2279251700680272,0.84,99.45
2022-10-24,Haryana,224,3,217,2947,4184,2305,7.6,4,29.4,838631,7029,834038,14.23,7.84,0.10023809523809524,0.84,99.45
2022-10-25,Haryana,1379,12,1378,16910,1592,1406,8.15,0,29.4,840010,7041,835416,5.41,4.78,0.5751700680272109,0.84,99.45
2022-10-26,Haryana,1300,14,1296,16153,4407,3756,8.05,0,29.4,841310,7055,836712,14.99,12.78,0.5494217687074829,0.84,99.45
2022-10-27,Haryana,772,9,766,9741,1266,191,7.93,0,29.4,842082,7064,837478,4.31,0.65,0.3313265306122449,0.84,99.45
2022-10-28,Haryana,281,2,278,3481,611,469,8.07,1,29.4,842363,7066,837756,2.08,1.6,0.11840136054421768,0.84,99.45
2022-10-29,Haryana,504,2,500,6382,1609,304,7.9,2,29.4,842867,7068,838256,5.47,1.03,0.2170748299319728,0.84,99.45
2022-10-30,Haryana,1430,11,1427,18112,1788,555,7.9,0,29.4,844297,7079,839683,6.08,1.89,0.6160544217687075,0.84,99.45
2022-10-31,Haryana,1450,15,1446,18094,2568,1753,8.01,0,29.4,845747,7094,841129,8.73,5.96,0.6154421768707483,0.84,99.45
2022-11-01,Haryana,712,3,710,9014,442,104,7.9,0,29.4,846459,7097,841839,1.5,0.35,0.3065986394557823,0.84,99.45
2022-11-02,Haryana,432,4,429,5433,4793,1946,7.95,0,29.4,846891,7101,842268,16.3,6.62,0.18479591836734693,0.84,99.45
2022-11-03,Haryana,350,4,347,4147,3721,3366,8.44,0,29.4,847241,7105,842615,12.66,11.45,0.14105442176870747,0.84,99.45
2022-11-04,Haryana,1504,15,1500,18817,940,283,7.99,0,29.4,848745,7120,844115,3.2,0.96,0.6400340136054422,0.84,99.45
2022-11-05,Haryana,1512,14,1504,18567,1947,572,8.14,0,29.4,850257,7134,845619,6.62,1.95,0.6315306122448979,0.84,99.45
2022-11-06,Haryana,553,6,544,6612,3680,175,8.36,3,29.4,850810,7140,846163,12.52,0.6,0.22489795918367347,0.84,99.45
2022-11-07,Haryana,238,2,234,2999,4601,1657,7.94,2,29.4,851048,7142,846397,15.65,5.64,0.10200680272108843,0.84,99.45
2022-11-08,Haryana,144,1,142,1902,3033,2734,7.57,1,29.4,851192,7143,846539,10.32,9.3,0.0646938775510204,0.84,99.45
2022-11-09,Haryana,1508,14,1500,18505,619,607,8.15,0,29.4,852700,7157,848039,2.11,2.06,0.629421768707483,0.84,99.45
2022-11-10,Haryana,1142,6,1142,13988,4299,2876,8.16,0,29.4,853842,7163,849181,14.62,9.78,0.4757823129251701,0.84,99.45
2022-11-11,Haryana,241,3,234,2879,3375,956,8.37,4,29.4,854083,7166,849415,11.48,3.25,0.09792517006802721,0.84,99.45
2022-11-12,Haryana,128,0,120,1826,3828,1553,7.01,8,29.4,854211,7166,849535,13.02,5.28,0.062108843537414964,0.84,99.45
2022-11-13,Haryana,78,0,78,1006,3588,2118,7.75,0,29.4,854289,7166,849613,12.2,7.2,0.03421768707482993,0.84,99.45
2022-11-14,Haryana,1143,8,1141,14284,3802,1954,8.0,0,29.4,855432,7174,850754,12.93,6.65,0.48585034013605444,0.84,99.45
2022-11-15,Haryana,378,2,378,5151,4875,1900,7.34,0,29.4,855810,7176,851132,16.58,6.46,0.17520408163265305,0.84,99.45
2022-11-16,Haryana,1257,8,1251,15806,13,7,7.95,0,29.4,857067,7184,852383,0.04,0.02,0.5376190476190477,0.84,99.45
2022-11-17,Haryana,53,0,46,652,2206,345,8.13,7,29.4,857120,7184,852429,7.5,1.17,0.02217687074829932,0.84,99.45
2022-11-18,Haryana,805,4,798,10325,4376,4334,7.8,3,29.4,857925,7188,853227,14.88,14.74,0.35119047619047616,0.84,99.45
2022-11-19,Haryana,59,0,58,786,3603,611,7.51,1,29.4,857984,7188,853285,12.26,2.08,0.026734693877551022,0.84,99.45
2022-11-20,Haryana,840,4,834,10557,4593,1729,7.96,2,29.4,858824,7192,854119,15.62,5.88,0.3590816326530612,0.84,99.45
2022-11-21,Haryana,955,12,946,11810,1524,299,8.09,0,29.4,859779,7204,855065,5.18,1.02,0.40170068027210887,0.84,99.45
2022-11-22,Haryana,1075,7,1068,13462,3789,1868,7.99,0,29.4,860854,7211,856133,12.89,6.35,0.45789115646258505,0.84,99.45
2022-11-23,Haryana,390,1,383,4886,4677,4042,7.98,6,29.4,861244,7212,856516,15.91,13.75,0.1661904761904762,0.84,99.45
2022-11-24,Haryana,62,0,57,616,1196,888,10.06,5,29.4,861306,7212,856573,4.07,3.02,0.02095238095238095,0.84,99.45
2022-11-25,Haryana,1450,13,1449,18214,4461,202,7.96,0,29.4,862756,7225,858022,15.17,0.69,0.6195238095238095,0.84,99.45
2022-11-26,Haryana,222,3,216,2960,2176,365,7.5,3,29.4,862978,7228,858238,7.4,1.24,0.10068027210884353,0.84,99.45
2022-11-27,Haryana,92,0,86,1372,1817,101,6.71,6,29.4,863070,7228,858324,6.18,0.34,0.04666666666666667,0.84,99.45
2022-11-28,Haryana,919,4,914,11263,714,416,8.16,1,29.4,863989,7232,859238,2.43,1.41,0.3830952380952381,0.84,99.45
2022-11-29,Haryana,1182,14,1177,14788,3769,1556,7.99,0,29.4,865171,7246,860415,12.82,5.29,0.5029931972789116,0.84,99.45
2022-11-30,Haryana,1264,5,1262,15626,1699,1590,8.09,0,29.4,866435,7251,861677,5.78,5.41,0.5314965986394558,0.84,99.45
2022-12-01,Haryana,189,2,181,2551,570,71,7.41,6,29.4,866624,7253,861858,1.94,0.24,0.0867687074829932,0.84,99.45
2022-12-02,Haryana,241,2,236,2693,1812,736,8.95,3,29.4,866865,7255,862094,6.16,2.5,0.09159863945578231,0.84,99.45
2022-12-03,Haryana,1109,3,1107,13688,2195,1184,8.1,0,29.4,867974,7258,863201,7.47,4.03,0.465578231292517,0.84,99.45
2022-12-04,Haryana,59,0,57,842,266,77,7.01,2,29.4,868033,7258,863258,0.9,0.26,0.028639455782312924,0.84,99.45
2022-12-05,Haryana,806,7,803,10482,2546,1805,7.69,0,29.4,868839,7265,864061,8.66,6.14,0.35653061224489796,0.84,99.45
2022-12-06,Haryana,1460,8,1460,18681,249,73,7.82,0,29.4,870299,7273,865521,0.85,0.25,0.6354081632653061,0.84,99.45
2022-12-07,Haryana,1045,13,1044,13123,689,27,7.96,0,29.4,871344,7286,866565,2.34,0.09,0.44636054421768706,0.84,99.45
2022-12-08,Haryana,297,3,289,4011,4095,860,7.4,5,29.4,871641,7289,866854,13.93,2.93,0.13642857142857143,0.84,99.45
2022-12-09,Haryana,1473,17,1470,18551,2702,845,7.94,0,29.4,873114,7306,868324,9.19,2.87,0.6309863945578231,0.84,99.45
2022-12-10,Haryana,1373,15,1365,17166,3645,1286,8.0,0,29.4,874487,7321,869689,12.4,4.37,0.5838775510204082,0.84,99.45
2022-12-11,Haryana,514,7,506,6207,610,116,8.28,1,29.4,875001,7328,870195,2.07,0.39,0.21112244897959184,0.84,99.45
2022-12-12,Haryana,49,0,40,861,134,63,5.69,9,29.4,875050,7328,870235,0.46,0.21,0.029285714285714286,0.84,99.45
2022-12-13,Haryana,835,11,833,10428,973,181,8.01,0,29.4,875885,7339,871068,3.31,0.62,0.3546938775510204,0.84,99.45
2022-12-14,Haryana,1354,14,1349,17031,2176,166,7.95,0,29.4,877239,7353,872417,7.4,0.56,0.5792857142857143,0.84,99.45
2022-12-15,Haryana,931,12,929,11962,4487,1378,7.78,0,29.4,878170,7365,873346,15.26,4.69,0.40687074829931974,0.84,99.45
2022-12-16,Haryana,226,1,224,2623,2322,1038,8.62,1,29.4,878396,7366,873570,7.9,3.53,0.08921768707482994,0.84,99.45
2022-12-17,Haryana,524,4,523,6348,197,171,8.25,0,29.4,878920,7370,874093,0.67,0.58,0.21591836734693878,0.84,99.45
2022-12-18,Haryana,1010,12,1001,12538,3721,900,8.06,0,29.4,879930,7382,875094,12.66,3.06,0.42646258503401363,0.84,99.45
2022-12-19,Haryana,1200,17,1192,15295,1537,544,7.85,0,29.4,881130,7399,876286,5.23,1.85,0.5202380952380953,0.84,99.45
2022-12-20,Haryana,1489,9,1489,18590,1519,10,8.01,0,29.4,882619,7408,877775,5.17,0.03,0.632312925170068,0.84,99.45
2022-12-21,Haryana,434,4,432,5565,4983,2263,7.8,0,29.4,883053,7412,878207,16.95,7.7,0.18928571428571428,0.84,99.45
2022-12-22,Haryana,518,6,518,6078,2583,612,8.52,0,29.4,883571,7418,878725,8.79,2.08,0.20673469387755103,0.84,99.45
2022-12-23,Haryana,943,6,939,12119,1572,562,7.78,0,29.4,884514,7424,879664,5.35,1.91,0.4122108843537415,0.84,99.45
2022-12-24,Haryana,1327,5,1319,16161,519,198,8.21,3,29.4,885841,7429,880983,1.77,0.67,0.5496938775510204,0.84,99.45
2022-12-25,Haryana,548,7,546,7322,1107,894,7.48,0,29.4,886389,7436,881529,3.77,3.04,0.24904761904761905,0.84,99.45
2022-12-26,Haryana,617,4,609,7632,1683,1601,8.08,4,29.4,887006,7440,882138,5.72,5.45,0.2595918367346939,0.84,99.45
2022-12-27,Haryana,1229,11,1224,15866,1287,975,7.75,0,29.4,888235,7451,883362,4.38,3.32,0.5396598639455782,0.84,99.45
2022-12-28,Haryana,1243,4,1234,15893,4380,4216,7.82,5,29.4,889478,7455,884596,14.9,14.34,0.540578231292517,0.84,99.45
2022-12-29,Haryana,917,2,913,10886,826,305,8.42,2,29.4,890395,7457,885509,2.81,1.04,0.3702721088435374,0.84,99.45
2022-12-30,Haryana,61,0,55,1005,3737,1593,6.07,6,29.4,890456,7457,885564,12.71,5.42,0.034183673469387756,0.84,99.45
2022-12-31,Haryana,112,0,103,1215,4606,2775,9.22,9,29.4,890568,7457,885667,15.67,9.44,0.0413265306122449,0.84,99.45
2020-01-01,Himachal Pradesh,1068,12,1064,13246,1688,766,8.06,0,7.4,1068,12,1064,22.81,10.35,1.79,1.12,99.63
2020-01-02,Himachal Pradesh,1462,5,1456,18423,1526,612,7.94,1,7.4,2530,17,2520,20.62,8.27,2.4895945945945948,0.67,99.6
2020-01-03,Himachal Pradesh,945,11,939,11549,4102,2177,8.18,0,7.4,3475,28,3459,55.43,29.42,1.5606756756756757,0.81,99.54
2020-01-04,Himachal Pradesh,1115,14,1106,14179,3892,3512,7.86,0,7.4,4590,42,4565,52.59,47.46,1.916081081081081,0.92,99.46
2020-01-05,Himachal Pradesh,663,9,655,8519,3030,1596,7.78,0,7.4,5253,51,5220,40.95,21.57,1.1512162162162163,0.97,99.37
2020-01-06,Himachal Pradesh,467,2,466,5405,1668,1611,8.64,0,7.4,5720,53,5686,22.54,21.77,0.7304054054054054,0.93,99.41
2020-01-07,Himachal Pradesh,989,10,988,12491,3562,1514,7.92,0,7.4,6709,63,6674,48.14,20.46,1.6879729729729729,0.94,99.48
2020-01-08,Himachal Pradesh,1419,15,1411,17736,2651,164,8.0,0,7.4,8128,78,8085,35.82,2.22,2.3967567567567567,0.96,99.47
2020-01-09,Himachal Pradesh,126,0,126,1246,2394,209,10.11,0,7.4,8254,78,8211,32.35,2.82,0.16837837837837838,0.94,99.48
2020-01-10,Himachal Pradesh,842,6,839,10494,1507,390,8.02,0,7.4,9096,84,9050,20.36,5.27,1.4181081081081082,0.92,99.49
2020-01-11,Himachal Pradesh,142,1,140,1924,4714,1879,7.38,1,7.4,9238,85,9190,63.7,25.39,0.26,0.92,99.48
2020-01-12,Himachal Pradesh,286,3,279,3838,1776,1142,7.45,4,7.4,9524,88,9469,24.0,15.43,0.5186486486486487,0.92,99.42
2020-01-13,Himachal Pradesh,222,2,215,2656,3619,3310,8.36,5,7.4,9746,90,9684,48.91,44.73,0.3589189189189189,0.92,99.36
2020-01-14,Himachal Pradesh,123,0,120,1612,2357,2108,7.63,3,7.4,9869,90,9804,31.85,28.49,0.21783783783783783,0.91,99.34
2020-01-15,Himachal Pradesh,1109,9,1103,14105,4071,3878,7.86,0,7.4,10978,99,10907,55.01,52.41,1.906081081081081,0.9,99.35
2020-01-16,Himachal Pradesh,1149,5,1142,14163,911,323,8.11,2,7.4,12127,104,12049,12.31,4.36,1.913918918918919,0.86,99.36
2020-01-17,Himachal Pradesh,143,1,137,1688,3409,1392,8.47,5,7.4,12270,105,12186,46.07,18.81,0.2281081081081081,0.86,99.32
2020-01-18,Himachal Pradesh,1110,14,1102,14026,4917,1377,7.91,0,7.4,13380,119,13288,66.45,18.61,1.8954054054054055,0.89,99.31
2020-01-19,Himachal Pradesh,1131,11,1124,13985,2279,1843,8.09,0,7.4,14511,130,14412,30.8,24.91,1.8898648648648648,0.9,99.32
2020-01-20,Himachal Pradesh,24,0,21,755,3486,2829,3.18,3,7.4,14535,130,14433,47.11,38.23,0.10202702702702703,0.89,99.3
2020-01-21,Himachal Pradesh,844,12,841,10399,3000,2846,8.12,0,7.4,15379,142,15274,40.54,38.46,1.4052702702702702,0.92,99.32
2020-01-22,Himachal Pradesh,466,3,463,5959,3450,22,7.82,0,7.4,15845,145,15737,46.62,0.3,0.8052702702702703,0.92,99.32
2020-01-23,Himachal Pradesh,566,3,558,7429,4509,3880,7.62,5,7.4,16411,148,16295,60.93,52.43,1.0039189189189188,0.9,99.29
2020-01-24,Himachal Pradesh,1283,6,1283,15747,4708,4600,8.15,0,7.4,17694,154,17578,63.62,62.16,2.127972972972973,0.87,99.34
2020-01-25,Himachal Pradesh,1233,7,1227,16222,2419,1416,7.6,0,7.4,18927,161,18805,32.69,19.14,2.192162162162162,0.85,99.36
2020-01-26,Himachal Pradesh,894,10,885,11101,1117,937,8.05,0,7.4,19821,171,19690,15.09,12.66,1.500135135135135,0.86,99.34
2020-01-27,Himachal Pradesh,446,6,437,5439,2083,288,8.2,3,7.4,20267,177,20127,28.15,3.89,0.735,0.87,99.31
2020-01-28,Himachal Pradesh,120,0,117,1619,542,114,7.41,3,7.4,20387,177,20244,7.32,1.54,0.2187837837837838,0.87,99.3
2020-01-29,Himachal Pradesh,1483,19,1475,18719,3340,1354,7.92,0,7.4,21870,196,21719,45.14,18.3,2.529594594594595,0.9,99.31
2020-01-30,Himachal Pradesh,193,1,190,2342,4248,227,8.24,2,7.4,22063,197,21909,57.41,3.07,0.3164864864864865,0.89,99.3
2020-01-31,Himachal Pradesh,345,2,345,4608,2406,661,7.49,0,7.4,22408,199,22254,32.51,8.93,0.6227027027027027,0.89,99.31
2020-02-01,Himachal Pradesh,1425,13,1425,18100,241,84,7.87,0,7.4,23833,212,23679,3.26,1.14,2.445945945945946,0.89,99.35
2020-02-02,Himachal Pradesh,1544,13,1542,19502,4758,3455,7.92,0,7.4,25377,225,25221,64.3,46.69,2.6354054054054052,0.89,99.39
2020-02-03,Himachal Pradesh,1067,9,1065,13226,2206,2023,8.07,0,7.4,26444,234,26286,29.81,27.34,1.7872972972972974,0.88,99.4
2020-02-04,Himachal Pradesh,998,4,995,12442,139,118,8.02,0,7.4,27442,238,27281,1.88,1.59,1.6813513513513514,0.87,99.41
2020-02-05,Himachal Pradesh,808,11,802,9909,2449,782,8.15,0,7.4,28250,249,28083,33.09,10.57,1.339054054054054,0.88,99.41
2020-02-06,Himachal Pradesh,1475,14,1474,18291,4233,1347,8.06,0,7.4,29725,263,29557,57.2,18.2,2.471756756756757,0.88,99.43
2020-02-07,Himachal Pradesh,688,6,682,8313,90,6,8.28,0,7.4,30413,269,30239,1.22,0.08,1.1233783783783784,0.88,99.43
2020-02-08,Himachal Pradesh,662,4,658,8628,1908,1361,7.67,0,7.4,31075,273,30897,25.78,18.39,1.165945945945946,0.88,99.43
2020-02-09,Himachal Pradesh,855,11,849,10512,4286,3253,8.13,0,7.4,31930,284,31746,57.92,43.96,1.4205405405405405,0.89,99.42
2020-02-10,Himachal Pradesh,1328,14,1323,16583,3476,2398,8.01,0,7.4,33258,298,33069,46.97,32.41,2.240945945945946,0.9,99.43
2020-02-11,Himachal Pradesh,375,5,372,4445,3682,2180,8.44,0,7.4,33633,303,33441,49.76,29.46,0.6006756756756757,0.9,99.43
2020-02-12,Himachal Pradesh,927,10,923,11577,2386,483,8.01,0,7.4,34560,313,34364,32.24,6.53,1.5644594594594594,0.91,99.43
2020-02-13,Himachal Pradesh,319,1,314,3631,234,140,8.79,4,7.4,34879,314,34678,3.16,1.89,0.49067567567567566,0.9,99.42
2020-02-14,Himachal Pradesh,866,3,866,10862,540,519,7.97,0,7.4,35745,317,35544,7.3,7.01,1.4678378378378378,0.89,99.44
2020-02-15,Himachal Pradesh,1164,14,1158,14542,2741,1697,8.0,0,7.4,36909,331,36702,37.04,22.93,1.9651351351351352,0.9,99.44
2020-02-16,Himachal Pradesh,318,3,318,3860,3874,2266,8.24,0,7.4,37227,334,37020,52.35,30.62,0.5216216216216216,0.9,99.44
2020-02-17,Himachal Pradesh,519,6,518,6304,3824,1120,8.23,0,7.4,37746,340,37538,51.68,15.14,0.8518918918918919,0.9,99.45
2020-02-18,Himachal Pradesh,899,7,894,11102,2323,335,8.1,0,7.4,38645,347,38432,31.39,4.53,1.5002702702702704,0.9,99.45
2020-02-19,Himachal Pradesh,1448,7,1447,18348,1604,263,7.89,0,7.4,40093,354,39879,21.68,3.55,2.4794594594594597,0.88,99.47
2020-02-20,Himachal Pradesh,181,1,173,2246,3282,1071,8.06,7,7.4,40274,355,40052,44.35,14.47,0.3035135135135135,0.88,99.45
2020-02-21,Himachal Pradesh,300,3,297,3580,2350,1991,8.38,0,7.4,40574,358,40349,31.76,26.91,0.4837837837837838,0.88,99.45
2020-02-22,Himachal Pradesh,870,6,865,11006,3343,889,7.9,0,7.4,41444,364,41214,45.18,12.01,1.4872972972972973,0.88,99.45
2020-02-23,Himachal Pradesh,56,0,47,656,521,499,8.54,9,7.4,41500,364,41261,7.04,6.74,0.08864864864864865,0.88,99.42
2020-02-24,Himachal Pradesh,619,1,610,7723,702,238,8.02,8,7.4,42119,365,41871,9.49,3.22,1.0436486486486487,0.87,99.41
2020-02-25,Himachal Pradesh,1421,9,1421,17611,454,48,8.07,0,7.4,43540,374,43292,6.14,0.65,2.379864864864865,0.86,99.43
2020-02-26,Himachal Pradesh,415,2,408,5059,4944,2969,8.2,5,7.4,43955,376,43700,66.81,40.12,0.6836486486486486,0.86,99.42
2020-02-27,Himachal Pradesh,420,1,420,5337,1525,990,7.87,0,7.4,44375,377,44120,20.61,13.38,0.7212162162162162,0.85,99.43
2020-02-28,Himachal Pradesh,645,2,638,8018,133,122,8.04,5,7.4,45020,379,44758,1.8,1.65,1.0835135135135134,0.84,99.42
2020-02-29,Himachal Pradesh,1239,13,1231,15475,1178,233,8.01,0,7.4,46259,392,45989,15.92,3.15,2.0912162162162162,0.85,99.42
2020-03-01,Himachal Pradesh,1160,8,1151,14580,4368,1579,7.96,1,7.4,47419,400,47140,59.03,21.34,1.9702702702702704,0.84,99.41
2020-03-02,Himachal Pradesh,517,7,510,6446,4803,3737,8.02,0,7.4,47936,407,47650,64.91,50.5,0.8710810810810811,0.85,99.4
2020-03-03,Himachal Pradesh,646,6,645,8052,755,264,8.02,0,7.4,48582,413,48295,10.2,3.57,1.088108108108108,0.85,99.41
2020-03-04,Himachal Pradesh,1328,13,1328,16266,834,82,8.16,0,7.4,49910,426,49623,11.27,1.11,2.198108108108108,0.85,99.42
2020-03-05,Himachal Pradesh,292,2,290,3548,3647,484,8.23,0,7.4,50202,428,49913,49.28,6.54,0.47945945945945945,0.85,99.42
2020-03-06,Himachal Pradesh,309,2,307,3963,133,10,7.8,0,7.4,50511,430,50220,1.8,0.14,0.5355405405405406,0.85,99.42
2020-03-07,Himachal Pradesh,1095,9,1089,13547,2593,2072,8.08,0,7.4,51606,439,51309,35.04,28.0,1.8306756756756757,0.85,99.42
2020-03-08,Himachal Pradesh,1316,14,1315,17003,1620,1589,7.74,0,7.4,52922,453,52624,21.89,21.47,2.297702702702703,0.86,99.44
2020-03-09,Himachal Pradesh,964,13,964,12309,635,24,7.83,0,7.4,53886,466,53588,8.58,0.32,1.6633783783783784,0.86,99.45
2020-03-10,Himachal Pradesh,841,4,835,10274,2907,2224,8.19,2,7.4,54727,470,54423,39.28,30.05,1.3883783783783783,0.86,99.44
2020-03-11,Himachal Pradesh,328,2,323,4002,1098,376,8.2,3,7.4,55055,472,54746,14.84,5.08,0.5408108108108108,0.86,99.44
2020-03-12,Himachal Pradesh,1275,10,1267,15643,2827,684,8.15,0,7.4,56330,482,56013,38.2,9.24,2.1139189189189187,0.86,99.44
2020-03-13,Himachal Pradesh,216,2,212,2708,1175,314,7.98,2,7.4,56546,484,56225,15.88,4.24,0.3659459459459459,0.86,99.43
2020-03-14,Himachal Pradesh,1499,5,1494,18706,4129,2504,8.01,0,7.4,58045,489,57719,55.8,33.84,2.5278378378378377,0.84,99.44
2020-03-15,Himachal Pradesh,1205,5,1203,14773,670,659,8.16,0,7.4,59250,494,58922,9.05,8.91,1.9963513513513513,0.83,99.45
2020-03-16,Himachal Pradesh,106,1,100,1422,3100,70,7.45,5,7.4,59356,495,59022,41.89,0.95,0.19216216216216217,0.83,99.44
2020-03-17,Himachal Pradesh,857,7,856,10245,683,392,8.37,0,7.4,60213,502,59878,9.23,5.3,1.3844594594594595,0.83,99.44
2020-03-18,Himachal Pradesh,1147,7,1143,14612,1432,463,7.85,0,7.4,61360,509,61021,19.35,6.26,1.9745945945945946,0.83,99.45
2020-03-19,Himachal Pradesh,373,2,369,4472,2854,2262,8.34,2,7.4,61733,511,61390,38.57,30.57,0.6043243243243244,0.83,99.44
2020-03-20,Himachal Pradesh,631,5,627,8204,3655,3360,7.69,0,7.4,62364,516,62017,49.39,45.41,1.1086486486486486,0.83,99.44
2020-03-21,Himachal Pradesh,1080,13,1071,13759,3324,840,7.85,0,7.4,63444,529,63088,44.92,11.35,1.8593243243243243,0.83,99.44
2020-03-22,Himachal Pradesh,988,7,981,12801,1487,785,7.72,0,7.4,64432,536,64069,20.09,10.61,1.729864864864865,0.83,99.44
2020-03-23,Himachal Pradesh,901,13,897,11326,2012,1771,7.96,0,7.4,65333,549,64966,27.19,23.93,1.5305405405405406,0.84,99.44
2020-03-24,Himachal Pradesh,1042,9,1040,12617,1427,1190,8.26,0,7.4,66375,558,66006,19.28,16.08,1.705,0.84,99.44
2020-03-25,Himachal Pradesh,212,2,208,3015,4320,3824,7.03,2,7.4,66587,560,66214,58.38,51.68,0.40743243243243243,0.84,99.44
2020-03-26,Himachal Pradesh,337,5,335,3864,632,594,8.72,0,7.4,66924,565,66549,8.54,8.03,0.5221621621621622,0.84,99.44
2020-03-27,Himachal Pradesh,1418,13,1409,17831,460,355,7.95,0,7.4,68342,578,67958,6.22,4.8,2.4095945945945947,0.85,99.44
2020-03-28,Himachal Pradesh,97,0,89,1185,4723,161,8.19,8,7.4,68439,578,68047,63.82,2.18,0.16013513513513514,0.84,99.43
2020-03-29,Himachal Pradesh,775,4,773,10258,4392,776,7.56,0,7.4,69214,582,68820,59.35,10.49,1.3862162162162162,0.84,99.43
2020-03-30,Himachal Pradesh,215,3,214,2658,2206,861,8.09,0,7.4,69429,585,69034,29.81,11.64,0.3591891891891892,0.84,99.43
2020-03-31,Himachal Pradesh,1160,6,1155,14368,4056,515,8.07,0,7.4,70589,591,70189,54.81,6.96,1.9416216216216216,0.84,99.43
2020-04-01,Himachal Pradesh,872,3,869,10915,1551,434,7.99,0,7.4,71461,594,71058,20.96,5.86,1.475,0.83,99.44
2020-04-02,Himachal Pradesh,600,7,599,7334,3679,834,8.18,0,7.4,72061,601,71657,49.72,11.27,0.9910810810810811,0.83,99.44
2020-04-03,Himachal Pradesh,1507,7,1507,19056,3567,460,7.91,0,7.4,73568,608,73164,48.2,6.22,2.575135135135135,0.83,99.45
2020-04-04,Himachal Pradesh,948,8,941,12617,3694,371,7.51,0,7.4,74516,616,74105,49.92,5.01,1.705,0.83,99.45
2020-04-05,Himachal Pradesh,1326,12,1324,16561,4060,2127,8.01,0,7.4,75842,628,75429,54.86,28.74,2.237972972972973,0.83,99.46
2020-04-06,Himachal Pradesh,234,1,229,2564,4793,6,9.13,4,7.4,76076,629,75658,64.77,0.08,0.3464864864864865,0.83,99.45
2020-04-07,Himachal Pradesh,1033,3,1032,13190,3125,2900,7.83,0,7.4,77109,632,76690,42.23,39.19,1.7824324324324323,0.82,99.46
2020-04-08,Himachal Pradesh,1518,16,1512,19505,3875,2821,7.78,0,7.4,78627,648,78202,52.36,38.12,2.6358108108108107,0.82,99.46
2020-04-09,Himachal Pradesh,213,2,213,2859,1824,1250,7.45,0,7.4,78840,650,78415,24.65,16.89,0.38635135135135135,0.82,99.46
2020-04-10,Himachal Pradesh,764,3,758,9239,4843,170,8.27,3,7.4,79604,653,79173,65.45,2.3,1.2485135135135135,0.82,99.46
2020-04-11,Himachal Pradesh,1012,4,1007,12999,4217,2048,7.79,1,7.4,80616,657,80180,56.99,27.68,1.7566216216216217,0.81,99.46
2020-04-12,Himachal Pradesh,1378,5,1370,17095,4385,696,8.06,3,7.4,81994,662,81550,59.26,9.41,2.3101351351351354,0.81,99.46
2020-04-13,Himachal Pradesh,1139,8,1136,14149,739,54,8.05,0,7.4,83133,670,82686,9.99,0.73,1.912027027027027,0.81,99.46
2020-04-14,Himachal Pradesh,325,2,316,4112,1949,1573,7.9,7,7.4,83458,672,83002,26.34,21.26,0.5556756756756757,0.81,99.45
2020-04-15,Himachal Pradesh,143,0,143,2058,1171,579,6.95,0,7.4,83601,672,83145,15.82,7.82,0.2781081081081081,0.8,99.45
2020-04-16,Himachal Pradesh,1209,14,1200,15152,2917,692,7.98,0,7.4,84810,686,84345,39.42,9.35,2.0475675675675675,0.81,99.45
2020-04-17,Himachal Pradesh,176,0,169,2036,1678,103,8.64,7,7.4,84986,686,84514,22.68,1.39,0.27513513513513516,0.81,99.44
2020-04-18,Himachal Pradesh,437,3,430,5295,2673,152,8.25,4,7.4,85423,689,84944,36.12,2.05,0.7155405405405405,0.81,99.44
2020-04-19,Himachal Pradesh,1081,5,1076,13932,1034,374,7.76,0,7.4,86504,694,86020,13.97,5.05,1.8827027027027028,0.8,99.44
2020-04-20,Himachal Pradesh,549,1,544,6958,3408,1960,7.89,4,7.4,87053,695,86564,46.05,26.49,0.9402702702702703,0.8,99.44
2020-04-21,Himachal Pradesh,110,0,108,1387,1546,464,7.93,2,7.4,87163,695,86672,20.89,6.27,0.18743243243243243,0.8,99.44
2020-04-22,Himachal Pradesh,510,2,507,6303,4517,1291,8.09,1,7.4,87673,697,87179,61.04,17.45,0.8517567567567568,0.79,99.44
2020-04-23,Himachal Pradesh,959,8,950,12105,567,228,7.92,1,7.4,88632,705,88129,7.66,3.08,1.6358108108108107,0.8,99.43
2020-04-24,Himachal Pradesh,1571,11,1564,19675,4600,1320,7.98,0,7.4,90203,716,89693,62.16,17.84,2.6587837837837838,0.79,99.43
2020-04-25,Himachal Pradesh,352,3,345,4174,4605,3499,8.43,4,7.4,90555,719,90038,62.23,47.28,0.5640540540540541,0.79,99.43
2020-04-26,Himachal Pradesh,1395,18,1395,17493,3814,2204,7.97,0,7.4,91950,737,91433,51.54,29.78,2.3639189189189187,0.8,99.44
2020-04-27,Himachal Pradesh,1387,8,1385,17118,2139,889,8.1,0,7.4,93337,745,92818,28.91,12.01,2.3132432432432433,0.8,99.44
2020-04-28,Himachal Pradesh,370,2,369,4600,1893,744,8.04,0,7.4,93707,747,93187,25.58,10.05,0.6216216216216216,0.8,99.45
2020-04-29,Himachal Pradesh,410,4,410,4971,3447,939,8.25,0,7.4,94117,751,93597,46.58,12.69,0.6717567567567567,0.8,99.45
2020-04-30,Himachal Pradesh,1136,11,1136,14307,3275,2427,7.94,0,7.4,95253,762,94733,44.26,32.8,1.9333783783783784,0.8,99.45
2020-05-01,Himachal Pradesh,832,6,824,10091,913,117,8.24,2,7.4,96085,768,95557,12.34,1.58,1.3636486486486485,0.8,99.45
2020-05-02,Himachal Pradesh,1087,4,1082,13971,4490,262,7.78,1,7.4,97172,772,96639,60.68,3.54,1.887972972972973,0.79,99.45
2020-05-03,Himachal Pradesh,1244,5,1244,15683,180,152,7.93,0,7.4,98416,777,97883,2.43,2.05,2.1193243243243245,0.79,99.46
2020-05-04,Himachal Pradesh,972,12,971,11580,2792,2563,8.39,0,7.4,99388,789,98854,37.73,34.64,1.5648648648648649,0.79,99.46
2020-05-05,Himachal Pradesh,56,0,54,927,1840,400,6.04,2,7.4,99444,789,98908,24.86,5.41,0.12527027027027027,0.79,99.46
2020-05-06,Himachal Pradesh,1319,19,1315,16745,4502,847,7.88,0,7.4,100763,808,100223,60.84,11.45,2.262837837837838,0.8,99.46
2020-05-07,Himachal Pradesh,942,4,938,11726,115,38,8.03,0,7.4,101705,812,101161,1.55,0.51,1.5845945945945945,0.8,99.47
2020-05-08,Himachal Pradesh,1348,19,1339,16926,259,55,7.96,0,7.4,103053,831,102500,3.5,0.74,2.287297297297297,0.81,99.46
2020-05-09,Himachal Pradesh,795,7,788,10041,1036,928,7.92,0,7.4,103848,838,103288,14.0,12.54,1.356891891891892,0.81,99.46
2020-05-10,Himachal Pradesh,1494,17,1491,18886,3044,153,7.91,0,7.4,105342,855,104779,41.14,2.07,2.552162162162162,0.81,99.47
2020-05-11,Himachal Pradesh,803,11,800,10384,2101,1816,7.73,0,7.4,106145,866,105579,28.39,24.54,1.4032432432432433,0.82,99.47
2020-05-12,Himachal Pradesh,1523,11,1521,19044,2890,2321,8.0,0,7.4,107668,877,107100,39.05,31.36,2.5735135135135137,0.81,99.47
2020-05-13,Himachal Pradesh,1365,14,1362,17104,242,66,7.98,0,7.4,109033,891,108462,3.27,0.89,2.3113513513513513,0.82,99.48
2020-05-14,Himachal Pradesh,86,0,79,550,1649,414,15.64,7,7.4,109119,891,108541,22.28,5.59,0.07432432432432433,0.82,99.47
2020-05-15,Himachal Pradesh,772,6,764,9462,4749,530,8.16,2,7.4,109891,897,109305,64.18,7.16,1.2786486486486486,0.82,99.47
2020-05-16,Himachal Pradesh,427,5,419,5091,433,256,8.39,3,7.4,110318,902,109724,5.85,3.46,0.687972972972973,0.82,99.46
2020-05-17,Himachal Pradesh,1277,8,1274,15758,3296,636,8.1,0,7.4,111595,910,110998,44.54,8.59,2.1294594594594596,0.82,99.47
2020-05-18,Himachal Pradesh,1310,16,1301,15925,4037,2552,8.23,0,7.4,112905,926,112299,54.55,34.49,2.152027027027027,0.82,99.46
2020-05-19,Himachal Pradesh,745,8,743,8769,4727,4207,8.5,0,7.4,113650,934,113042,63.88,56.85,1.185,0.82,99.47
2020-05-20,Himachal Pradesh,98,0,95,780,1826,240,12.56,3,7.4,113748,934,113137,24.68,3.24,0.10540540540540541,0.82,99.46
2020-05-21,Himachal Pradesh,136,0,134,1793,3163,738,7.59,2,7.4,113884,934,113271,42.74,9.97,0.2422972972972973,0.82,99.46
2020-05-22,Himachal Pradesh,1066,15,1060,13441,2999,2564,7.93,0,7.4,114950,949,114331,40.53,34.65,1.8163513513513514,0.83,99.46
2020-05-23,Himachal Pradesh,738,8,736,9412,1018,869,7.84,0,7.4,115688,957,115067,13.76,11.74,1.271891891891892,0.83,99.46
2020-05-24,Himachal Pradesh,416,4,414,4926,2027,1554,8.44,0,7.4,116104,961,115481,27.39,21.0,0.6656756756756756,0.83,99.46
2020-05-25,Himachal Pradesh,1452,17,1450,18222,279,252,7.97,0,7.4,117556,978,116931,3.77,3.41,2.4624324324324323,0.83,99.47
2020-05-26,Himachal Pradesh,913,5,912,11753,4722,3338,7.77,0,7.4,118469,983,117843,63.81,45.11,1.5882432432432432,0.83,99.47
2020-05-27,Himachal Pradesh,720,5,713,9408,3211,662,7.65,2,7.4,119189,988,118556,43.39,8.95,1.2713513513513512,0.83,99.47
2020-05-28,Himachal Pradesh,1073,9,1070,13296,3029,1619,8.07,0,7.4,120262,997,119626,40.93,21.88,1.7967567567567568,0.83,99.47
2020-05-29,Himachal Pradesh,650,2,649,8193,24,16,7.93,0,7.4,120912,999,120275,0.32,0.22,1.1071621621621621,0.83,99.47
2020-05-30,Himachal Pradesh,744,5,740,9624,173,26,7.73,0,7.4,121656,1004,121015,2.34,0.35,1.3005405405405406,0.83,99.47
2020-05-31,Himachal Pradesh,1064,4,1064,13102,558,185,8.12,0,7.4,122720,1008,122079,7.54,2.5,1.7705405405405406,0.82,99.48
2020-06-01,Himachal Pradesh,1577,19,1576,19042,3974,271,8.28,0,7.4,124297,1027,123655,53.7,3.66,2.573243243243243,0.83,99.48
2020-06-02,Himachal Pradesh,682,8,677,8794,4273,899,7.76,0,7.4,124979,1035,124332,57.74,12.15,1.1883783783783783,0.83,99.48
2020-06-03,Himachal Pradesh,252,2,243,3242,2170,405,7.77,7,7.4,125231,1037,124575,29.32,5.47,0.43810810810810813,0.83,99.48
2020-06-04,Himachal Pradesh,668,4,667,8170,3968,2174,8.18,0,7.4,125899,1041,125242,53.62,29.38,1.104054054054054,0.83,99.48
2020-06-05,Himachal Pradesh,1220,14,1218,14999,4753,1533,8.13,0,7.4,127119,1055,126460,64.23,20.72,2.026891891891892,0.83,99.48
2020-06-06,Himachal Pradesh,1230,17,1222,15169,857,205,8.11,0,7.4,128349,1072,127682,11.58,2.77,2.049864864864865,0.84,99.48
2020-06-07,Himachal Pradesh,544,6,536,6819,4849,2678,7.98,2,7.4,128893,1078,128218,65.53,36.19,0.9214864864864865,0.84,99.48
2020-06-08,Himachal Pradesh,1086,14,1078,13959,4502,359,7.78,0,7.4,129979,1092,129296,60.84,4.85,1.8863513513513515,0.84,99.47
2020-06-09,Himachal Pradesh,1109,14,1100,13673,1142,267,8.11,0,7.4,131088,1106,130396,15.43,3.61,1.8477027027027026,0.84,99.47
2020-06-10,Himachal Pradesh,264,1,257,2889,544,490,9.14,6,7.4,131352,1107,130653,7.35,6.62,0.3904054054054054,0.84,99.47
2020-06-11,Himachal Pradesh,1511,8,1506,18984,851,314,7.96,0,7.4,132863,1115,132159,11.5,4.24,2.5654054054054054,0.84,99.47
2020-06-12,Himachal Pradesh,1451,15,1448,18452,720,381,7.86,0,7.4,134314,1130,133607,9.73,5.15,2.4935135135135136,0.84,99.47
2020-06-13,Himachal Pradesh,862,5,859,10907,1938,1460,7.9,0,7.4,135176,1135,134466,26.19,19.73,1.473918918918919,0.84,99.47
2020-06-14,Himachal Pradesh,974,14,970,12464,3036,1046,7.81,0,7.4,136150,1149,135436,41.03,14.14,1.6843243243243242,0.84,99.48
2020-06-15,Himachal Pradesh,371,2,368,4346,2557,959,8.54,1,7.4,136521,1151,135804,34.55,12.96,0.5872972972972973,0.84,99.47
2020-06-16,Himachal Pradesh,1443,7,1441,18473,3599,1976,7.81,0,7.4,137964,1158,137245,48.64,26.7,2.4963513513513513,0.84,99.48
2020-06-17,Himachal Pradesh,1259,12,1253,15721,40,38,8.01,0,7.4,139223,1170,138498,0.54,0.51,2.1244594594594592,0.84,99.48
2020-06-18,Himachal Pradesh,1532,9,1529,19392,4528,1834,7.9,0,7.4,140755,1179,140027,61.19,24.78,2.6205405405405404,0.84,99.48
2020-06-19,Himachal Pradesh,245,0,243,2871,3173,1454,8.53,2,7.4,141000,1179,140270,42.88,19.65,0.38797297297297295,0.84,99.48
2020-06-20,Himachal Pradesh,553,3,551,6889,541,294,8.03,0,7.4,141553,1182,140821,7.31,3.97,0.9309459459459459,0.84,99.48
2020-06-21,Himachal Pradesh,1430,6,1429,17970,2498,1929,7.96,0,7.4,142983,1188,142250,33.76,26.07,2.4283783783783783,0.83,99.49
2020-06-22,Himachal Pradesh,375,2,371,4439,2361,794,8.45,2,7.4,143358,1190,142621,31.91,10.73,0.5998648648648649,0.83,99.49
2020-06-23,Himachal Pradesh,68,0,59,676,4659,4654,10.06,9,7.4,143426,1190,142680,62.96,62.89,0.09135135135135135,0.83,99.48
2020-06-24,Himachal Pradesh,1105,4,1096,13754,611,507,8.03,5,7.4,144531,1194,143776,8.26,6.85,1.8586486486486486,0.83,99.48
2020-06-25,Himachal Pradesh,746,6,742,9264,4724,2062,8.05,0,7.4,145277,1200,144518,63.84,27.86,1.251891891891892,0.83,99.48
2020-06-26,Himachal Pradesh,141,1,136,1902,1181,1109,7.41,4,7.4,145418,1201,144654,15.96,14.99,0.257027027027027,0.83,99.47
2020-06-27,Himachal Pradesh,751,4,746,9295,933,143,8.08,1,7.4,146169,1205,145400,12.61,1.93,1.2560810810810812,0.82,99.47
2020-06-28,Himachal Pradesh,621,2,615,7876,590,451,7.88,4,7.4,146790,1207,146015,7.97,6.09,1.0643243243243243,0.82,99.47
2020-06-29,Himachal Pradesh,70,0,64,1001,2045,543,6.99,6,7.4,146860,1207,146079,27.64,7.34,0.13527027027027028,0.82,99.47
2020-06-30,Himachal Pradesh,433,2,428,5381,619,381,8.05,3,7.4,147293,1209,146507,8.36,5.15,0.7271621621621621,0.82,99.47
2020-07-01,Himachal Pradesh,229,2,223,2897,4646,740,7.9,4,7.4,147522,1211,146730,62.78,10.0,0.3914864864864865,0.82,99.46
2020-07-02,Himachal Pradesh,837,6,837,10529,759,439,7.95,0,7.4,148359,1217,147567,10.26,5.93,1.422837837837838,0.82,99.47
2020-07-03,Himachal Pradesh,482,3,478,5418,3788,958,8.9,1,7.4,148841,1220,148045,51.19,12.95,0.7321621621621621,0.82,99.47
2020-07-04,Himachal Pradesh,654,4,649,7662,787,44,8.54,1,7.4,149495,1224,148694,10.64,0.59,1.0354054054054054,0.82,99.46
2020-07-05,Himachal Pradesh,1006,8,999,12449,1898,117,8.08,0,7.4,150501,1232,149693,25.65,1.58,1.6822972972972974,0.82,99.46
2020-07-06,Himachal Pradesh,1442,8,1435,18200,3395,280,7.92,0,7.4,151943,1240,151128,45.88,3.78,2.4594594594594597,0.82,99.46
2020-07-07,Himachal Pradesh,1581,8,1577,19688,2257,901,8.03,0,7.4,153524,1248,152705,30.5,12.18,2.6605405405405405,0.81,99.47
2020-07-08,Himachal Pradesh,1502,19,1502,19058,621,348,7.88,0,7.4,155026,1267,154207,8.39,4.7,2.575405405405405,0.82,99.47
2020-07-09,Himachal Pradesh,852,5,843,10583,2191,1991,8.05,4,7.4,155878,1272,155050,29.61,26.91,1.4301351351351352,0.82,99.47
2020-07-10,Himachal Pradesh,682,2,677,8678,1562,1352,7.86,3,7.4,156560,1274,155727,21.11,18.27,1.1727027027027026,0.81,99.47
2020-07-11,Himachal Pradesh,946,5,942,12040,3324,1323,7.86,0,7.4,157506,1279,156669,44.92,17.88,1.627027027027027,0.81,99.47
2020-07-12,Himachal Pradesh,581,8,581,7140,2993,816,8.14,0,7.4,158087,1287,157250,40.45,11.03,0.9648648648648649,0.81,99.47
2020-07-13,Himachal Pradesh,1551,8,1550,19221,4789,1347,8.07,0,7.4,159638,1295,158800,64.72,18.2,2.5974324324324325,0.81,99.48
2020-07-14,Himachal Pradesh,1200,15,1199,15009,251,27,8.0,0,7.4,160838,1310,159999,3.39,0.36,2.028243243243243,0.81,99.48
2020-07-15,Himachal Pradesh,205,0,204,2896,356,150,7.08,1,7.4,161043,1310,160203,4.81,2.03,0.39135135135135135,0.81,99.48
2020-07-16,Himachal Pradesh,915,13,909,11258,2627,2133,8.13,0,7.4,161958,1323,161112,35.5,28.82,1.5213513513513512,0.82,99.48
2020-07-17,Himachal Pradesh,76,0,72,952,2595,1237,7.98,4,7.4,162034,1323,161184,35.07,16.72,0.12864864864864864,0.82,99.48
2020-07-18,Himachal Pradesh,1146,5,1141,13968,368,258,8.2,0,7.4,163180,1328,162325,4.97,3.49,1.8875675675675676,0.81,99.48
2020-07-19,Himachal Pradesh,966,8,957,12511,1198,1028,7.72,1,7.4,164146,1336,163282,16.19,13.89,1.6906756756756758,0.81,99.47
2020-07-20,Himachal Pradesh,679,8,672,8843,4987,2513,7.68,0,7.4,164825,1344,163954,67.39,33.96,1.195,0.82,99.47
2020-07-21,Himachal Pradesh,1262,16,1253,15835,1796,1041,7.97,0,7.4,166087,1360,165207,24.27,14.07,2.139864864864865,0.82,99.47
2020-07-22,Himachal Pradesh,800,3,799,10385,2026,1921,7.7,0,7.4,166887,1363,166006,27.38,25.96,1.4033783783783784,0.82,99.47
2020-07-23,Himachal Pradesh,1452,11,1448,18234,2022,1532,7.96,0,7.4,168339,1374,167454,27.32,20.7,2.464054054054054,0.82,99.47
2020-07-24,Himachal Pradesh,364,5,362,4290,970,219,8.48,0,7.4,168703,1379,167816,13.11,2.96,0.5797297297297297,0.82,99.47
2020-07-25,Himachal Pradesh,491,5,491,5686,2579,2400,8.64,0,7.4,169194,1384,168307,34.85,32.43,0.7683783783783784,0.82,99.48
2020-07-26,Himachal Pradesh,588,3,585,7265,4194,3746,8.09,0,7.4,169782,1387,168892,56.68,50.62,0.9817567567567568,0.82,99.48
2020-07-27,Himachal Pradesh,25,0,20,653,908,888,3.83,5,7.4,169807,1387,168912,12.27,12.0,0.08824324324324324,0.82,99.47
2020-07-28,Himachal Pradesh,599,4,595,7784,3351,2796,7.7,0,7.4,170406,1391,169507,45.28,37.78,1.0518918918918918,0.82,99.47
2020-07-29,Himachal Pradesh,1044,11,1039,12762,4306,2557,8.18,0,7.4,171450,1402,170546,58.19,34.55,1.7245945945945946,0.82,99.47
2020-07-30,Himachal Pradesh,1527,22,1523,19102,3162,3057,7.99,0,7.4,172977,1424,172069,42.73,41.31,2.5813513513513513,0.82,99.48
2020-07-31,Himachal Pradesh,609,8,608,7548,1594,1191,8.07,0,7.4,173586,1432,172677,21.54,16.09,1.02,0.82,99.48
2020-08-01,Himachal Pradesh,193,2,185,2386,463,462,8.09,6,7.4,173779,1434,172862,6.26,6.24,0.3224324324324324,0.83,99.47
2020-08-02,Himachal Pradesh,1208,18,1203,15514,989,400,7.79,0,7.4,174987,1452,174065,13.36,5.41,2.0964864864864863,0.83,99.47
2020-08-03,Himachal Pradesh,759,2,757,9522,828,805,7.97,0,7.4,175746,1454,174822,11.19,10.88,1.2867567567567568,0.83,99.47
2020-08-04,Himachal Pradesh,1419,10,1419,17690,125,121,8.02,0,7.4,177165,1464,176241,1.69,1.64,2.3905405405405404,0.83,99.48
2020-08-05,Himachal Pradesh,320,1,316,3779,857,433,8.47,3,7.4,177485,1465,176557,11.58,5.85,0.5106756756756756,0.83,99.48
2020-08-06,Himachal Pradesh,1080,8,1076,13473,1009,491,8.02,0,7.4,178565,1473,177633,13.64,6.64,1.8206756756756757,0.82,99.48
2020-08-07,Himachal Pradesh,982,3,980,12228,984,718,8.03,0,7.4,179547,1476,178613,13.3,9.7,1.6524324324324324,0.82,99.48
2020-08-08,Himachal Pradesh,122,1,119,1446,3841,834,8.44,2,7.4,179669,1477,178732,51.91,11.27,0.1954054054054054,0.82,99.48
2020-08-09,Himachal Pradesh,1117,10,1115,13919,805,701,8.03,0,7.4,180786,1487,179847,10.88,9.47,1.8809459459459459,0.82,99.48
2020-08-10,Himachal Pradesh,692,2,688,9016,1054,773,7.68,2,7.4,181478,1489,180535,14.24,10.45,1.2183783783783784,0.82,99.48
2020-08-11,Himachal Pradesh,1465,15,1457,18573,4571,38,7.89,0,7.4,182943,1504,181992,61.77,0.51,2.509864864864865,0.82,99.48
2020-08-12,Himachal Pradesh,643,6,643,7641,4293,2867,8.42,0,7.4,183586,1510,182635,58.01,38.74,1.0325675675675676,0.82,99.48
2020-08-13,Himachal Pradesh,1039,8,1038,12521,23,3,8.3,0,7.4,184625,1518,183673,0.31,0.04,1.692027027027027,0.82,99.48
2020-08-14,Himachal Pradesh,884,9,883,11500,4904,4428,7.69,0,7.4,185509,1527,184556,66.27,59.84,1.554054054054054,0.82,99.49
2020-08-15,Himachal Pradesh,1386,20,1383,17114,95,83,8.1,0,7.4,186895,1547,185939,1.28,1.12,2.3127027027027025,0.83,99.49
2020-08-16,Himachal Pradesh,39,0,31,566,1472,1046,6.89,8,7.4,186934,1547,185970,19.89,14.14,0.07648648648648648,0.83,99.48
2020-08-17,Himachal Pradesh,1044,15,1038,13193,2332,194,7.91,0,7.4,187978,1562,187008,31.51,2.62,1.7828378378378378,0.83,99.48
2020-08-18,Himachal Pradesh,1067,7,1066,13671,79,18,7.8,0,7.4,189045,1569,188074,1.07,0.24,1.8474324324324325,0.83,99.49
2020-08-19,Himachal Pradesh,323,4,321,3836,1002,541,8.42,0,7.4,189368,1573,188395,13.54,7.31,0.5183783783783784,0.83,99.49
2020-08-20,Himachal Pradesh,612,7,608,7159,796,520,8.55,0,7.4,189980,1580,189003,10.76,7.03,0.9674324324324325,0.83,99.49
2020-08-21,Himachal Pradesh,1176,9,1172,14794,3446,792,7.95,0,7.4,191156,1589,190175,46.57,10.7,1.999189189189189,0.83,99.49
2020-08-22,Himachal Pradesh,703,3,699,8804,1176,225,7.99,1,7.4,191859,1592,190874,15.89,3.04,1.1897297297297298,0.83,99.49
2020-08-23,Himachal Pradesh,1137,16,1129,14387,1113,1024,7.9,0,7.4,192996,1608,192003,15.04,13.84,1.9441891891891891,0.83,99.49
2020-08-24,Himachal Pradesh,1253,17,1248,15062,2655,1420,8.32,0,7.4,194249,1625,193251,35.88,19.19,2.0354054054054056,0.84,99.49
2020-08-25,Himachal Pradesh,1315,18,1310,16808,663,425,7.82,0,7.4,195564,1643,194561,8.96,5.74,2.2713513513513512,0.84,99.49
2020-08-26,Himachal Pradesh,1564,21,1558,19270,2918,2375,8.12,0,7.4,197128,1664,196119,39.43,32.09,2.604054054054054,0.84,99.49
2020-08-27,Himachal Pradesh,882,10,882,10624,4418,942,8.3,0,7.4,198010,1674,197001,59.7,12.73,1.4356756756756757,0.85,99.49
2020-08-28,Himachal Pradesh,1111,15,1110,13708,2598,842,8.1,0,7.4,199121,1689,198111,35.11,11.38,1.8524324324324324,0.85,99.49
2020-08-29,Himachal Pradesh,1388,4,1379,17602,3090,2563,7.89,5,7.4,200509,1693,199490,41.76,34.64,2.3786486486486487,0.84,99.49
2020-08-30,Himachal Pradesh,189,0,189,2059,641,26,9.18,0,7.4,200698,1693,199679,8.66,0.35,0.27824324324324323,0.84,99.49
2020-08-31,Himachal Pradesh,364,5,358,4944,3428,910,7.36,1,7.4,201062,1698,200037,46.32,12.3,0.6681081081081081,0.84,99.49
2020-09-01,Himachal Pradesh,1121,5,1116,14462,1001,173,7.75,0,7.4,202183,1703,201153,13.53,2.34,1.9543243243243242,0.84,99.49
2020-09-02,Himachal Pradesh,681,2,680,8306,3414,1884,8.2,0,7.4,202864,1705,201833,46.14,25.46,1.1224324324324324,0.84,99.49
2020-09-03,Himachal Pradesh,1011,11,1011,12419,2012,916,8.14,0,7.4,203875,1716,202844,27.19,12.38,1.6782432432432433,0.84,99.49
2020-09-04,Himachal Pradesh,1283,14,1280,16137,3259,1272,7.95,0,7.4,205158,1730,204124,44.04,17.19,2.1806756756756758,0.84,99.5
2020-09-05,Himachal Pradesh,867,8,867,10939,3775,766,7.93,0,7.4,206025,1738,204991,51.01,10.35,1.4782432432432433,0.84,99.5
2020-09-06,Himachal Pradesh,928,3,921,11491,3337,1755,8.08,4,7.4,206953,1741,205912,45.09,23.72,1.5528378378378378,0.84,99.5
2020-09-07,Himachal Pradesh,1009,5,1002,12608,2193,779,8.0,2,7.4,207962,1746,206914,29.64,10.53,1.7037837837837837,0.84,99.5
2020-09-08,Himachal Pradesh,1050,14,1048,13098,2997,1368,8.02,0,7.4,209012,1760,207962,40.5,18.49,1.77,0.84,99.5
2020-09-09,Himachal Pradesh,190,1,182,2238,3846,1768,8.49,7,7.4,209202,1761,208144,51.97,23.89,0.30243243243243245,0.84,99.49
2020-09-10,Himachal Pradesh,130,0,130,1613,2379,1720,8.06,0,7.4,209332,1761,208274,32.15,23.24,0.21797297297297297,0.84,99.49
2020-09-11,Himachal Pradesh,15,0,10,608,3821,3573,2.47,5,7.4,209347,1761,208284,51.64,48.28,0.08216216216216216,0.84,99.49
2020-09-12,Himachal Pradesh,1050,4,1041,12896,2645,1243,8.14,5,7.4,210397,1765,209325,35.74,16.8,1.7427027027027027,0.84,99.49
2020-09-13,Himachal Pradesh,1344,19,1342,16474,4039,3480,8.16,0,7.4,211741,1784,210667,54.58,47.03,2.226216216216216,0.84,99.49
2020-09-14,Himachal Pradesh,1300,10,1294,16247,611,11,8.0,0,7.4,213041,1794,211961,8.26,0.15,2.1955405405405406,0.84,99.49
2020-09-15,Himachal Pradesh,455,5,452,6063,747,729,7.5,0,7.4,213496,1799,212413,10.09,9.85,0.8193243243243243,0.84,99.49
2020-09-16,Himachal Pradesh,1489,10,1485,18674,1075,551,7.97,0,7.4,214985,1809,213898,14.53,7.45,2.5235135135135134,0.84,99.49
2020-09-17,Himachal Pradesh,703,2,703,8773,3209,2553,8.01,0,7.4,215688,1811,214601,43.36,34.5,1.1855405405405406,0.84,99.5
2020-09-18,Himachal Pradesh,452,4,448,5603,4709,700,8.07,0,7.4,216140,1815,215049,63.64,9.46,0.7571621621621621,0.84,99.5
2020-09-19,Himachal Pradesh,581,2,577,7225,1250,526,8.04,2,7.4,216721,1817,215626,16.89,7.11,0.9763513513513513,0.84,99.49
2020-09-20,Himachal Pradesh,331,1,329,4039,2511,260,8.2,1,7.4,217052,1818,215955,33.93,3.51,0.5458108108108108,0.84,99.49
2020-09-21,Himachal Pradesh,762,8,754,9773,1116,499,7.8,0,7.4,217814,1826,216709,15.08,6.74,1.3206756756756757,0.84,99.49
2020-09-22,Himachal Pradesh,1016,3,1010,13362,370,80,7.6,3,7.4,218830,1829,217719,5.0,1.08,1.8056756756756758,0.84,99.49
2020-09-23,Himachal Pradesh,1347,5,1345,16555,3031,2091,8.14,0,7.4,220177,1834,219064,40.96,28.26,2.237162162162162,0.83,99.49
2020-09-24,Himachal Pradesh,499,1,491,6109,4014,1130,8.17,7,7.4,220676,1835,219555,54.24,15.27,0.8255405405405405,0.83,99.49
2020-09-25,Himachal Pradesh,1402,14,1394,17368,2945,1607,8.07,0,7.4,222078,1849,220949,39.8,21.72,2.347027027027027,0.83,99.49
2020-09-26,Himachal Pradesh,919,2,915,11455,4179,2464,8.02,2,7.4,222997,1851,221864,56.47,33.3,1.547972972972973,0.83,99.49
2020-09-27,Himachal Pradesh,487,6,484,6127,2125,153,7.95,0,7.4,223484,1857,222348,28.72,2.07,0.827972972972973,0.83,99.49
2020-09-28,Himachal Pradesh,1488,7,1487,19259,3051,2527,7.73,0,7.4,224972,1864,223835,41.23,34.15,2.6025675675675677,0.83,99.49
2020-09-29,Himachal Pradesh,181,0,179,2412,1544,952,7.5,2,7.4,225153,1864,224014,20.86,12.86,0.32594594594594595,0.83,99.49
2020-09-30,Himachal Pradesh,1458,5,1455,18137,1298,471,8.04,0,7.4,226611,1869,225469,17.54,6.36,2.450945945945946,0.82,99.5
2020-10-01,Himachal Pradesh,737,3,735,9226,4523,74,7.99,0,7.4,227348,1872,226204,61.12,1.0,1.2467567567567568,0.82,99.5
2020-10-02,Himachal Pradesh,1582,13,1575,19679,2736,21,8.04,0,7.4,228930,1885,227779,36.97,0.28,2.6593243243243245,0.82,99.5
2020-10-03,Himachal Pradesh,1437,10,1429,18163,424,177,7.91,0,7.4,230367,1895,229208,5.73,2.39,2.4544594594594593,0.82,99.5
2020-10-04,Himachal Pradesh,1250,6,1242,15311,2115,1544,8.16,2,7.4,231617,1901,230450,28.58,20.86,2.069054054054054,0.82,99.5
2020-10-05,Himachal Pradesh,960,12,958,11847,483,360,8.1,0,7.4,232577,1913,231408,6.53,4.86,1.6009459459459459,0.82,99.5
2020-10-06,Himachal Pradesh,693,5,693,8799,1615,1163,7.88,0,7.4,233270,1918,232101,21.82,15.72,1.189054054054054,0.82,99.5
2020-10-07,Himachal Pradesh,1015,5,1013,12521,4338,4127,8.11,0,7.4,234285,1923,233114,58.62,55.77,1.692027027027027,0.82,99.5
2020-10-08,Himachal Pradesh,432,6,423,6060,3451,304,7.13,3,7.4,234717,1929,233537,46.64,4.11,0.8189189189189189,0.82,99.5
2020-10-09,Himachal Pradesh,704,2,695,9065,224,25,7.77,7,7.4,235421,1931,234232,3.03,0.34,1.225,0.82,99.49
2020-10-10,Himachal Pradesh,390,5,388,4715,4639,2318,8.27,0,7.4,235811,1936,234620,62.69,31.32,0.6371621621621621,0.82,99.49
2020-10-11,Himachal Pradesh,279,1,275,3134,3015,1640,8.9,3,7.4,236090,1937,234895,40.74,22.16,0.4235135135135135,0.82,99.49
2020-10-12,Himachal Pradesh,822,5,816,10439,308,187,7.87,1,7.4,236912,1942,235711,4.16,2.53,1.4106756756756758,0.82,99.49
2020-10-13,Himachal Pradesh,511,5,509,6837,1404,200,7.47,0,7.4,237423,1947,236220,18.97,2.7,0.923918918918919,0.82,99.49
2020-10-14,Himachal Pradesh,400,5,392,4905,2068,213,8.15,3,7.4,237823,1952,236612,27.95,2.88,0.6628378378378378,0.82,99.49
2020-10-15,Himachal Pradesh,587,3,586,7315,2308,438,8.02,0,7.4,238410,1955,237198,31.19,5.92,0.9885135135135135,0.82,99.49
2020-10-16,Himachal Pradesh,571,7,562,7130,4777,3189,8.01,2,7.4,238981,1962,237760,64.55,43.09,0.9635135135135136,0.82,99.49
2020-10-17,Himachal Pradesh,737,5,729,9575,633,614,7.7,3,7.4,239718,1967,238489,8.55,8.3,1.2939189189189189,0.82,99.49
2020-10-18,Himachal Pradesh,829,11,829,10660,759,480,7.78,0,7.4,240547,1978,239318,10.26,6.49,1.4405405405405405,0.82,99.49
2020-10-19,Himachal Pradesh,248,0,241,3233,3109,1546,7.67,7,7.4,240795,1978,239559,42.01,20.89,0.43689189189189187,0.82,99.49
2020-10-20,Himachal Pradesh,677,3,671,8594,2317,1754,7.88,3,7.4,241472,1981,240230,31.31,23.7,1.1613513513513514,0.82,99.49
2020-10-21,Himachal Pradesh,1430,16,1425,17794,2023,1643,8.04,0,7.4,242902,1997,241655,27.34,22.2,2.404594594594595,0.82,99.49
2020-10-22,Himachal Pradesh,1079,7,1078,13228,1483,158,8.16,0,7.4,243981,2004,242733,20.04,2.14,1.7875675675675675,0.82,99.49
2020-10-23,Himachal Pradesh,934,4,934,11715,1838,585,7.97,0,7.4,244915,2008,243667,24.84,7.91,1.5831081081081082,0.82,99.49
2020-10-24,Himachal Pradesh,591,7,590,7238,4628,361,8.17,0,7.4,245506,2015,244257,62.54,4.88,0.9781081081081081,0.82,99.49
2020-10-25,Himachal Pradesh,1055,6,1047,12874,3314,2642,8.19,2,7.4,246561,2021,245304,44.78,35.7,1.7397297297297298,0.82,99.49
2020-10-26,Himachal Pradesh,1472,12,1466,18866,1466,605,7.8,0,7.4,248033,2033,246770,19.81,8.18,2.5494594594594595,0.82,99.49
2020-10-27,Himachal Pradesh,1236,10,1227,15402,959,501,8.02,0,7.4,249269,2043,247997,12.96,6.77,2.0813513513513513,0.82,99.49
2020-10-28,Himachal Pradesh,690,3,681,8471,3216,3046,8.15,6,7.4,249959,2046,248678,43.46,41.16,1.1447297297297296,0.82,99.49
2020-10-29,Himachal Pradesh,174,1,165,2016,3251,1272,8.63,8,7.4,250133,2047,248843,43.93,17.19,0.2724324324324324,0.82,99.48
2020-10-30,Himachal Pradesh,1262,15,1253,15634,4854,949,8.07,0,7.4,251395,2062,250096,65.59,12.82,2.1127027027027028,0.82,99.48
2020-10-31,Himachal Pradesh,1270,8,1261,15586,1488,902,8.15,1,7.4,252665,2070,251357,20.11,12.19,2.1062162162162164,0.82,99.48
2020-11-01,Himachal Pradesh,1506,12,1499,18706,4020,1760,8.05,0,7.4,254171,2082,252856,54.32,23.78,2.5278378378378377,0.82,99.48
2020-11-02,Himachal Pradesh,1005,7,1001,12375,2117,2063,8.12,0,7.4,255176,2089,253857,28.61,27.88,1.6722972972972974,0.82,99.48
2020-11-03,Himachal Pradesh,395,4,391,5043,3606,3192,7.83,0,7.4,255571,2093,254248,48.73,43.14,0.6814864864864865,0.82,99.48
2020-11-04,Himachal Pradesh,116,1,109,1707,60,60,6.8,6,7.4,255687,2094,254357,0.81,0.81,0.23067567567567568,0.82,99.48
2020-11-05,Himachal Pradesh,172,1,166,2007,441,139,8.57,5,7.4,255859,2095,254523,5.96,1.88,0.2712162162162162,0.82,99.48
2020-11-06,Himachal Pradesh,1442,9,1435,17892,789,489,8.06,0,7.4,257301,2104,255958,10.66,6.61,2.417837837837838,0.82,99.48
2020-11-07,Himachal Pradesh,609,3,600,7930,3904,3620,7.68,6,7.4,257910,2107,256558,52.76,48.92,1.0716216216216217,0.82,99.48
2020-11-08,Himachal Pradesh,253,1,245,2810,2766,1788,9.0,7,7.4,258163,2108,256803,37.38,24.16,0.37972972972972974,0.82,99.47
2020-11-09,Himachal Pradesh,1457,15,1448,18425,309,85,7.91,0,7.4,259620,2123,258251,4.18,1.15,2.489864864864865,0.82,99.47
2020-11-10,Himachal Pradesh,1498,13,1495,18527,390,2,8.09,0,7.4,261118,2136,259746,5.27,0.03,2.5036486486486487,0.82,99.47
2020-11-11,Himachal Pradesh,156,1,156,1555,4744,4553,10.03,0,7.4,261274,2137,259902,64.11,61.53,0.21013513513513513,0.82,99.47
2020-11-12,Himachal Pradesh,1312,6,1310,15887,1380,216,8.26,0,7.4,262586,2143,261212,18.65,2.92,2.146891891891892,0.82,99.48
2020-11-13,Himachal Pradesh,771,9,767,9842,4090,1280,7.83,0,7.4,263357,2152,261979,55.27,17.3,1.33,0.82,99.48
2020-11-14,Himachal Pradesh,306,4,303,3957,1504,98,7.73,0,7.4,263663,2156,262282,20.32,1.32,0.5347297297297298,0.82,99.48
2020-11-15,Himachal Pradesh,457,5,452,5761,3023,3004,7.93,0,7.4,264120,2161,262734,40.85,40.59,0.7785135135135135,0.82,99.48
2020-11-16,Himachal Pradesh,235,2,229,2779,1325,338,8.46,4,7.4,264355,2163,262963,17.91,4.57,0.37554054054054054,0.82,99.47
2020-11-17,Himachal Pradesh,607,4,602,7499,109,46,8.09,1,7.4,264962,2167,263565,1.47,0.62,1.0133783783783783,0.82,99.47
2020-11-18,Himachal Pradesh,635,7,633,8294,2664,2017,7.66,0,7.4,265597,2174,264198,36.0,27.26,1.1208108108108108,0.82,99.47
2020-11-19,Himachal Pradesh,104,1,98,1030,924,623,10.1,5,7.4,265701,2175,264296,12.49,8.42,0.13918918918918918,0.82,99.47
2020-11-20,Himachal Pradesh,1120,4,1111,14100,1167,391,7.94,5,7.4,266821,2179,265407,15.77,5.28,1.9054054054054055,0.82,99.47
2020-11-21,Himachal Pradesh,135,1,129,1316,2303,1927,10.26,5,7.4,266956,2180,265536,31.12,26.04,0.17783783783783783,0.82,99.47
2020-11-22,Himachal Pradesh,1595,21,1594,19618,413,73,8.13,0,7.4,268551,2201,267130,5.58,0.99,2.651081081081081,0.82,99.47
2020-11-23,Himachal Pradesh,756,6,749,9505,435,261,7.95,1,7.4,269307,2207,267879,5.88,3.53,1.2844594594594594,0.82,99.47
2020-11-24,Himachal Pradesh,810,5,807,10069,287,19,8.04,0,7.4,270117,2212,268686,3.88,0.26,1.3606756756756757,0.82,99.47
2020-11-25,Himachal Pradesh,1370,17,1363,17111,1370,0,8.01,0,7.4,271487,2229,270049,18.51,0.0,2.3122972972972975,0.82,99.47
2020-11-26,Himachal Pradesh,470,3,462,5755,4841,855,8.17,5,7.4,271957,2232,270511,65.42,11.55,0.7777027027027027,0.82,99.47
2020-11-27,Himachal Pradesh,1280,6,1277,16109,2442,1157,7.95,0,7.4,273237,2238,271788,33.0,15.64,2.176891891891892,0.82,99.47
2020-11-28,Himachal Pradesh,305,3,302,3809,2674,2137,8.01,0,7.4,273542,2241,272090,36.14,28.88,0.5147297297297297,0.82,99.47
2020-11-29,Himachal Pradesh,822,8,813,10089,3361,123,8.15,1,7.4,274364,2249,272903,45.42,1.66,1.3633783783783784,0.82,99.47
2020-11-30,Himachal Pradesh,1311,17,1305,16653,721,591,7.87,0,7.4,275675,2266,274208,9.74,7.99,2.2504054054054055,0.82,99.47
2020-12-01,Himachal Pradesh,1538,4,1532,19133,7,2,8.04,2,7.4,277213,2270,275740,0.09,0.03,2.5855405405405407,0.82,99.47
2020-12-02,Himachal Pradesh,1294,8,1288,16494,4892,4631,7.85,0,7.4,278507,2278,277028,66.11,62.58,2.228918918918919,0.82,99.47
2020-12-03,Himachal Pradesh,509,5,500,6505,3416,2116,7.82,4,7.4,279016,2283,277528,46.16,28.59,0.879054054054054,0.82,99.47
2020-12-04,Himachal Pradesh,1014,8,1008,12812,119,84,7.91,0,7.4,280030,2291,278536,1.61,1.14,1.7313513513513514,0.82,99.47
2020-12-05,Himachal Pradesh,143,0,140,1979,1852,595,7.23,3,7.4,280173,2291,278676,25.03,8.04,0.2674324324324324,0.82,99.47
2020-12-06,Himachal Pradesh,760,5,754,9770,812,338,7.78,1,7.4,280933,2296,279430,10.97,4.57,1.3202702702702702,0.82,99.46
2020-12-07,Himachal Pradesh,956,12,950,11892,1513,611,8.04,0,7.4,281889,2308,280380,20.45,8.26,1.607027027027027,0.82,99.46
2020-12-08,Himachal Pradesh,179,1,171,2351,2777,1239,7.61,7,7.4,282068,2309,280551,37.53,16.74,0.3177027027027027,0.82,99.46
2020-12-09,Himachal Pradesh,681,2,673,7928,2275,2242,8.59,6,7.4,282749,2311,281224,30.74,30.3,1.0713513513513513,0.82,99.46
2020-12-10,Himachal Pradesh,1361,12,1358,17011,3917,2950,8.0,0,7.4,284110,2323,282582,52.93,39.86,2.298783783783784,0.82,99.46
2020-12-11,Himachal Pradesh,804,8,797,10415,2393,272,7.72,0,7.4,284914,2331,283379,32.34,3.68,1.4074324324324323,0.82,99.46
2020-12-12,Himachal Pradesh,1393,14,1391,17422,828,149,8.0,0,7.4,286307,2345,284770,11.19,2.01,2.3543243243243244,0.82,99.46
2020-12-13,Himachal Pradesh,1539,17,1534,19446,2417,1944,7.91,0,7.4,287846,2362,286304,32.66,26.27,2.6278378378378378,0.82,99.46
2020-12-14,Himachal Pradesh,799,5,798,10193,60,22,7.84,0,7.4,288645,2367,287102,0.81,0.3,1.3774324324324325,0.82,99.47
2020-12-15,Himachal Pradesh,1391,8,1389,17446,4966,1162,7.97,0,7.4,290036,2375,288491,67.11,15.7,2.3575675675675676,0.82,99.47
2020-12-16,Himachal Pradesh,1535,10,1530,19430,223,53,7.9,0,7.4,291571,2385,290021,3.01,0.72,2.6256756756756756,0.82,99.47
2020-12-17,Himachal Pradesh,231,1,230,2969,1516,138,7.78,0,7.4,291802,2386,290251,20.49,1.86,0.4012162162162162,0.82,99.47
2020-12-18,Himachal Pradesh,1543,6,1541,19258,4368,1629,8.01,0,7.4,293345,2392,291792,59.03,22.01,2.6024324324324324,0.82,99.47
2020-12-19,Himachal Pradesh,677,7,670,8446,625,147,8.02,0,7.4,294022,2399,292462,8.45,1.99,1.1413513513513514,0.82,99.47
2020-12-20,Himachal Pradesh,1223,14,1223,15253,2767,481,8.02,0,7.4,295245,2413,293685,37.39,6.5,2.0612162162162164,0.82,99.47
2020-12-21,Himachal Pradesh,281,2,276,3002,1347,827,9.36,3,7.4,295526,2415,293961,18.2,11.18,0.4056756756756757,0.82,99.47
2020-12-22,Himachal Pradesh,1512,19,1504,19078,4216,3865,7.93,0,7.4,297038,2434,295465,56.97,52.23,2.578108108108108,0.82,99.47
2020-12-23,Himachal Pradesh,1252,9,1250,15644,1216,1035,8.0,0,7.4,298290,2443,296715,16.43,13.99,2.114054054054054,0.82,99.47
2020-12-24,Himachal Pradesh,762,8,757,9426,2600,1756,8.08,0,7.4,299052,2451,297472,35.14,23.73,1.2737837837837838,0.82,99.47
2020-12-25,Himachal Pradesh,1296,12,1294,15892,4332,4082,8.16,0,7.4,300348,2463,298766,58.54,55.16,2.1475675675675676,0.82,99.47
2020-12-26,Himachal Pradesh,83,0,83,840,3897,2458,9.88,0,7.4,300431,2463,298849,52.66,33.22,0.11351351351351352,0.82,99.47
2020-12-27,Himachal Pradesh,250,1,247,2893,1995,1029,8.64,2,7.4,300681,2464,299096,26.96,13.91,0.39094594594594595,0.82,99.47
2020-12-28,Himachal Pradesh,1467,4,1465,18514,1439,609,7.92,0,7.4,302148,2468,300561,19.45,8.23,2.501891891891892,0.82,99.47
2020-12-29,Himachal Pradesh,1225,4,1218,15349,3232,3212,7.98,3,7.4,303373,2472,301779,43.68,43.41,2.0741891891891893,0.81,99.47
2020-12-30,Himachal Pradesh,836,9,833,10584,4506,3364,7.9,0,7.4,304209,2481,302612,60.89,45.46,1.4302702702702703,0.82,99.48
2020-12-31,Himachal Pradesh,794,9,786,9784,4671,103,8.12,0,7.4,305003,2490,303398,63.12,1.39,1.3221621621621622,0.82,99.47
2021-01-01,Himachal Pradesh,452,2,448,5793,2242,224,7.8,2,7.4,305455,2492,303846,30.3,3.03,0.7828378378378379,0.82,99.47
2021-01-02,Himachal Pradesh,779,6,774,9944,1168,839,7.83,0,7.4,306234,2498,304620,15.78,11.34,1.3437837837837838,0.82,99.47
2021-01-03,Himachal Pradesh,1475,20,1474,18205,1173,66,8.1,0,7.4,307709,2518,306094,15.85,0.89,2.4601351351351353,0.82,99.48
2021-01-04,Himachal Pradesh,488,4,484,5591,315,67,8.73,0,7.4,308197,2522,306578,4.26,0.91,0.7555405405405405,0.82,99.47
2021-01-05,Himachal Pradesh,576,7,575,7175,4691,4574,8.03,0,7.4,308773,2529,307153,63.39,61.81,0.9695945945945946,0.82,99.48
2021-01-06,Himachal Pradesh,982,9,981,12014,3541,2930,8.17,0,7.4,309755,2538,308134,47.85,39.59,1.6235135135135135,0.82,99.48
2021-01-07,Himachal Pradesh,1372,10,1364,17279,2456,45,7.94,0,7.4,311127,2548,309498,33.19,0.61,2.335,0.82,99.48
2021-01-08,Himachal Pradesh,654,4,648,8692,1008,497,7.52,2,7.4,311781,2552,310146,13.62,6.72,1.1745945945945946,0.82,99.48
2021-01-09,Himachal Pradesh,177,2,168,2352,529,298,7.53,7,7.4,311958,2554,310314,7.15,4.03,0.3178378378378378,0.82,99.47
2021-01-10,Himachal Pradesh,1306,15,1304,16383,4100,3680,7.97,0,7.4,313264,2569,311618,55.41,49.73,2.213918918918919,0.82,99.47
2021-01-11,Himachal Pradesh,695,5,687,8780,4225,2325,7.92,3,7.4,313959,2574,312305,57.09,31.42,1.1864864864864866,0.82,99.47
2021-01-12,Himachal Pradesh,665,9,656,8470,4216,2362,7.85,0,7.4,314624,2583,312961,56.97,31.92,1.1445945945945946,0.82,99.47
2021-01-13,Himachal Pradesh,252,1,249,3336,3319,2114,7.55,2,7.4,314876,2584,313210,44.85,28.57,0.4508108108108108,0.82,99.47
2021-01-14,Himachal Pradesh,136,0,131,1400,656,175,9.71,5,7.4,315012,2584,313341,8.86,2.36,0.1891891891891892,0.82,99.47
2021-01-15,Himachal Pradesh,1036,6,1034,12841,2606,1840,8.07,0,7.4,316048,2590,314375,35.22,24.86,1.7352702702702703,0.82,99.47
2021-01-16,Himachal Pradesh,1269,4,1263,15613,1187,1155,8.13,2,7.4,317317,2594,315638,16.04,15.61,2.109864864864865,0.82,99.47
2021-01-17,Himachal Pradesh,1152,10,1152,14273,1285,589,8.07,0,7.4,318469,2604,316790,17.36,7.96,1.9287837837837838,0.82,99.47
2021-01-18,Himachal Pradesh,1124,7,1116,13748,856,406,8.18,1,7.4,319593,2611,317906,11.57,5.49,1.8578378378378377,0.82,99.47
2021-01-19,Himachal Pradesh,1176,15,1172,14568,3161,1805,8.07,0,7.4,320769,2626,319078,42.72,24.39,1.9686486486486487,0.82,99.47
2021-01-20,Himachal Pradesh,1324,4,1317,16755,1823,703,7.9,3,7.4,322093,2630,320395,24.64,9.5,2.264189189189189,0.82,99.47
2021-01-21,Himachal Pradesh,132,0,131,1643,1212,673,8.03,1,7.4,322225,2630,320526,16.38,9.09,0.22202702702702704,0.82,99.47
2021-01-22,Himachal Pradesh,613,3,604,7347,4425,324,8.34,6,7.4,322838,2633,321130,59.8,4.38,0.9928378378378379,0.82,99.47
2021-01-23,Himachal Pradesh,389,4,386,5390,2853,990,7.22,0,7.4,323227,2637,321516,38.55,13.38,0.7283783783783784,0.82,99.47
2021-01-24,Himachal Pradesh,832,11,831,10154,1845,74,8.19,0,7.4,324059,2648,322347,24.93,1.0,1.3721621621621622,0.82,99.47
2021-01-25,Himachal Pradesh,855,4,853,10617,3712,3169,8.05,0,7.4,324914,2652,323200,50.16,42.82,1.4347297297297297,0.82,99.47
2021-01-26,Himachal Pradesh,325,1,321,4303,3010,2205,7.55,3,7.4,325239,2653,323521,40.68,29.8,0.5814864864864865,0.82,99.47
2021-01-27,Himachal Pradesh,1373,7,1369,17395,4940,3280,7.89,0,7.4,326612,2660,324890,66.76,44.32,2.3506756756756757,0.81,99.47
2021-01-28,Himachal Pradesh,581,5,572,7001,700,217,8.3,4,7.4,327193,2665,325462,9.46,2.93,0.9460810810810811,0.81,99.47
2021-01-29,Himachal Pradesh,484,2,484,6247,4203,2585,7.75,0,7.4,327677,2667,325946,56.8,34.93,0.8441891891891892,0.81,99.47
2021-01-30,Himachal Pradesh,1339,14,1333,16845,4815,3105,7.95,0,7.4,329016,2681,327279,65.07,41.96,2.276351351351351,0.81,99.47
2021-01-31,Himachal Pradesh,992,10,992,12698,8,3,7.81,0,7.4,330008,2691,328271,0.11,0.04,1.7159459459459458,0.82,99.47
2021-02-01,Himachal Pradesh,954,7,954,11965,811,237,7.97,0,7.4,330962,2698,329225,10.96,3.2,1.616891891891892,0.82,99.48
2021-02-02,Himachal Pradesh,620,1,616,7934,4227,1871,7.81,3,7.4,331582,2699,329841,57.12,25.28,1.0721621621621622,0.81,99.47
2021-02-03,Himachal Pradesh,1476,6,1469,18608,1890,514,7.93,1,7.4,333058,2705,331310,25.54,6.95,2.5145945945945947,0.81,99.48
2021-02-04,Himachal Pradesh,428,4,419,5235,1037,8,8.18,5,7.4,333486,2709,331729,14.01,0.11,0.7074324324324325,0.81,99.47
2021-02-05,Himachal Pradesh,740,2,735,9358,3565,477,7.91,3,7.4,334226,2711,332464,48.18,6.45,1.2645945945945947,0.81,99.47
2021-02-06,Himachal Pradesh,1205,4,1204,15002,1196,565,8.03,0,7.4,335431,2715,333668,16.16,7.64,2.0272972972972974,0.81,99.47
2021-02-07,Himachal Pradesh,845,6,837,10694,648,551,7.9,2,7.4,336276,2721,334505,8.76,7.45,1.4451351351351351,0.81,99.47
2021-02-08,Himachal Pradesh,1083,11,1076,13802,1779,534,7.85,0,7.4,337359,2732,335581,24.04,7.22,1.865135135135135,0.81,99.47
2021-02-09,Himachal Pradesh,1548,13,1546,19197,1103,609,8.06,0,7.4,338907,2745,337127,14.91,8.23,2.5941891891891893,0.81,99.47
2021-02-10,Himachal Pradesh,153,0,153,1600,4762,3209,9.56,0,7.4,339060,2745,337280,64.35,43.36,0.21621621621621623,0.81,99.48
2021-02-11,Himachal Pradesh,1367,7,1361,16652,2504,790,8.21,0,7.4,340427,2752,338641,33.84,10.68,2.25027027027027,0.81,99.48
2021-02-12,Himachal Pradesh,1394,6,1391,17134,798,361,8.14,0,7.4,341821,2758,340032,10.78,4.88,2.3154054054054054,0.81,99.48
2021-02-13,Himachal Pradesh,627,3,624,7847,4663,2940,7.99,0,7.4,342448,2761,340656,63.01,39.73,1.0604054054054055,0.81,99.48
2021-02-14,Himachal Pradesh,1415,13,1412,17372,3221,1695,8.15,0,7.4,343863,2774,342068,43.53,22.91,2.3475675675675673,0.81,99.48
2021-02-15,Himachal Pradesh,1052,4,1047,12914,2825,881,8.15,1,7.4,344915,2778,343115,38.18,11.91,1.7451351351351352,0.81,99.48
2021-02-16,Himachal Pradesh,1062,4,1059,12828,2241,489,8.28,0,7.4,345977,2782,344174,30.28,6.61,1.7335135135135136,0.8,99.48
2021-02-17,Himachal Pradesh,926,4,925,11654,1998,615,7.95,0,7.4,346903,2786,345099,27.0,8.31,1.5748648648648649,0.8,99.48
2021-02-18,Himachal Pradesh,35,0,28,580,4137,838,6.03,7,7.4,346938,2786,345127,55.91,11.32,0.07837837837837838,0.8,99.48
2021-02-19,Himachal Pradesh,743,5,741,9279,3166,1805,8.01,0,7.4,347681,2791,345868,42.78,24.39,1.2539189189189188,0.8,99.48
2021-02-20,Himachal Pradesh,773,4,768,9747,1424,1107,7.93,1,7.4,348454,2795,346636,19.24,14.96,1.317162162162162,0.8,99.48
2021-02-21,Himachal Pradesh,53,0,46,609,4754,1669,8.7,7,7.4,348507,2795,346682,64.24,22.55,0.0822972972972973,0.8,99.48
2021-02-22,Himachal Pradesh,71,0,69,873,2909,201,8.13,2,7.4,348578,2795,346751,39.31,2.72,0.11797297297297298,0.8,99.48
2021-02-23,Himachal Pradesh,1598,9,1594,19636,4800,156,8.14,0,7.4,350176,2804,348345,64.86,2.11,2.6535135135135137,0.8,99.48
2021-02-24,Himachal Pradesh,556,6,556,6895,4541,322,8.06,0,7.4,350732,2810,348901,61.36,4.35,0.9317567567567567,0.8,99.48
2021-02-25,Himachal Pradesh,400,2,392,4982,1922,1611,8.03,6,7.4,351132,2812,349293,25.97,21.77,0.6732432432432433,0.8,99.48
2021-02-26,Himachal Pradesh,745,3,737,9013,3731,2140,8.27,5,7.4,351877,2815,350030,50.42,28.92,1.217972972972973,0.8,99.48
2021-02-27,Himachal Pradesh,1260,13,1257,15751,2161,1000,8.0,0,7.4,353137,2828,351287,29.2,13.51,2.1285135135135134,0.8,99.48
2021-02-28,Himachal Pradesh,248,1,241,2883,2750,2694,8.6,6,7.4,353385,2829,351528,37.16,36.41,0.3895945945945946,0.8,99.47
2021-03-01,Himachal Pradesh,1528,22,1520,19131,1530,1215,7.99,0,7.4,354913,2851,353048,20.68,16.42,2.58527027027027,0.8,99.47
2021-03-02,Himachal Pradesh,819,8,812,10136,2564,252,8.08,0,7.4,355732,2859,353860,34.65,3.41,1.3697297297297297,0.8,99.47
2021-03-03,Himachal Pradesh,254,2,252,2883,1268,125,8.81,0,7.4,355986,2861,354112,17.14,1.69,0.3895945945945946,0.8,99.47
2021-03-04,Himachal Pradesh,624,7,624,7425,4002,3069,8.4,0,7.4,356610,2868,354736,54.08,41.47,1.0033783783783783,0.8,99.47
2021-03-05,Himachal Pradesh,517,5,509,6656,1215,761,7.77,3,7.4,357127,2873,355245,16.42,10.28,0.8994594594594595,0.8,99.47
2021-03-06,Himachal Pradesh,1156,5,1156,14964,4790,3625,7.73,0,7.4,358283,2878,356401,64.73,48.99,2.022162162162162,0.8,99.47
2021-03-07,Himachal Pradesh,1564,11,1556,19195,4593,2277,8.15,0,7.4,359847,2889,357957,62.07,30.77,2.593918918918919,0.8,99.47
2021-03-08,Himachal Pradesh,209,2,205,2717,2464,1402,7.69,2,7.4,360056,2891,358162,33.3,18.95,0.3671621621621622,0.8,99.47
2021-03-09,Himachal Pradesh,1597,5,1589,19715,3914,958,8.1,3,7.4,361653,2896,359751,52.89,12.95,2.664189189189189,0.8,99.47
2021-03-10,Himachal Pradesh,1465,13,1464,17973,2864,116,8.15,0,7.4,363118,2909,361215,38.7,1.57,2.428783783783784,0.8,99.48
2021-03-11,Himachal Pradesh,783,8,781,9680,3185,544,8.09,0,7.4,363901,2917,361996,43.04,7.35,1.308108108108108,0.8,99.48
2021-03-12,Himachal Pradesh,1104,5,1096,13681,629,310,8.07,3,7.4,365005,2922,363092,8.5,4.19,1.8487837837837837,0.8,99.48
2021-03-13,Himachal Pradesh,549,6,543,7038,2859,2709,7.8,0,7.4,365554,2928,363635,38.64,36.61,0.951081081081081,0.8,99.48
2021-03-14,Himachal Pradesh,718,8,715,9440,1500,200,7.61,0,7.4,366272,2936,364350,20.27,2.7,1.2756756756756757,0.8,99.48
2021-03-15,Himachal Pradesh,411,2,407,5290,887,675,7.77,2,7.4,366683,2938,364757,11.99,9.12,0.7148648648648649,0.8,99.47
2021-03-16,Himachal Pradesh,251,3,249,3339,927,40,7.52,0,7.4,366934,2941,365006,12.53,0.54,0.4512162162162162,0.8,99.47
2021-03-17,Himachal Pradesh,1284,4,1281,16407,1951,281,7.83,0,7.4,368218,2945,366287,26.36,3.8,2.217162162162162,0.8,99.48
2021-03-18,Himachal Pradesh,1152,7,1146,14374,1006,510,8.01,0,7.4,369370,2952,367433,13.59,6.89,1.9424324324324325,0.8,99.48
2021-03-19,Himachal Pradesh,424,6,424,5172,4269,306,8.2,0,7.4,369794,2958,367857,57.69,4.14,0.6989189189189189,0.8,99.48
2021-03-20,Himachal Pradesh,476,6,475,5990,2505,1039,7.95,0,7.4,370270,2964,368332,33.85,14.04,0.8094594594594594,0.8,99.48
2021-03-21,Himachal Pradesh,289,2,285,3550,4339,4314,8.14,2,7.4,370559,2966,368617,58.64,58.3,0.4797297297297297,0.8,99.48
2021-03-22,Himachal Pradesh,633,6,625,7982,2092,792,7.93,2,7.4,371192,2972,369242,28.27,10.7,1.0786486486486486,0.8,99.47
2021-03-23,Himachal Pradesh,874,2,866,11140,2221,1455,7.85,6,7.4,372066,2974,370108,30.01,19.66,1.5054054054054054,0.8,99.47
2021-03-24,Himachal Pradesh,1406,21,1404,17472,4275,2880,8.05,0,7.4,373472,2995,371512,57.77,38.92,2.361081081081081,0.8,99.48
2021-03-25,Himachal Pradesh,1366,7,1364,17580,2923,1672,7.77,0,7.4,374838,3002,372876,39.5,22.59,2.3756756756756756,0.8,99.48
2021-03-26,Himachal Pradesh,267,3,266,3094,1509,1383,8.63,0,7.4,375105,3005,373142,20.39,18.69,0.4181081081081081,0.8,99.48
2021-03-27,Himachal Pradesh,1434,12,1433,17802,4178,4072,8.06,0,7.4,376539,3017,374575,56.46,55.03,2.405675675675676,0.8,99.48
2021-03-28,Himachal Pradesh,1088,6,1082,13094,2159,1576,8.31,0,7.4,377627,3023,375657,29.18,21.3,1.7694594594594595,0.8,99.48
2021-03-29,Himachal Pradesh,190,2,187,2682,378,204,7.08,1,7.4,377817,3025,375844,5.11,2.76,0.36243243243243245,0.8,99.48
2021-03-30,Himachal Pradesh,888,8,885,11131,424,186,7.98,0,7.4,378705,3033,376729,5.73,2.51,1.5041891891891892,0.8,99.48
2021-03-31,Himachal Pradesh,712,8,711,8796,2730,1925,8.09,0,7.4,379417,3041,377440,36.89,26.01,1.1886486486486487,0.8,99.48
2021-04-01,Himachal Pradesh,283,1,283,3827,2728,1962,7.39,0,7.4,379700,3042,377723,36.86,26.51,0.5171621621621622,0.8,99.48
2021-04-02,Himachal Pradesh,901,4,895,11058,68,29,8.15,2,7.4,380601,3046,378618,0.92,0.39,1.4943243243243243,0.8,99.48
2021-04-03,Himachal Pradesh,595,7,588,7650,2032,1226,7.78,0,7.4,381196,3053,379206,27.46,16.57,1.0337837837837838,0.8,99.48
2021-04-04,Himachal Pradesh,275,1,271,3641,2867,2029,7.55,3,7.4,381471,3054,379477,38.74,27.42,0.49202702702702705,0.8,99.48
2021-04-05,Himachal Pradesh,1505,17,1503,18693,702,597,8.05,0,7.4,382976,3071,380980,9.49,8.07,2.526081081081081,0.8,99.48
2021-04-06,Himachal Pradesh,457,3,454,5309,4064,2312,8.61,0,7.4,383433,3074,381434,54.92,31.24,0.7174324324324325,0.8,99.48
2021-04-07,Himachal Pradesh,563,6,557,6922,1925,132,8.13,0,7.4,383996,3080,381991,26.01,1.78,0.9354054054054054,0.8,99.48
2021-04-08,Himachal Pradesh,1277,10,1273,15967,113,56,8.0,0,7.4,385273,3090,383264,1.53,0.76,2.1577027027027027,0.8,99.48
2021-04-09,Himachal Pradesh,919,7,917,11276,4749,3959,8.15,0,7.4,386192,3097,384181,64.18,53.5,1.5237837837837838,0.8,99.48
2021-04-10,Himachal Pradesh,292,3,290,3900,928,608,7.49,0,7.4,386484,3100,384471,12.54,8.22,0.527027027027027,0.8,99.48
2021-04-11,Himachal Pradesh,370,3,369,4616,2726,1936,8.02,0,7.4,386854,3103,384840,36.84,26.16,0.6237837837837837,0.8,99.48
2021-04-12,Himachal Pradesh,798,4,794,10124,3610,3588,7.88,0,7.4,387652,3107,385634,48.78,48.49,1.3681081081081081,0.8,99.48
2021-04-13,Himachal Pradesh,519,2,515,6629,4705,1063,7.83,2,7.4,388171,3109,386149,63.58,14.36,0.8958108108108108,0.8,99.48
2021-04-14,Himachal Pradesh,183,1,178,2330,4053,1596,7.85,4,7.4,388354,3110,386327,54.77,21.57,0.31486486486486487,0.8,99.48
2021-04-15,Himachal Pradesh,990,10,990,12531,3382,1922,7.9,0,7.4,389344,3120,387317,45.7,25.97,1.6933783783783785,0.8,99.48
2021-04-16,Himachal Pradesh,1380,19,1377,17694,4092,1925,7.8,0,7.4,390724,3139,388694,55.3,26.01,2.391081081081081,0.8,99.48
2021-04-17,Himachal Pradesh,640,8,635,7991,1238,725,8.01,0,7.4,391364,3147,389329,16.73,9.8,1.0798648648648648,0.8,99.48
2021-04-18,Himachal Pradesh,1076,9,1073,13357,467,269,8.06,0,7.4,392440,3156,390402,6.31,3.64,1.805,0.8,99.48
2021-04-19,Himachal Pradesh,1053,3,1053,12918,4424,2174,8.15,0,7.4,393493,3159,391455,59.78,29.38,1.7456756756756757,0.8,99.48
2021-04-20,Himachal Pradesh,867,6,867,10523,1351,260,8.24,0,7.4,394360,3165,392322,18.26,3.51,1.422027027027027,0.8,99.48
2021-04-21,Himachal Pradesh,937,10,937,11706,3786,173,8.0,0,7.4,395297,3175,393259,51.16,2.34,1.5818918918918918,0.8,99.48
2021-04-22,Himachal Pradesh,1052,6,1044,13214,872,631,7.96,2,7.4,396349,3181,394303,11.78,8.53,1.7856756756756758,0.8,99.48
2021-04-23,Himachal Pradesh,736,5,727,9269,1414,1208,7.94,4,7.4,397085,3186,395030,19.11,16.32,1.2525675675675676,0.8,99.48
2021-04-24,Himachal Pradesh,785,4,783,9625,1360,982,8.16,0,7.4,397870,3190,395813,18.38,13.27,1.3006756756756757,0.8,99.48
2021-04-25,Himachal Pradesh,1022,8,1015,12758,3562,3000,8.01,0,7.4,398892,3198,396828,48.14,40.54,1.724054054054054,0.8,99.48
2021-04-26,Himachal Pradesh,1455,11,1447,18143,3541,713,8.02,0,7.4,400347,3209,398275,47.85,9.64,2.451756756756757,0.8,99.48
2021-04-27,Himachal Pradesh,77,0,74,1061,4703,1822,7.26,3,7.4,400424,3209,398349,63.55,24.62,0.14337837837837838,0.8,99.48
2021-04-28,Himachal Pradesh,1316,15,1310,16488,4325,4216,7.98,0,7.4,401740,3224,399659,58.45,56.97,2.228108108108108,0.8,99.48
2021-04-29,Himachal Pradesh,820,3,820,10369,755,23,7.91,0,7.4,402560,3227,400479,10.2,0.31,1.4012162162162163,0.8,99.48
2021-04-30,Himachal Pradesh,1156,15,1154,14374,1991,821,8.04,0,7.4,403716,3242,401633,26.91,11.09,1.9424324324324325,0.8,99.48
2021-05-01,Himachal Pradesh,1090,14,1088,13312,932,554,8.19,0,7.4,404806,3256,402721,12.59,7.49,1.798918918918919,0.8,99.48
2021-05-02,Himachal Pradesh,1399,15,1397,17725,3327,96,7.89,0,7.4,406205,3271,404118,44.96,1.3,2.39527027027027,0.81,99.49
2021-05-03,Himachal Pradesh,552,2,544,6547,2484,2445,8.43,6,7.4,406757,3273,404662,33.57,33.04,0.8847297297297297,0.8,99.48
2021-05-04,Himachal Pradesh,1148,7,1140,14316,4686,3654,8.02,1,7.4,407905,3280,405802,63.32,49.38,1.9345945945945946,0.8,99.48
2021-05-05,Himachal Pradesh,1186,13,1185,14883,311,28,7.97,0,7.4,409091,3293,406987,4.2,0.38,2.011216216216216,0.8,99.49
2021-05-06,Himachal Pradesh,622,2,614,7829,1234,1226,7.94,6,7.4,409713,3295,407601,16.68,16.57,1.057972972972973,0.8,99.48
2021-05-07,Himachal Pradesh,401,3,396,4976,1821,1377,8.06,2,7.4,410114,3298,407997,24.61,18.61,0.6724324324324324,0.8,99.48
2021-05-08,Himachal Pradesh,822,7,819,9894,1878,1482,8.31,0,7.4,410936,3305,408816,25.38,20.03,1.337027027027027,0.8,99.48
2021-05-09,Himachal Pradesh,1398,16,1397,17360,2833,1593,8.05,0,7.4,412334,3321,410213,38.28,21.53,2.345945945945946,0.81,99.49
2021-05-10,Himachal Pradesh,1426,7,1418,17514,3527,2391,8.14,1,7.4,413760,3328,411631,47.66,32.31,2.366756756756757,0.8,99.49
2021-05-11,Himachal Pradesh,1482,21,1476,18780,709,386,7.89,0,7.4,415242,3349,413107,9.58,5.22,2.537837837837838,0.81,99.49
2021-05-12,Himachal Pradesh,978,5,974,12086,2475,1449,8.09,0,7.4,416220,3354,414081,33.45,19.58,1.6332432432432433,0.81,99.49
2021-05-13,Himachal Pradesh,1335,11,1332,16071,1278,1018,8.31,0,7.4,417555,3365,415413,17.27,13.76,2.1717567567567566,0.81,99.49
2021-05-14,Himachal Pradesh,863,9,855,11042,3838,1491,7.82,0,7.4,418418,3374,416268,51.86,20.15,1.4921621621621621,0.81,99.49
2021-05-15,Himachal Pradesh,1192,5,1188,14493,4301,2698,8.22,0,7.4,419610,3379,417456,58.12,36.46,1.9585135135135134,0.81,99.49
2021-05-16,Himachal Pradesh,868,6,863,11614,1618,1493,7.47,0,7.4,420478,3385,418319,21.86,20.18,1.5694594594594595,0.81,99.49
2021-05-17,Himachal Pradesh,427,4,422,5352,4393,3077,7.98,1,7.4,420905,3389,418741,59.36,41.58,0.7232432432432433,0.81,99.49
2021-05-18,Himachal Pradesh,1246,11,1245,15243,1071,561,8.17,0,7.4,422151,3400,419986,14.47,7.58,2.0598648648648648,0.81,99.49
2021-05-19,Himachal Pradesh,968,6,963,12093,2995,2205,8.0,0,7.4,423119,3406,420949,40.47,29.8,1.634189189189189,0.8,99.49
2021-05-20,Himachal Pradesh,1286,11,1282,15812,4864,1066,8.13,0,7.4,424405,3417,422231,65.73,14.41,2.136756756756757,0.81,99.49
2021-05-21,Himachal Pradesh,1509,16,1505,18664,1632,133,8.09,0,7.4,425914,3433,423736,22.05,1.8,2.522162162162162,0.81,99.49
2021-05-22,Himachal Pradesh,983,6,975,12060,1917,233,8.15,2,7.4,426897,3439,424711,25.91,3.15,1.6297297297297297,0.81,99.49
2021-05-23,Himachal Pradesh,1345,10,1337,16401,2370,2170,8.2,0,7.4,428242,3449,426048,32.03,29.32,2.2163513513513515,0.81,99.49
2021-05-24,Himachal Pradesh,589,3,580,7334,398,88,8.03,6,7.4,428831,3452,426628,5.38,1.19,0.9910810810810811,0.8,99.49
2021-05-25,Himachal Pradesh,1180,11,1180,14813,858,564,7.97,0,7.4,430011,3463,427808,11.59,7.62,2.0017567567567567,0.81,99.49
2021-05-26,Himachal Pradesh,1377,13,1372,16873,609,446,8.16,0,7.4,431388,3476,429180,8.23,6.03,2.280135135135135,0.81,99.49
2021-05-27,Himachal Pradesh,468,5,465,5771,1813,688,8.11,0,7.4,431856,3481,429645,24.5,9.3,0.7798648648648648,0.81,99.49
2021-05-28,Himachal Pradesh,1144,9,1137,13728,1346,301,8.33,0,7.4,433000,3490,430782,18.19,4.07,1.855135135135135,0.81,99.49
2021-05-29,Himachal Pradesh,463,6,460,5938,4228,1642,7.8,0,7.4,433463,3496,431242,57.14,22.19,0.8024324324324325,0.81,99.49
2021-05-30,Himachal Pradesh,374,4,371,4944,1808,1604,7.56,0,7.4,433837,3500,431613,24.43,21.68,0.6681081081081081,0.81,99.49
2021-05-31,Himachal Pradesh,273,3,271,3762,1682,887,7.26,0,7.4,434110,3503,431884,22.73,11.99,0.5083783783783784,0.81,99.49
2021-06-01,Himachal Pradesh,193,0,189,2507,4163,1986,7.7,4,7.4,434303,3503,432073,56.26,26.84,0.33878378378378377,0.81,99.49
2021-06-02,Himachal Pradesh,536,1,527,6739,4322,850,7.95,8,7.4,434839,3504,432600,58.41,11.49,0.9106756756756756,0.81,99.49
2021-06-03,Himachal Pradesh,1210,6,1209,15178,2477,329,7.97,0,7.4,436049,3510,433809,33.47,4.45,2.051081081081081,0.8,99.49
2021-06-04,Himachal Pradesh,668,3,665,8458,2709,1369,7.9,0,7.4,436717,3513,434474,36.61,18.5,1.142972972972973,0.8,99.49
2021-06-05,Himachal Pradesh,854,8,845,10796,4175,852,7.91,1,7.4,437571,3521,435319,56.42,11.51,1.458918918918919,0.8,99.49
2021-06-06,Himachal Pradesh,1368,6,1359,17669,2539,1642,7.74,3,7.4,438939,3527,436678,34.31,22.19,2.3877027027027027,0.8,99.48
2021-06-07,Himachal Pradesh,1382,7,1378,17402,1751,1258,7.94,0,7.4,440321,3534,438056,23.66,17.0,2.3516216216216215,0.8,99.49
2021-06-08,Himachal Pradesh,303,1,299,3760,1297,1127,8.06,3,7.4,440624,3535,438355,17.53,15.23,0.5081081081081081,0.8,99.49
2021-06-09,Himachal Pradesh,1547,10,1539,19348,920,275,8.0,0,7.4,442171,3545,439894,12.43,3.72,2.6145945945945948,0.8,99.49
2021-06-10,Himachal Pradesh,351,2,344,4187,3489,3142,8.38,5,7.4,442522,3547,440238,47.15,42.46,0.5658108108108109,0.8,99.48
2021-06-11,Himachal Pradesh,1206,17,1201,14874,780,263,8.11,0,7.4,443728,3564,441439,10.54,3.55,2.01,0.8,99.48
2021-06-12,Himachal Pradesh,270,2,268,2828,1451,1122,9.55,0,7.4,443998,3566,441707,19.61,15.16,0.38216216216216214,0.8,99.48
2021-06-13,Himachal Pradesh,742,6,738,9335,3787,2927,7.95,0,7.4,444740,3572,442445,51.18,39.55,1.2614864864864865,0.8,99.48
2021-06-14,Himachal Pradesh,1197,10,1188,14420,3417,3024,8.3,0,7.4,445937,3582,443633,46.18,40.86,1.9486486486486487,0.8,99.48
2021-06-15,Himachal Pradesh,176,2,172,2304,3476,3016,7.64,2,7.4,446113,3584,443805,46.97,40.76,0.31135135135135134,0.8,99.48
2021-06-16,Himachal Pradesh,326,4,325,4227,3291,2098,7.71,0,7.4,446439,3588,444130,44.47,28.35,0.5712162162162162,0.8,99.48
2021-06-17,Himachal Pradesh,1527,14,1519,19518,4096,608,7.82,0,7.4,447966,3602,445649,55.35,8.22,2.6375675675675674,0.8,99.48
2021-06-18,Himachal Pradesh,398,4,398,5635,1213,892,7.06,0,7.4,448364,3606,446047,16.39,12.05,0.7614864864864865,0.8,99.48
2021-06-19,Himachal Pradesh,173,1,171,2328,3232,2938,7.43,1,7.4,448537,3607,446218,43.68,39.7,0.3145945945945946,0.8,99.48
2021-06-20,Himachal Pradesh,1548,4,1547,18866,4893,1184,8.21,0,7.4,450085,3611,447765,66.12,16.0,2.5494594594594595,0.8,99.48
2021-06-21,Himachal Pradesh,57,0,48,911,4330,1255,6.26,9,7.4,450142,3611,447813,58.51,16.96,0.12310810810810811,0.8,99.48
2021-06-22,Himachal Pradesh,1139,16,1134,14724,695,347,7.74,0,7.4,451281,3627,448947,9.39,4.69,1.9897297297297298,0.8,99.48
2021-06-23,Himachal Pradesh,1187,13,1185,14933,1452,593,7.95,0,7.4,452468,3640,450132,19.62,8.01,2.017972972972973,0.8,99.48
2021-06-24,Himachal Pradesh,449,4,442,5492,3942,2469,8.18,3,7.4,452917,3644,450574,53.27,33.36,0.7421621621621621,0.8,99.48
2021-06-25,Himachal Pradesh,15,0,8,522,3874,2296,2.87,7,7.4,452932,3644,450582,52.35,31.03,0.07054054054054054,0.8,99.48
2021-06-26,Himachal Pradesh,1256,17,1250,15932,2656,626,7.88,0,7.4,454188,3661,451832,35.89,8.46,2.152972972972973,0.81,99.48
2021-06-27,Himachal Pradesh,1161,14,1156,14726,4756,2107,7.88,0,7.4,455349,3675,452988,64.27,28.47,1.99,0.81,99.48
2021-06-28,Himachal Pradesh,1204,6,1199,15719,3803,344,7.66,0,7.4,456553,3681,454187,51.39,4.65,2.124189189189189,0.81,99.48
2021-06-29,Himachal Pradesh,691,5,690,8676,4102,1444,7.96,0,7.4,457244,3686,454877,55.43,19.51,1.1724324324324324,0.81,99.48
2021-06-30,Himachal Pradesh,867,6,864,11031,3854,1722,7.86,0,7.4,458111,3692,455741,52.08,23.27,1.4906756756756756,0.81,99.48
2021-07-01,Himachal Pradesh,876,3,872,10762,4025,1810,8.14,1,7.4,458987,3695,456613,54.39,24.46,1.4543243243243242,0.81,99.48
2021-07-02,Himachal Pradesh,1479,11,1474,18401,2407,2279,8.04,0,7.4,460466,3706,458087,32.53,30.8,2.4866216216216217,0.8,99.48
2021-07-03,Himachal Pradesh,730,2,724,9185,1729,1088,7.95,4,7.4,461196,3708,458811,23.36,14.7,1.2412162162162161,0.8,99.48
2021-07-04,Himachal Pradesh,876,5,876,10846,1069,125,8.08,0,7.4,462072,3713,459687,14.45,1.69,1.4656756756756757,0.8,99.48
2021-07-05,Himachal Pradesh,1280,8,1280,16032,3964,1071,7.98,0,7.4,463352,3721,460967,53.57,14.47,2.1664864864864866,0.8,99.49
2021-07-06,Himachal Pradesh,716,4,712,8961,1637,1323,7.99,0,7.4,464068,3725,461679,22.12,17.88,1.210945945945946,0.8,99.49
2021-07-07,Himachal Pradesh,723,4,723,9159,2531,1398,7.89,0,7.4,464791,3729,462402,34.2,18.89,1.2377027027027028,0.8,99.49
2021-07-08,Himachal Pradesh,754,7,753,9501,860,791,7.94,0,7.4,465545,3736,463155,11.62,10.69,1.2839189189189189,0.8,99.49
2021-07-09,Himachal Pradesh,889,2,888,11237,3817,2944,7.91,0,7.4,466434,3738,464043,51.58,39.78,1.5185135135135135,0.8,99.49
2021-07-10,Himachal Pradesh,1194,4,1185,14791,1873,748,8.07,5,7.4,467628,3742,465228,25.31,10.11,1.9987837837837839,0.8,99.49
2021-07-11,Himachal Pradesh,827,3,826,10643,2844,914,7.77,0,7.4,468455,3745,466054,38.43,12.35,1.4382432432432433,0.8,99.49
2021-07-12,Himachal Pradesh,1232,15,1226,15772,4993,1917,7.81,0,7.4,469687,3760,467280,67.47,25.91,2.1313513513513516,0.8,99.49
2021-07-13,Himachal Pradesh,671,9,664,8710,2630,1293,7.7,0,7.4,470358,3769,467944,35.54,17.47,1.177027027027027,0.8,99.49
2021-07-14,Himachal Pradesh,160,1,152,2285,3188,1406,7.0,7,7.4,470518,3770,468096,43.08,19.0,0.3087837837837838,0.8,99.49
2021-07-15,Himachal Pradesh,813,7,809,10025,4921,253,8.11,0,7.4,471331,3777,468905,66.5,3.42,1.3547297297297298,0.8,99.49
2021-07-16,Himachal Pradesh,1202,6,1193,14837,4003,2968,8.1,3,7.4,472533,3783,470098,54.09,40.11,2.005,0.8,99.48
2021-07-17,Himachal Pradesh,942,10,934,12133,2844,1980,7.76,0,7.4,473475,3793,471032,38.43,26.76,1.6395945945945947,0.8,99.48
2021-07-18,Himachal Pradesh,157,0,157,2427,4453,3019,6.47,0,7.4,473632,3793,471189,60.18,40.8,0.32797297297297295,0.8,99.48
2021-07-19,Himachal Pradesh,1394,11,1390,17043,2079,925,8.18,0,7.4,475026,3804,472579,28.09,12.5,2.303108108108108,0.8,99.48
2021-07-20,Himachal Pradesh,1321,5,1315,16141,1567,340,8.18,1,7.4,476347,3809,473894,21.18,4.59,2.181216216216216,0.8,99.49
2021-07-21,Himachal Pradesh,393,1,392,4536,4871,1679,8.66,0,7.4,476740,3810,474286,65.82,22.69,0.6129729729729729,0.8,99.49
2021-07-22,Himachal Pradesh,144,1,139,1939,1576,720,7.43,4,7.4,476884,3811,474425,21.3,9.73,0.262027027027027,0.8,99.48
2021-07-23,Himachal Pradesh,1165,8,1158,14531,4153,19,8.02,0,7.4,478049,3819,475583,56.12,0.26,1.9636486486486486,0.8,99.48
2021-07-24,Himachal Pradesh,1234,14,1234,15527,1805,991,7.95,0,7.4,479283,3833,476817,24.39,13.39,2.0982432432432434,0.8,99.49
2021-07-25,Himachal Pradesh,359,4,350,4382,394,82,8.19,5,7.4,479642,3837,477167,5.32,1.11,0.5921621621621621,0.8,99.48
2021-07-26,Himachal Pradesh,1436,7,1434,17422,1767,1178,8.24,0,7.4,481078,3844,478601,23.88,15.92,2.3543243243243244,0.8,99.49
2021-07-27,Himachal Pradesh,1256,12,1252,15931,3722,2018,7.88,0,7.4,482334,3856,479853,50.3,27.27,2.1528378378378377,0.8,99.49
2021-07-28,Himachal Pradesh,1391,4,1388,17373,3607,1486,8.01,0,7.4,483725,3860,481241,48.74,20.08,2.3477027027027026,0.8,99.49
2021-07-29,Himachal Pradesh,186,0,180,2259,4846,2110,8.23,6,7.4,483911,3860,481421,65.49,28.51,0.30527027027027026,0.8,99.49
2021-07-30,Himachal Pradesh,729,8,725,9170,4953,3554,7.95,0,7.4,484640,3868,482146,66.93,48.03,1.2391891891891893,0.8,99.49
2021-07-31,Himachal Pradesh,1245,7,1238,15341,604,252,8.12,0,7.4,485885,3875,483384,8.16,3.41,2.073108108108108,0.8,99.49
2021-08-01,Himachal Pradesh,1135,12,1127,14396,2756,2211,7.88,0,7.4,487020,3887,484511,37.24,29.88,1.9454054054054053,0.8,99.48
2021-08-02,Himachal Pradesh,627,5,626,7795,2834,897,8.04,0,7.4,487647,3892,485137,38.3,12.12,1.0533783783783783,0.8,99.49
2021-08-03,Himachal Pradesh,731,4,725,9235,2998,2727,7.92,2,7.4,488378,3896,485862,40.51,36.85,1.247972972972973,0.8,99.48
2021-08-04,Himachal Pradesh,1063,13,1063,12952,4009,1365,8.21,0,7.4,489441,3909,486925,54.18,18.45,1.7502702702702704,0.8,99.49
2021-08-05,Himachal Pradesh,1139,10,1133,14149,93,15,8.05,0,7.4,490580,3919,488058,1.26,0.2,1.912027027027027,0.8,99.49
2021-08-06,Himachal Pradesh,205,1,205,2743,4302,4072,7.47,0,7.4,490785,3920,488263,58.14,55.03,0.37067567567567566,0.8,99.49
2021-08-07,Himachal Pradesh,346,1,339,4503,3855,3566,7.68,6,7.4,491131,3921,488602,52.09,48.19,0.6085135135135135,0.8,99.49
2021-08-08,Himachal Pradesh,289,3,282,4043,3985,991,7.15,4,7.4,491420,3924,488884,53.85,13.39,0.5463513513513514,0.8,99.48
2021-08-09,Himachal Pradesh,1525,13,1522,19264,639,438,7.92,0,7.4,492945,3937,490406,8.64,5.92,2.6032432432432433,0.8,99.48
2021-08-10,Himachal Pradesh,535,2,531,6397,460,383,8.36,2,7.4,493480,3939,490937,6.22,5.18,0.8644594594594595,0.8,99.48
2021-08-11,Himachal Pradesh,1425,7,1423,17372,4731,4280,8.2,0,7.4,494905,3946,492360,63.93,57.84,2.3475675675675673,0.8,99.49
2021-08-12,Himachal Pradesh,628,7,623,7839,970,550,8.01,0,7.4,495533,3953,492983,13.11,7.43,1.0593243243243242,0.8,99.49
2021-08-13,Himachal Pradesh,1573,22,1567,19259,3751,1121,8.17,0,7.4,497106,3975,494550,50.69,15.15,2.6025675675675677,0.8,99.49
2021-08-14,Himachal Pradesh,778,11,772,9856,4631,3757,7.89,0,7.4,497884,3986,495322,62.58,50.77,1.3318918918918918,0.8,99.49
2021-08-15,Himachal Pradesh,89,0,80,1212,3649,3386,7.34,9,7.4,497973,3986,495402,49.31,45.76,0.16378378378378378,0.8,99.48
2021-08-16,Himachal Pradesh,1505,22,1500,18945,190,20,7.94,0,7.4,499478,4008,496902,2.57,0.27,2.5601351351351354,0.8,99.48
2021-08-17,Himachal Pradesh,525,3,518,6415,754,742,8.18,4,7.4,500003,4011,497420,10.19,10.03,0.8668918918918919,0.8,99.48
2021-08-18,Himachal Pradesh,463,2,455,5352,4198,1924,8.65,6,7.4,500466,4013,497875,56.73,26.0,0.7232432432432433,0.8,99.48
2021-08-19,Himachal Pradesh,939,11,934,11765,4468,558,7.98,0,7.4,501405,4024,498809,60.38,7.54,1.5898648648648648,0.8,99.48
2021-08-20,Himachal Pradesh,1335,15,1326,16759,3040,18,7.97,0,7.4,502740,4039,500135,41.08,0.24,2.2647297297297295,0.8,99.48
2021-08-21,Himachal Pradesh,680,8,676,8606,2678,121,7.9,0,7.4,503420,4047,500811,36.19,1.64,1.162972972972973,0.8,99.48
2021-08-22,Himachal Pradesh,656,6,650,7930,1852,570,8.27,0,7.4,504076,4053,501461,25.03,7.7,1.0716216216216217,0.8,99.48
2021-08-23,Himachal Pradesh,1291,6,1284,16128,4543,3702,8.0,1,7.4,505367,4059,502745,61.39,50.03,2.1794594594594594,0.8,99.48
2021-08-24,Himachal Pradesh,1496,9,1491,18892,2579,2069,7.92,0,7.4,506863,4068,504236,34.85,27.96,2.552972972972973,0.8,99.48
2021-08-25,Himachal Pradesh,1436,14,1428,18311,2660,2579,7.84,0,7.4,508299,4082,505664,35.95,34.85,2.4744594594594593,0.8,99.48
2021-08-26,Himachal Pradesh,799,5,795,9701,732,543,8.24,0,7.4,509098,4087,506459,9.89,7.34,1.310945945945946,0.8,99.48
2021-08-27,Himachal Pradesh,437,5,437,5420,2736,1062,8.06,0,7.4,509535,4092,506896,36.97,14.35,0.7324324324324324,0.8,99.48
2021-08-28,Himachal Pradesh,325,3,321,3666,4992,3260,8.87,1,7.4,509860,4095,507217,67.46,44.05,0.4954054054054054,0.8,99.48
2021-08-29,Himachal Pradesh,1508,10,1499,19022,3193,2978,7.93,0,7.4,511368,4105,508716,43.15,40.24,2.5705405405405406,0.8,99.48
2021-08-30,Himachal Pradesh,190,1,187,2298,4596,2707,8.27,2,7.4,511558,4106,508903,62.11,36.58,0.31054054054054053,0.8,99.48
2021-08-31,Himachal Pradesh,458,1,454,6057,895,471,7.56,3,7.4,512016,4107,509357,12.09,6.36,0.8185135135135135,0.8,99.48
2021-09-01,Himachal Pradesh,985,7,977,12597,1706,367,7.82,1,7.4,513001,4114,510334,23.05,4.96,1.7022972972972974,0.8,99.48
2021-09-02,Himachal Pradesh,751,2,751,9783,4867,3934,7.68,0,7.4,513752,4116,511085,65.77,53.16,1.3220270270270271,0.8,99.48
2021-09-03,Himachal Pradesh,83,0,80,954,1683,53,8.7,3,7.4,513835,4116,511165,22.74,0.72,0.1289189189189189,0.8,99.48
2021-09-04,Himachal Pradesh,1267,18,1266,16076,2307,647,7.88,0,7.4,515102,4134,512431,31.18,8.74,2.1724324324324322,0.8,99.48
2021-09-05,Himachal Pradesh,1018,9,1012,12820,1792,1583,7.94,0,7.4,516120,4143,513443,24.22,21.39,1.7324324324324325,0.8,99.48
2021-09-06,Himachal Pradesh,1484,19,1478,18446,1793,1535,8.05,0,7.4,517604,4162,514921,24.23,20.74,2.4927027027027027,0.8,99.48
2021-09-07,Himachal Pradesh,1514,9,1507,18799,4452,4274,8.05,0,7.4,519118,4171,516428,60.16,57.76,2.5404054054054055,0.8,99.48
2021-09-08,Himachal Pradesh,1152,11,1145,14420,3811,3115,7.99,0,7.4,520270,4182,517573,51.5,42.09,1.9486486486486487,0.8,99.48
2021-09-09,Himachal Pradesh,930,8,921,11818,4063,315,7.87,1,7.4,521200,4190,518494,54.91,4.26,1.597027027027027,0.8,99.48
2021-09-10,Himachal Pradesh,707,10,706,8984,2168,326,7.87,0,7.4,521907,4200,519200,29.3,4.41,1.214054054054054,0.8,99.48
2021-09-11,Himachal Pradesh,925,11,921,11844,3704,346,7.81,0,7.4,522832,4211,520121,50.05,4.68,1.6005405405405406,0.81,99.48
2021-09-12,Himachal Pradesh,1308,18,1302,15939,184,141,8.21,0,7.4,524140,4229,521423,2.49,1.91,2.1539189189189187,0.81,99.48
2021-09-13,Himachal Pradesh,1626,18,1620,19729,4794,1114,8.24,0,7.4,525766,4247,523043,64.78,15.05,2.666081081081081,0.81,99.48
2021-09-14,Himachal Pradesh,1249,10,1246,15335,2454,1082,8.14,0,7.4,527015,4257,524289,33.16,14.62,2.0722972972972973,0.81,99.48
2021-09-15,Himachal Pradesh,966,6,959,12537,4514,4479,7.71,1,7.4,527981,4263,525248,61.0,60.53,1.6941891891891891,0.81,99.48
2021-09-16,Himachal Pradesh,1561,18,1559,19439,3964,22,8.03,0,7.4,529542,4281,526807,53.57,0.3,2.626891891891892,0.81,99.48
2021-09-17,Himachal Pradesh,1511,10,1503,19059,167,23,7.93,0,7.4,531053,4291,528310,2.26,0.31,2.5755405405405405,0.81,99.48
2021-09-18,Himachal Pradesh,483,3,474,6053,884,514,7.98,6,7.4,531536,4294,528784,11.95,6.95,0.817972972972973,0.81,99.48
2021-09-19,Himachal Pradesh,428,2,422,6099,3224,1792,7.02,4,7.4,531964,4296,529206,43.57,24.22,0.8241891891891892,0.81,99.48
2021-09-20,Himachal Pradesh,363,3,356,5113,3649,1539,7.1,4,7.4,532327,4299,529562,49.31,20.8,0.6909459459459459,0.81,99.48
2021-09-21,Himachal Pradesh,1053,5,1049,13473,1777,1291,7.82,0,7.4,533380,4304,530611,24.01,17.45,1.8206756756756757,0.81,99.48
2021-09-22,Himachal Pradesh,1403,8,1403,17681,845,282,7.94,0,7.4,534783,4312,532014,11.42,3.81,2.3893243243243245,0.81,99.48
2021-09-23,Himachal Pradesh,1460,4,1456,17752,4787,3933,8.22,0,7.4,536243,4316,533470,64.69,53.15,2.398918918918919,0.8,99.48
2021-09-24,Himachal Pradesh,450,2,447,5714,818,530,7.88,1,7.4,536693,4318,533917,11.05,7.16,0.7721621621621622,0.8,99.48
2021-09-25,Himachal Pradesh,295,1,292,3547,184,9,8.32,2,7.4,536988,4319,534209,2.49,0.12,0.4793243243243243,0.8,99.48
2021-09-26,Himachal Pradesh,1273,17,1265,15700,4275,1044,8.11,0,7.4,538261,4336,535474,57.77,14.11,2.1216216216216215,0.81,99.48
2021-09-27,Himachal Pradesh,604,3,598,7505,1816,1539,8.05,3,7.4,538865,4339,536072,24.54,20.8,1.0141891891891892,0.81,99.48
2021-09-28,Himachal Pradesh,235,1,232,2576,1274,1161,9.12,2,7.4,539100,4340,536304,17.22,15.69,0.3481081081081081,0.81,99.48
2021-09-29,Himachal Pradesh,1168,5,1166,14701,3833,764,7.95,0,7.4,540268,4345,537470,51.8,10.32,1.9866216216216217,0.8,99.48
2021-09-30,Himachal Pradesh,892,11,891,11404,134,105,7.82,0,7.4,541160,4356,538361,1.81,1.42,1.541081081081081,0.8,99.48
2021-10-01,Himachal Pradesh,1567,13,1562,19362,208,139,8.09,0,7.4,542727,4369,539923,2.81,1.88,2.6164864864864863,0.81,99.48
2021-10-02,Himachal Pradesh,100,0,100,1172,1236,642,8.53,0,7.4,542827,4369,540023,16.7,8.68,0.15837837837837837,0.8,99.48
2021-10-03,Himachal Pradesh,676,7,674,8375,1596,1355,8.07,0,7.4,543503,4376,540697,21.57,18.31,1.1317567567567568,0.81,99.48
2021-10-04,Himachal Pradesh,1342,13,1338,16677,1292,336,8.05,0,7.4,544845,4389,542035,17.46,4.54,2.2536486486486487,0.81,99.48
2021-10-05,Himachal Pradesh,1197,11,1192,15269,3376,2262,7.84,0,7.4,546042,4400,543227,45.62,30.57,2.0633783783783786,0.81,99.48
2021-10-06,Himachal Pradesh,746,5,738,9453,783,320,7.89,3,7.4,546788,4405,543965,10.58,4.32,1.2774324324324324,0.81,99.48
2021-10-07,Himachal Pradesh,1484,18,1479,18444,2858,2295,8.05,0,7.4,548272,4423,545444,38.62,31.01,2.4924324324324325,0.81,99.48
2021-10-08,Himachal Pradesh,807,11,807,10045,2506,1886,8.03,0,7.4,549079,4434,546251,33.86,25.49,1.3574324324324325,0.81,99.48
2021-10-09,Himachal Pradesh,1057,12,1054,13041,2679,651,8.11,0,7.4,550136,4446,547305,36.2,8.8,1.7622972972972972,0.81,99.49
2021-10-10,Himachal Pradesh,1489,18,1489,18479,1366,686,8.06,0,7.4,551625,4464,548794,18.46,9.27,2.4971621621621622,0.81,99.49
2021-10-11,Himachal Pradesh,482,6,474,5807,3596,1253,8.3,2,7.4,552107,4470,549268,48.59,16.93,0.7847297297297298,0.81,99.49
2021-10-12,Himachal Pradesh,1445,8,1440,17956,4569,1402,8.05,0,7.4,553552,4478,550708,61.74,18.95,2.4264864864864863,0.81,99.49
2021-10-13,Himachal Pradesh,286,3,282,3922,4813,2335,7.29,1,7.4,553838,4481,550990,65.04,31.55,0.53,0.81,99.49
2021-10-14,Himachal Pradesh,1501,13,1499,18513,380,178,8.11,0,7.4,555339,4494,552489,5.14,2.41,2.5017567567567567,0.81,99.49
2021-10-15,Himachal Pradesh,1020,14,1017,12782,4695,1722,7.98,0,7.4,556359,4508,553506,63.45,23.27,1.7272972972972973,0.81,99.49
2021-10-16,Himachal Pradesh,1358,4,1352,16577,2017,1199,8.19,2,7.4,557717,4512,554858,27.26,16.2,2.240135135135135,0.81,99.49
2021-10-17,Himachal Pradesh,1183,6,1175,15008,4592,1408,7.88,2,7.4,558900,4518,556033,62.05,19.03,2.0281081081081083,0.81,99.49
2021-10-18,Himachal Pradesh,878,6,871,11116,1184,1082,7.9,1,7.4,559778,4524,556904,16.0,14.62,1.5021621621621621,0.81,99.49
2021-10-19,Himachal Pradesh,591,6,590,7765,4781,1438,7.61,0,7.4,560369,4530,557494,64.61,19.43,1.0493243243243244,0.81,99.49
2021-10-20,Himachal Pradesh,880,8,873,10890,1838,961,8.08,0,7.4,561249,4538,558367,24.84,12.99,1.4716216216216216,0.81,99.49
2021-10-21,Himachal Pradesh,1117,15,1114,14006,2654,948,7.98,0,7.4,562366,4553,559481,35.86,12.81,1.8927027027027028,0.81,99.49
2021-10-22,Himachal Pradesh,1447,10,1442,18562,255,211,7.8,0,7.4,563813,4563,560923,3.45,2.85,2.5083783783783784,0.81,99.49
2021-10-23,Himachal Pradesh,1515,13,1511,18589,4403,596,8.15,0,7.4,565328,4576,562434,59.5,8.05,2.512027027027027,0.81,99.49
2021-10-24,Himachal Pradesh,526,3,518,6645,1819,177,7.92,5,7.4,565854,4579,562952,24.58,2.39,0.897972972972973,0.81,99.49
2021-10-25,Himachal Pradesh,1351,5,1350,16421,2823,1065,8.23,0,7.4,567205,4584,564302,38.15,14.39,2.219054054054054,0.81,99.49
2021-10-26,Himachal Pradesh,106,0,98,1309,4361,2183,8.1,8,7.4,567311,4584,564400,58.93,29.5,0.1768918918918919,0.81,99.49
2021-10-27,Himachal Pradesh,462,5,456,6094,2519,2137,7.58,1,7.4,567773,4589,564856,34.04,28.88,0.8235135135135135,0.81,99.49
2021-10-28,Himachal Pradesh,803,10,798,10248,55,9,7.84,0,7.4,568576,4599,565654,0.74,0.12,1.384864864864865,0.81,99.49
2021-10-29,Himachal Pradesh,149,0,143,1947,3060,90,7.65,6,7.4,568725,4599,565797,41.35,1.22,0.2631081081081081,0.81,99.49
2021-10-30,Himachal Pradesh,1372,14,1370,17380,725,187,7.89,0,7.4,570097,4613,567167,9.8,2.53,2.348648648648649,0.81,99.49
2021-10-31,Himachal Pradesh,1602,10,1598,19978,624,435,8.02,0,7.4,571699,4623,568765,8.43,5.88,2.6997297297297296,0.81,99.49
2021-11-01,Himachal Pradesh,1076,13,1068,13482,2915,1631,7.98,0,7.4,572775,4636,569833,39.39,22.04,1.8218918918918918,0.81,99.49
2021-11-02,Himachal Pradesh,1232,7,1229,15673,4398,2327,7.86,0,7.4,574007,4643,571062,59.43,31.45,2.117972972972973,0.81,99.49
2021-11-03,Himachal Pradesh,617,5,615,7989,218,56,7.72,0,7.4,574624,4648,571677,2.95,0.76,1.0795945945945946,0.81,99.49
2021-11-04,Himachal Pradesh,1376,12,1370,16658,8,8,8.26,0,7.4,576000,4660,573047,0.11,0.11,2.251081081081081,0.81,99.49
2021-11-05,Himachal Pradesh,828,4,819,10494,3679,277,7.89,5,7.4,576828,4664,573866,49.72,3.74,1.4181081081081082,0.81,99.49
2021-11-06,Himachal Pradesh,1024,7,1020,12500,3308,3041,8.19,0,7.4,577852,4671,574886,44.7,41.09,1.6891891891891893,0.81,99.49
2021-11-07,Himachal Pradesh,822,7,819,10138,517,64,8.11,0,7.4,578674,4678,575705,6.99,0.86,1.37,0.81,99.49
2021-11-08,Himachal Pradesh,742,5,735,9285,4078,2999,7.99,2,7.4,579416,4683,576440,55.11,40.53,1.2547297297297297,0.81,99.49
2021-11-09,Himachal Pradesh,1391,5,1386,17735,3213,885,7.84,0,7.4,580807,4688,577826,43.42,11.96,2.3966216216216214,0.81,99.49
2021-11-10,Himachal Pradesh,1072,15,1064,13256,4754,960,8.09,0,7.4,581879,4703,578890,64.24,12.97,1.7913513513513513,0.81,99.49
2021-11-11,Himachal Pradesh,141,0,138,1991,4384,2703,7.08,3,7.4,582020,4703,579028,59.24,36.53,0.2690540540540541,0.81,99.49
2021-11-12,Himachal Pradesh,168,1,162,2062,1924,1117,8.15,5,7.4,582188,4704,579190,26.0,15.09,0.27864864864864863,0.81,99.49
2021-11-13,Himachal Pradesh,1321,16,1319,16773,2402,815,7.88,0,7.4,583509,4720,580509,32.46,11.01,2.2666216216216215,0.81,99.49
2021-11-14,Himachal Pradesh,1554,12,1552,19353,1839,790,8.03,0,7.4,585063,4732,582061,24.85,10.68,2.6152702702702704,0.81,99.49
2021-11-15,Himachal Pradesh,1105,16,1098,13979,4893,1128,7.9,0,7.4,586168,4748,583159,66.12,15.24,1.8890540540540541,0.81,99.49
2021-11-16,Himachal Pradesh,865,10,863,11061,3877,1238,7.82,0,7.4,587033,4758,584022,52.39,16.73,1.4947297297297297,0.81,99.49
2021-11-17,Himachal Pradesh,78,0,72,1261,1308,381,6.19,6,7.4,587111,4758,584094,17.68,5.15,0.1704054054054054,0.81,99.49
2021-11-18,Himachal Pradesh,440,5,436,5278,366,195,8.34,0,7.4,587551,4763,584530,4.95,2.64,0.7132432432432433,0.81,99.49
2021-11-19,Himachal Pradesh,53,0,51,640,359,234,8.28,2,7.4,587604,4763,584581,4.85,3.16,0.08648648648648649,0.81,99.49
2021-11-20,Himachal Pradesh,779,3,770,9518,3033,2480,8.18,6,7.4,588383,4766,585351,40.99,33.51,1.2862162162162163,0.81,99.48
2021-11-21,Himachal Pradesh,909,4,909,11564,638,593,7.86,0,7.4,589292,4770,586260,8.62,8.01,1.5627027027027027,0.81,99.49
2021-11-22,Himachal Pradesh,1012,13,1009,12582,2572,319,8.04,0,7.4,590304,4783,587269,34.76,4.31,1.7002702702702703,0.81,99.49
2021-11-23,Himachal Pradesh,750,3,749,9504,447,10,7.89,0,7.4,591054,4786,588018,6.04,0.14,1.2843243243243243,0.81,99.49
2021-11-24,Himachal Pradesh,1606,14,1597,19920,4395,3348,8.06,0,7.4,592660,4800,589615,59.39,45.24,2.691891891891892,0.81,99.49
2021-11-25,Himachal Pradesh,574,5,570,7524,4053,1100,7.63,0,7.4,593234,4805,590185,54.77,14.86,1.0167567567567568,0.81,99.49
2021-11-26,Himachal Pradesh,548,3,541,6762,2667,278,8.1,4,7.4,593782,4808,590726,36.04,3.76,0.9137837837837838,0.81,99.49
2021-11-27,Himachal Pradesh,1435,15,1431,18157,2994,2775,7.9,0,7.4,595217,4823,592157,40.46,37.5,2.453648648648649,0.81,99.49
2021-11-28,Himachal Pradesh,102,0,99,1462,3748,2953,6.98,3,7.4,595319,4823,592256,50.65,39.91,0.19756756756756758,0.81,99.49
2021-11-29,Himachal Pradesh,494,6,494,6017,2819,576,8.21,0,7.4,595813,4829,592750,38.09,7.78,0.8131081081081081,0.81,99.49
2021-11-30,Himachal Pradesh,1523,7,1516,19069,1083,379,7.99,0,7.4,597336,4836,594266,14.64,5.12,2.5768918918918917,0.81,99.49
2021-12-01,Himachal Pradesh,1363,7,1360,16779,2583,585,8.12,0,7.4,598699,4843,595626,34.91,7.91,2.2674324324324324,0.81,99.49
2021-12-02,Himachal Pradesh,1240,10,1232,14942,1980,631,8.3,0,7.4,599939,4853,596858,26.76,8.53,2.019189189189189,0.81,99.49
2021-12-03,Himachal Pradesh,1414,16,1407,17955,1413,146,7.88,0,7.4,601353,4869,598265,19.09,1.97,2.4263513513513515,0.81,99.49
2021-12-04,Himachal Pradesh,59,0,58,658,739,44,8.97,1,7.4,601412,4869,598323,9.99,0.59,0.08891891891891891,0.81,99.49
2021-12-05,Himachal Pradesh,602,4,596,7568,1482,34,7.95,2,7.4,602014,4873,598919,20.03,0.46,1.0227027027027027,0.81,99.49
2021-12-06,Himachal Pradesh,1383,18,1381,17012,1636,1246,8.13,0,7.4,603397,4891,600300,22.11,16.84,2.2989189189189188,0.81,99.49
2021-12-07,Himachal Pradesh,156,1,148,1867,3604,3029,8.36,7,7.4,603553,4892,600448,48.7,40.93,0.2522972972972973,0.81,99.49
2021-12-08,Himachal Pradesh,517,4,514,6314,151,134,8.19,0,7.4,604070,4896,600962,2.04,1.81,0.8532432432432432,0.81,99.49
2021-12-09,Himachal Pradesh,1550,8,1546,19250,2567,2541,8.05,0,7.4,605620,4904,602508,34.69,34.34,2.6013513513513513,0.81,99.49
2021-12-10,Himachal Pradesh,1255,4,1246,15718,2800,1995,7.98,5,7.4,606875,4908,603754,37.84,26.96,2.1240540540540542,0.81,99.49
2021-12-11,Himachal Pradesh,1154,8,1154,14345,2638,258,8.04,0,7.4,608029,4916,604908,35.65,3.49,1.9385135135135134,0.81,99.49
2021-12-12,Himachal Pradesh,1048,10,1044,13018,3438,2743,8.05,0,7.4,609077,4926,605952,46.46,37.07,1.759189189189189,0.81,99.49
2021-12-13,Himachal Pradesh,388,5,380,4753,3979,1365,8.16,3,7.4,609465,4931,606332,53.77,18.45,0.6422972972972973,0.81,99.49
2021-12-14,Himachal Pradesh,612,2,611,7639,1789,1486,8.01,0,7.4,610077,4933,606943,24.18,20.08,1.0322972972972972,0.81,99.49
2021-12-15,Himachal Pradesh,1533,17,1527,18972,147,64,8.08,0,7.4,611610,4950,608470,1.99,0.86,2.5637837837837836,0.81,99.49
2021-12-16,Himachal Pradesh,990,14,987,12418,3135,987,7.97,0,7.4,612600,4964,609457,42.36,13.34,1.6781081081081082,0.81,99.49
2021-12-17,Himachal Pradesh,1360,4,1359,17157,2413,2167,7.93,0,7.4,613960,4968,610816,32.61,29.28,2.3185135135135133,0.81,99.49
2021-12-18,Himachal Pradesh,1005,13,999,12688,2327,114,7.92,0,7.4,614965,4981,611815,31.45,1.54,1.7145945945945946,0.81,99.49
2021-12-19,Himachal Pradesh,942,5,937,11725,3838,2177,8.03,0,7.4,615907,4986,612752,51.86,29.42,1.5844594594594594,0.81,99.49
2021-12-20,Himachal Pradesh,735,5,728,9340,1811,1642,7.87,2,7.4,616642,4991,613480,24.47,22.19,1.2621621621621621,0.81,99.49
2021-12-21,Himachal Pradesh,18,0,11,556,686,391,3.24,7,7.4,616660,4991,613491,9.27,5.28,0.07513513513513513,0.81,99.49
2021-12-22,Himachal Pradesh,114,0,105,1430,2557,908,7.97,9,7.4,616774,4991,613596,34.55,12.27,0.19324324324324324,0.81,99.48
2021-12-23,Himachal Pradesh,1064,7,1056,13004,4690,2180,8.18,1,7.4,617838,4998,614652,63.38,29.46,1.7572972972972973,0.81,99.48
2021-12-24,Himachal Pradesh,1082,10,1076,13468,2725,2277,8.03,0,7.4,618920,5008,615728,36.82,30.77,1.82,0.81,99.48
2021-12-25,Himachal Pradesh,815,11,812,10280,405,266,7.93,0,7.4,619735,5019,616540,5.47,3.59,1.3891891891891892,0.81,99.48
2021-12-26,Himachal Pradesh,1282,4,1273,15836,999,838,8.1,5,7.4,621017,5023,617813,13.5,11.32,2.14,0.81,99.48
2021-12-27,Himachal Pradesh,1512,9,1508,18863,2899,1118,8.02,0,7.4,622529,5032,619321,39.18,15.11,2.549054054054054,0.81,99.48
2021-12-28,Himachal Pradesh,1155,5,1146,14127,1813,865,8.18,4,7.4,623684,5037,620467,24.5,11.69,1.9090540540540542,0.81,99.48
2021-12-29,Himachal Pradesh,1599,10,1596,19707,2443,1066,8.11,0,7.4,625283,5047,622063,33.01,14.41,2.663108108108108,0.81,99.49
2021-12-30,Himachal Pradesh,713,9,711,9108,1317,1058,7.83,0,7.4,625996,5056,622774,17.8,14.3,1.230810810810811,0.81,99.49
2021-12-31,Himachal Pradesh,1081,15,1079,13725,410,378,7.88,0,7.4,627077,5071,623853,5.54,5.11,1.8547297297297298,0.81,99.49
2022-01-01,Himachal Pradesh,1497,10,1494,18740,3002,1957,7.99,0,7.4,628574,5081,625347,40.57,26.45,2.5324324324324325,0.81,99.49
2022-01-02,Himachal Pradesh,834,4,827,10178,1224,653,8.19,3,7.4,629408,5085,626174,16.54,8.82,1.3754054054054055,0.81,99.49
2022-01-03,Himachal Pradesh,753,9,750,9242,4677,1306,8.15,0,7.4,630161,5094,626924,63.2,17.65,1.248918918918919,0.81,99.49
2022-01-04,Himachal Pradesh,557,4,556,7044,2341,72,7.91,0,7.4,630718,5098,627480,31.64,0.97,0.9518918918918919,0.81,99.49
2022-01-05,Himachal Pradesh,140,0,136,2267,3236,338,6.18,4,7.4,630858,5098,627616,43.73,4.57,0.30635135135135133,0.81,99.49
2022-01-06,Himachal Pradesh,250,2,250,3329,3440,983,7.51,0,7.4,631108,5100,627866,46.49,13.28,0.4498648648648649,0.81,99.49
2022-01-07,Himachal Pradesh,1002,5,1002,12667,2148,2066,7.91,0,7.4,632110,5105,628868,29.03,27.92,1.7117567567567566,0.81,99.49
2022-01-08,Himachal Pradesh,222,0,220,2651,1491,656,8.37,2,7.4,632332,5105,629088,20.15,8.86,0.35824324324324325,0.81,99.49
2022-01-09,Himachal Pradesh,1444,11,1443,18083,1520,577,7.99,0,7.4,633776,5116,630531,20.54,7.8,2.4436486486486486,0.81,99.49
2022-01-10,Himachal Pradesh,1612,10,1611,19574,3813,2516,8.24,0,7.4,635388,5126,632142,51.53,34.0,2.6451351351351353,0.81,99.49
2022-01-11,Himachal Pradesh,1618,23,1611,19802,1801,581,8.17,0,7.4,637006,5149,633753,24.34,7.85,2.675945945945946,0.81,99.49
2022-01-12,Himachal Pradesh,136,1,134,1519,442,344,8.95,1,7.4,637142,5150,633887,5.97,4.65,0.20527027027027028,0.81,99.49
2022-01-13,Himachal Pradesh,1093,13,1086,13832,1441,27,7.9,0,7.4,638235,5163,634973,19.47,0.36,1.8691891891891892,0.81,99.49
2022-01-14,Himachal Pradesh,341,4,337,4271,4506,3500,7.98,0,7.4,638576,5167,635310,60.89,47.3,0.5771621621621622,0.81,99.49
2022-01-15,Himachal Pradesh,445,5,445,5481,2707,251,8.12,0,7.4,639021,5172,635755,36.58,3.39,0.7406756756756757,0.81,99.49
2022-01-16,Himachal Pradesh,1126,5,1118,14498,3528,1387,7.77,3,7.4,640147,5177,636873,47.68,18.74,1.9591891891891893,0.81,99.49
2022-01-17,Himachal Pradesh,341,1,333,4392,3945,624,7.76,7,7.4,640488,5178,637206,53.31,8.43,0.5935135135135136,0.81,99.49
2022-01-18,Himachal Pradesh,802,3,800,9722,301,168,8.25,0,7.4,641290,5181,638006,4.07,2.27,1.3137837837837838,0.81,99.49
2022-01-19,Himachal Pradesh,1486,21,1481,18626,1461,99,7.98,0,7.4,642776,5202,639487,19.74,1.34,2.517027027027027,0.81,99.49
2022-01-20,Himachal Pradesh,759,6,755,9459,3965,404,8.02,0,7.4,643535,5208,640242,53.58,5.46,1.2782432432432433,0.81,99.49
2022-01-21,Himachal Pradesh,1194,12,1194,15198,3741,1686,7.86,0,7.4,644729,5220,641436,50.55,22.78,2.053783783783784,0.81,99.49
2022-01-22,Himachal Pradesh,1525,19,1525,19362,2213,1249,7.88,0,7.4,646254,5239,642961,29.91,16.88,2.6164864864864863,0.81,99.49
2022-01-23,Himachal Pradesh,1322,16,1318,16297,3925,2296,8.11,0,7.4,647576,5255,644279,53.04,31.03,2.202297297297297,0.81,99.49
2022-01-24,Himachal Pradesh,859,5,859,10855,2057,614,7.91,0,7.4,648435,5260,645138,27.8,8.3,1.4668918918918918,0.81,99.49
2022-01-25,Himachal Pradesh,1446,19,1445,18007,4154,2552,8.03,0,7.4,649881,5279,646583,56.14,34.49,2.4333783783783782,0.81,99.49
2022-01-26,Himachal Pradesh,1226,17,1221,15555,3633,3488,7.88,0,7.4,651107,5296,647804,49.09,47.14,2.102027027027027,0.81,99.49
2022-01-27,Himachal Pradesh,1079,13,1076,12653,4544,2386,8.53,0,7.4,652186,5309,648880,61.41,32.24,1.7098648648648649,0.81,99.49
2022-01-28,Himachal Pradesh,1143,13,1137,14383,744,595,7.95,0,7.4,653329,5322,650017,10.05,8.04,1.9436486486486486,0.81,99.49
2022-01-29,Himachal Pradesh,420,2,416,4977,2501,1283,8.44,2,7.4,653749,5324,650433,33.8,17.34,0.6725675675675675,0.81,99.49
2022-01-30,Himachal Pradesh,1514,22,1513,19026,4188,4030,7.96,0,7.4,655263,5346,651946,56.59,54.46,2.571081081081081,0.82,99.49
2022-01-31,Himachal Pradesh,105,1,98,1134,4002,2285,9.26,6,7.4,655368,5347,652044,54.08,30.88,0.15324324324324323,0.82,99.49
2022-02-01,Himachal Pradesh,381,2,372,4910,2407,615,7.76,7,7.4,655749,5349,652416,32.53,8.31,0.6635135135135135,0.82,99.49
2022-02-02,Himachal Pradesh,359,3,352,4664,3016,2236,7.7,4,7.4,656108,5352,652768,40.76,30.22,0.6302702702702703,0.82,99.49
2022-02-03,Himachal Pradesh,1476,21,1468,18240,3784,282,8.09,0,7.4,657584,5373,654236,51.14,3.81,2.464864864864865,0.82,99.49
2022-02-04,Himachal Pradesh,1355,5,1352,16903,4298,227,8.02,0,7.4,658939,5378,655588,58.08,3.07,2.2841891891891892,0.82,99.49
2022-02-05,Himachal Pradesh,1065,6,1065,13783,2024,1572,7.73,0,7.4,660004,5384,656653,27.35,21.24,1.8625675675675675,0.82,99.49
2022-02-06,Himachal Pradesh,647,6,639,7681,3643,209,8.42,2,7.4,660651,5390,657292,49.23,2.82,1.037972972972973,0.82,99.49
2022-02-07,Himachal Pradesh,474,4,469,5748,3089,2419,8.25,1,7.4,661125,5394,657761,41.74,32.69,0.7767567567567567,0.82,99.49
2022-02-08,Himachal Pradesh,909,5,908,11225,4389,1992,8.1,0,7.4,662034,5399,658669,59.31,26.92,1.5168918918918919,0.82,99.49
2022-02-09,Himachal Pradesh,357,2,356,4786,4212,3953,7.46,0,7.4,662391,5401,659025,56.92,53.42,0.6467567567567568,0.82,99.49
2022-02-10,Himachal Pradesh,1101,13,1096,13880,278,203,7.93,0,7.4,663492,5414,660121,3.76,2.74,1.8756756756756756,0.82,99.49
2022-02-11,Himachal Pradesh,1598,21,1597,19743,1693,1496,8.09,0,7.4,665090,5435,661718,22.88,20.22,2.667972972972973,0.82,99.49
2022-02-12,Himachal Pradesh,1511,20,1504,19127,4399,2158,7.9,0,7.4,666601,5455,663222,59.45,29.16,2.58472972972973,0.82,99.49
2022-02-13,Himachal Pradesh,78,0,72,1019,1284,1035,7.65,6,7.4,666679,5455,663294,17.35,13.99,0.1377027027027027,0.82,99.49
2022-02-14,Himachal Pradesh,730,10,724,9053,2082,1445,8.06,0,7.4,667409,5465,664018,28.14,19.53,1.2233783783783785,0.82,99.49
2022-02-15,Himachal Pradesh,1007,9,1001,12255,4506,1083,8.22,0,7.4,668416,5474,665019,60.89,14.64,1.656081081081081,0.82,99.49
2022-02-16,Himachal Pradesh,48,0,44,870,4731,4660,5.52,4,7.4,668464,5474,665063,63.93,62.97,0.11756756756756757,0.82,99.49
2022-02-17,Himachal Pradesh,806,6,802,10125,4861,1493,7.96,0,7.4,669270,5480,665865,65.69,20.18,1.3682432432432432,0.82,99.49
2022-02-18,Himachal Pradesh,381,1,379,4701,929,473,8.1,1,7.4,669651,5481,666244,12.55,6.39,0.6352702702702703,0.82,99.49
2022-02-19,Himachal Pradesh,652,9,645,8277,4393,3740,7.88,0,7.4,670303,5490,666889,59.36,50.54,1.1185135135135136,0.82,99.49
2022-02-20,Himachal Pradesh,1298,12,1298,16146,3150,1591,8.04,0,7.4,671601,5502,668187,42.57,21.5,2.1818918918918917,0.82,99.49
2022-02-21,Himachal Pradesh,1063,12,1055,13538,2097,1438,7.85,0,7.4,672664,5514,669242,28.34,19.43,1.8294594594594595,0.82,99.49
2022-02-22,Himachal Pradesh,217,2,216,2568,1307,1234,8.45,0,7.4,672881,5516,669458,17.66,16.68,0.34702702702702704,0.82,99.49
2022-02-23,Himachal Pradesh,419,2,413,5436,4519,42,7.71,4,7.4,673300,5518,669871,61.07,0.57,0.7345945945945946,0.82,99.49
2022-02-24,Himachal Pradesh,529,5,523,6308,3985,2044,8.39,1,7.4,673829,5523,670394,53.85,27.62,0.8524324324324324,0.82,99.49
2022-02-25,Himachal Pradesh,1207,7,1202,15156,4419,2164,7.96,0,7.4,675036,5530,671596,59.72,29.24,2.0481081081081083,0.82,99.49
2022-02-26,Himachal Pradesh,740,10,734,9694,912,589,7.63,0,7.4,675776,5540,672330,12.32,7.96,1.31,0.82,99.49
2022-02-27,Himachal Pradesh,1207,11,1205,15003,3472,881,8.05,0,7.4,676983,5551,673535,46.92,11.91,2.0274324324324327,0.82,99.49
2022-02-28,Himachal Pradesh,199,0,198,2795,3479,531,7.12,1,7.4,677182,5551,673733,47.01,7.18,0.3777027027027027,0.82,99.49
2022-03-01,Himachal Pradesh,177,0,168,2821,2730,1544,6.27,9,7.4,677359,5551,673901,36.89,20.86,0.3812162162162162,0.82,99.49
2022-03-02,Himachal Pradesh,727,7,722,9358,4782,4028,7.77,0,7.4,678086,5558,674623,64.62,54.43,1.2645945945945947,0.82,99.49
2022-03-03,Himachal Pradesh,1058,6,1055,12784,501,49,8.28,0,7.4,679144,5564,675678,6.77,0.66,1.7275675675675675,0.82,99.49
2022-03-04,Himachal Pradesh,983,8,978,12321,4367,3641,7.98,0,7.4,680127,5572,676656,59.01,49.2,1.665,0.82,99.49
2022-03-05,Himachal Pradesh,1036,14,1034,13171,4148,3766,7.87,0,7.4,681163,5586,677690,56.05,50.89,1.779864864864865,0.82,99.49
2022-03-06,Himachal Pradesh,1097,6,1089,13623,113,30,8.05,2,7.4,682260,5592,678779,1.53,0.41,1.8409459459459458,0.82,99.49
2022-03-07,Himachal Pradesh,1078,12,1072,13374,2348,2097,8.06,0,7.4,683338,5604,679851,31.73,28.34,1.8072972972972974,0.82,99.49
2022-03-08,Himachal Pradesh,1477,21,1472,18295,3747,1227,8.07,0,7.4,684815,5625,681323,50.64,16.58,2.472297297297297,0.82,99.49
2022-03-09,Himachal Pradesh,630,1,626,7434,1851,482,8.47,3,7.4,685445,5626,681949,25.01,6.51,1.0045945945945947,0.82,99.49
2022-03-10,Himachal Pradesh,1218,14,1217,15048,2677,1295,8.09,0,7.4,686663,5640,683166,36.18,17.5,2.0335135135135136,0.82,99.49
2022-03-11,Himachal Pradesh,181,2,177,1970,1493,1042,9.19,2,7.4,686844,5642,683343,20.18,14.08,0.2662162162162162,0.82,99.49
2022-03-12,Himachal Pradesh,95,1,93,1542,3712,1598,6.16,1,7.4,686939,5643,683436,50.16,21.59,0.2083783783783784,0.82,99.49
2022-03-13,Himachal Pradesh,1060,4,1058,13539,3867,3229,7.83,0,7.4,687999,5647,684494,52.26,43.64,1.8295945945945946,0.82,99.49
2022-03-14,Himachal Pradesh,937,8,935,11502,2826,686,8.15,0,7.4,688936,5655,685429,38.19,9.27,1.5543243243243243,0.82,99.49
2022-03-15,Himachal Pradesh,509,3,507,5850,1488,1100,8.7,0,7.4,689445,5658,685936,20.11,14.86,0.7905405405405406,0.82,99.49
2022-03-16,Himachal Pradesh,1141,10,1135,14486,3801,1697,7.88,0,7.4,690586,5668,687071,51.36,22.93,1.9575675675675677,0.82,99.49
2022-03-17,Himachal Pradesh,311,3,311,3668,2634,10,8.48,0,7.4,690897,5671,687382,35.59,0.14,0.49567567567567566,0.82,99.49
2022-03-18,Himachal Pradesh,714,10,710,9386,2097,380,7.61,0,7.4,691611,5681,688092,28.34,5.14,1.2683783783783784,0.82,99.49
2022-03-19,Himachal Pradesh,568,4,561,7081,3049,1162,8.02,3,7.4,692179,5685,688653,41.2,15.7,0.9568918918918919,0.82,99.49
2022-03-20,Himachal Pradesh,378,4,369,5170,1222,458,7.31,5,7.4,692557,5689,689022,16.51,6.19,0.6986486486486486,0.82,99.49
2022-03-21,Himachal Pradesh,1554,5,1551,19493,2739,562,7.97,0,7.4,694111,5694,690573,37.01,7.59,2.6341891891891893,0.82,99.49
2022-03-22,Himachal Pradesh,835,6,835,10240,4746,3177,8.15,0,7.4,694946,5700,691408,64.14,42.93,1.3837837837837839,0.82,99.49
2022-03-23,Himachal Pradesh,1349,13,1343,16988,471,289,7.94,0,7.4,696295,5713,692751,6.36,3.91,2.2956756756756755,0.82,99.49
2022-03-24,Himachal Pradesh,271,3,271,3185,3931,3046,8.51,0,7.4,696566,5716,693022,53.12,41.16,0.4304054054054054,0.82,99.49
2022-03-25,Himachal Pradesh,675,2,673,8312,1907,757,8.12,0,7.4,697241,5718,693695,25.77,10.23,1.1232432432432433,0.82,99.49
2022-03-26,Himachal Pradesh,929,3,927,11829,2334,1033,7.85,0,7.4,698170,5721,694622,31.54,13.96,1.5985135135135136,0.82,99.49
2022-03-27,Himachal Pradesh,1421,15,1420,17388,4551,1821,8.17,0,7.4,699591,5736,696042,61.5,24.61,2.34972972972973,0.82,99.49
2022-03-28,Himachal Pradesh,653,6,651,8524,248,236,7.66,0,7.4,700244,5742,696693,3.35,3.19,1.151891891891892,0.82,99.49
2022-03-29,Himachal Pradesh,1552,10,1547,19296,410,137,8.04,0,7.4,701796,5752,698240,5.54,1.85,2.6075675675675676,0.82,99.49
2022-03-30,Himachal Pradesh,1500,22,1500,18630,294,100,8.05,0,7.4,703296,5774,699740,3.97,1.35,2.5175675675675677,0.82,99.49
2022-03-31,Himachal Pradesh,612,1,605,7351,3469,864,8.33,6,7.4,703908,5775,700345,46.88,11.68,0.9933783783783784,0.82,99.49
2022-04-01,Himachal Pradesh,603,2,598,7451,362,217,8.09,3,7.4,704511,5777,700943,4.89,2.93,1.0068918918918919,0.82,99.49
2022-04-02,Himachal Pradesh,745,7,745,9393,2993,1136,7.93,0,7.4,705256,5784,701688,40.45,15.35,1.2693243243243244,0.82,99.49
2022-04-03,Himachal Pradesh,1039,3,1030,13247,2064,786,7.84,6,7.4,706295,5787,702718,27.89,10.62,1.7901351351351351,0.82,99.49
2022-04-04,Himachal Pradesh,1440,4,1432,17865,401,130,8.06,4,7.4,707735,5791,704150,5.42,1.76,2.414189189189189,0.82,99.49
2022-04-05,Himachal Pradesh,1579,10,1576,19915,1574,932,7.93,0,7.4,709314,5801,705726,21.27,12.59,2.6912162162162163,0.82,99.49
2022-04-06,Himachal Pradesh,972,8,964,12186,3706,2211,7.98,0,7.4,710286,5809,706690,50.08,29.88,1.6467567567567567,0.82,99.49
2022-04-07,Himachal Pradesh,1366,6,1365,16834,3423,3371,8.11,0,7.4,711652,5815,708055,46.26,45.55,2.274864864864865,0.82,99.49
2022-04-08,Himachal Pradesh,1217,7,1209,14959,786,120,8.14,1,7.4,712869,5822,709264,10.62,1.62,2.0214864864864865,0.82,99.49
2022-04-09,Himachal Pradesh,939,9,934,12192,3014,1237,7.7,0,7.4,713808,5831,710198,40.73,16.72,1.6475675675675676,0.82,99.49
2022-04-10,Himachal Pradesh,1440,4,1434,17798,3,1,8.09,2,7.4,715248,5835,711632,0.04,0.01,2.405135135135135,0.82,99.49
2022-04-11,Himachal Pradesh,1308,11,1301,16311,3566,684,8.02,0,7.4,716556,5846,712933,48.19,9.24,2.204189189189189,0.82,99.49
2022-04-12,Himachal Pradesh,676,3,673,8454,3242,2546,8.0,0,7.4,717232,5849,713606,43.81,34.41,1.1424324324324324,0.82,99.49
2022-04-13,Himachal Pradesh,1407,15,1403,17671,4558,2576,7.96,0,7.4,718639,5864,715009,61.59,34.81,2.387972972972973,0.82,99.49
2022-04-14,Himachal Pradesh,878,5,876,10969,1759,996,8.0,0,7.4,719517,5869,715885,23.77,13.46,1.4822972972972972,0.82,99.5
2022-04-15,Himachal Pradesh,517,3,517,6357,2511,325,8.13,0,7.4,720034,5872,716402,33.93,4.39,0.8590540540540541,0.82,99.5
2022-04-16,Himachal Pradesh,1415,8,1406,17869,4501,3811,7.92,1,7.4,721449,5880,717808,60.82,51.5,2.41472972972973,0.82,99.5
2022-04-17,Himachal Pradesh,669,5,660,8035,1274,907,8.33,4,7.4,722118,5885,718468,17.22,12.26,1.0858108108108109,0.81,99.49
2022-04-18,Himachal Pradesh,1392,12,1389,17266,4892,4559,8.06,0,7.4,723510,5897,719857,66.11,61.61,2.3332432432432433,0.82,99.5
2022-04-19,Himachal Pradesh,486,3,480,5835,1850,206,8.33,3,7.4,723996,5900,720337,25.0,2.78,0.7885135135135135,0.81,99.49
2022-04-20,Himachal Pradesh,1353,5,1347,16731,613,225,8.09,1,7.4,725349,5905,721684,8.28,3.04,2.260945945945946,0.81,99.49
2022-04-21,Himachal Pradesh,1140,3,1136,14118,1930,158,8.07,1,7.4,726489,5908,722820,26.08,2.14,1.9078378378378378,0.81,99.49
2022-04-22,Himachal Pradesh,994,12,990,12281,4739,1954,8.09,0,7.4,727483,5920,723810,64.04,26.41,1.6595945945945947,0.81,99.5
2022-04-23,Himachal Pradesh,220,1,217,2602,1551,719,8.46,2,7.4,727703,5921,724027,20.96,9.72,0.35162162162162164,0.81,99.49
2022-04-24,Himachal Pradesh,622,7,619,7875,310,268,7.9,0,7.4,728325,5928,724646,4.19,3.62,1.0641891891891893,0.81,99.49
2022-04-25,Himachal Pradesh,1105,16,1099,14104,593,118,7.83,0,7.4,729430,5944,725745,8.01,1.59,1.905945945945946,0.81,99.49
2022-04-26,Himachal Pradesh,359,4,357,4351,3168,59,8.25,0,7.4,729789,5948,726102,42.81,0.8,0.587972972972973,0.82,99.49
2022-04-27,Himachal Pradesh,1521,22,1520,18926,4006,1461,8.04,0,7.4,731310,5970,727622,54.14,19.74,2.5575675675675678,0.82,99.5
2022-04-28,Himachal Pradesh,730,7,726,8862,601,60,8.24,0,7.4,732040,5977,728348,8.12,0.81,1.1975675675675677,0.82,99.5
2022-04-29,Himachal Pradesh,1046,9,1039,13071,474,437,8.0,0,7.4,733086,5986,729387,6.41,5.91,1.7663513513513514,0.82,99.5
2022-04-30,Himachal Pradesh,424,5,423,5192,419,215,8.17,0,7.4,733510,5991,729810,5.66,2.91,0.7016216216216217,0.82,99.5
2022-05-01,Himachal Pradesh,746,7,737,9166,3617,706,8.14,2,7.4,734256,5998,730547,48.88,9.54,1.2386486486486485,0.82,99.49
2022-05-02,Himachal Pradesh,1226,13,1221,15409,1792,873,7.96,0,7.4,735482,6011,731768,24.22,11.8,2.0822972972972975,0.82,99.5
2022-05-03,Himachal Pradesh,1173,13,1164,14686,4775,2939,7.99,0,7.4,736655,6024,732932,64.53,39.72,1.9845945945945946,0.82,99.49
2022-05-04,Himachal Pradesh,1458,18,1449,18135,1529,484,8.04,0,7.4,738113,6042,734381,20.66,6.54,2.450675675675676,0.82,99.49
2022-05-05,Himachal Pradesh,1345,17,1338,16552,2459,845,8.13,0,7.4,739458,6059,735719,33.23,11.42,2.2367567567567566,0.82,99.49
2022-05-06,Himachal Pradesh,458,3,456,6075,2733,582,7.54,0,7.4,739916,6062,736175,36.93,7.86,0.8209459459459459,0.82,99.49
2022-05-07,Himachal Pradesh,722,6,718,9101,2553,689,7.93,0,7.4,740638,6068,736893,34.5,9.31,1.229864864864865,0.82,99.49
2022-05-08,Himachal Pradesh,1287,11,1287,16078,4213,1453,8.0,0,7.4,741925,6079,738180,56.93,19.64,2.172702702702703,0.82,99.5
2022-05-09,Himachal Pradesh,1226,11,1219,15222,2666,8,8.05,0,7.4,743151,6090,739399,36.03,0.11,2.057027027027027,0.82,99.5
2022-05-10,Himachal Pradesh,1203,10,1195,14727,1836,677,8.17,0,7.4,744354,6100,740594,24.81,9.15,1.990135135135135,0.82,99.49
2022-05-11,Himachal Pradesh,1348,8,1345,16984,1062,609,7.94,0,7.4,745702,6108,741939,14.35,8.23,2.2951351351351352,0.82,99.5
2022-05-12,Himachal Pradesh,712,4,709,8666,4240,3603,8.22,0,7.4,746414,6112,742648,57.3,48.69,1.171081081081081,0.82,99.5
2022-05-13,Himachal Pradesh,1010,12,1009,12703,2517,245,7.95,0,7.4,747424,6124,743657,34.01,3.31,1.7166216216216217,0.82,99.5
2022-05-14,Himachal Pradesh,492,4,483,6065,1765,429,8.11,5,7.4,747916,6128,744140,23.85,5.8,0.8195945945945946,0.82,99.5
2022-05-15,Himachal Pradesh,1260,16,1255,15498,4212,156,8.13,0,7.4,749176,6144,745395,56.92,2.11,2.094324324324324,0.82,99.5
2022-05-16,Himachal Pradesh,1263,9,1262,15805,1911,1736,7.99,0,7.4,750439,6153,746657,25.82,23.46,2.1358108108108107,0.82,99.5
2022-05-17,Himachal Pradesh,201,2,195,2707,3799,740,7.43,4,7.4,750640,6155,746852,51.34,10.0,0.3658108108108108,0.82,99.5
2022-05-18,Himachal Pradesh,1043,7,1034,13151,3459,2825,7.93,2,7.4,751683,6162,747886,46.74,38.18,1.777162162162162,0.82,99.49
2022-05-19,Himachal Pradesh,1025,14,1019,12907,4665,1565,7.94,0,7.4,752708,6176,748905,63.04,21.15,1.7441891891891892,0.82,99.49
2022-05-20,Himachal Pradesh,811,11,803,9715,1638,729,8.35,0,7.4,753519,6187,749708,22.14,9.85,1.3128378378378378,0.82,99.49
2022-05-21,Himachal Pradesh,1475,8,1474,18763,4223,2410,7.86,0,7.4,754994,6195,751182,57.07,32.57,2.5355405405405405,0.82,99.5
2022-05-22,Himachal Pradesh,182,0,180,2159,2085,1017,8.43,2,7.4,755176,6195,751362,28.18,13.74,0.2917567567567568,0.82,99.49
2022-05-23,Himachal Pradesh,229,0,228,3120,1622,1421,7.34,1,7.4,755405,6195,751590,21.92,19.2,0.42162162162162165,0.82,99.49
2022-05-24,Himachal Pradesh,454,1,450,5543,677,471,8.19,3,7.4,755859,6196,752040,9.15,6.36,0.749054054054054,0.82,99.49
2022-05-25,Himachal Pradesh,620,6,616,7661,4953,3235,8.09,0,7.4,756479,6202,752656,66.93,43.72,1.0352702702702703,0.82,99.49
2022-05-26,Himachal Pradesh,1547,5,1540,19456,2433,1449,7.95,2,7.4,758026,6207,754196,32.88,19.58,2.629189189189189,0.82,99.49
2022-05-27,Himachal Pradesh,1533,19,1532,19061,89,83,8.04,0,7.4,759559,6226,755728,1.2,1.12,2.5758108108108106,0.82,99.5
2022-05-28,Himachal Pradesh,1285,6,1278,15939,4143,2083,8.06,1,7.4,760844,6232,757006,55.99,28.15,2.1539189189189187,0.82,99.5
2022-05-29,Himachal Pradesh,1255,4,1252,15385,1789,232,8.16,0,7.4,762099,6236,758258,24.18,3.14,2.079054054054054,0.82,99.5
2022-05-30,Himachal Pradesh,299,1,299,3471,3927,1734,8.61,0,7.4,762398,6237,758557,53.07,23.43,0.46905405405405404,0.82,99.5
2022-05-31,Himachal Pradesh,149,1,140,1779,1452,58,8.38,8,7.4,762547,6238,758697,19.62,0.78,0.2404054054054054,0.82,99.5
2022-06-01,Himachal Pradesh,305,1,300,3559,3901,449,8.57,4,7.4,762852,6239,758997,52.72,6.07,0.4809459459459459,0.82,99.49
2022-06-02,Himachal Pradesh,789,4,789,10438,2023,1888,7.56,0,7.4,763641,6243,759786,27.34,25.51,1.4105405405405405,0.82,99.5
2022-06-03,Himachal Pradesh,1444,17,1435,17950,18,7,8.04,0,7.4,765085,6260,761221,0.24,0.09,2.425675675675676,0.82,99.49
2022-06-04,Himachal Pradesh,579,5,571,6964,3919,444,8.31,3,7.4,765664,6265,761792,52.96,6.0,0.9410810810810811,0.82,99.49
2022-06-05,Himachal Pradesh,1344,18,1336,16420,876,38,8.19,0,7.4,767008,6283,763128,11.84,0.51,2.218918918918919,0.82,99.49
2022-06-06,Himachal Pradesh,1500,15,1496,18081,3457,3147,8.3,0,7.4,768508,6298,764624,46.72,42.53,2.4433783783783785,0.82,99.49
2022-06-07,Himachal Pradesh,722,3,713,8677,2189,626,8.32,6,7.4,769230,6301,765337,29.58,8.46,1.1725675675675675,0.82,99.49
2022-06-08,Himachal Pradesh,1295,11,1290,16113,304,112,8.04,0,7.4,770525,6312,766627,4.11,1.51,2.1774324324324326,0.82,99.49
2022-06-09,Himachal Pradesh,1032,7,1029,12693,3469,543,8.13,0,7.4,771557,6319,767656,46.88,7.34,1.7152702702702702,0.82,99.49
2022-06-10,Himachal Pradesh,706,9,698,9056,1025,162,7.8,0,7.4,772263,6328,768354,13.85,2.19,1.2237837837837837,0.82,99.49
2022-06-11,Himachal Pradesh,723,6,723,9475,2078,428,7.63,0,7.4,772986,6334,769077,28.08,5.78,1.2804054054054055,0.82,99.49
2022-06-12,Himachal Pradesh,982,4,975,11960,3939,2528,8.21,3,7.4,773968,6338,770052,53.23,34.16,1.6162162162162161,0.82,99.49
2022-06-13,Himachal Pradesh,895,12,895,11011,316,233,8.13,0,7.4,774863,6350,770947,4.27,3.15,1.487972972972973,0.82,99.49
2022-06-14,Himachal Pradesh,1123,5,1118,14135,1222,557,7.94,0,7.4,775986,6355,772065,16.51,7.53,1.9101351351351352,0.82,99.49
2022-06-15,Himachal Pradesh,389,2,380,4930,4174,1404,7.89,7,7.4,776375,6357,772445,56.41,18.97,0.6662162162162162,0.82,99.49
2022-06-16,Himachal Pradesh,454,3,451,5976,2871,587,7.6,0,7.4,776829,6360,772896,38.8,7.93,0.8075675675675675,0.82,99.49
2022-06-17,Himachal Pradesh,914,7,910,11722,3958,1904,7.8,0,7.4,777743,6367,773806,53.49,25.73,1.584054054054054,0.82,99.49
2022-06-18,Himachal Pradesh,1506,20,1506,19187,3890,2740,7.85,0,7.4,779249,6387,775312,52.57,37.03,2.592837837837838,0.82,99.49
2022-06-19,Himachal Pradesh,500,7,491,5911,1251,749,8.46,2,7.4,779749,6394,775803,16.91,10.12,0.7987837837837838,0.82,99.49
2022-06-20,Himachal Pradesh,149,1,146,2148,3144,400,6.94,2,7.4,779898,6395,775949,42.49,5.41,0.29027027027027025,0.82,99.49
2022-06-21,Himachal Pradesh,1051,5,1042,13087,4216,2853,8.03,4,7.4,780949,6400,776991,56.97,38.55,1.7685135135135135,0.82,99.49
2022-06-22,Himachal Pradesh,1229,7,1229,15538,3363,1519,7.91,0,7.4,782178,6407,778220,45.45,20.53,2.09972972972973,0.82,99.49
2022-06-23,Himachal Pradesh,547,3,540,6958,2224,1807,7.86,4,7.4,782725,6410,778760,30.05,24.42,0.9402702702702703,0.82,99.49
2022-06-24,Himachal Pradesh,711,2,706,8576,4551,2788,8.29,3,7.4,783436,6412,779466,61.5,37.68,1.1589189189189189,0.82,99.49
2022-06-25,Himachal Pradesh,713,5,707,8317,2837,1811,8.57,1,7.4,784149,6417,780173,38.34,24.47,1.123918918918919,0.82,99.49
2022-06-26,Himachal Pradesh,291,2,283,3590,2364,2156,8.11,6,7.4,784440,6419,780456,31.95,29.14,0.4851351351351351,0.82,99.49
2022-06-27,Himachal Pradesh,1511,21,1506,18929,1119,664,7.98,0,7.4,785951,6440,781962,15.12,8.97,2.5579729729729728,0.82,99.49
2022-06-28,Himachal Pradesh,651,8,643,7763,3569,562,8.39,0,7.4,786602,6448,782605,48.23,7.59,1.049054054054054,0.82,99.49
2022-06-29,Himachal Pradesh,1274,13,1272,15944,1334,295,7.99,0,7.4,787876,6461,783877,18.03,3.99,2.154594594594595,0.82,99.49
2022-06-30,Himachal Pradesh,378,1,377,4642,4618,1341,8.14,0,7.4,788254,6462,784254,62.41,18.12,0.6272972972972973,0.82,99.49
2022-07-01,Himachal Pradesh,1428,13,1420,18322,565,519,7.79,0,7.4,789682,6475,785674,7.64,7.01,2.475945945945946,0.82,99.49
2022-07-02,Himachal Pradesh,1487,15,1482,18699,457,97,7.95,0,7.4,791169,6490,787156,6.18,1.31,2.526891891891892,0.82,99.49
2022-07-03,Himachal Pradesh,953,9,948,12196,461,222,7.81,0,7.4,792122,6499,788104,6.23,3.0,1.6481081081081081,0.82,99.49
2022-07-04,Himachal Pradesh,909,9,905,10964,2470,599,8.29,0,7.4,793031,6508,789009,33.38,8.09,1.4816216216216216,0.82,99.49
2022-07-05,Himachal Pradesh,352,4,350,4168,2934,132,8.45,0,7.4,793383,6512,789359,39.65,1.78,0.5632432432432433,0.82,99.49
2022-07-06,Himachal Pradesh,1137,5,1133,14180,2627,1298,8.02,0,7.4,794520,6517,790492,35.5,17.54,1.9162162162162162,0.82,99.49
2022-07-07,Himachal Pradesh,247,2,241,3486,4532,3829,7.09,4,7.4,794767,6519,790733,61.24,51.74,0.4710810810810811,0.82,99.49
2022-07-08,Himachal Pradesh,686,3,681,8616,2975,894,7.96,2,7.4,795453,6522,791414,40.2,12.08,1.1643243243243244,0.82,99.49
2022-07-09,Himachal Pradesh,691,10,686,8531,4703,3992,8.1,0,7.4,796144,6532,792100,63.55,53.95,1.1528378378378379,0.82,99.49
2022-07-10,Himachal Pradesh,643,4,637,8055,903,559,7.98,2,7.4,796787,6536,792737,12.2,7.55,1.0885135135135136,0.82,99.49
2022-07-11,Himachal Pradesh,1473,6,1470,18232,893,839,8.08,0,7.4,798260,6542,794207,12.07,11.34,2.463783783783784,0.82,99.49
2022-07-12,Himachal Pradesh,409,4,408,5347,1529,1416,7.65,0,7.4,798669,6546,794615,20.66,19.14,0.7225675675675676,0.82,99.49
2022-07-13,Himachal Pradesh,901,11,893,11061,4002,3566,8.15,0,7.4,799570,6557,795508,54.08,48.19,1.4947297297297297,0.82,99.49
2022-07-14,Himachal Pradesh,241,1,241,3166,3167,900,7.61,0,7.4,799811,6558,795749,42.8,12.16,0.42783783783783785,0.82,99.49
2022-07-15,Himachal Pradesh,303,2,294,3844,724,402,7.88,7,7.4,800114,6560,796043,9.78,5.43,0.5194594594594595,0.82,99.49
2022-07-16,Himachal Pradesh,1492,19,1484,18635,4708,4162,8.01,0,7.4,801606,6579,797527,63.62,56.24,2.5182432432432433,0.82,99.49
2022-07-17,Himachal Pradesh,251,3,244,2994,3031,2561,8.38,4,7.4,801857,6582,797771,40.96,34.61,0.40459459459459457,0.82,99.49
2022-07-18,Himachal Pradesh,358,4,356,4330,4050,1111,8.27,0,7.4,802215,6586,798127,54.73,15.01,0.5851351351351352,0.82,99.49
2022-07-19,Himachal Pradesh,1135,15,1134,14453,3213,107,7.85,0,7.4,803350,6601,799261,43.42,1.45,1.953108108108108,0.82,99.49
2022-07-20,Himachal Pradesh,218,2,218,2874,854,20,7.59,0,7.4,803568,6603,799479,11.54,0.27,0.38837837837837835,0.82,99.49
2022-07-21,Himachal Pradesh,1137,6,1128,14193,2838,1290,8.01,3,7.4,804705,6609,800607,38.35,17.43,1.9179729729729729,0.82,99.49
2022-07-22,Himachal Pradesh,1454,13,1453,18575,1075,854,7.83,0,7.4,806159,6622,802060,14.53,11.54,2.510135135135135,0.82,99.49
2022-07-23,Himachal Pradesh,422,2,415,5492,4849,819,7.68,5,7.4,806581,6624,802475,65.53,11.07,0.7421621621621621,0.82,99.49
2022-07-24,Himachal Pradesh,803,11,803,10202,4671,1553,7.87,0,7.4,807384,6635,803278,63.12,20.99,1.3786486486486487,0.82,99.49
2022-07-25,Himachal Pradesh,1443,5,1436,17615,488,372,8.19,2,7.4,808827,6640,804714,6.59,5.03,2.3804054054054054,0.82,99.49
2022-07-26,Himachal Pradesh,427,4,425,5371,3335,2044,7.95,0,7.4,809254,6644,805139,45.07,27.62,0.7258108108108108,0.82,99.49
2022-07-27,Himachal Pradesh,755,2,755,9722,3900,2634,7.77,0,7.4,810009,6646,805894,52.7,35.59,1.3137837837837838,0.82,99.49
2022-07-28,Himachal Pradesh,260,2,253,3473,4279,282,7.49,5,7.4,810269,6648,806147,57.82,3.81,0.4693243243243243,0.82,99.49
2022-07-29,Himachal Pradesh,388,2,383,4927,4318,1790,7.87,3,7.4,810657,6650,806530,58.35,24.19,0.6658108108108108,0.82,99.49
2022-07-30,Himachal Pradesh,1077,6,1077,13420,679,451,8.03,0,7.4,811734,6656,807607,9.18,6.09,1.8135135135135134,0.82,99.49
2022-07-31,Himachal Pradesh,415,3,408,4892,1037,691,8.48,4,7.4,812149,6659,808015,14.01,9.34,0.6610810810810811,0.82,99.49
2022-08-01,Himachal Pradesh,730,9,722,8846,2582,1975,8.25,0,7.4,812879,6668,808737,34.89,26.69,1.1954054054054053,0.82,99.49
2022-08-02,Himachal Pradesh,372,1,365,4979,3101,1510,7.47,6,7.4,813251,6669,809102,41.91,20.41,0.6728378378378378,0.82,99.49
2022-08-03,Himachal Pradesh,1108,15,1105,13968,2076,1226,7.93,0,7.4,814359,6684,810207,28.05,16.57,1.8875675675675676,0.82,99.49
2022-08-04,Himachal Pradesh,1045,11,1043,13014,3567,407,8.03,0,7.4,815404,6695,811250,48.2,5.5,1.7586486486486486,0.82,99.49
2022-08-05,Himachal Pradesh,198,1,195,2406,4255,3109,8.23,2,7.4,815602,6696,811445,57.5,42.01,0.32513513513513514,0.82,99.49
2022-08-06,Himachal Pradesh,1195,11,1194,14688,363,361,8.14,0,7.4,816797,6707,812639,4.91,4.88,1.9848648648648648,0.82,99.49
2022-08-07,Himachal Pradesh,867,10,863,10951,3265,1907,7.92,0,7.4,817664,6717,813502,44.12,25.77,1.479864864864865,0.82,99.49
2022-08-08,Himachal Pradesh,1325,17,1325,16564,1230,124,8.0,0,7.4,818989,6734,814827,16.62,1.68,2.2383783783783784,0.82,99.49
2022-08-09,Himachal Pradesh,1272,13,1272,15737,3017,377,8.08,0,7.4,820261,6747,816099,40.77,5.09,2.126621621621622,0.82,99.49
2022-08-10,Himachal Pradesh,1404,17,1402,17373,1805,4,8.08,0,7.4,821665,6764,817501,24.39,0.05,2.3477027027027026,0.82,99.49
2022-08-11,Himachal Pradesh,173,2,170,2164,680,621,7.99,1,7.4,821838,6766,817671,9.19,8.39,0.29243243243243244,0.82,99.49
2022-08-12,Himachal Pradesh,788,2,779,9778,1541,353,8.06,7,7.4,822626,6768,818450,20.82,4.77,1.3213513513513513,0.82,99.49
2022-08-13,Himachal Pradesh,1277,16,1277,15982,4063,3638,7.99,0,7.4,823903,6784,819727,54.91,49.16,2.1597297297297295,0.82,99.49
2022-08-14,Himachal Pradesh,1407,10,1401,17293,3804,3578,8.14,0,7.4,825310,6794,821128,51.41,48.35,2.336891891891892,0.82,99.49
2022-08-15,Himachal Pradesh,1563,16,1559,19512,3384,498,8.01,0,7.4,826873,6810,822687,45.73,6.73,2.636756756756757,0.82,99.49
2022-08-16,Himachal Pradesh,1394,19,1394,17551,2129,314,7.94,0,7.4,828267,6829,824081,28.77,4.24,2.371756756756757,0.82,99.49
2022-08-17,Himachal Pradesh,1516,17,1514,18557,4388,4048,8.17,0,7.4,829783,6846,825595,59.3,54.7,2.507702702702703,0.83,99.5
2022-08-18,Himachal Pradesh,1199,12,1195,15108,2557,2475,7.94,0,7.4,830982,6858,826790,34.55,33.45,2.0416216216216214,0.83,99.5
2022-08-19,Himachal Pradesh,1070,9,1066,13642,3129,3128,7.84,0,7.4,832052,6867,827856,42.28,42.27,1.8435135135135134,0.83,99.5
2022-08-20,Himachal Pradesh,796,3,793,10187,1994,1970,7.81,0,7.4,832848,6870,828649,26.95,26.62,1.3766216216216216,0.82,99.5
2022-08-21,Himachal Pradesh,424,6,415,5242,4908,526,8.09,3,7.4,833272,6876,829064,66.32,7.11,0.7083783783783784,0.83,99.5
2022-08-22,Himachal Pradesh,1098,16,1097,13709,1723,383,8.01,0,7.4,834370,6892,830161,23.28,5.18,1.8525675675675675,0.83,99.5
2022-08-23,Himachal Pradesh,1117,13,1116,13975,4689,4033,7.99,0,7.4,835487,6905,831277,63.36,54.5,1.8885135135135136,0.83,99.5
2022-08-24,Himachal Pradesh,1561,17,1559,19532,4982,4892,7.99,0,7.4,837048,6922,832836,67.32,66.11,2.6394594594594594,0.83,99.5
2022-08-25,Himachal Pradesh,1583,6,1581,19573,4532,3530,8.09,0,7.4,838631,6928,834417,61.24,47.7,2.645,0.83,99.5
2022-08-26,Himachal Pradesh,1370,5,1365,17074,2087,1047,8.02,0,7.4,840001,6933,835782,28.2,14.15,2.307297297297297,0.83,99.5
2022-08-27,Himachal Pradesh,1126,4,1123,14084,287,146,7.99,0,7.4,841127,6937,836905,3.88,1.97,1.9032432432432433,0.82,99.5
2022-08-28,Himachal Pradesh,1192,16,1189,14905,2488,1990,8.0,0,7.4,842319,6953,838094,33.62,26.89,2.014189189189189,0.83,99.5
2022-08-29,Himachal Pradesh,1112,5,1103,13831,1019,891,8.04,4,7.4,843431,6958,839197,13.77,12.04,1.8690540540540541,0.82,99.5
2022-08-30,Himachal Pradesh,920,7,918,11373,1727,1189,8.09,0,7.4,844351,6965,840115,23.34,16.07,1.536891891891892,0.82,99.5
2022-08-31,Himachal Pradesh,444,5,435,5889,4133,2867,7.54,4,7.4,844795,6970,840550,55.85,38.74,0.7958108108108108,0.83,99.5
2022-09-01,Himachal Pradesh,1068,6,1060,13219,2372,140,8.08,2,7.4,845863,6976,841610,32.05,1.89,1.7863513513513514,0.82,99.5
2022-09-02,Himachal Pradesh,921,4,919,11491,4643,889,8.01,0,7.4,846784,6980,842529,62.74,12.01,1.5528378378378378,0.82,99.5
2022-09-03,Himachal Pradesh,1448,13,1448,18436,3608,841,7.85,0,7.4,848232,6993,843977,48.76,11.36,2.4913513513513514,0.82,99.5
2022-09-04,Himachal Pradesh,1450,21,1443,18172,4823,1592,7.98,0,7.4,849682,7014,845420,65.18,21.51,2.4556756756756757,0.83,99.5
2022-09-05,Himachal Pradesh,528,1,523,6828,247,246,7.73,4,7.4,850210,7015,845943,3.34,3.32,0.9227027027027027,0.83,99.5
2022-09-06,Himachal Pradesh,685,6,680,9043,1657,301,7.57,0,7.4,850895,7021,846623,22.39,4.07,1.222027027027027,0.83,99.5
2022-09-07,Himachal Pradesh,1035,5,1033,12745,4723,2385,8.12,0,7.4,851930,7026,847656,63.82,32.23,1.7222972972972972,0.82,99.5
2022-09-08,Himachal Pradesh,301,1,299,3569,1445,687,8.43,1,7.4,852231,7027,847955,19.53,9.28,0.4822972972972973,0.82,99.5
2022-09-09,Himachal Pradesh,1460,17,1452,18179,4610,2242,8.03,0,7.4,853691,7044,849407,62.3,30.3,2.4566216216216215,0.83,99.5
2022-09-10,Himachal Pradesh,47,0,45,554,4099,3910,8.48,2,7.4,853738,7044,849452,55.39,52.84,0.07486486486486486,0.83,99.5
2022-09-11,Himachal Pradesh,140,1,139,1542,3474,1087,9.08,0,7.4,853878,7045,849591,46.95,14.69,0.2083783783783784,0.83,99.5
2022-09-12,Himachal Pradesh,1133,11,1126,14058,1705,197,8.06,0,7.4,855011,7056,850717,23.04,2.66,1.8997297297297298,0.83,99.5
2022-09-13,Himachal Pradesh,801,6,797,10157,182,0,7.89,0,7.4,855812,7062,851514,2.46,0.0,1.3725675675675675,0.83,99.5
2022-09-14,Himachal Pradesh,234,2,233,3356,1161,1058,6.97,0,7.4,856046,7064,851747,15.69,14.3,0.4535135135135135,0.83,99.5
2022-09-15,Himachal Pradesh,696,5,692,8781,1078,920,7.93,0,7.4,856742,7069,852439,14.57,12.43,1.1866216216216217,0.83,99.5
2022-09-16,Himachal Pradesh,1430,10,1423,17387,4884,438,8.22,0,7.4,858172,7079,853862,66.0,5.92,2.3495945945945946,0.82,99.5
2022-09-17,Himachal Pradesh,706,10,700,8659,4368,571,8.15,0,7.4,858878,7089,854562,59.03,7.72,1.1701351351351352,0.83,99.5
2022-09-18,Himachal Pradesh,1536,19,1532,19182,542,457,8.01,0,7.4,860414,7108,856094,7.32,6.18,2.592162162162162,0.83,99.5
2022-09-19,Himachal Pradesh,788,9,788,9728,1423,456,8.1,0,7.4,861202,7117,856882,19.23,6.16,1.3145945945945945,0.83,99.5
2022-09-20,Himachal Pradesh,1486,20,1484,18560,3723,3345,8.01,0,7.4,862688,7137,858366,50.31,45.2,2.5081081081081082,0.83,99.5
2022-09-21,Himachal Pradesh,1092,6,1090,13326,923,386,8.19,0,7.4,863780,7143,859456,12.47,5.22,1.8008108108108107,0.83,99.5
2022-09-22,Himachal Pradesh,617,7,617,7605,4451,2938,8.11,0,7.4,864397,7150,860073,60.15,39.7,1.0277027027027028,0.83,99.5
2022-09-23,Himachal Pradesh,810,7,807,10750,4802,1370,7.53,0,7.4,865207,7157,860880,64.89,18.51,1.4527027027027026,0.83,99.5
2022-09-24,Himachal Pradesh,612,3,609,7863,3527,1075,7.78,0,7.4,865819,7160,861489,47.66,14.53,1.0625675675675677,0.83,99.5
2022-09-25,Himachal Pradesh,536,4,532,6816,3576,1970,7.86,0,7.4,866355,7164,862021,48.32,26.62,0.9210810810810811,0.83,99.5
2022-09-26,Himachal Pradesh,398,4,393,5112,3060,170,7.79,1,7.4,866753,7168,862414,41.35,2.3,0.6908108108108109,0.83,99.5
2022-09-27,Himachal Pradesh,1425,6,1420,18125,1008,725,7.86,0,7.4,868178,7174,863834,13.62,9.8,2.449324324324324,0.83,99.5
2022-09-28,Himachal Pradesh,484,2,476,5827,51,51,8.31,6,7.4,868662,7176,864310,0.69,0.69,0.7874324324324324,0.83,99.5
2022-09-29,Himachal Pradesh,1587,7,1585,19407,436,410,8.18,0,7.4,870249,7183,865895,5.89,5.54,2.6225675675675677,0.83,99.5
2022-09-30,Himachal Pradesh,600,6,597,7943,3475,2312,7.55,0,7.4,870849,7189,866492,46.96,31.24,1.0733783783783784,0.83,99.5
2022-10-01,Himachal Pradesh,1415,20,1409,17939,2527,936,7.89,0,7.4,872264,7209,867901,34.15,12.65,2.4241891891891894,0.83,99.5
2022-10-02,Himachal Pradesh,545,5,540,6923,4812,1393,7.87,0,7.4,872809,7214,868441,65.03,18.82,0.9355405405405406,0.83,99.5
2022-10-03,Himachal Pradesh,644,6,635,7926,3104,464,8.13,3,7.4,873453,7220,869076,41.95,6.27,1.0710810810810811,0.83,99.5
2022-10-04,Himachal Pradesh,499,1,490,6374,4308,1893,7.83,8,7.4,873952,7221,869566,58.22,25.58,0.8613513513513513,0.83,99.5
2022-10-05,Himachal Pradesh,577,3,575,7895,1478,789,7.31,0,7.4,874529,7224,870141,19.97,10.66,1.066891891891892,0.83,99.5
2022-10-06,Himachal Pradesh,1243,4,1242,15537,558,290,8.0,0,7.4,875772,7228,871383,7.54,3.92,2.0995945945945946,0.83,99.5
2022-10-07,Himachal Pradesh,280,1,278,3017,3316,2015,9.28,1,7.4,876052,7229,871661,44.81,27.23,0.4077027027027027,0.83,99.5
2022-10-08,Himachal Pradesh,821,9,812,10015,3213,1025,8.2,0,7.4,876873,7238,872473,43.42,13.85,1.3533783783783784,0.83,99.5
2022-10-09,Himachal Pradesh,1202,16,1198,15160,4093,3784,7.93,0,7.4,878075,7254,873671,55.31,51.14,2.0486486486486486,0.83,99.5
2022-10-10,Himachal Pradesh,433,4,425,5686,3650,2191,7.62,4,7.4,878508,7258,874096,49.32,29.61,0.7683783783783784,0.83,99.5
2022-10-11,Himachal Pradesh,821,4,813,10110,1708,36,8.12,4,7.4,879329,7262,874909,23.08,0.49,1.3662162162162161,0.83,99.5
2022-10-12,Himachal Pradesh,1299,7,1295,16259,3751,1388,7.99,0,7.4,880628,7269,876204,50.69,18.76,2.197162162162162,0.83,99.5
2022-10-13,Himachal Pradesh,93,0,87,1373,2376,1879,6.77,6,7.4,880721,7269,876291,32.11,25.39,0.18554054054054053,0.83,99.5
2022-10-14,Himachal Pradesh,177,2,171,2297,4541,2631,7.71,4,7.4,880898,7271,876462,61.36,35.55,0.3104054054054054,0.83,99.5
2022-10-15,Himachal Pradesh,110,0,110,1380,2912,1571,7.97,0,7.4,881008,7271,876572,39.35,21.23,0.1864864864864865,0.83,99.5
2022-10-16,Himachal Pradesh,1399,12,1391,17521,3464,989,7.98,0,7.4,882407,7283,877963,46.81,13.36,2.3677027027027027,0.83,99.5
2022-10-17,Himachal Pradesh,981,13,977,12116,3931,2989,8.1,0,7.4,883388,7296,878940,53.12,40.39,1.6372972972972972,0.83,99.5
2022-10-18,Himachal Pradesh,49,0,42,957,2142,77,5.12,7,7.4,883437,7296,878982,28.95,1.04,0.12932432432432434,0.83,99.5
2022-10-19,Himachal Pradesh,1079,8,1071,13489,3257,1929,8.0,0,7.4,884516,7304,880053,44.01,26.07,1.8228378378378378,0.83,99.5
2022-10-20,Himachal Pradesh,985,13,981,12363,4960,2457,7.97,0,7.4,885501,7317,881034,67.03,33.2,1.6706756756756758,0.83,99.5
2022-10-21,Himachal Pradesh,1417,21,1415,17800,1384,155,7.96,0,7.4,886918,7338,882449,18.7,2.09,2.4054054054054053,0.83,99.5
2022-10-22,Himachal Pradesh,94,0,86,1354,3366,3256,6.94,8,7.4,887012,7338,882535,45.49,44.0,0.18297297297297296,0.83,99.5
2022-10-23,Himachal Pradesh,1289,17,1285,16228,2372,1898,7.94,0,7.4,888301,7355,883820,32.05,25.65,2.192972972972973,0.83,99.5
2022-10-24,Himachal Pradesh,892,9,883,11276,1233,20,7.91,0,7.4,889193,7364,884703,16.66,0.27,1.5237837837837838,0.83,99.5
2022-10-25,Himachal Pradesh,1530,7,1526,19041,2516,1767,8.04,0,7.4,890723,7371,886229,34.0,23.88,2.573108108108108,0.83,99.5
2022-10-26,Himachal Pradesh,356,4,350,4855,3313,712,7.33,2,7.4,891079,7375,886579,44.77,9.62,0.6560810810810811,0.83,99.49
2022-10-27,Himachal Pradesh,238,1,236,2889,1499,1275,8.24,1,7.4,891317,7376,886815,20.26,17.23,0.3904054054054054,0.83,99.49
2022-10-28,Himachal Pradesh,1386,5,1378,16862,52,16,8.22,3,7.4,892703,7381,888193,0.7,0.22,2.2786486486486486,0.83,99.49
2022-10-29,Himachal Pradesh,1440,19,1438,18378,4154,1452,7.84,0,7.4,894143,7400,889631,56.14,19.62,2.4835135135135133,0.83,99.5
2022-10-30,Himachal Pradesh,698,4,698,8676,1429,331,8.05,0,7.4,894841,7404,890329,19.31,4.47,1.1724324324324324,0.83,99.5
2022-10-31,Himachal Pradesh,44,0,38,737,2765,1097,5.97,6,7.4,894885,7404,890367,37.36,14.82,0.09959459459459459,0.83,99.5
2022-11-01,Himachal Pradesh,1051,12,1048,13350,4300,4068,7.87,0,7.4,895936,7416,891415,58.11,54.97,1.804054054054054,0.83,99.5
2022-11-02,Himachal Pradesh,941,9,938,12105,2017,1853,7.77,0,7.4,896877,7425,892353,27.26,25.04,1.6358108108108107,0.83,99.5
2022-11-03,Himachal Pradesh,131,0,123,1669,3673,628,7.85,8,7.4,897008,7425,892476,49.64,8.49,0.22554054054054054,0.83,99.49
2022-11-04,Himachal Pradesh,302,2,296,4184,3714,2084,7.22,4,7.4,897310,7427,892772,50.19,28.16,0.5654054054054054,0.83,99.49
2022-11-05,Himachal Pradesh,1253,10,1251,15769,103,75,7.95,0,7.4,898563,7437,894023,1.39,1.01,2.130945945945946,0.83,99.49
2022-11-06,Himachal Pradesh,1488,20,1487,18476,2059,988,8.05,0,7.4,900051,7457,895510,27.82,13.35,2.496756756756757,0.83,99.5
2022-11-07,Himachal Pradesh,542,6,538,6435,1599,953,8.42,0,7.4,900593,7463,896048,21.61,12.88,0.8695945945945946,0.83,99.5
2022-11-08,Himachal Pradesh,213,2,204,2298,2414,2223,9.27,7,7.4,900806,7465,896252,32.62,30.04,0.31054054054054053,0.83,99.49
2022-11-09,Himachal Pradesh,509,3,500,6519,4393,2609,7.81,6,7.4,901315,7468,896752,59.36,35.26,0.880945945945946,0.83,99.49
2022-11-10,Himachal Pradesh,863,5,856,11163,4386,2940,7.73,2,7.4,902178,7473,897608,59.27,39.73,1.5085135135135135,0.83,99.49
2022-11-11,Himachal Pradesh,1062,9,1062,13030,485,113,8.15,0,7.4,903240,7482,898670,6.55,1.53,1.7608108108108107,0.83,99.49
2022-11-12,Himachal Pradesh,151,1,151,1875,2297,1296,8.05,0,7.4,903391,7483,898821,31.04,17.51,0.2533783783783784,0.83,99.49
2022-11-13,Himachal Pradesh,851,4,849,10290,1001,16,8.27,0,7.4,904242,7487,899670,13.53,0.22,1.3905405405405404,0.83,99.49
2022-11-14,Himachal Pradesh,1051,13,1044,13278,4372,3166,7.92,0,7.4,905293,7500,900714,59.08,42.78,1.7943243243243243,0.83,99.49
2022-11-15,Himachal Pradesh,278,2,276,3180,4872,2085,8.74,0,7.4,905571,7502,900990,65.84,28.18,0.4297297297297297,0.83,99.49
2022-11-16,Himachal Pradesh,251,1,247,3691,3120,1653,6.8,3,7.4,905822,7503,901237,42.16,22.34,0.4987837837837838,0.83,99.49
2022-11-17,Himachal Pradesh,664,9,658,8397,4342,2730,7.91,0,7.4,906486,7512,901895,58.68,36.89,1.1347297297297296,0.83,99.49
2022-11-18,Himachal Pradesh,1469,10,1461,18055,2731,2103,8.14,0,7.4,907955,7522,903356,36.91,28.42,2.4398648648648646,0.83,99.49
2022-11-19,Himachal Pradesh,37,0,28,678,4249,792,5.46,9,7.4,907992,7522,903384,57.42,10.7,0.09162162162162162,0.83,99.49
2022-11-20,Himachal Pradesh,1152,13,1144,14593,3977,2038,7.89,0,7.4,909144,7535,904528,53.74,27.54,1.972027027027027,0.83,99.49
2022-11-21,Himachal Pradesh,326,4,320,3861,3605,1526,8.44,2,7.4,909470,7539,904848,48.72,20.62,0.5217567567567568,0.83,99.49
2022-11-22,Himachal Pradesh,1515,14,1514,18831,1529,521,8.05,0,7.4,910985,7553,906362,20.66,7.04,2.5447297297297298,0.83,99.49
2022-11-23,Himachal Pradesh,234,2,229,2972,4169,1235,7.87,3,7.4,911219,7555,906591,56.34,16.69,0.4016216216216216,0.83,99.49
2022-11-24,Himachal Pradesh,1469,18,1463,18684,614,321,7.86,0,7.4,912688,7573,908054,8.3,4.34,2.524864864864865,0.83,99.49
2022-11-25,Himachal Pradesh,788,8,788,9549,2267,1276,8.25,0,7.4,913476,7581,908842,30.64,17.24,1.2904054054054055,0.83,99.49
2022-11-26,Himachal Pradesh,337,2,337,3958,4391,485,8.51,0,7.4,913813,7583,909179,59.34,6.55,0.5348648648648648,0.83,99.49
2022-11-27,Himachal Pradesh,392,4,386,4570,2517,1914,8.58,2,7.4,914205,7587,909565,34.01,25.86,0.6175675675675676,0.83,99.49
2022-11-28,Himachal Pradesh,384,2,383,5038,4195,3466,7.62,0,7.4,914589,7589,909948,56.69,46.84,0.6808108108108109,0.83,99.49
2022-11-29,Himachal Pradesh,168,2,166,2381,4022,522,7.06,0,7.4,914757,7591,910114,54.35,7.05,0.32175675675675675,0.83,99.49
2022-11-30,Himachal Pradesh,848,8,847,10743,4856,3599,7.89,0,7.4,915605,7599,910961,65.62,48.64,1.4517567567567569,0.83,99.49
2022-12-01,Himachal Pradesh,862,12,855,10928,3193,2900,7.89,0,7.4,916467,7611,911816,43.15,39.19,1.4767567567567568,0.83,99.49
2022-12-02,Himachal Pradesh,1416,16,1410,17789,1666,1004,7.96,0,7.4,917883,7627,913226,22.51,13.57,2.4039189189189187,0.83,99.49
2022-12-03,Himachal Pradesh,408,3,402,5437,4303,3345,7.5,3,7.4,918291,7630,913628,58.15,45.2,0.7347297297297297,0.83,99.49
2022-12-04,Himachal Pradesh,1492,9,1487,18813,2494,838,7.93,0,7.4,919783,7639,915115,33.7,11.32,2.5422972972972975,0.83,99.49
2022-12-05,Himachal Pradesh,206,1,203,2558,2954,2475,8.05,2,7.4,919989,7640,915318,39.92,33.45,0.3456756756756757,0.83,99.49
2022-12-06,Himachal Pradesh,744,10,742,9154,1568,1006,8.13,0,7.4,920733,7650,916060,21.19,13.59,1.237027027027027,0.83,99.49
2022-12-07,Himachal Pradesh,1085,6,1085,13988,2966,2394,7.76,0,7.4,921818,7656,917145,40.08,32.35,1.8902702702702703,0.83,99.49
2022-12-08,Himachal Pradesh,183,1,179,2567,2097,1612,7.13,3,7.4,922001,7657,917324,28.34,21.78,0.3468918918918919,0.83,99.49
2022-12-09,Himachal Pradesh,259,2,259,3474,4977,2740,7.46,0,7.4,922260,7659,917583,67.26,37.03,0.46945945945945944,0.83,99.49
2022-12-10,Himachal Pradesh,913,3,909,11042,3038,394,8.27,1,7.4,923173,7662,918492,41.05,5.32,1.4921621621621621,0.83,99.49
2022-12-11,Himachal Pradesh,559,4,559,7303,1954,1638,7.65,0,7.4,923732,7666,919051,26.41,22.14,0.9868918918918919,0.83,99.49
2022-12-12,Himachal Pradesh,544,7,537,6968,1324,756,7.81,0,7.4,924276,7673,919588,17.89,10.22,0.9416216216216217,0.83,99.49
2022-12-13,Himachal Pradesh,1105,15,1096,13583,1984,162,8.14,0,7.4,925381,7688,920684,26.81,2.19,1.8355405405405405,0.83,99.49
2022-12-14,Himachal Pradesh,46,0,37,524,2288,1617,8.78,9,7.4,925427,7688,920721,30.92,21.85,0.07081081081081081,0.83,99.49
2022-12-15,Himachal Pradesh,1068,10,1059,13382,4669,1051,7.98,0,7.4,926495,7698,921780,63.09,14.2,1.8083783783783784,0.83,99.49
2022-12-16,Himachal Pradesh,1486,16,1480,18363,722,484,8.09,0,7.4,927981,7714,923260,9.76,6.54,2.4814864864864865,0.83,99.49
2022-12-17,Himachal Pradesh,134,0,125,1477,383,38,9.07,9,7.4,928115,7714,923385,5.18,0.51,0.19959459459459458,0.83,99.49
2022-12-18,Himachal Pradesh,510,4,501,6650,1537,1493,7.67,5,7.4,928625,7718,923886,20.77,20.18,0.8986486486486487,0.83,99.49
2022-12-19,Himachal Pradesh,776,10,776,10043,1286,1272,7.73,0,7.4,929401,7728,924662,17.38,17.19,1.3571621621621621,0.83,99.49
2022-12-20,Himachal Pradesh,1589,8,1585,19811,2524,69,8.02,0,7.4,930990,7736,926247,34.11,0.93,2.677162162162162,0.83,99.49
2022-12-21,Himachal Pradesh,862,5,860,10450,3529,2734,8.25,0,7.4,931852,7741,927107,47.69,36.95,1.412162162162162,0.83,99.49
2022-12-22,Himachal Pradesh,1505,18,1497,18737,2779,2683,8.03,0,7.4,933357,7759,928604,37.55,36.26,2.532027027027027,0.83,99.49
2022-12-23,Himachal Pradesh,1202,13,1194,14887,158,43,8.07,0,7.4,934559,7772,929798,2.14,0.58,2.011756756756757,0.83,99.49
2022-12-24,Himachal Pradesh,718,6,709,8362,2331,1834,8.59,3,7.4,935277,7778,930507,31.5,24.78,1.13,0.83,99.49
2022-12-25,Himachal Pradesh,997,7,993,12636,2299,782,7.89,0,7.4,936274,7785,931500,31.07,10.57,1.7075675675675677,0.83,99.49
2022-12-26,Himachal Pradesh,65,0,57,680,482,100,9.56,8,7.4,936339,7785,931557,6.51,1.35,0.0918918918918919,0.83,99.49
2022-12-27,Himachal Pradesh,157,0,149,2490,2622,503,6.31,8,7.4,936496,7785,931706,35.43,6.8,0.3364864864864865,0.83,99.49
2022-12-28,Himachal Pradesh,968,7,961,11855,1740,1052,8.17,0,7.4,937464,7792,932667,23.51,14.22,1.602027027027027,0.83,99.49
2022-12-29,Himachal Pradesh,994,5,993,12286,1670,152,8.09,0,7.4,938458,7797,933660,22.57,2.05,1.6602702702702703,0.83,99.49
2022-12-30,Himachal Pradesh,1207,14,1203,15290,637,502,7.89,0,7.4,939665,7811,934863,8.61,6.78,2.0662162162162163,0.83,99.49
2022-12-31,Himachal Pradesh,1454,9,1446,17722,3405,530,8.2,0,7.4,941119,7820,936309,46.01,7.16,2.3948648648648647,0.83,99.49
2020-01-01,Jharkhand,199,2,193,2035,3718,1045,9.78,4,39.6,199,2,193,9.39,2.64,0.05138888888888889,1.01,96.98
2020-01-02,Jharkhand,1027,13,1019,12701,3607,2536,8.09,0,39.6,1226,15,1212,9.11,6.4,0.32073232323232326,1.22,98.86
2020-01-03,Jharkhand,393,2,384,4646,4630,4077,8.46,7,39.6,1619,17,1596,11.69,10.3,0.11732323232323233,1.05,98.58
2020-01-04,Jharkhand,1022,9,1017,12629,895,628,8.09,0,39.6,2641,26,2613,2.26,1.59,0.3189141414141414,0.98,98.94
2020-01-05,Jharkhand,372,1,363,4821,2864,1412,7.72,8,39.6,3013,27,2976,7.23,3.57,0.12174242424242425,0.9,98.77
2020-01-06,Jharkhand,1254,10,1249,15614,4980,4074,8.03,0,39.6,4267,37,4225,12.58,10.29,0.3942929292929293,0.87,99.02
2020-01-07,Jharkhand,813,10,810,9922,339,232,8.19,0,39.6,5080,47,5035,0.86,0.59,0.25055555555555553,0.93,99.11
2020-01-08,Jharkhand,624,4,621,7704,2649,789,8.1,0,39.6,5704,51,5656,6.69,1.99,0.19454545454545455,0.89,99.16
2020-01-09,Jharkhand,458,4,455,5675,4225,4055,8.07,0,39.6,6162,55,6111,10.67,10.24,0.1433080808080808,0.89,99.17
2020-01-10,Jharkhand,291,1,282,3514,406,5,8.28,8,39.6,6453,56,6393,1.03,0.01,0.08873737373737374,0.87,99.07
2020-01-11,Jharkhand,424,4,420,4817,2282,1320,8.8,0,39.6,6877,60,6813,5.76,3.33,0.12164141414141415,0.87,99.07
2020-01-12,Jharkhand,1275,13,1268,16221,4863,652,7.86,0,39.6,8152,73,8081,12.28,1.65,0.4096212121212121,0.9,99.13
2020-01-13,Jharkhand,934,3,925,11848,545,539,7.88,6,39.6,9086,76,9006,1.38,1.36,0.2991919191919192,0.84,99.12
2020-01-14,Jharkhand,1199,15,1198,14980,2138,221,8.0,0,39.6,10285,91,10204,5.4,0.56,0.3782828282828283,0.88,99.21
2020-01-15,Jharkhand,1457,17,1452,18364,4714,4021,7.93,0,39.6,11742,108,11656,11.9,10.15,0.4637373737373737,0.92,99.27
2020-01-16,Jharkhand,1200,8,1192,15372,4450,3437,7.81,0,39.6,12942,116,12848,11.24,8.68,0.3881818181818182,0.9,99.27
2020-01-17,Jharkhand,633,3,624,7894,3826,2206,8.02,6,39.6,13575,119,13472,9.66,5.57,0.19934343434343435,0.88,99.24
2020-01-18,Jharkhand,458,1,452,5961,802,502,7.68,5,39.6,14033,120,13924,2.03,1.27,0.15053030303030304,0.86,99.22
2020-01-19,Jharkhand,1213,16,1211,15060,2208,203,8.05,0,39.6,15246,136,15135,5.58,0.51,0.3803030303030303,0.89,99.27
2020-01-20,Jharkhand,966,7,957,12197,1355,765,7.92,2,39.6,16212,143,16092,3.42,1.93,0.3080050505050505,0.88,99.26
2020-01-21,Jharkhand,1419,16,1415,17763,2111,1030,7.99,0,39.6,17631,159,17507,5.33,2.6,0.44856060606060605,0.9,99.3
2020-01-22,Jharkhand,839,9,831,10148,3175,2079,8.27,0,39.6,18470,168,18338,8.02,5.25,0.25626262626262625,0.91,99.29
2020-01-23,Jharkhand,1503,7,1498,18983,149,117,7.92,0,39.6,19973,175,19836,0.38,0.3,0.4793686868686869,0.88,99.31
2020-01-24,Jharkhand,1447,7,1447,17875,3345,2279,8.1,0,39.6,21420,182,21283,8.45,5.76,0.4513888888888889,0.85,99.36
2020-01-25,Jharkhand,1257,12,1249,15608,1349,321,8.05,0,39.6,22677,194,22532,3.41,0.81,0.3941414141414141,0.86,99.36
2020-01-26,Jharkhand,842,10,837,10587,4579,3717,7.95,0,39.6,23519,204,23369,11.56,9.39,0.26734848484848484,0.87,99.36
2020-01-27,Jharkhand,285,3,276,3486,979,898,8.18,6,39.6,23804,207,23645,2.47,2.27,0.08803030303030303,0.87,99.33
2020-01-28,Jharkhand,899,9,899,11324,4142,2153,7.94,0,39.6,24703,216,24544,10.46,5.44,0.28595959595959597,0.87,99.36
2020-01-29,Jharkhand,550,7,548,6357,1035,842,8.65,0,39.6,25253,223,25092,2.61,2.13,0.16053030303030302,0.88,99.36
2020-01-30,Jharkhand,989,3,986,12266,848,641,8.06,0,39.6,26242,226,26078,2.14,1.62,0.30974747474747477,0.86,99.38
2020-01-31,Jharkhand,759,5,752,9272,3165,2471,8.19,2,39.6,27001,231,26830,7.99,6.24,0.23414141414141415,0.86,99.37
2020-02-01,Jharkhand,711,3,706,8431,1453,495,8.43,2,39.6,27712,234,27536,3.67,1.25,0.2129040404040404,0.84,99.36
2020-02-02,Jharkhand,568,3,567,7077,2854,2195,8.03,0,39.6,28280,237,28103,7.21,5.54,0.1787121212121212,0.84,99.37
2020-02-03,Jharkhand,1340,5,1334,16628,168,21,8.06,1,39.6,29620,242,29437,0.42,0.05,0.4198989898989899,0.82,99.38
2020-02-04,Jharkhand,358,1,349,4603,4921,4385,7.78,8,39.6,29978,243,29786,12.43,11.07,0.11623737373737374,0.81,99.36
2020-02-05,Jharkhand,927,7,919,11199,878,529,8.28,1,39.6,30905,250,30705,2.22,1.34,0.2828030303030303,0.81,99.35
2020-02-06,Jharkhand,1580,6,1577,19985,1411,55,7.91,0,39.6,32485,256,32282,3.56,0.14,0.5046717171717172,0.79,99.38
2020-02-07,Jharkhand,49,0,43,1096,3723,2277,4.47,6,39.6,32534,256,32325,9.4,5.75,0.027676767676767678,0.79,99.36
2020-02-08,Jharkhand,1135,13,1126,14527,3032,1736,7.81,0,39.6,33669,269,33451,7.66,4.38,0.36684343434343436,0.8,99.35
2020-02-09,Jharkhand,1111,16,1108,13830,857,0,8.03,0,39.6,34780,285,34559,2.16,0.0,0.34924242424242424,0.82,99.36
2020-02-10,Jharkhand,236,2,231,2610,3935,789,9.04,3,39.6,35016,287,34790,9.94,1.99,0.0659090909090909,0.82,99.35
2020-02-11,Jharkhand,1544,14,1538,19042,4055,302,8.11,0,39.6,36560,301,36328,10.24,0.76,0.4808585858585859,0.82,99.37
2020-02-12,Jharkhand,1460,10,1458,17900,3342,634,8.16,0,39.6,38020,311,37786,8.44,1.6,0.45202020202020204,0.82,99.38
2020-02-13,Jharkhand,1539,17,1534,19419,2210,1816,7.93,0,39.6,39559,328,39320,5.58,4.59,0.49037878787878786,0.83,99.4
2020-02-14,Jharkhand,1322,10,1322,16608,4243,3422,7.96,0,39.6,40881,338,40642,10.71,8.64,0.4193939393939394,0.83,99.42
2020-02-15,Jharkhand,197,1,196,2720,3032,2049,7.24,0,39.6,41078,339,40838,7.66,5.17,0.06868686868686869,0.83,99.42
2020-02-16,Jharkhand,1068,15,1067,13716,469,278,7.79,0,39.6,42146,354,41905,1.18,0.7,0.3463636363636364,0.84,99.43
2020-02-17,Jharkhand,649,5,645,8093,4570,2065,8.02,0,39.6,42795,359,42550,11.54,5.21,0.20436868686868687,0.84,99.43
2020-02-18,Jharkhand,972,11,965,12321,625,192,7.89,0,39.6,43767,370,43515,1.58,0.48,0.31113636363636366,0.85,99.42
2020-02-19,Jharkhand,1413,17,1408,17636,4342,2358,8.01,0,39.6,45180,387,44923,10.96,5.95,0.44535353535353533,0.86,99.43
2020-02-20,Jharkhand,562,4,553,6677,1668,164,8.42,5,39.6,45742,391,45476,4.21,0.41,0.1686111111111111,0.85,99.42
2020-02-21,Jharkhand,319,1,313,3611,4117,2066,8.83,5,39.6,46061,392,45789,10.4,5.22,0.09118686868686869,0.85,99.41
2020-02-22,Jharkhand,331,2,326,3960,2470,1044,8.36,3,39.6,46392,394,46115,6.24,2.64,0.1,0.85,99.4
2020-02-23,Jharkhand,1463,10,1463,18563,3775,2392,7.88,0,39.6,47855,404,47578,9.53,6.04,0.46876262626262627,0.84,99.42
2020-02-24,Jharkhand,1532,16,1529,18903,4845,3478,8.1,0,39.6,49387,420,49107,12.23,8.78,0.47734848484848486,0.85,99.43
2020-02-25,Jharkhand,311,3,307,3401,3763,3505,9.14,1,39.6,49698,423,49414,9.5,8.85,0.08588383838383838,0.85,99.43
2020-02-26,Jharkhand,894,12,894,11230,3161,148,7.96,0,39.6,50592,435,50308,7.98,0.37,0.2835858585858586,0.86,99.44
2020-02-27,Jharkhand,729,8,728,9215,4042,1350,7.91,0,39.6,51321,443,51036,10.21,3.41,0.23270202020202022,0.86,99.44
2020-02-28,Jharkhand,1343,19,1339,16733,117,62,8.03,0,39.6,52664,462,52375,0.3,0.16,0.42255050505050507,0.88,99.45
2020-02-29,Jharkhand,726,3,717,9452,501,23,7.68,6,39.6,53390,465,53092,1.27,0.06,0.2386868686868687,0.87,99.44
2020-03-01,Jharkhand,1497,20,1497,18323,1136,1050,8.17,0,39.6,54887,485,54589,2.87,2.65,0.4627020202020202,0.88,99.46
2020-03-02,Jharkhand,1515,14,1512,19191,3168,1195,7.89,0,39.6,56402,499,56101,8.0,3.02,0.4846212121212121,0.88,99.47
2020-03-03,Jharkhand,9,0,7,565,4160,1567,1.59,2,39.6,56411,499,56108,10.51,3.96,0.014267676767676768,0.88,99.46
2020-03-04,Jharkhand,224,2,220,2941,2723,900,7.62,2,39.6,56635,501,56328,6.88,2.27,0.07426767676767677,0.88,99.46
2020-03-05,Jharkhand,619,5,616,7659,2103,129,8.08,0,39.6,57254,506,56944,5.31,0.33,0.19340909090909092,0.88,99.46
2020-03-06,Jharkhand,604,2,604,7725,2322,2130,7.82,0,39.6,57858,508,57548,5.86,5.38,0.19507575757575757,0.88,99.46
2020-03-07,Jharkhand,1036,3,1030,13013,4483,3613,7.96,3,39.6,58894,511,58578,11.32,9.12,0.32861111111111113,0.87,99.46
2020-03-08,Jharkhand,662,6,655,8375,4321,697,7.9,1,39.6,59556,517,59233,10.91,1.76,0.21148989898989898,0.87,99.46
2020-03-09,Jharkhand,890,12,888,11275,2389,893,7.89,0,39.6,60446,529,60121,6.03,2.26,0.2847222222222222,0.88,99.46
2020-03-10,Jharkhand,65,0,63,1325,2775,1305,4.91,2,39.6,60511,529,60184,7.01,3.3,0.03345959595959596,0.87,99.46
2020-03-11,Jharkhand,348,3,348,4211,4749,4091,8.26,0,39.6,60859,532,60532,11.99,10.33,0.10633838383838384,0.87,99.46
2020-03-12,Jharkhand,996,11,996,12623,180,128,7.89,0,39.6,61855,543,61528,0.45,0.32,0.31876262626262625,0.88,99.47
2020-03-13,Jharkhand,778,6,777,9777,3560,3033,7.96,0,39.6,62633,549,62305,8.99,7.66,0.2468939393939394,0.88,99.48
2020-03-14,Jharkhand,532,4,523,6214,2060,431,8.56,5,39.6,63165,553,62828,5.2,1.09,0.15691919191919193,0.88,99.47
2020-03-15,Jharkhand,1452,8,1452,17562,4298,2706,8.27,0,39.6,64617,561,64280,10.85,6.83,0.4434848484848485,0.87,99.48
2020-03-16,Jharkhand,466,2,459,5980,1927,392,7.79,5,39.6,65083,563,64739,4.87,0.99,0.151010101010101,0.87,99.47
2020-03-17,Jharkhand,43,0,35,569,2582,92,7.56,8,39.6,65126,563,64774,6.52,0.23,0.01436868686868687,0.86,99.46
2020-03-18,Jharkhand,1349,8,1345,16796,2712,2637,8.03,0,39.6,66475,571,66119,6.85,6.66,0.42414141414141415,0.86,99.46
2020-03-19,Jharkhand,1148,4,1148,14130,1059,411,8.12,0,39.6,67623,575,67267,2.67,1.04,0.3568181818181818,0.85,99.47
2020-03-20,Jharkhand,485,4,481,6390,4371,1458,7.59,0,39.6,68108,579,67748,11.04,3.68,0.16136363636363638,0.85,99.47
2020-03-21,Jharkhand,62,0,56,1031,1657,391,6.01,6,39.6,68170,579,67804,4.18,0.99,0.026035353535353536,0.85,99.46
2020-03-22,Jharkhand,1063,4,1056,12676,1672,737,8.39,3,39.6,69233,583,68860,4.22,1.86,0.3201010101010101,0.84,99.46
2020-03-23,Jharkhand,399,3,398,4774,4349,2847,8.36,0,39.6,69632,586,69258,10.98,7.19,0.12055555555555555,0.84,99.46
2020-03-24,Jharkhand,224,3,217,2942,450,136,7.61,4,39.6,69856,589,69475,1.14,0.34,0.0742929292929293,0.84,99.45
2020-03-25,Jharkhand,934,9,925,11523,2550,226,8.11,0,39.6,70790,598,70400,6.44,0.57,0.29098484848484846,0.84,99.45
2020-03-26,Jharkhand,1531,6,1531,18715,4618,1494,8.18,0,39.6,72321,604,71931,11.66,3.77,0.4726010101010101,0.84,99.46
2020-03-27,Jharkhand,340,2,333,4253,2414,1031,7.99,5,39.6,72661,606,72264,6.1,2.6,0.1073989898989899,0.83,99.45
2020-03-28,Jharkhand,721,4,717,9180,1795,720,7.85,0,39.6,73382,610,72981,4.53,1.82,0.2318181818181818,0.83,99.45
2020-03-29,Jharkhand,5,0,0,524,3989,3683,0.95,5,39.6,73387,610,72981,10.07,9.3,0.013232323232323233,0.83,99.45
2020-03-30,Jharkhand,700,6,694,8369,4094,267,8.36,0,39.6,74087,616,73675,10.34,0.67,0.21133838383838383,0.83,99.44
2020-03-31,Jharkhand,1525,10,1519,19266,1810,339,7.92,0,39.6,75612,626,75194,4.57,0.86,0.4865151515151515,0.83,99.45
2020-04-01,Jharkhand,1414,16,1411,17558,1403,866,8.05,0,39.6,77026,642,76605,3.54,2.19,0.4433838383838384,0.83,99.45
2020-04-02,Jharkhand,1528,5,1523,19558,1362,1122,7.81,0,39.6,78554,647,78128,3.44,2.83,0.4938888888888889,0.82,99.46
2020-04-03,Jharkhand,554,4,545,6640,205,21,8.34,5,39.6,79108,651,78673,0.52,0.05,0.16767676767676767,0.82,99.45
2020-04-04,Jharkhand,1526,18,1519,18671,3612,7,8.17,0,39.6,80634,669,80192,9.12,0.02,0.471489898989899,0.83,99.45
2020-04-05,Jharkhand,1362,17,1360,17025,3329,199,8.0,0,39.6,81996,686,81552,8.41,0.5,0.42992424242424243,0.84,99.46
2020-04-06,Jharkhand,393,1,391,5031,3148,2742,7.81,1,39.6,82389,687,81943,7.95,6.92,0.12704545454545454,0.83,99.46
2020-04-07,Jharkhand,682,7,674,8476,72,25,8.05,1,39.6,83071,694,82617,0.18,0.06,0.21404040404040403,0.84,99.45
2020-04-08,Jharkhand,603,5,603,7248,583,349,8.32,0,39.6,83674,699,83220,1.47,0.88,0.18303030303030304,0.84,99.46
2020-04-09,Jharkhand,1498,14,1493,18595,3555,288,8.06,0,39.6,85172,713,84713,8.98,0.73,0.4695707070707071,0.84,99.46
2020-04-10,Jharkhand,220,3,217,2938,3016,1037,7.49,0,39.6,85392,716,84930,7.62,2.62,0.0741919191919192,0.84,99.46
2020-04-11,Jharkhand,515,6,515,6385,4038,1536,8.07,0,39.6,85907,722,85445,10.2,3.88,0.16123737373737373,0.84,99.46
2020-04-12,Jharkhand,202,1,200,2426,2746,573,8.33,1,39.6,86109,723,85645,6.93,1.45,0.06126262626262626,0.84,99.46
2020-04-13,Jharkhand,1530,17,1527,19219,568,32,7.96,0,39.6,87639,740,87172,1.43,0.08,0.48532828282828283,0.84,99.47
2020-04-14,Jharkhand,223,3,218,2724,3901,1238,8.19,2,39.6,87862,743,87390,9.85,3.13,0.06878787878787879,0.85,99.46
2020-04-15,Jharkhand,789,7,786,10095,1409,277,7.82,0,39.6,88651,750,88176,3.56,0.7,0.25492424242424244,0.85,99.46
2020-04-16,Jharkhand,534,5,525,6364,421,296,8.39,4,39.6,89185,755,88701,1.06,0.75,0.16070707070707071,0.85,99.46
2020-04-17,Jharkhand,617,4,617,7977,509,505,7.73,0,39.6,89802,759,89318,1.29,1.28,0.20143939393939395,0.85,99.46
2020-04-18,Jharkhand,1137,7,1130,13812,3644,1197,8.23,0,39.6,90939,766,90448,9.2,3.02,0.3487878787878788,0.84,99.46
2020-04-19,Jharkhand,419,3,419,5289,4153,2402,7.92,0,39.6,91358,769,90867,10.49,6.07,0.13356060606060607,0.84,99.46
2020-04-20,Jharkhand,610,4,607,7512,4839,2976,8.12,0,39.6,91968,773,91474,12.22,7.52,0.1896969696969697,0.84,99.46
2020-04-21,Jharkhand,622,8,614,7658,4490,2926,8.12,0,39.6,92590,781,92088,11.34,7.39,0.19338383838383838,0.84,99.46
2020-04-22,Jharkhand,533,5,527,6575,4443,2769,8.11,1,39.6,93123,786,92615,11.22,6.99,0.16603535353535354,0.84,99.45
2020-04-23,Jharkhand,1548,9,1542,19113,1271,1239,8.1,0,39.6,94671,795,94157,3.21,3.13,0.48265151515151516,0.84,99.46
2020-04-24,Jharkhand,552,7,551,6833,420,235,8.08,0,39.6,95223,802,94708,1.06,0.59,0.17255050505050504,0.84,99.46
2020-04-25,Jharkhand,1300,7,1297,16375,653,472,7.94,0,39.6,96523,809,96005,1.65,1.19,0.413510101010101,0.84,99.46
2020-04-26,Jharkhand,731,6,725,9499,88,33,7.7,0,39.6,97254,815,96730,0.22,0.08,0.23987373737373738,0.84,99.46
2020-04-27,Jharkhand,172,2,167,2169,1315,155,7.93,3,39.6,97426,817,96897,3.32,0.39,0.05477272727272727,0.84,99.46
2020-04-28,Jharkhand,128,0,121,1452,3376,2491,8.82,7,39.6,97554,817,97018,8.53,6.29,0.03666666666666667,0.84,99.45
2020-04-29,Jharkhand,579,7,571,7210,1939,848,8.03,1,39.6,98133,824,97589,4.9,2.14,0.18207070707070708,0.84,99.45
2020-04-30,Jharkhand,1585,21,1577,19566,3794,362,8.1,0,39.6,99718,845,99166,9.58,0.91,0.4940909090909091,0.85,99.45
2020-05-01,Jharkhand,877,9,871,11304,3548,2949,7.76,0,39.6,100595,854,100037,8.96,7.45,0.28545454545454546,0.85,99.45
2020-05-02,Jharkhand,1543,8,1535,19056,679,313,8.1,0,39.6,102138,862,101572,1.71,0.79,0.4812121212121212,0.84,99.45
2020-05-03,Jharkhand,145,1,145,1820,3572,2376,7.97,0,39.6,102283,863,101717,9.02,6.0,0.04595959595959596,0.84,99.45
2020-05-04,Jharkhand,634,1,628,7914,3613,1360,8.01,5,39.6,102917,864,102345,9.12,3.43,0.19984848484848486,0.84,99.44
2020-05-05,Jharkhand,1332,4,1324,16735,1710,995,7.96,4,39.6,104249,868,103669,4.32,2.51,0.4226010101010101,0.83,99.44
2020-05-06,Jharkhand,979,14,975,12593,3269,128,7.77,0,39.6,105228,882,104644,8.26,0.32,0.3180050505050505,0.84,99.45
2020-05-07,Jharkhand,956,7,951,11581,1164,257,8.25,0,39.6,106184,889,105595,2.94,0.65,0.29244949494949496,0.84,99.45
2020-05-08,Jharkhand,59,0,53,616,4309,3538,9.58,6,39.6,106243,889,105648,10.88,8.93,0.015555555555555555,0.84,99.44
2020-05-09,Jharkhand,92,1,87,1206,3656,1378,7.63,4,39.6,106335,890,105735,9.23,3.48,0.030454545454545453,0.84,99.44
2020-05-10,Jharkhand,1323,13,1322,16343,4519,3475,8.1,0,39.6,107658,903,107057,11.41,8.78,0.4127020202020202,0.84,99.44
2020-05-11,Jharkhand,577,2,570,7411,3242,2955,7.79,5,39.6,108235,905,107627,8.19,7.46,0.18714646464646464,0.84,99.44
2020-05-12,Jharkhand,161,1,152,2032,762,357,7.92,8,39.6,108396,906,107779,1.92,0.9,0.05131313131313131,0.84,99.43
2020-05-13,Jharkhand,157,0,153,1748,2796,2022,8.98,4,39.6,108553,906,107932,7.06,5.11,0.04414141414141414,0.83,99.43
2020-05-14,Jharkhand,1272,6,1269,15454,663,100,8.23,0,39.6,109825,912,109201,1.67,0.25,0.39025252525252524,0.83,99.43
2020-05-15,Jharkhand,711,5,705,8666,341,6,8.2,1,39.6,110536,917,109906,0.86,0.02,0.21883838383838383,0.83,99.43
2020-05-16,Jharkhand,795,5,790,9875,1303,179,8.05,0,39.6,111331,922,110696,3.29,0.45,0.24936868686868688,0.83,99.43
2020-05-17,Jharkhand,299,1,298,3477,3594,3572,8.6,0,39.6,111630,923,110994,9.08,9.02,0.0878030303030303,0.83,99.43
2020-05-18,Jharkhand,1133,5,1128,14165,3503,181,8.0,0,39.6,112763,928,112122,8.85,0.46,0.3577020202020202,0.82,99.43
2020-05-19,Jharkhand,1425,20,1423,17612,597,153,8.09,0,39.6,114188,948,113545,1.51,0.39,0.4447474747474747,0.83,99.44
2020-05-20,Jharkhand,725,5,722,9315,2605,1782,7.78,0,39.6,114913,953,114267,6.58,4.5,0.23522727272727273,0.83,99.44
2020-05-21,Jharkhand,717,8,715,9106,1264,1142,7.87,0,39.6,115630,961,114982,3.19,2.88,0.22994949494949496,0.83,99.44
2020-05-22,Jharkhand,646,4,645,8101,4654,3915,7.97,0,39.6,116276,965,115627,11.75,9.89,0.20457070707070707,0.83,99.44
2020-05-23,Jharkhand,1043,13,1041,13064,2384,1018,7.98,0,39.6,117319,978,116668,6.02,2.57,0.3298989898989899,0.83,99.45
2020-05-24,Jharkhand,340,3,340,3953,3846,1944,8.6,0,39.6,117659,981,117008,9.71,4.91,0.09982323232323233,0.83,99.45
2020-05-25,Jharkhand,1458,12,1449,18073,2798,2731,8.07,0,39.6,119117,993,118457,7.07,6.9,0.4563888888888889,0.83,99.45
2020-05-26,Jharkhand,1324,14,1318,16518,2293,1698,8.02,0,39.6,120441,1007,119775,5.79,4.29,0.4171212121212121,0.84,99.45
2020-05-27,Jharkhand,155,1,155,1979,4646,4165,7.83,0,39.6,120596,1008,119930,11.73,10.52,0.04997474747474748,0.84,99.45
2020-05-28,Jharkhand,1012,13,1004,12705,4462,2850,7.97,0,39.6,121608,1021,120934,11.27,7.2,0.32083333333333336,0.84,99.45
2020-05-29,Jharkhand,299,3,294,3805,1459,932,7.86,2,39.6,121907,1024,121228,3.68,2.35,0.09608585858585858,0.84,99.44
2020-05-30,Jharkhand,432,3,431,5325,62,54,8.11,0,39.6,122339,1027,121659,0.16,0.14,0.13446969696969696,0.84,99.44
2020-05-31,Jharkhand,163,2,158,1862,1672,1242,8.75,3,39.6,122502,1029,121817,4.22,3.14,0.04702020202020202,0.84,99.44
2020-06-01,Jharkhand,1543,9,1534,19196,3437,2636,8.04,0,39.6,124045,1038,123351,8.68,6.66,0.48474747474747476,0.84,99.44
2020-06-02,Jharkhand,174,0,165,2139,3191,514,8.13,9,39.6,124219,1038,123516,8.06,1.3,0.054015151515151516,0.84,99.43
2020-06-03,Jharkhand,422,2,414,5128,4588,3965,8.23,6,39.6,124641,1040,123930,11.59,10.01,0.1294949494949495,0.83,99.43
2020-06-04,Jharkhand,222,1,214,2548,4191,3119,8.71,7,39.6,124863,1041,124144,10.58,7.88,0.06434343434343434,0.83,99.42
2020-06-05,Jharkhand,1495,18,1492,18707,4774,4086,7.99,0,39.6,126358,1059,125636,12.06,10.32,0.4723989898989899,0.84,99.43
2020-06-06,Jharkhand,898,11,889,11144,4218,1042,8.06,0,39.6,127256,1070,126525,10.65,2.63,0.2814141414141414,0.84,99.43
2020-06-07,Jharkhand,896,4,894,11563,1428,839,7.75,0,39.6,128152,1074,127419,3.61,2.12,0.2919949494949495,0.84,99.43
2020-06-08,Jharkhand,914,8,914,11191,2759,1032,8.17,0,39.6,129066,1082,128333,6.97,2.61,0.2826010101010101,0.84,99.43
2020-06-09,Jharkhand,1062,10,1062,13102,837,678,8.11,0,39.6,130128,1092,129395,2.11,1.71,0.33085858585858585,0.84,99.44
2020-06-10,Jharkhand,1372,5,1369,17421,3380,1110,7.88,0,39.6,131500,1097,130764,8.54,2.8,0.43992424242424244,0.83,99.44
2020-06-11,Jharkhand,1095,4,1086,14031,1526,603,7.8,5,39.6,132595,1101,131850,3.85,1.52,0.3543181818181818,0.83,99.44
2020-06-12,Jharkhand,1512,20,1505,18846,3410,1896,8.02,0,39.6,134107,1121,133355,8.61,4.79,0.4759090909090909,0.84,99.44
2020-06-13,Jharkhand,1015,6,1009,12744,2574,185,7.96,0,39.6,135122,1127,134364,6.5,0.47,0.32181818181818184,0.83,99.44
2020-06-14,Jharkhand,719,9,714,8550,2128,1199,8.41,0,39.6,135841,1136,135078,5.37,3.03,0.2159090909090909,0.84,99.44
2020-06-15,Jharkhand,352,4,344,4349,1597,1053,8.09,4,39.6,136193,1140,135422,4.03,2.66,0.10982323232323232,0.84,99.43
2020-06-16,Jharkhand,963,12,959,11945,616,514,8.06,0,39.6,137156,1152,136381,1.56,1.3,0.30164141414141415,0.84,99.43
2020-06-17,Jharkhand,575,5,574,6791,4758,3454,8.47,0,39.6,137731,1157,136955,12.02,8.72,0.171489898989899,0.84,99.44
2020-06-18,Jharkhand,353,5,345,4562,3183,1977,7.74,3,39.6,138084,1162,137300,8.04,4.99,0.11520202020202021,0.84,99.43
2020-06-19,Jharkhand,771,7,769,9794,1407,1336,7.87,0,39.6,138855,1169,138069,3.55,3.37,0.24732323232323233,0.84,99.43
2020-06-20,Jharkhand,100,0,99,1262,741,305,7.92,1,39.6,138955,1169,138168,1.87,0.77,0.031868686868686866,0.84,99.43
2020-06-21,Jharkhand,1073,6,1066,13421,2349,928,7.99,1,39.6,140028,1175,139234,5.93,2.34,0.3389141414141414,0.84,99.43
2020-06-22,Jharkhand,331,3,327,4091,3119,1638,8.09,1,39.6,140359,1178,139561,7.88,4.14,0.10330808080808081,0.84,99.43
2020-06-23,Jharkhand,1579,17,1574,19671,3856,1476,8.03,0,39.6,141938,1195,141135,9.74,3.73,0.49674242424242426,0.84,99.43
2020-06-24,Jharkhand,1004,12,1000,12613,4150,1498,7.96,0,39.6,142942,1207,142135,10.48,3.78,0.318510101010101,0.84,99.44
2020-06-25,Jharkhand,583,3,576,6868,1710,818,8.49,4,39.6,143525,1210,142711,4.32,2.07,0.17343434343434344,0.84,99.43
2020-06-26,Jharkhand,1147,5,1146,14765,4383,4187,7.77,0,39.6,144672,1215,143857,11.07,10.57,0.3728535353535353,0.84,99.44
2020-06-27,Jharkhand,770,5,761,9456,4204,1911,8.14,4,39.6,145442,1220,144618,10.62,4.83,0.2387878787878788,0.84,99.43
2020-06-28,Jharkhand,1317,13,1313,16028,2815,2396,8.22,0,39.6,146759,1233,145931,7.11,6.05,0.40474747474747474,0.84,99.44
2020-06-29,Jharkhand,1116,3,1116,13733,742,272,8.13,0,39.6,147875,1236,147047,1.87,0.69,0.3467929292929293,0.84,99.44
2020-06-30,Jharkhand,550,1,541,7039,4626,2656,7.81,8,39.6,148425,1237,147588,11.68,6.71,0.17775252525252525,0.83,99.44
2020-07-01,Jharkhand,916,8,914,11483,2311,213,7.98,0,39.6,149341,1245,148502,5.84,0.54,0.2899747474747475,0.83,99.44
2020-07-02,Jharkhand,642,5,642,7918,603,75,8.11,0,39.6,149983,1250,149144,1.52,0.19,0.19994949494949496,0.83,99.44
2020-07-03,Jharkhand,1325,17,1321,16618,4273,1299,7.97,0,39.6,151308,1267,150465,10.79,3.28,0.41964646464646466,0.84,99.44
2020-07-04,Jharkhand,1056,10,1053,13088,4347,2473,8.07,0,39.6,152364,1277,151518,10.98,6.24,0.3305050505050505,0.84,99.44
2020-07-05,Jharkhand,532,3,529,6875,343,85,7.74,0,39.6,152896,1280,152047,0.87,0.21,0.1736111111111111,0.84,99.44
2020-07-06,Jharkhand,601,7,599,7507,276,196,8.01,0,39.6,153497,1287,152646,0.7,0.49,0.18957070707070708,0.84,99.45
2020-07-07,Jharkhand,1157,10,1155,14638,3654,3627,7.9,0,39.6,154654,1297,153801,9.23,9.16,0.36964646464646467,0.84,99.45
2020-07-08,Jharkhand,773,3,765,9551,1109,132,8.09,5,39.6,155427,1300,154566,2.8,0.33,0.2411868686868687,0.84,99.45
2020-07-09,Jharkhand,1388,8,1379,17236,3288,221,8.05,1,39.6,156815,1308,155945,8.3,0.56,0.4352525252525253,0.83,99.45
2020-07-10,Jharkhand,1227,4,1226,15350,4929,477,7.99,0,39.6,158042,1312,157171,12.45,1.2,0.38762626262626265,0.83,99.45
2020-07-11,Jharkhand,560,5,559,7083,3885,2363,7.91,0,39.6,158602,1317,157730,9.81,5.97,0.17886363636363636,0.83,99.45
2020-07-12,Jharkhand,1244,7,1239,16058,4209,37,7.75,0,39.6,159846,1324,158969,10.63,0.09,0.4055050505050505,0.83,99.45
2020-07-13,Jharkhand,1287,17,1279,16240,2440,1540,7.92,0,39.6,161133,1341,160248,6.16,3.89,0.4101010101010101,0.83,99.45
2020-07-14,Jharkhand,1486,7,1482,17977,891,347,8.27,0,39.6,162619,1348,161730,2.25,0.88,0.45396464646464646,0.83,99.45
2020-07-15,Jharkhand,1211,13,1209,14674,2257,125,8.25,0,39.6,163830,1361,162939,5.7,0.32,0.3705555555555556,0.83,99.46
2020-07-16,Jharkhand,634,6,629,8036,2695,1815,7.89,0,39.6,164464,1367,163568,6.81,4.58,0.20292929292929293,0.83,99.46
2020-07-17,Jharkhand,1264,4,1256,15683,3711,1615,8.06,4,39.6,165728,1371,164824,9.37,4.08,0.3960353535353535,0.83,99.45
2020-07-18,Jharkhand,1137,13,1129,14028,1500,868,8.11,0,39.6,166865,1384,165953,3.79,2.19,0.35424242424242425,0.83,99.45
2020-07-19,Jharkhand,960,10,952,12019,1982,1127,7.99,0,39.6,167825,1394,166905,5.01,2.85,0.303510101010101,0.83,99.45
2020-07-20,Jharkhand,399,5,390,4665,1091,804,8.55,4,39.6,168224,1399,167295,2.76,2.03,0.1178030303030303,0.83,99.45
2020-07-21,Jharkhand,1537,8,1529,18991,2079,1440,8.09,0,39.6,169761,1407,168824,5.25,3.64,0.4795707070707071,0.83,99.45
2020-07-22,Jharkhand,1457,9,1457,18212,1133,1028,8.0,0,39.6,171218,1416,170281,2.86,2.6,0.4598989898989899,0.83,99.45
2020-07-23,Jharkhand,1183,11,1183,15020,3744,1854,7.88,0,39.6,172401,1427,171464,9.45,4.68,0.3792929292929293,0.83,99.46
2020-07-24,Jharkhand,1219,10,1212,14749,2622,2390,8.26,0,39.6,173620,1437,172676,6.62,6.04,0.372449494949495,0.83,99.46
2020-07-25,Jharkhand,652,4,648,7735,2979,1937,8.43,0,39.6,174272,1441,173324,7.52,4.89,0.19532828282828282,0.83,99.46
2020-07-26,Jharkhand,1330,14,1330,16482,4918,1680,8.07,0,39.6,175602,1455,174654,12.42,4.24,0.4162121212121212,0.83,99.46
2020-07-27,Jharkhand,1070,6,1068,13177,3975,208,8.12,0,39.6,176672,1461,175722,10.04,0.53,0.33275252525252524,0.83,99.46
2020-07-28,Jharkhand,645,6,641,8512,1710,48,7.58,0,39.6,177317,1467,176363,4.32,0.12,0.21494949494949495,0.83,99.46
2020-07-29,Jharkhand,952,5,943,12003,3671,2671,7.93,4,39.6,178269,1472,177306,9.27,6.74,0.3031060606060606,0.83,99.46
2020-07-30,Jharkhand,1572,8,1564,19556,2745,2198,8.04,0,39.6,179841,1480,178870,6.93,5.55,0.49383838383838385,0.82,99.46
2020-07-31,Jharkhand,384,1,376,5083,3591,1324,7.55,7,39.6,180225,1481,179246,9.07,3.34,0.12835858585858587,0.82,99.46
2020-08-01,Jharkhand,668,9,664,7951,1279,276,8.4,0,39.6,180893,1490,179910,3.23,0.7,0.20078282828282829,0.82,99.46
2020-08-02,Jharkhand,408,4,407,5105,290,226,7.99,0,39.6,181301,1494,180317,0.73,0.57,0.12891414141414143,0.82,99.46
2020-08-03,Jharkhand,485,3,478,6516,4979,1871,7.44,4,39.6,181786,1497,180795,12.57,4.72,0.16454545454545455,0.82,99.45
2020-08-04,Jharkhand,893,3,884,11542,3790,3106,7.74,6,39.6,182679,1500,181679,9.57,7.84,0.2914646464646465,0.82,99.45
2020-08-05,Jharkhand,1402,7,1395,17718,1972,908,7.91,0,39.6,184081,1507,183074,4.98,2.29,0.44742424242424245,0.82,99.45
2020-08-06,Jharkhand,863,6,857,10484,985,212,8.23,0,39.6,184944,1513,183931,2.49,0.54,0.26474747474747473,0.82,99.45
2020-08-07,Jharkhand,1223,6,1220,15126,1742,337,8.09,0,39.6,186167,1519,185151,4.4,0.85,0.38196969696969696,0.82,99.45
2020-08-08,Jharkhand,761,8,752,9543,1052,689,7.97,1,39.6,186928,1527,185903,2.66,1.74,0.2409848484848485,0.82,99.45
2020-08-09,Jharkhand,36,0,31,533,3941,3123,6.75,5,39.6,186964,1527,185934,9.95,7.89,0.01345959595959596,0.82,99.45
2020-08-10,Jharkhand,1331,11,1327,16367,1008,198,8.13,0,39.6,188295,1538,187261,2.55,0.5,0.4133080808080808,0.82,99.45
2020-08-11,Jharkhand,1299,13,1295,16215,4897,1330,8.01,0,39.6,189594,1551,188556,12.37,3.36,0.409469696969697,0.82,99.45
2020-08-12,Jharkhand,1209,10,1201,14937,1056,253,8.09,0,39.6,190803,1561,189757,2.67,0.64,0.3771969696969697,0.82,99.45
2020-08-13,Jharkhand,213,2,206,2659,3563,1371,8.01,5,39.6,191016,1563,189963,9.0,3.46,0.06714646464646465,0.82,99.45
2020-08-14,Jharkhand,1243,10,1243,15432,4034,3785,8.05,0,39.6,192259,1573,191206,10.19,9.56,0.3896969696969697,0.82,99.45
2020-08-15,Jharkhand,1147,13,1139,14310,1989,279,8.02,0,39.6,193406,1586,192345,5.02,0.7,0.3613636363636364,0.82,99.45
2020-08-16,Jharkhand,1422,4,1421,17686,883,223,8.04,0,39.6,194828,1590,193766,2.23,0.56,0.44661616161616163,0.82,99.45
2020-08-17,Jharkhand,761,9,754,9454,2926,740,8.05,0,39.6,195589,1599,194520,7.39,1.87,0.23873737373737375,0.82,99.45
2020-08-18,Jharkhand,865,11,859,10709,1229,568,8.08,0,39.6,196454,1610,195379,3.1,1.43,0.2704292929292929,0.82,99.45
2020-08-19,Jharkhand,972,8,971,12130,2206,1143,8.01,0,39.6,197426,1618,196350,5.57,2.89,0.3063131313131313,0.82,99.45
2020-08-20,Jharkhand,1202,6,1195,14940,4845,1273,8.05,1,39.6,198628,1624,197545,12.23,3.21,0.37727272727272726,0.82,99.45
2020-08-21,Jharkhand,1189,5,1185,14769,4127,2932,8.05,0,39.6,199817,1629,198730,10.42,7.4,0.3729545454545454,0.82,99.46
2020-08-22,Jharkhand,911,4,910,11706,4321,2848,7.78,0,39.6,200728,1633,199640,10.91,7.19,0.2956060606060606,0.81,99.46
2020-08-23,Jharkhand,597,6,597,7373,2399,1011,8.1,0,39.6,201325,1639,200237,6.06,2.55,0.18618686868686868,0.81,99.46
2020-08-24,Jharkhand,425,5,423,5251,4765,1719,8.09,0,39.6,201750,1644,200660,12.03,4.34,0.1326010101010101,0.81,99.46
2020-08-25,Jharkhand,446,5,442,5223,677,558,8.54,0,39.6,202196,1649,201102,1.71,1.41,0.1318939393939394,0.82,99.46
2020-08-26,Jharkhand,1075,7,1073,13661,3713,792,7.87,0,39.6,203271,1656,202175,9.38,2.0,0.3449747474747475,0.81,99.46
2020-08-27,Jharkhand,1074,13,1066,13640,703,526,7.87,0,39.6,204345,1669,203241,1.78,1.33,0.34444444444444444,0.82,99.46
2020-08-28,Jharkhand,1564,5,1555,19598,2026,1971,7.98,4,39.6,205909,1674,204796,5.12,4.98,0.4948989898989899,0.81,99.46
2020-08-29,Jharkhand,1105,13,1102,13667,3342,626,8.09,0,39.6,207014,1687,205898,8.44,1.58,0.3451262626262626,0.81,99.46
2020-08-30,Jharkhand,1537,20,1537,19177,4923,1236,8.01,0,39.6,208551,1707,207435,12.43,3.12,0.4842676767676768,0.82,99.46
2020-08-31,Jharkhand,40,0,40,526,716,87,7.6,0,39.6,208591,1707,207475,1.81,0.22,0.013282828282828283,0.82,99.46
2020-09-01,Jharkhand,141,1,141,2123,3581,595,6.64,0,39.6,208732,1708,207616,9.04,1.5,0.05361111111111111,0.82,99.47
2020-09-02,Jharkhand,401,4,399,4693,1191,1116,8.54,0,39.6,209133,1712,208015,3.01,2.82,0.11851010101010101,0.82,99.47
2020-09-03,Jharkhand,854,4,847,10618,1260,657,8.04,3,39.6,209987,1716,208862,3.18,1.66,0.2681313131313131,0.82,99.46
2020-09-04,Jharkhand,206,1,205,2475,3634,1662,8.32,0,39.6,210193,1717,209067,9.18,4.2,0.0625,0.82,99.46
2020-09-05,Jharkhand,697,3,697,9013,4829,4413,7.73,0,39.6,210890,1720,209764,12.19,11.14,0.2276010101010101,0.82,99.47
2020-09-06,Jharkhand,1003,12,994,12947,1275,721,7.75,0,39.6,211893,1732,210758,3.22,1.82,0.3269444444444444,0.82,99.46
2020-09-07,Jharkhand,926,4,921,12313,425,174,7.52,1,39.6,212819,1736,211679,1.07,0.44,0.31093434343434345,0.82,99.46
2020-09-08,Jharkhand,598,6,594,6977,2931,2459,8.57,0,39.6,213417,1742,212273,7.4,6.21,0.1761868686868687,0.82,99.46
2020-09-09,Jharkhand,1193,6,1188,14942,544,271,7.98,0,39.6,214610,1748,213461,1.37,0.68,0.37732323232323234,0.81,99.46
2020-09-10,Jharkhand,1269,12,1266,15919,2363,2252,7.97,0,39.6,215879,1760,214727,5.97,5.69,0.4019949494949495,0.82,99.47
2020-09-11,Jharkhand,695,8,691,8580,699,115,8.1,0,39.6,216574,1768,215418,1.77,0.29,0.21666666666666667,0.82,99.47
2020-09-12,Jharkhand,1020,9,1013,12819,346,175,7.96,0,39.6,217594,1777,216431,0.87,0.44,0.32371212121212123,0.82,99.47
2020-09-13,Jharkhand,732,8,730,9073,3887,2125,8.07,0,39.6,218326,1785,217161,9.82,5.37,0.2291161616161616,0.82,99.47
2020-09-14,Jharkhand,403,2,397,5185,314,115,7.77,4,39.6,218729,1787,217558,0.79,0.29,0.13093434343434343,0.82,99.46
2020-09-15,Jharkhand,1314,8,1305,16410,3052,1593,8.01,1,39.6,220043,1795,218863,7.71,4.02,0.41439393939393937,0.82,99.46
2020-09-16,Jharkhand,751,2,751,9850,4818,4283,7.62,0,39.6,220794,1797,219614,12.17,10.82,0.24873737373737373,0.81,99.47
2020-09-17,Jharkhand,1275,13,1273,15510,2044,1035,8.22,0,39.6,222069,1810,220887,5.16,2.61,0.39166666666666666,0.82,99.47
2020-09-18,Jharkhand,676,6,669,8319,3490,3147,8.13,1,39.6,222745,1816,221556,8.81,7.95,0.21007575757575758,0.82,99.47
2020-09-19,Jharkhand,451,2,446,5707,2343,131,7.9,3,39.6,223196,1818,222002,5.92,0.33,0.14411616161616161,0.81,99.47
2020-09-20,Jharkhand,221,2,215,2646,4083,871,8.35,4,39.6,223417,1820,222217,10.31,2.2,0.06681818181818182,0.81,99.46
2020-09-21,Jharkhand,316,2,308,3970,4560,2527,7.96,6,39.6,223733,1822,222525,11.52,6.38,0.10025252525252525,0.81,99.46
2020-09-22,Jharkhand,1599,11,1595,19925,1837,944,8.03,0,39.6,225332,1833,224120,4.64,2.38,0.5031565656565656,0.81,99.46
2020-09-23,Jharkhand,705,5,700,8694,4394,2408,8.11,0,39.6,226037,1838,224820,11.1,6.08,0.21954545454545454,0.81,99.46
2020-09-24,Jharkhand,1611,5,1602,19617,1785,162,8.21,4,39.6,227648,1843,226422,4.51,0.41,0.49537878787878786,0.81,99.46
2020-09-25,Jharkhand,133,1,133,1811,709,371,7.34,0,39.6,227781,1844,226555,1.79,0.94,0.045732323232323235,0.81,99.46
2020-09-26,Jharkhand,245,1,239,3013,2384,1326,8.13,5,39.6,228026,1845,226794,6.02,3.35,0.07608585858585859,0.81,99.46
2020-09-27,Jharkhand,77,1,68,828,244,179,9.3,8,39.6,228103,1846,226862,0.62,0.45,0.02090909090909091,0.81,99.46
2020-09-28,Jharkhand,787,6,786,9584,4364,649,8.21,0,39.6,228890,1852,227648,11.02,1.64,0.24202020202020202,0.81,99.46
2020-09-29,Jharkhand,345,1,340,3910,4501,3251,8.82,4,39.6,229235,1853,227988,11.37,8.21,0.09873737373737373,0.81,99.46
2020-09-30,Jharkhand,784,4,784,9585,1908,761,8.18,0,39.6,230019,1857,228772,4.82,1.92,0.24204545454545454,0.81,99.46
2020-10-01,Jharkhand,676,2,673,8935,3163,249,7.57,1,39.6,230695,1859,229445,7.99,0.63,0.22563131313131313,0.81,99.46
2020-10-02,Jharkhand,571,5,571,7524,2206,530,7.59,0,39.6,231266,1864,230016,5.57,1.34,0.19,0.81,99.46
2020-10-03,Jharkhand,1233,17,1231,15592,4165,572,7.91,0,39.6,232499,1881,231247,10.52,1.44,0.3937373737373737,0.81,99.46
2020-10-04,Jharkhand,320,2,316,3977,452,420,8.05,2,39.6,232819,1883,231563,1.14,1.06,0.10042929292929292,0.81,99.46
2020-10-05,Jharkhand,195,0,190,2447,1849,174,7.97,5,39.6,233014,1883,231753,4.67,0.44,0.061792929292929295,0.81,99.46
2020-10-06,Jharkhand,884,6,877,11323,1872,1224,7.81,1,39.6,233898,1889,232630,4.73,3.09,0.28593434343434343,0.81,99.46
2020-10-07,Jharkhand,902,7,895,11118,4918,3765,8.11,0,39.6,234800,1896,233525,12.42,9.51,0.28075757575757576,0.81,99.46
2020-10-08,Jharkhand,1252,13,1250,15570,4874,722,8.04,0,39.6,236052,1909,234775,12.31,1.82,0.3931818181818182,0.81,99.46
2020-10-09,Jharkhand,1130,15,1123,14239,3590,3470,7.94,0,39.6,237182,1924,235898,9.07,8.76,0.3595707070707071,0.81,99.46
2020-10-10,Jharkhand,815,11,810,10139,2159,109,8.04,0,39.6,237997,1935,236708,5.45,0.28,0.25603535353535356,0.81,99.46
2020-10-11,Jharkhand,1093,7,1086,13496,3955,916,8.1,0,39.6,239090,1942,237794,9.99,2.31,0.3408080808080808,0.81,99.46
2020-10-12,Jharkhand,936,12,931,11785,262,117,7.94,0,39.6,240026,1954,238725,0.66,0.3,0.2976010101010101,0.81,99.46
2020-10-13,Jharkhand,1177,10,1175,14339,1461,1133,8.21,0,39.6,241203,1964,239900,3.69,2.86,0.3620959595959596,0.81,99.46
2020-10-14,Jharkhand,455,1,455,6062,157,157,7.51,0,39.6,241658,1965,240355,0.4,0.4,0.15308080808080807,0.81,99.46
2020-10-15,Jharkhand,730,7,727,8820,463,326,8.28,0,39.6,242388,1972,241082,1.17,0.82,0.22272727272727272,0.81,99.46
2020-10-16,Jharkhand,193,0,186,2926,635,209,6.6,7,39.6,242581,1972,241268,1.6,0.53,0.07388888888888889,0.81,99.46
2020-10-17,Jharkhand,1152,9,1149,14415,3886,1545,7.99,0,39.6,243733,1981,242417,9.81,3.9,0.3640151515151515,0.81,99.46
2020-10-18,Jharkhand,722,7,715,9328,2733,1149,7.74,0,39.6,244455,1988,243132,6.9,2.9,0.23555555555555555,0.81,99.46
2020-10-19,Jharkhand,1542,9,1541,19398,3959,2550,7.95,0,39.6,245997,1997,244673,10.0,6.44,0.48984848484848487,0.81,99.46
2020-10-20,Jharkhand,169,1,167,2030,1118,677,8.33,1,39.6,246166,1998,244840,2.82,1.71,0.05126262626262626,0.81,99.46
2020-10-21,Jharkhand,1483,13,1481,18705,3190,1350,7.93,0,39.6,247649,2011,246321,8.06,3.41,0.47234848484848485,0.81,99.46
2020-10-22,Jharkhand,373,5,366,5017,2641,1670,7.43,2,39.6,248022,2016,246687,6.67,4.22,0.1266919191919192,0.81,99.46
2020-10-23,Jharkhand,610,8,610,7498,4660,612,8.14,0,39.6,248632,2024,247297,11.77,1.55,0.18934343434343434,0.81,99.46
2020-10-24,Jharkhand,288,2,286,3875,3408,474,7.43,0,39.6,248920,2026,247583,8.61,1.2,0.09785353535353536,0.81,99.46
2020-10-25,Jharkhand,505,6,502,5523,2036,2032,9.14,0,39.6,249425,2032,248085,5.14,5.13,0.13946969696969697,0.81,99.46
2020-10-26,Jharkhand,1267,10,1267,15588,929,259,8.13,0,39.6,250692,2042,249352,2.35,0.65,0.3936363636363636,0.81,99.47
2020-10-27,Jharkhand,948,13,942,11713,696,438,8.09,0,39.6,251640,2055,250294,1.76,1.11,0.29578282828282826,0.82,99.47
2020-10-28,Jharkhand,331,4,323,4336,3957,3782,7.63,4,39.6,251971,2059,250617,9.99,9.55,0.10949494949494949,0.82,99.46
2020-10-29,Jharkhand,194,2,194,2557,3210,2594,7.59,0,39.6,252165,2061,250811,8.11,6.55,0.06457070707070707,0.82,99.46
2020-10-30,Jharkhand,1349,18,1342,16278,3615,2801,8.29,0,39.6,253514,2079,252153,9.13,7.07,0.41106060606060607,0.82,99.46
2020-10-31,Jharkhand,180,2,176,2247,4817,2123,8.01,2,39.6,253694,2081,252329,12.16,5.36,0.05674242424242424,0.82,99.46
2020-11-01,Jharkhand,33,0,27,964,1995,486,3.42,6,39.6,253727,2081,252356,5.04,1.23,0.024343434343434344,0.82,99.46
2020-11-02,Jharkhand,1425,18,1418,18011,2614,2079,7.91,0,39.6,255152,2099,253774,6.6,5.25,0.4548232323232323,0.82,99.46
2020-11-03,Jharkhand,1010,12,1007,12232,11,2,8.26,0,39.6,256162,2111,254781,0.03,0.01,0.3088888888888889,0.82,99.46
2020-11-04,Jharkhand,937,11,937,11966,3464,3452,7.83,0,39.6,257099,2122,255718,8.75,8.72,0.30217171717171715,0.83,99.46
2020-11-05,Jharkhand,886,9,884,11063,2015,1373,8.01,0,39.6,257985,2131,256602,5.09,3.47,0.2793686868686869,0.83,99.46
2020-11-06,Jharkhand,659,3,658,8353,1703,521,7.89,0,39.6,258644,2134,257260,4.3,1.32,0.21093434343434345,0.83,99.46
2020-11-07,Jharkhand,1266,12,1265,15253,2034,1914,8.3,0,39.6,259910,2146,258525,5.14,4.83,0.3851767676767677,0.83,99.47
2020-11-08,Jharkhand,422,3,419,5532,2250,1540,7.63,0,39.6,260332,2149,258944,5.68,3.89,0.1396969696969697,0.83,99.47
2020-11-09,Jharkhand,727,4,724,9006,1466,623,8.07,0,39.6,261059,2153,259668,3.7,1.57,0.22742424242424242,0.82,99.47
2020-11-10,Jharkhand,1150,16,1149,14310,603,345,8.04,0,39.6,262209,2169,260817,1.52,0.87,0.3613636363636364,0.83,99.47
2020-11-11,Jharkhand,1493,9,1487,18482,332,10,8.08,0,39.6,263702,2178,262304,0.84,0.03,0.4667171717171717,0.83,99.47
2020-11-12,Jharkhand,360,2,352,4563,1118,377,7.89,6,39.6,264062,2180,262656,2.82,0.95,0.11522727272727273,0.83,99.47
2020-11-13,Jharkhand,856,11,854,11210,641,528,7.64,0,39.6,264918,2191,263510,1.62,1.33,0.2830808080808081,0.83,99.47
2020-11-14,Jharkhand,261,0,253,3576,3560,3125,7.3,8,39.6,265179,2191,263763,8.99,7.89,0.0903030303030303,0.83,99.47
2020-11-15,Jharkhand,835,10,826,10267,4997,2254,8.13,0,39.6,266014,2201,264589,12.62,5.69,0.25926767676767676,0.83,99.46
2020-11-16,Jharkhand,1085,3,1078,13743,3042,890,7.89,4,39.6,267099,2204,265667,7.68,2.25,0.34704545454545455,0.83,99.46
2020-11-17,Jharkhand,1290,4,1285,15889,2766,2646,8.12,1,39.6,268389,2208,266952,6.98,6.68,0.4012373737373737,0.82,99.46
2020-11-18,Jharkhand,1572,21,1571,19395,4802,2255,8.11,0,39.6,269961,2229,268523,12.13,5.69,0.48977272727272725,0.83,99.47
2020-11-19,Jharkhand,1431,11,1422,18049,1090,670,7.93,0,39.6,271392,2240,269945,2.75,1.69,0.4557828282828283,0.83,99.47
2020-11-20,Jharkhand,867,4,862,10778,1149,578,8.04,1,39.6,272259,2244,270807,2.9,1.46,0.2721717171717172,0.82,99.47
2020-11-21,Jharkhand,204,2,203,1890,4000,371,10.79,0,39.6,272463,2246,271010,10.1,0.94,0.04772727272727273,0.82,99.47
2020-11-22,Jharkhand,1510,10,1501,19415,4385,1227,7.78,0,39.6,273973,2256,272511,11.07,3.1,0.49027777777777776,0.82,99.47
2020-11-23,Jharkhand,1181,10,1172,14918,2481,305,7.92,0,39.6,275154,2266,273683,6.27,0.77,0.37671717171717173,0.82,99.47
2020-11-24,Jharkhand,189,1,182,2316,1342,858,8.16,6,39.6,275343,2267,273865,3.39,2.17,0.05848484848484849,0.82,99.46
2020-11-25,Jharkhand,1493,13,1486,18867,618,311,7.91,0,39.6,276836,2280,275351,1.56,0.79,0.47643939393939394,0.82,99.46
2020-11-26,Jharkhand,143,1,140,2216,4814,2758,6.45,2,39.6,276979,2281,275491,12.16,6.96,0.05595959595959596,0.82,99.46
2020-11-27,Jharkhand,309,2,303,4235,4705,3504,7.3,4,39.6,277288,2283,275794,11.88,8.85,0.10694444444444444,0.82,99.46
2020-11-28,Jharkhand,807,8,799,10250,3963,3085,7.87,0,39.6,278095,2291,276593,10.01,7.79,0.2588383838383838,0.82,99.46
2020-11-29,Jharkhand,997,14,997,12547,3905,2581,7.95,0,39.6,279092,2305,277590,9.86,6.52,0.3168434343434343,0.83,99.46
2020-11-30,Jharkhand,104,1,97,1271,2497,756,8.18,6,39.6,279196,2306,277687,6.31,1.91,0.032095959595959594,0.83,99.46
2020-12-01,Jharkhand,1138,6,1137,13818,2386,1586,8.24,0,39.6,280334,2312,278824,6.03,4.01,0.34893939393939394,0.82,99.46
2020-12-02,Jharkhand,1475,14,1475,18543,4920,610,7.95,0,39.6,281809,2326,280299,12.42,1.54,0.46825757575757576,0.83,99.46
2020-12-03,Jharkhand,1598,19,1598,19842,1164,301,8.05,0,39.6,283407,2345,281897,2.94,0.76,0.5010606060606061,0.83,99.47
2020-12-04,Jharkhand,62,0,57,531,1191,588,11.68,5,39.6,283469,2345,281954,3.01,1.48,0.013409090909090909,0.83,99.47
2020-12-05,Jharkhand,110,1,107,1084,1516,668,10.15,2,39.6,283579,2346,282061,3.83,1.69,0.027373737373737373,0.83,99.46
2020-12-06,Jharkhand,70,0,70,1374,344,139,5.09,0,39.6,283649,2346,282131,0.87,0.35,0.0346969696969697,0.83,99.46
2020-12-07,Jharkhand,1343,19,1338,16533,118,0,8.12,0,39.6,284992,2365,283469,0.3,0.0,0.4175,0.83,99.47
2020-12-08,Jharkhand,855,9,847,10823,4477,1986,7.9,0,39.6,285847,2374,284316,11.31,5.02,0.27330808080808083,0.83,99.46
2020-12-09,Jharkhand,1412,9,1409,17919,1803,945,7.88,0,39.6,287259,2383,285725,4.55,2.39,0.4525,0.83,99.47
2020-12-10,Jharkhand,59,0,56,677,4061,2842,8.71,3,39.6,287318,2383,285781,10.26,7.18,0.017095959595959595,0.83,99.47
2020-12-11,Jharkhand,1505,13,1498,19086,3583,2106,7.89,0,39.6,288823,2396,287279,9.05,5.32,0.481969696969697,0.83,99.47
2020-12-12,Jharkhand,1236,17,1229,15834,309,141,7.81,0,39.6,290059,2413,288508,0.78,0.36,0.39984848484848484,0.83,99.47
2020-12-13,Jharkhand,548,1,540,6921,2099,1792,7.92,7,39.6,290607,2414,289048,5.3,4.53,0.17477272727272727,0.83,99.46
2020-12-14,Jharkhand,458,4,454,5551,1695,1648,8.25,0,39.6,291065,2418,289502,4.28,4.16,0.14017676767676768,0.83,99.46
2020-12-15,Jharkhand,372,2,367,4459,4366,3286,8.34,3,39.6,291437,2420,289869,11.03,8.3,0.1126010101010101,0.83,99.46
2020-12-16,Jharkhand,726,8,721,9269,1582,992,7.83,0,39.6,292163,2428,290590,3.99,2.51,0.23406565656565656,0.83,99.46
2020-12-17,Jharkhand,194,1,189,2388,4416,3243,8.12,4,39.6,292357,2429,290779,11.15,8.19,0.0603030303030303,0.83,99.46
2020-12-18,Jharkhand,639,4,631,7881,1120,230,8.11,4,39.6,292996,2433,291410,2.83,0.58,0.1990151515151515,0.83,99.46
2020-12-19,Jharkhand,286,2,279,3922,4446,2325,7.29,5,39.6,293282,2435,291689,11.23,5.87,0.09904040404040404,0.83,99.46
2020-12-20,Jharkhand,1608,18,1606,19846,2552,991,8.1,0,39.6,294890,2453,293295,6.44,2.5,0.5011616161616161,0.83,99.46
2020-12-21,Jharkhand,318,1,318,3726,2854,2348,8.53,0,39.6,295208,2454,293613,7.21,5.93,0.09409090909090909,0.83,99.46
2020-12-22,Jharkhand,1061,14,1060,13124,1471,635,8.08,0,39.6,296269,2468,294673,3.71,1.6,0.33141414141414144,0.83,99.46
2020-12-23,Jharkhand,841,10,837,10439,4632,1762,8.06,0,39.6,297110,2478,295510,11.7,4.45,0.26361111111111113,0.83,99.46
2020-12-24,Jharkhand,531,3,527,6963,1340,800,7.63,1,39.6,297641,2481,296037,3.38,2.02,0.17583333333333334,0.83,99.46
2020-12-25,Jharkhand,211,3,203,2566,3776,692,8.22,5,39.6,297852,2484,296240,9.54,1.75,0.0647979797979798,0.83,99.46
2020-12-26,Jharkhand,459,4,450,5822,2319,1641,7.88,5,39.6,298311,2488,296690,5.86,4.14,0.14702020202020202,0.83,99.46
2020-12-27,Jharkhand,1318,4,1314,16571,3581,2089,7.95,0,39.6,299629,2492,298004,9.04,5.28,0.418459595959596,0.83,99.46
2020-12-28,Jharkhand,1193,4,1191,14918,4109,1005,8.0,0,39.6,300822,2496,299195,10.38,2.54,0.37671717171717173,0.83,99.46
2020-12-29,Jharkhand,849,8,843,10660,3723,2920,7.96,0,39.6,301671,2504,300038,9.4,7.37,0.2691919191919192,0.83,99.46
2020-12-30,Jharkhand,507,4,503,6182,1552,986,8.2,0,39.6,302178,2508,300541,3.92,2.49,0.15611111111111112,0.83,99.46
2020-12-31,Jharkhand,599,7,592,7648,4917,2921,7.83,0,39.6,302777,2515,301133,12.42,7.38,0.19313131313131313,0.83,99.46
2021-01-01,Jharkhand,1246,4,1243,15673,1848,1842,7.95,0,39.6,304023,2519,302376,4.67,4.65,0.3957828282828283,0.83,99.46
2021-01-02,Jharkhand,204,2,196,2204,280,117,9.26,6,39.6,304227,2521,302572,0.71,0.3,0.055656565656565654,0.83,99.46
2021-01-03,Jharkhand,726,3,726,8617,780,110,8.43,0,39.6,304953,2524,303298,1.97,0.28,0.2176010101010101,0.83,99.46
2021-01-04,Jharkhand,204,0,199,2237,4040,1830,9.12,5,39.6,305157,2524,303497,10.2,4.62,0.05648989898989899,0.83,99.46
2021-01-05,Jharkhand,1271,7,1269,15761,4412,2223,8.06,0,39.6,306428,2531,304766,11.14,5.61,0.39800505050505053,0.83,99.46
2021-01-06,Jharkhand,544,7,537,6671,907,672,8.15,0,39.6,306972,2538,305303,2.29,1.7,0.16845959595959595,0.83,99.46
2021-01-07,Jharkhand,940,6,933,11868,3554,655,7.92,1,39.6,307912,2544,306236,8.97,1.65,0.2996969696969697,0.83,99.46
2021-01-08,Jharkhand,653,2,653,7820,652,35,8.35,0,39.6,308565,2546,306889,1.65,0.09,0.19747474747474747,0.83,99.46
2021-01-09,Jharkhand,1193,6,1190,14732,3354,3129,8.1,0,39.6,309758,2552,308079,8.47,7.9,0.37202020202020203,0.82,99.46
2021-01-10,Jharkhand,568,1,563,7051,4897,3704,8.06,4,39.6,310326,2553,308642,12.37,9.35,0.17805555555555555,0.82,99.46
2021-01-11,Jharkhand,827,3,818,10657,3171,2769,7.76,6,39.6,311153,2556,309460,8.01,6.99,0.26911616161616164,0.82,99.46
2021-01-12,Jharkhand,442,4,437,5472,2265,1719,8.08,1,39.6,311595,2560,309897,5.72,4.34,0.13818181818181818,0.82,99.46
2021-01-13,Jharkhand,949,9,946,11685,4578,2301,8.12,0,39.6,312544,2569,310843,11.56,5.81,0.2950757575757576,0.82,99.46
2021-01-14,Jharkhand,802,3,798,10006,4800,255,8.02,1,39.6,313346,2572,311641,12.12,0.64,0.25267676767676767,0.82,99.46
2021-01-15,Jharkhand,1578,11,1570,19799,3340,1187,7.97,0,39.6,314924,2583,313211,8.43,3.0,0.49997474747474746,0.82,99.46
2021-01-16,Jharkhand,1413,16,1405,17026,2702,2479,8.3,0,39.6,316337,2599,314616,6.82,6.26,0.42994949494949497,0.82,99.46
2021-01-17,Jharkhand,1331,6,1328,16859,3446,1838,7.89,0,39.6,317668,2605,315944,8.7,4.64,0.42573232323232324,0.82,99.46
2021-01-18,Jharkhand,1304,13,1303,16483,3874,554,7.91,0,39.6,318972,2618,317247,9.78,1.4,0.41623737373737374,0.82,99.46
2021-01-19,Jharkhand,342,2,342,4201,267,249,8.14,0,39.6,319314,2620,317589,0.67,0.63,0.10608585858585859,0.82,99.46
2021-01-20,Jharkhand,233,1,229,2602,3159,687,8.95,3,39.6,319547,2621,317818,7.98,1.73,0.06570707070707071,0.82,99.46
2021-01-21,Jharkhand,411,1,404,5333,1972,1904,7.71,6,39.6,319958,2622,318222,4.98,4.81,0.13467171717171716,0.82,99.46
2021-01-22,Jharkhand,1380,12,1380,16795,954,655,8.22,0,39.6,321338,2634,319602,2.41,1.65,0.4241161616161616,0.82,99.46
2021-01-23,Jharkhand,1245,11,1239,15506,4630,4629,8.03,0,39.6,322583,2645,320841,11.69,11.69,0.39156565656565656,0.82,99.46
2021-01-24,Jharkhand,645,3,645,8776,2034,2014,7.35,0,39.6,323228,2648,321486,5.14,5.09,0.22161616161616163,0.82,99.46
2021-01-25,Jharkhand,1470,12,1469,18181,2351,188,8.09,0,39.6,324698,2660,322955,5.94,0.47,0.4591161616161616,0.82,99.46
2021-01-26,Jharkhand,737,9,730,9095,1860,1606,8.1,0,39.6,325435,2669,323685,4.7,4.06,0.22967171717171717,0.82,99.46
2021-01-27,Jharkhand,119,0,115,1226,1944,425,9.71,4,39.6,325554,2669,323800,4.91,1.07,0.03095959595959596,0.82,99.46
2021-01-28,Jharkhand,1083,12,1083,13341,2458,2014,8.12,0,39.6,326637,2681,324883,6.21,5.09,0.3368939393939394,0.82,99.46
2021-01-29,Jharkhand,924,5,916,11186,2133,1829,8.26,3,39.6,327561,2686,325799,5.39,4.62,0.2824747474747475,0.82,99.46
2021-01-30,Jharkhand,1161,14,1158,14477,3002,1041,8.02,0,39.6,328722,2700,326957,7.58,2.63,0.36558080808080806,0.82,99.46
2021-01-31,Jharkhand,266,2,262,3195,2578,1421,8.33,2,39.6,328988,2702,327219,6.51,3.59,0.08068181818181819,0.82,99.46
2021-02-01,Jharkhand,853,12,848,10703,3179,1232,7.97,0,39.6,329841,2714,328067,8.03,3.11,0.2702777777777778,0.82,99.46
2021-02-02,Jharkhand,694,8,688,8313,513,45,8.35,0,39.6,330535,2722,328755,1.3,0.11,0.20992424242424243,0.82,99.46
2021-02-03,Jharkhand,970,10,969,12339,3909,1155,7.86,0,39.6,331505,2732,329724,9.87,2.92,0.3115909090909091,0.82,99.46
2021-02-04,Jharkhand,582,2,574,6774,2669,198,8.59,6,39.6,332087,2734,330298,6.74,0.5,0.17106060606060605,0.82,99.46
2021-02-05,Jharkhand,1442,16,1439,17894,3864,1551,8.06,0,39.6,333529,2750,331737,9.76,3.92,0.45186868686868686,0.82,99.46
2021-02-06,Jharkhand,741,3,737,8907,4004,3208,8.32,1,39.6,334270,2753,332474,10.11,8.1,0.22492424242424242,0.82,99.46
2021-02-07,Jharkhand,986,4,986,12517,4791,2622,7.88,0,39.6,335256,2757,333460,12.1,6.62,0.3160858585858586,0.82,99.46
2021-02-08,Jharkhand,739,3,734,8815,2653,1039,8.38,2,39.6,335995,2760,334194,6.7,2.62,0.2226010101010101,0.82,99.46
2021-02-09,Jharkhand,402,1,397,4608,1853,246,8.72,4,39.6,336397,2761,334591,4.68,0.62,0.11636363636363636,0.82,99.46
2021-02-10,Jharkhand,513,6,507,6282,2171,1619,8.17,0,39.6,336910,2767,335098,5.48,4.09,0.15863636363636363,0.82,99.46
2021-02-11,Jharkhand,732,3,724,9378,4718,2665,7.81,5,39.6,337642,2770,335822,11.91,6.73,0.23681818181818182,0.82,99.46
2021-02-12,Jharkhand,1355,8,1348,16732,4641,1222,8.1,0,39.6,338997,2778,337170,11.72,3.09,0.4225252525252525,0.82,99.46
2021-02-13,Jharkhand,58,0,54,611,1852,828,9.49,4,39.6,339055,2778,337224,4.68,2.09,0.01542929292929293,0.82,99.46
2021-02-14,Jharkhand,264,3,260,3056,1149,1077,8.64,1,39.6,339319,2781,337484,2.9,2.72,0.07717171717171717,0.82,99.46
2021-02-15,Jharkhand,1010,7,1004,12505,351,204,8.08,0,39.6,340329,2788,338488,0.89,0.52,0.3157828282828283,0.82,99.46
2021-02-16,Jharkhand,490,2,482,5703,3195,1475,8.59,6,39.6,340819,2790,338970,8.07,3.72,0.1440151515151515,0.82,99.46
2021-02-17,Jharkhand,218,1,216,2557,2305,705,8.53,1,39.6,341037,2791,339186,5.82,1.78,0.06457070707070707,0.82,99.46
2021-02-18,Jharkhand,342,3,341,4400,877,203,7.77,0,39.6,341379,2794,339527,2.21,0.51,0.1111111111111111,0.82,99.46
2021-02-19,Jharkhand,817,6,809,10339,3713,3343,7.9,2,39.6,342196,2800,340336,9.38,8.44,0.2610858585858586,0.82,99.46
2021-02-20,Jharkhand,1536,22,1527,19560,2037,695,7.85,0,39.6,343732,2822,341863,5.14,1.76,0.49393939393939396,0.82,99.46
2021-02-21,Jharkhand,187,1,187,2520,3609,2578,7.42,0,39.6,343919,2823,342050,9.11,6.51,0.06363636363636363,0.82,99.46
2021-02-22,Jharkhand,616,2,611,7762,1838,267,7.94,3,39.6,344535,2825,342661,4.64,0.67,0.19601010101010102,0.82,99.46
2021-02-23,Jharkhand,1140,16,1137,14084,3793,1453,8.09,0,39.6,345675,2841,343798,9.58,3.67,0.35565656565656567,0.82,99.46
2021-02-24,Jharkhand,987,11,984,12704,2077,1922,7.77,0,39.6,346662,2852,344782,5.24,4.85,0.3208080808080808,0.82,99.46
2021-02-25,Jharkhand,1325,16,1323,17178,2254,1507,7.71,0,39.6,347987,2868,346105,5.69,3.81,0.4337878787878788,0.82,99.46
2021-02-26,Jharkhand,1207,10,1199,14955,3177,3021,8.07,0,39.6,349194,2878,347304,8.02,7.63,0.3776515151515151,0.82,99.46
2021-02-27,Jharkhand,407,1,403,4869,907,714,8.36,3,39.6,349601,2879,347707,2.29,1.8,0.12295454545454546,0.82,99.46
2021-02-28,Jharkhand,51,0,43,650,4536,3174,7.85,8,39.6,349652,2879,347750,11.45,8.02,0.016414141414141416,0.82,99.46
2021-03-01,Jharkhand,586,8,583,7637,3339,2280,7.67,0,39.6,350238,2887,348333,8.43,5.76,0.19285353535353536,0.82,99.46
2021-03-02,Jharkhand,615,7,606,8019,4514,1710,7.67,2,39.6,350853,2894,348939,11.4,4.32,0.2025,0.82,99.45
2021-03-03,Jharkhand,406,5,403,4664,1834,1029,8.7,0,39.6,351259,2899,349342,4.63,2.6,0.11777777777777777,0.83,99.45
2021-03-04,Jharkhand,1085,13,1084,13527,3561,3452,8.02,0,39.6,352344,2912,350426,8.99,8.72,0.3415909090909091,0.83,99.46
2021-03-05,Jharkhand,626,7,626,7912,4849,725,7.91,0,39.6,352970,2919,351052,12.24,1.83,0.1997979797979798,0.83,99.46
2021-03-06,Jharkhand,560,5,551,6976,1988,1035,8.03,4,39.6,353530,2924,351603,5.02,2.61,0.17616161616161616,0.83,99.45
2021-03-07,Jharkhand,579,4,577,7281,1985,776,7.95,0,39.6,354109,2928,352180,5.01,1.96,0.18386363636363637,0.83,99.46
2021-03-08,Jharkhand,897,6,889,10996,6,0,8.16,2,39.6,355006,2934,353069,0.02,0.0,0.2776767676767677,0.83,99.45
2021-03-09,Jharkhand,541,7,536,6602,4340,70,8.19,0,39.6,355547,2941,353605,10.96,0.18,0.1667171717171717,0.83,99.45
2021-03-10,Jharkhand,793,11,786,9715,551,165,8.16,0,39.6,356340,2952,354391,1.39,0.42,0.24532828282828284,0.83,99.45
2021-03-11,Jharkhand,165,1,164,2139,2435,120,7.71,0,39.6,356505,2953,354555,6.15,0.3,0.054015151515151516,0.83,99.45
2021-03-12,Jharkhand,173,0,167,2398,2258,68,7.21,6,39.6,356678,2953,354722,5.7,0.17,0.06055555555555556,0.83,99.45
2021-03-13,Jharkhand,780,10,771,9743,4933,2983,8.01,0,39.6,357458,2963,355493,12.46,7.53,0.24603535353535352,0.83,99.45
2021-03-14,Jharkhand,922,2,916,10972,3664,1408,8.4,4,39.6,358380,2965,356409,9.25,3.56,0.2770707070707071,0.83,99.45
2021-03-15,Jharkhand,1371,4,1364,17096,2186,1128,8.02,3,39.6,359751,2969,357773,5.52,2.85,0.4317171717171717,0.83,99.45
2021-03-16,Jharkhand,181,1,176,2885,4298,3473,6.27,4,39.6,359932,2970,357949,10.85,8.77,0.07285353535353535,0.83,99.45
2021-03-17,Jharkhand,1325,6,1317,16462,3790,187,8.05,2,39.6,361257,2976,359266,9.57,0.47,0.4157070707070707,0.82,99.45
2021-03-18,Jharkhand,97,1,89,1134,4017,1346,8.55,7,39.6,361354,2977,359355,10.14,3.4,0.028636363636363637,0.82,99.45
2021-03-19,Jharkhand,404,5,399,4563,2167,1099,8.85,0,39.6,361758,2982,359754,5.47,2.78,0.11522727272727273,0.82,99.45
2021-03-20,Jharkhand,1205,9,1198,14728,4909,4064,8.18,0,39.6,362963,2991,360952,12.4,10.26,0.3719191919191919,0.82,99.45
2021-03-21,Jharkhand,714,7,710,8810,486,311,8.1,0,39.6,363677,2998,361662,1.23,0.79,0.22247474747474746,0.82,99.45
2021-03-22,Jharkhand,227,1,221,3515,354,157,6.46,5,39.6,363904,2999,361883,0.89,0.4,0.08876262626262627,0.82,99.44
2021-03-23,Jharkhand,318,4,312,3811,1955,966,8.34,2,39.6,364222,3003,362195,4.94,2.44,0.09623737373737373,0.82,99.44
2021-03-24,Jharkhand,511,6,506,6215,50,11,8.22,0,39.6,364733,3009,362701,0.13,0.03,0.15694444444444444,0.82,99.44
2021-03-25,Jharkhand,493,7,491,6080,1632,998,8.11,0,39.6,365226,3016,363192,4.12,2.52,0.15353535353535352,0.83,99.44
2021-03-26,Jharkhand,1009,13,1004,12511,4732,2268,8.06,0,39.6,366235,3029,364196,11.95,5.73,0.31593434343434346,0.83,99.44
2021-03-27,Jharkhand,896,6,889,11336,4042,1662,7.9,1,39.6,367131,3035,365085,10.21,4.2,0.2862626262626263,0.83,99.44
2021-03-28,Jharkhand,601,7,596,7523,2289,987,7.99,0,39.6,367732,3042,365681,5.78,2.49,0.18997474747474746,0.83,99.44
2021-03-29,Jharkhand,416,3,408,4901,4218,3603,8.49,5,39.6,368148,3045,366089,10.65,9.1,0.12376262626262627,0.83,99.44
2021-03-30,Jharkhand,69,0,64,992,621,407,6.96,5,39.6,368217,3045,366153,1.57,1.03,0.025050505050505052,0.83,99.44
2021-03-31,Jharkhand,136,1,135,1509,143,131,9.01,0,39.6,368353,3046,366288,0.36,0.33,0.03810606060606061,0.83,99.44
2021-04-01,Jharkhand,177,2,173,2103,3610,1264,8.42,2,39.6,368530,3048,366461,9.12,3.19,0.05310606060606061,0.83,99.44
2021-04-02,Jharkhand,1463,6,1458,18800,3476,2595,7.78,0,39.6,369993,3054,367919,8.78,6.55,0.47474747474747475,0.83,99.44
2021-04-03,Jharkhand,808,4,808,10165,2747,1468,7.95,0,39.6,370801,3058,368727,6.94,3.71,0.2566919191919192,0.82,99.44
2021-04-04,Jharkhand,1163,9,1154,14184,3795,1773,8.2,0,39.6,371964,3067,369881,9.58,4.48,0.35818181818181816,0.82,99.44
2021-04-05,Jharkhand,851,5,843,10791,3804,3427,7.89,3,39.6,372815,3072,370724,9.61,8.65,0.2725,0.82,99.44
2021-04-06,Jharkhand,273,4,268,3190,399,61,8.56,1,39.6,373088,3076,370992,1.01,0.15,0.08055555555555556,0.82,99.44
2021-04-07,Jharkhand,1356,19,1348,16462,2967,629,8.24,0,39.6,374444,3095,372340,7.49,1.59,0.4157070707070707,0.83,99.44
2021-04-08,Jharkhand,1154,8,1149,14252,3034,674,8.1,0,39.6,375598,3103,373489,7.66,1.7,0.3598989898989899,0.83,99.44
2021-04-09,Jharkhand,164,0,164,2122,3898,2444,7.73,0,39.6,375762,3103,373653,9.84,6.17,0.053585858585858584,0.83,99.44
2021-04-10,Jharkhand,1190,14,1181,14505,3968,26,8.2,0,39.6,376952,3117,374834,10.02,0.07,0.3662878787878788,0.83,99.44
2021-04-11,Jharkhand,269,0,266,3655,2391,174,7.36,3,39.6,377221,3117,375100,6.04,0.44,0.0922979797979798,0.83,99.44
2021-04-12,Jharkhand,668,4,666,8349,3539,562,8.0,0,39.6,377889,3121,375766,8.94,1.42,0.21083333333333334,0.83,99.44
2021-04-13,Jharkhand,1561,6,1555,19398,3725,2273,8.05,0,39.6,379450,3127,377321,9.41,5.74,0.48984848484848487,0.82,99.44
2021-04-14,Jharkhand,358,2,353,4802,216,97,7.46,3,39.6,379808,3129,377674,0.55,0.24,0.12126262626262627,0.82,99.44
2021-04-15,Jharkhand,608,4,608,7678,334,257,7.92,0,39.6,380416,3133,378282,0.84,0.65,0.1938888888888889,0.82,99.44
2021-04-16,Jharkhand,177,0,173,1590,1811,197,11.13,4,39.6,380593,3133,378455,4.57,0.5,0.04015151515151515,0.82,99.44
2021-04-17,Jharkhand,950,9,944,11870,3583,1399,8.0,0,39.6,381543,3142,379399,9.05,3.53,0.29974747474747476,0.82,99.44
2021-04-18,Jharkhand,1289,13,1289,15992,805,139,8.06,0,39.6,382832,3155,380688,2.03,0.35,0.40383838383838383,0.82,99.44
2021-04-19,Jharkhand,333,4,330,4103,1149,777,8.12,0,39.6,383165,3159,381018,2.9,1.96,0.10361111111111111,0.82,99.44
2021-04-20,Jharkhand,493,5,487,6036,3456,2085,8.17,1,39.6,383658,3164,381505,8.73,5.27,0.15242424242424243,0.82,99.44
2021-04-21,Jharkhand,464,1,455,5617,2712,1729,8.26,8,39.6,384122,3165,381960,6.85,4.37,0.14184343434343435,0.82,99.44
2021-04-22,Jharkhand,1398,12,1398,17928,3063,1945,7.8,0,39.6,385520,3177,383358,7.73,4.91,0.4527272727272727,0.82,99.44
2021-04-23,Jharkhand,759,2,753,9845,2255,1453,7.71,4,39.6,386279,3179,384111,5.69,3.67,0.24861111111111112,0.82,99.44
2021-04-24,Jharkhand,675,2,673,8533,931,693,7.91,0,39.6,386954,3181,384784,2.35,1.75,0.215479797979798,0.82,99.44
2021-04-25,Jharkhand,1334,8,1327,16569,3059,528,8.05,0,39.6,388288,3189,386111,7.72,1.33,0.4184090909090909,0.82,99.44
2021-04-26,Jharkhand,1469,16,1463,18096,3347,2723,8.12,0,39.6,389757,3205,387574,8.45,6.88,0.45696969696969697,0.82,99.44
2021-04-27,Jharkhand,1366,20,1362,17469,4032,51,7.82,0,39.6,391123,3225,388936,10.18,0.13,0.44113636363636366,0.82,99.44
2021-04-28,Jharkhand,635,7,629,7906,4780,2583,8.03,0,39.6,391758,3232,389565,12.07,6.52,0.19964646464646466,0.82,99.44
2021-04-29,Jharkhand,791,2,784,9823,3381,2246,8.05,5,39.6,392549,3234,390349,8.54,5.67,0.24805555555555556,0.82,99.44
2021-04-30,Jharkhand,36,0,29,620,3458,878,5.81,7,39.6,392585,3234,390378,8.73,2.22,0.015656565656565657,0.82,99.44
2021-05-01,Jharkhand,554,5,545,7309,4630,736,7.58,4,39.6,393139,3239,390923,11.69,1.86,0.18457070707070708,0.82,99.44
2021-05-02,Jharkhand,946,3,942,11991,250,2,7.89,1,39.6,394085,3242,391865,0.63,0.01,0.3028030303030303,0.82,99.44
2021-05-03,Jharkhand,324,4,321,4059,669,508,7.98,0,39.6,394409,3246,392186,1.69,1.28,0.1025,0.82,99.44
2021-05-04,Jharkhand,356,5,351,3889,3188,1485,9.15,0,39.6,394765,3251,392537,8.05,3.75,0.0982070707070707,0.82,99.44
2021-05-05,Jharkhand,182,1,179,2393,76,0,7.61,2,39.6,394947,3252,392716,0.19,0.0,0.06042929292929293,0.82,99.44
2021-05-06,Jharkhand,1588,18,1580,19555,3951,1994,8.12,0,39.6,396535,3270,394296,9.98,5.04,0.4938131313131313,0.82,99.44
2021-05-07,Jharkhand,717,5,715,9100,1232,1148,7.88,0,39.6,397252,3275,395011,3.11,2.9,0.2297979797979798,0.82,99.44
2021-05-08,Jharkhand,1355,12,1355,17110,2289,1968,7.92,0,39.6,398607,3287,396366,5.78,4.97,0.43207070707070705,0.82,99.44
2021-05-09,Jharkhand,127,1,124,1006,43,27,12.62,2,39.6,398734,3288,396490,0.11,0.07,0.025404040404040405,0.82,99.44
2021-05-10,Jharkhand,825,8,824,10419,4137,255,7.92,0,39.6,399559,3296,397314,10.45,0.64,0.2631060606060606,0.82,99.44
2021-05-11,Jharkhand,1578,20,1573,19854,2942,437,7.95,0,39.6,401137,3316,398887,7.43,1.1,0.5013636363636363,0.83,99.44
2021-05-12,Jharkhand,615,7,613,7883,126,43,7.8,0,39.6,401752,3323,399500,0.32,0.11,0.19906565656565656,0.83,99.44
2021-05-13,Jharkhand,746,7,743,9446,2023,2000,7.9,0,39.6,402498,3330,400243,5.11,5.05,0.23853535353535354,0.83,99.44
2021-05-14,Jharkhand,560,3,560,6708,135,38,8.35,0,39.6,403058,3333,400803,0.34,0.1,0.1693939393939394,0.83,99.44
2021-05-15,Jharkhand,459,5,452,5718,4403,2418,8.03,2,39.6,403517,3338,401255,11.12,6.11,0.1443939393939394,0.83,99.44
2021-05-16,Jharkhand,731,4,724,9113,3531,286,8.02,3,39.6,404248,3342,401979,8.92,0.72,0.23012626262626262,0.83,99.44
2021-05-17,Jharkhand,551,6,550,7192,3402,353,7.66,0,39.6,404799,3348,402529,8.59,0.89,0.18161616161616162,0.83,99.44
2021-05-18,Jharkhand,261,2,256,3576,1301,15,7.3,3,39.6,405060,3350,402785,3.29,0.04,0.0903030303030303,0.83,99.44
2021-05-19,Jharkhand,1444,12,1436,18498,4548,3771,7.81,0,39.6,406504,3362,404221,11.48,9.52,0.4671212121212121,0.83,99.44
2021-05-20,Jharkhand,1213,8,1213,15025,1238,743,8.07,0,39.6,407717,3370,405434,3.13,1.88,0.37941919191919193,0.83,99.44
2021-05-21,Jharkhand,1310,4,1308,15930,2763,2108,8.22,0,39.6,409027,3374,406742,6.98,5.32,0.4022727272727273,0.82,99.44
2021-05-22,Jharkhand,905,4,899,11024,3077,1512,8.21,2,39.6,409932,3378,407641,7.77,3.82,0.2783838383838384,0.82,99.44
2021-05-23,Jharkhand,735,7,735,8720,2350,368,8.43,0,39.6,410667,3385,408376,5.93,0.93,0.2202020202020202,0.82,99.44
2021-05-24,Jharkhand,1242,11,1237,16080,3939,1162,7.72,0,39.6,411909,3396,409613,9.95,2.93,0.40606060606060607,0.82,99.44
2021-05-25,Jharkhand,239,1,234,3087,2849,1470,7.74,4,39.6,412148,3397,409847,7.19,3.71,0.07795454545454546,0.82,99.44
2021-05-26,Jharkhand,1198,9,1196,15182,4429,1947,7.89,0,39.6,413346,3406,411043,11.18,4.92,0.3833838383838384,0.82,99.44
2021-05-27,Jharkhand,710,7,703,8883,4150,4112,7.99,0,39.6,414056,3413,411746,10.48,10.38,0.2243181818181818,0.82,99.44
2021-05-28,Jharkhand,380,2,371,4485,2488,56,8.47,7,39.6,414436,3415,412117,6.28,0.14,0.11325757575757575,0.82,99.44
2021-05-29,Jharkhand,1084,6,1078,13028,404,325,8.32,0,39.6,415520,3421,413195,1.02,0.82,0.328989898989899,0.82,99.44
2021-05-30,Jharkhand,358,1,358,4616,1307,480,7.76,0,39.6,415878,3422,413553,3.3,1.21,0.11656565656565657,0.82,99.44
2021-05-31,Jharkhand,300,4,292,3704,3623,1878,8.1,4,39.6,416178,3426,413845,9.15,4.74,0.09353535353535354,0.82,99.44
2021-06-01,Jharkhand,1216,5,1213,15213,788,131,7.99,0,39.6,417394,3431,415058,1.99,0.33,0.38416666666666666,0.82,99.44
2021-06-02,Jharkhand,1345,16,1343,16876,1432,807,7.97,0,39.6,418739,3447,416401,3.62,2.04,0.4261616161616162,0.82,99.44
2021-06-03,Jharkhand,1509,13,1501,18940,1863,1442,7.97,0,39.6,420248,3460,417902,4.7,3.64,0.4782828282828283,0.82,99.44
2021-06-04,Jharkhand,1340,16,1336,16851,1720,142,7.95,0,39.6,421588,3476,419238,4.34,0.36,0.42553030303030304,0.82,99.44
2021-06-05,Jharkhand,1361,13,1357,16941,4179,1019,8.03,0,39.6,422949,3489,420595,10.55,2.57,0.4278030303030303,0.82,99.44
2021-06-06,Jharkhand,1513,8,1510,18924,4575,3694,8.0,0,39.6,424462,3497,422105,11.55,9.33,0.4778787878787879,0.82,99.44
2021-06-07,Jharkhand,190,1,189,2345,1157,548,8.1,0,39.6,424652,3498,422294,2.92,1.38,0.05921717171717172,0.82,99.44
2021-06-08,Jharkhand,930,3,926,11784,2676,343,7.89,1,39.6,425582,3501,423220,6.76,0.87,0.29757575757575755,0.82,99.44
2021-06-09,Jharkhand,1367,12,1360,16896,556,115,8.09,0,39.6,426949,3513,424580,1.4,0.29,0.4266666666666667,0.82,99.45
2021-06-10,Jharkhand,438,6,434,5493,3982,437,7.97,0,39.6,427387,3519,425014,10.06,1.1,0.1387121212121212,0.82,99.44
2021-06-11,Jharkhand,1223,9,1221,15304,4247,1987,7.99,0,39.6,428610,3528,426235,10.72,5.02,0.38646464646464646,0.82,99.45
2021-06-12,Jharkhand,981,10,978,11937,229,204,8.22,0,39.6,429591,3538,427213,0.58,0.52,0.30143939393939395,0.82,99.45
2021-06-13,Jharkhand,219,1,214,3114,1028,965,7.03,4,39.6,429810,3539,427427,2.6,2.44,0.07863636363636364,0.82,99.45
2021-06-14,Jharkhand,792,6,790,9958,2411,745,7.95,0,39.6,430602,3545,428217,6.09,1.88,0.25146464646464645,0.82,99.45
2021-06-15,Jharkhand,348,4,342,4233,2194,682,8.22,2,39.6,430950,3549,428559,5.54,1.72,0.10689393939393939,0.82,99.45
2021-06-16,Jharkhand,69,0,63,1062,1445,1118,6.5,6,39.6,431019,3549,428622,3.65,2.82,0.026818181818181817,0.82,99.44
2021-06-17,Jharkhand,196,2,196,3040,2013,1436,6.45,0,39.6,431215,3551,428818,5.08,3.63,0.07676767676767676,0.82,99.44
2021-06-18,Jharkhand,1026,3,1025,12802,3917,472,8.01,0,39.6,432241,3554,429843,9.89,1.19,0.3232828282828283,0.82,99.45
2021-06-19,Jharkhand,274,1,272,3266,1621,811,8.39,1,39.6,432515,3555,430115,4.09,2.05,0.08247474747474748,0.82,99.45
2021-06-20,Jharkhand,512,3,507,6034,536,281,8.49,2,39.6,433027,3558,430622,1.35,0.71,0.15237373737373738,0.82,99.44
2021-06-21,Jharkhand,1075,13,1067,13334,3347,1856,8.06,0,39.6,434102,3571,431689,8.45,4.69,0.3367171717171717,0.82,99.44
2021-06-22,Jharkhand,272,0,272,3111,1647,28,8.74,0,39.6,434374,3571,431961,4.16,0.07,0.07856060606060607,0.82,99.44
2021-06-23,Jharkhand,1284,11,1275,15871,4964,2396,8.09,0,39.6,435658,3582,433236,12.54,6.05,0.4007828282828283,0.82,99.44
2021-06-24,Jharkhand,107,1,102,1246,2535,1175,8.59,4,39.6,435765,3583,433338,6.4,2.97,0.031464646464646466,0.82,99.44
2021-06-25,Jharkhand,876,8,869,10670,4855,4801,8.21,0,39.6,436641,3591,434207,12.26,12.12,0.26944444444444443,0.82,99.44
2021-06-26,Jharkhand,1414,20,1406,17802,3994,3578,7.94,0,39.6,438055,3611,435613,10.09,9.04,0.4495454545454545,0.82,99.44
2021-06-27,Jharkhand,455,3,448,5755,48,26,7.91,4,39.6,438510,3614,436061,0.12,0.07,0.14532828282828283,0.82,99.44
2021-06-28,Jharkhand,881,10,877,10852,287,111,8.12,0,39.6,439391,3624,436938,0.72,0.28,0.27404040404040403,0.82,99.44
2021-06-29,Jharkhand,782,7,781,9686,476,103,8.07,0,39.6,440173,3631,437719,1.2,0.26,0.2445959595959596,0.82,99.44
2021-06-30,Jharkhand,1192,4,1187,14717,4510,2265,8.1,1,39.6,441365,3635,438906,11.39,5.72,0.37164141414141416,0.82,99.44
2021-07-01,Jharkhand,867,11,864,11139,1844,882,7.78,0,39.6,442232,3646,439770,4.66,2.23,0.2812878787878788,0.82,99.44
2021-07-02,Jharkhand,130,0,129,1177,3911,3838,11.05,1,39.6,442362,3646,439899,9.88,9.69,0.029722222222222223,0.82,99.44
2021-07-03,Jharkhand,602,4,601,7621,2954,2468,7.9,0,39.6,442964,3650,440500,7.46,6.23,0.19244949494949495,0.82,99.44
2021-07-04,Jharkhand,990,3,982,12878,3825,1496,7.69,5,39.6,443954,3653,441482,9.66,3.78,0.3252020202020202,0.82,99.44
2021-07-05,Jharkhand,542,6,539,6884,4074,2982,7.87,0,39.6,444496,3659,442021,10.29,7.53,0.17383838383838385,0.82,99.44
2021-07-06,Jharkhand,710,6,703,8878,1862,475,8.0,1,39.6,445206,3665,442724,4.7,1.2,0.2241919191919192,0.82,99.44
2021-07-07,Jharkhand,427,5,425,5565,4356,3848,7.67,0,39.6,445633,3670,443149,11.0,9.72,0.14053030303030303,0.82,99.44
2021-07-08,Jharkhand,695,7,691,8611,4797,4136,8.07,0,39.6,446328,3677,443840,12.11,10.44,0.21744949494949495,0.82,99.44
2021-07-09,Jharkhand,1118,6,1117,14011,660,235,7.98,0,39.6,447446,3683,444957,1.67,0.59,0.3538131313131313,0.82,99.44
2021-07-10,Jharkhand,1280,17,1278,15507,4668,4617,8.25,0,39.6,448726,3700,446235,11.79,11.66,0.3915909090909091,0.82,99.44
2021-07-11,Jharkhand,657,5,657,8714,3912,2072,7.54,0,39.6,449383,3705,446892,9.88,5.23,0.22005050505050505,0.82,99.45
2021-07-12,Jharkhand,758,7,758,9490,4964,2222,7.99,0,39.6,450141,3712,447650,12.54,5.61,0.23964646464646464,0.82,99.45
2021-07-13,Jharkhand,1156,14,1149,14349,2233,1867,8.06,0,39.6,451297,3726,448799,5.64,4.71,0.36234848484848486,0.83,99.45
2021-07-14,Jharkhand,1198,4,1193,15509,2323,1588,7.72,1,39.6,452495,3730,449992,5.87,4.01,0.3916414141414141,0.82,99.45
2021-07-15,Jharkhand,224,1,222,3048,1144,72,7.35,1,39.6,452719,3731,450214,2.89,0.18,0.07696969696969697,0.82,99.45
2021-07-16,Jharkhand,1218,5,1210,15295,1975,1069,7.96,3,39.6,453937,3736,451424,4.99,2.7,0.3862373737373737,0.82,99.45
2021-07-17,Jharkhand,127,1,119,1748,2728,1353,7.27,7,39.6,454064,3737,451543,6.89,3.42,0.04414141414141414,0.82,99.44
2021-07-18,Jharkhand,296,4,290,3399,319,160,8.71,2,39.6,454360,3741,451833,0.81,0.4,0.08583333333333333,0.82,99.44
2021-07-19,Jharkhand,1172,14,1166,14753,320,258,7.94,0,39.6,455532,3755,452999,0.81,0.65,0.3725505050505051,0.82,99.44
2021-07-20,Jharkhand,1139,3,1131,14416,195,34,7.9,5,39.6,456671,3758,454130,0.49,0.09,0.36404040404040405,0.82,99.44
2021-07-21,Jharkhand,514,4,507,6008,1847,945,8.56,3,39.6,457185,3762,454637,4.66,2.39,0.15171717171717172,0.82,99.44
2021-07-22,Jharkhand,1052,15,1044,13512,2785,748,7.79,0,39.6,458237,3777,455681,7.03,1.89,0.3412121212121212,0.82,99.44
2021-07-23,Jharkhand,475,1,470,6578,2889,1427,7.22,4,39.6,458712,3778,456151,7.3,3.6,0.1661111111111111,0.82,99.44
2021-07-24,Jharkhand,1491,18,1485,18712,1901,1723,7.97,0,39.6,460203,3796,457636,4.8,4.35,0.4725252525252525,0.82,99.44
2021-07-25,Jharkhand,137,1,131,1959,1052,484,6.99,5,39.6,460340,3797,457767,2.66,1.22,0.04946969696969697,0.82,99.44
2021-07-26,Jharkhand,35,0,27,668,978,857,5.24,8,39.6,460375,3797,457794,2.47,2.16,0.01686868686868687,0.82,99.44
2021-07-27,Jharkhand,512,2,508,6482,1349,186,7.9,2,39.6,460887,3799,458302,3.41,0.47,0.1636868686868687,0.82,99.44
2021-07-28,Jharkhand,681,6,673,8453,4590,3,8.06,2,39.6,461568,3805,458975,11.59,0.01,0.21345959595959596,0.82,99.44
2021-07-29,Jharkhand,1142,7,1139,14403,233,68,7.93,0,39.6,462710,3812,460114,0.59,0.17,0.3637121212121212,0.82,99.44
2021-07-30,Jharkhand,1504,18,1504,18382,2636,2124,8.18,0,39.6,464214,3830,461618,6.66,5.36,0.4641919191919192,0.83,99.44
2021-07-31,Jharkhand,384,4,377,4600,1587,1456,8.35,3,39.6,464598,3834,461995,4.01,3.68,0.11616161616161616,0.83,99.44
2021-08-01,Jharkhand,1435,16,1431,18018,622,386,7.96,0,39.6,466033,3850,463426,1.57,0.97,0.455,0.83,99.44
2021-08-02,Jharkhand,161,2,158,2472,45,34,6.51,1,39.6,466194,3852,463584,0.11,0.09,0.062424242424242424,0.83,99.44
2021-08-03,Jharkhand,216,1,207,2246,4676,3323,9.62,8,39.6,466410,3853,463791,11.81,8.39,0.056717171717171715,0.83,99.44
2021-08-04,Jharkhand,1496,17,1487,18781,1504,1493,7.97,0,39.6,467906,3870,465278,3.8,3.77,0.4742676767676768,0.83,99.44
2021-08-05,Jharkhand,575,3,571,7407,206,124,7.76,1,39.6,468481,3873,465849,0.52,0.31,0.18704545454545454,0.83,99.44
2021-08-06,Jharkhand,1085,4,1079,13332,3750,924,8.14,2,39.6,469566,3877,466928,9.47,2.33,0.33666666666666667,0.83,99.44
2021-08-07,Jharkhand,268,1,268,3342,1079,746,8.02,0,39.6,469834,3878,467196,2.72,1.88,0.0843939393939394,0.83,99.44
2021-08-08,Jharkhand,957,12,957,12262,1372,1267,7.8,0,39.6,470791,3890,468153,3.46,3.2,0.30964646464646467,0.83,99.44
2021-08-09,Jharkhand,668,7,666,8224,2468,501,8.12,0,39.6,471459,3897,468819,6.23,1.27,0.20767676767676768,0.83,99.44
2021-08-10,Jharkhand,138,1,136,1621,2229,48,8.51,1,39.6,471597,3898,468955,5.63,0.12,0.040934343434343434,0.83,99.44
2021-08-11,Jharkhand,1057,12,1056,12918,1412,585,8.18,0,39.6,472654,3910,470011,3.57,1.48,0.32621212121212123,0.83,99.44
2021-08-12,Jharkhand,1168,14,1164,14847,4087,359,7.87,0,39.6,473822,3924,471175,10.32,0.91,0.37492424242424244,0.83,99.44
2021-08-13,Jharkhand,796,4,796,9846,1274,981,8.08,0,39.6,474618,3928,471971,3.22,2.48,0.24863636363636363,0.83,99.44
2021-08-14,Jharkhand,938,4,931,11570,3797,682,8.11,3,39.6,475556,3932,472902,9.59,1.72,0.2921717171717172,0.83,99.44
2021-08-15,Jharkhand,1506,17,1504,18681,4948,1626,8.06,0,39.6,477062,3949,474406,12.49,4.11,0.47174242424242424,0.83,99.44
2021-08-16,Jharkhand,1248,17,1243,15484,2462,2078,8.06,0,39.6,478310,3966,475649,6.22,5.25,0.39101010101010103,0.83,99.44
2021-08-17,Jharkhand,1252,4,1252,15426,2329,1064,8.12,0,39.6,479562,3970,476901,5.88,2.69,0.38954545454545453,0.83,99.45
2021-08-18,Jharkhand,1347,8,1346,16845,3287,2155,8.0,0,39.6,480909,3978,478247,8.3,5.44,0.42537878787878786,0.83,99.45
2021-08-19,Jharkhand,1023,11,1016,12902,2754,1279,7.93,0,39.6,481932,3989,479263,6.95,3.23,0.3258080808080808,0.83,99.45
2021-08-20,Jharkhand,164,2,161,1784,2731,2557,9.19,1,39.6,482096,3991,479424,6.9,6.46,0.04505050505050505,0.83,99.45
2021-08-21,Jharkhand,959,5,953,12162,724,179,7.89,1,39.6,483055,3996,480377,1.83,0.45,0.30712121212121213,0.83,99.45
2021-08-22,Jharkhand,819,3,818,10004,275,181,8.19,0,39.6,483874,3999,481195,0.69,0.46,0.25262626262626264,0.83,99.45
2021-08-23,Jharkhand,1562,16,1556,19248,4143,2023,8.12,0,39.6,485436,4015,482751,10.46,5.11,0.4860606060606061,0.83,99.45
2021-08-24,Jharkhand,168,1,168,1926,4850,3009,8.72,0,39.6,485604,4016,482919,12.25,7.6,0.04863636363636364,0.83,99.45
2021-08-25,Jharkhand,1057,14,1056,13253,1533,480,7.98,0,39.6,486661,4030,483975,3.87,1.21,0.3346717171717172,0.83,99.45
2021-08-26,Jharkhand,1380,19,1379,17557,609,287,7.86,0,39.6,488041,4049,485354,1.54,0.72,0.44335858585858584,0.83,99.45
2021-08-27,Jharkhand,1154,14,1152,14084,1476,1213,8.19,0,39.6,489195,4063,486506,3.73,3.06,0.35565656565656567,0.83,99.45
2021-08-28,Jharkhand,241,1,240,3139,1719,308,7.68,0,39.6,489436,4064,486746,4.34,0.78,0.07926767676767676,0.83,99.45
2021-08-29,Jharkhand,1310,8,1310,15809,4132,3371,8.29,0,39.6,490746,4072,488056,10.43,8.51,0.3992171717171717,0.83,99.45
2021-08-30,Jharkhand,1179,15,1170,14591,326,136,8.08,0,39.6,491925,4087,489226,0.82,0.34,0.368459595959596,0.83,99.45
2021-08-31,Jharkhand,1385,12,1381,17747,3598,1588,7.8,0,39.6,493310,4099,490607,9.09,4.01,0.44815656565656564,0.83,99.45
2021-09-01,Jharkhand,1523,9,1518,18582,3034,2333,8.2,0,39.6,494833,4108,492125,7.66,5.89,0.46924242424242424,0.83,99.45
2021-09-02,Jharkhand,1222,6,1219,14978,1783,633,8.16,0,39.6,496055,4114,493344,4.5,1.6,0.37823232323232325,0.83,99.45
2021-09-03,Jharkhand,1539,13,1535,19540,4061,1619,7.88,0,39.6,497594,4127,494879,10.26,4.09,0.49343434343434345,0.83,99.45
2021-09-04,Jharkhand,208,2,202,2812,2026,44,7.4,4,39.6,497802,4129,495081,5.12,0.11,0.07101010101010101,0.83,99.45
2021-09-05,Jharkhand,154,1,151,2323,3639,3525,6.63,2,39.6,497956,4130,495232,9.19,8.9,0.058661616161616165,0.83,99.45
2021-09-06,Jharkhand,1302,6,1299,16107,1450,827,8.08,0,39.6,499258,4136,496531,3.66,2.09,0.40674242424242424,0.83,99.45
2021-09-07,Jharkhand,1591,5,1583,19947,558,460,7.98,3,39.6,500849,4141,498114,1.41,1.16,0.5037121212121212,0.83,99.45
2021-09-08,Jharkhand,198,1,193,2490,1023,401,7.95,4,39.6,501047,4142,498307,2.58,1.01,0.06287878787878788,0.83,99.45
2021-09-09,Jharkhand,681,4,675,8362,311,306,8.14,2,39.6,501728,4146,498982,0.79,0.77,0.21116161616161616,0.83,99.45
2021-09-10,Jharkhand,162,1,162,2123,2215,128,7.63,0,39.6,501890,4147,499144,5.59,0.32,0.05361111111111111,0.83,99.45
2021-09-11,Jharkhand,1474,4,1467,18098,2229,506,8.14,3,39.6,503364,4151,500611,5.63,1.28,0.457020202020202,0.82,99.45
2021-09-12,Jharkhand,1323,14,1322,16270,4268,1743,8.13,0,39.6,504687,4165,501933,10.78,4.4,0.41085858585858587,0.83,99.45
2021-09-13,Jharkhand,627,1,620,8316,1715,874,7.54,6,39.6,505314,4166,502553,4.33,2.21,0.21,0.82,99.45
2021-09-14,Jharkhand,842,8,833,10461,3504,620,8.05,1,39.6,506156,4174,503386,8.85,1.57,0.26416666666666666,0.82,99.45
2021-09-15,Jharkhand,1455,20,1453,18106,3869,1872,8.04,0,39.6,507611,4194,504839,9.77,4.73,0.4572222222222222,0.83,99.45
2021-09-16,Jharkhand,160,0,151,1745,1101,877,9.17,9,39.6,507771,4194,504990,2.78,2.21,0.044065656565656565,0.83,99.45
2021-09-17,Jharkhand,318,3,313,3515,3280,3239,9.05,2,39.6,508089,4197,505303,8.28,8.18,0.08876262626262627,0.83,99.45
2021-09-18,Jharkhand,213,1,212,2759,2688,1965,7.72,0,39.6,508302,4198,505515,6.79,4.96,0.06967171717171718,0.83,99.45
2021-09-19,Jharkhand,896,3,894,11643,4193,495,7.7,0,39.6,509198,4201,506409,10.59,1.25,0.2940151515151515,0.83,99.45
2021-09-20,Jharkhand,1221,10,1220,15103,3762,846,8.08,0,39.6,510419,4211,507629,9.5,2.14,0.3813888888888889,0.83,99.45
2021-09-21,Jharkhand,1107,8,1104,13596,2527,562,8.14,0,39.6,511526,4219,508733,6.38,1.42,0.3433333333333333,0.82,99.45
2021-09-22,Jharkhand,1185,17,1176,14956,4154,4025,7.92,0,39.6,512711,4236,509909,10.49,10.16,0.37767676767676767,0.83,99.45
2021-09-23,Jharkhand,239,2,237,2892,1744,550,8.26,0,39.6,512950,4238,510146,4.4,1.39,0.07303030303030303,0.83,99.45
2021-09-24,Jharkhand,1498,18,1494,18201,208,56,8.23,0,39.6,514448,4256,511640,0.53,0.14,0.4596212121212121,0.83,99.45
2021-09-25,Jharkhand,637,7,635,7867,1257,146,8.1,0,39.6,515085,4263,512275,3.17,0.37,0.19866161616161615,0.83,99.45
2021-09-26,Jharkhand,1148,15,1143,14091,2905,1841,8.15,0,39.6,516233,4278,513418,7.34,4.65,0.35583333333333333,0.83,99.45
2021-09-27,Jharkhand,551,3,551,6758,624,458,8.15,0,39.6,516784,4281,513969,1.58,1.16,0.17065656565656565,0.83,99.46
2021-09-28,Jharkhand,201,2,195,2257,1105,81,8.91,4,39.6,516985,4283,514164,2.79,0.2,0.056994949494949494,0.83,99.45
2021-09-29,Jharkhand,1206,15,1202,15126,2190,2068,7.97,0,39.6,518191,4298,515366,5.53,5.22,0.38196969696969696,0.83,99.45
2021-09-30,Jharkhand,1578,10,1571,19858,933,492,7.95,0,39.6,519769,4308,516937,2.36,1.24,0.5014646464646465,0.83,99.46
2021-10-01,Jharkhand,449,5,447,5870,3891,623,7.65,0,39.6,520218,4313,517384,9.83,1.57,0.14823232323232324,0.83,99.46
2021-10-02,Jharkhand,403,3,402,4995,2647,1840,8.07,0,39.6,520621,4316,517786,6.68,4.65,0.12613636363636363,0.83,99.46
2021-10-03,Jharkhand,494,3,493,6507,1605,237,7.59,0,39.6,521115,4319,518279,4.05,0.6,0.1643181818181818,0.83,99.46
2021-10-04,Jharkhand,507,3,502,6411,1148,146,7.91,2,39.6,521622,4322,518781,2.9,0.37,0.1618939393939394,0.83,99.46
2021-10-05,Jharkhand,773,8,767,9760,4894,3758,7.92,0,39.6,522395,4330,519548,12.36,9.49,0.24646464646464647,0.83,99.46
2021-10-06,Jharkhand,659,4,650,8484,545,178,7.77,5,39.6,523054,4334,520198,1.38,0.45,0.21424242424242423,0.83,99.45
2021-10-07,Jharkhand,671,8,665,8237,2008,2000,8.15,0,39.6,523725,4342,520863,5.07,5.05,0.2080050505050505,0.83,99.45
2021-10-08,Jharkhand,761,10,759,9529,2981,18,7.99,0,39.6,524486,4352,521622,7.53,0.05,0.24063131313131314,0.83,99.45
2021-10-09,Jharkhand,718,10,718,8711,3742,581,8.24,0,39.6,525204,4362,522340,9.45,1.47,0.21997474747474746,0.83,99.45
2021-10-10,Jharkhand,664,9,663,8154,3825,2591,8.14,0,39.6,525868,4371,523003,9.66,6.54,0.2059090909090909,0.83,99.46
2021-10-11,Jharkhand,1105,11,1102,13364,3896,2832,8.27,0,39.6,526973,4382,524105,9.84,7.15,0.3374747474747475,0.83,99.46
2021-10-12,Jharkhand,221,2,220,3045,3951,3882,7.26,0,39.6,527194,4384,524325,9.98,9.8,0.07689393939393939,0.83,99.46
2021-10-13,Jharkhand,697,3,693,8420,2378,615,8.28,1,39.6,527891,4387,525018,6.01,1.55,0.21262626262626264,0.83,99.46
2021-10-14,Jharkhand,1264,15,1255,15380,4314,1828,8.22,0,39.6,529155,4402,526273,10.89,4.62,0.3883838383838384,0.83,99.46
2021-10-15,Jharkhand,806,5,805,10009,1615,1568,8.05,0,39.6,529961,4407,527078,4.08,3.96,0.25275252525252523,0.83,99.46
2021-10-16,Jharkhand,876,7,870,10761,1247,998,8.14,0,39.6,530837,4414,527948,3.15,2.52,0.27174242424242423,0.83,99.46
2021-10-17,Jharkhand,1560,21,1558,19256,925,412,8.1,0,39.6,532397,4435,529506,2.34,1.04,0.4862626262626263,0.83,99.46
2021-10-18,Jharkhand,1202,16,1200,15058,4191,205,7.98,0,39.6,533599,4451,530706,10.58,0.52,0.38025252525252523,0.83,99.46
2021-10-19,Jharkhand,1313,19,1304,16712,2653,945,7.86,0,39.6,534912,4470,532010,6.7,2.39,0.422020202020202,0.84,99.46
2021-10-20,Jharkhand,480,2,473,5761,4831,1195,8.33,5,39.6,535392,4472,532483,12.2,3.02,0.145479797979798,0.84,99.46
2021-10-21,Jharkhand,1178,16,1173,14571,3141,1689,8.08,0,39.6,536570,4488,533656,7.93,4.27,0.3679545454545455,0.84,99.46
2021-10-22,Jharkhand,857,10,853,10886,4800,4274,7.87,0,39.6,537427,4498,534509,12.12,10.79,0.2748989898989899,0.84,99.46
2021-10-23,Jharkhand,1526,19,1519,18725,2316,910,8.15,0,39.6,538953,4517,536028,5.85,2.3,0.47285353535353536,0.84,99.46
2021-10-24,Jharkhand,1375,7,1370,16637,4382,1558,8.26,0,39.6,540328,4524,537398,11.07,3.93,0.4201262626262626,0.84,99.46
2021-10-25,Jharkhand,1366,9,1358,17245,2910,2437,7.92,0,39.6,541694,4533,538756,7.35,6.15,0.43547979797979797,0.84,99.46
2021-10-26,Jharkhand,327,3,321,4406,3485,184,7.42,3,39.6,542021,4536,539077,8.8,0.46,0.11126262626262626,0.84,99.46
2021-10-27,Jharkhand,957,3,955,11751,1455,210,8.14,0,39.6,542978,4539,540032,3.67,0.53,0.29674242424242425,0.84,99.46
2021-10-28,Jharkhand,475,6,470,5388,3369,2896,8.82,0,39.6,543453,4545,540502,8.51,7.31,0.13606060606060605,0.84,99.46
2021-10-29,Jharkhand,583,5,576,7799,912,459,7.48,2,39.6,544036,4550,541078,2.3,1.16,0.19694444444444445,0.84,99.46
2021-10-30,Jharkhand,681,6,677,8186,3426,2530,8.32,0,39.6,544717,4556,541755,8.65,6.39,0.20671717171717172,0.84,99.46
2021-10-31,Jharkhand,1502,13,1501,18693,1101,975,8.04,0,39.6,546219,4569,543256,2.78,2.46,0.47204545454545455,0.84,99.46
2021-11-01,Jharkhand,1157,14,1153,14308,2362,2218,8.09,0,39.6,547376,4583,544409,5.96,5.6,0.3613131313131313,0.84,99.46
2021-11-02,Jharkhand,1384,12,1376,17445,3858,734,7.93,0,39.6,548760,4595,545785,9.74,1.85,0.44053030303030305,0.84,99.46
2021-11-03,Jharkhand,1097,13,1096,14035,1209,197,7.82,0,39.6,549857,4608,546881,3.05,0.5,0.3544191919191919,0.84,99.46
2021-11-04,Jharkhand,825,4,822,10100,1244,714,8.17,0,39.6,550682,4612,547703,3.14,1.8,0.255050505050505,0.84,99.46
2021-11-05,Jharkhand,42,0,36,931,3794,3197,4.51,6,39.6,550724,4612,547739,9.58,8.07,0.02351010101010101,0.84,99.46
2021-11-06,Jharkhand,629,2,620,7815,4851,320,8.05,7,39.6,551353,4614,548359,12.25,0.81,0.19734848484848486,0.84,99.46
2021-11-07,Jharkhand,319,3,315,3869,1677,805,8.25,1,39.6,551672,4617,548674,4.23,2.03,0.0977020202020202,0.84,99.46
2021-11-08,Jharkhand,1096,14,1096,14064,2955,1345,7.79,0,39.6,552768,4631,549770,7.46,3.4,0.35515151515151516,0.84,99.46
2021-11-09,Jharkhand,317,4,308,3992,2676,1672,7.94,5,39.6,553085,4635,550078,6.76,4.22,0.1008080808080808,0.84,99.46
2021-11-10,Jharkhand,744,7,743,9608,4144,1047,7.74,0,39.6,553829,4642,550821,10.46,2.64,0.24262626262626263,0.84,99.46
2021-11-11,Jharkhand,288,2,282,3781,3877,3010,7.62,4,39.6,554117,4644,551103,9.79,7.6,0.09547979797979798,0.84,99.46
2021-11-12,Jharkhand,1451,18,1449,18068,3082,2164,8.03,0,39.6,555568,4662,552552,7.78,5.46,0.45626262626262626,0.84,99.46
2021-11-13,Jharkhand,213,1,207,2907,3185,714,7.33,5,39.6,555781,4663,552759,8.04,1.8,0.07340909090909091,0.84,99.46
2021-11-14,Jharkhand,114,1,114,1740,2446,1474,6.55,0,39.6,555895,4664,552873,6.18,3.72,0.04393939393939394,0.84,99.46
2021-11-15,Jharkhand,978,14,972,11929,96,23,8.2,0,39.6,556873,4678,553845,0.24,0.06,0.30123737373737375,0.84,99.46
2021-11-16,Jharkhand,1258,12,1250,15701,1069,325,8.01,0,39.6,558131,4690,555095,2.7,0.82,0.396489898989899,0.84,99.46
2021-11-17,Jharkhand,1348,4,1343,16801,3202,449,8.02,1,39.6,559479,4694,556438,8.09,1.13,0.4242676767676768,0.84,99.46
2021-11-18,Jharkhand,462,1,462,5396,4537,3698,8.56,0,39.6,559941,4695,556900,11.46,9.34,0.13626262626262625,0.84,99.46
2021-11-19,Jharkhand,551,8,550,7299,2123,1994,7.55,0,39.6,560492,4703,557450,5.36,5.04,0.18431818181818183,0.84,99.46
2021-11-20,Jharkhand,117,0,109,1496,4969,506,7.82,8,39.6,560609,4703,557559,12.55,1.28,0.03777777777777778,0.84,99.46
2021-11-21,Jharkhand,763,3,754,9959,976,347,7.66,6,39.6,561372,4706,558313,2.46,0.88,0.251489898989899,0.84,99.46
2021-11-22,Jharkhand,253,1,250,3209,4605,1881,7.88,2,39.6,561625,4707,558563,11.63,4.75,0.08103535353535353,0.84,99.45
2021-11-23,Jharkhand,611,4,602,7511,3522,1396,8.13,5,39.6,562236,4711,559165,8.89,3.53,0.18967171717171716,0.84,99.45
2021-11-24,Jharkhand,800,10,795,9958,1030,634,8.03,0,39.6,563036,4721,559960,2.6,1.6,0.25146464646464645,0.84,99.45
2021-11-25,Jharkhand,209,2,206,2824,2087,459,7.4,1,39.6,563245,4723,560166,5.27,1.16,0.07131313131313131,0.84,99.45
2021-11-26,Jharkhand,832,3,828,10175,401,337,8.18,1,39.6,564077,4726,560994,1.01,0.85,0.2569444444444444,0.84,99.45
2021-11-27,Jharkhand,918,11,917,11776,2571,445,7.8,0,39.6,564995,4737,561911,6.49,1.12,0.2973737373737374,0.84,99.45
2021-11-28,Jharkhand,227,2,226,2836,1084,500,8.0,0,39.6,565222,4739,562137,2.74,1.26,0.07161616161616162,0.84,99.45
2021-11-29,Jharkhand,422,4,413,5408,1808,523,7.8,5,39.6,565644,4743,562550,4.57,1.32,0.13656565656565656,0.84,99.45
2021-11-30,Jharkhand,1564,18,1561,19884,2399,2332,7.87,0,39.6,567208,4761,564111,6.06,5.89,0.5021212121212121,0.84,99.45
2021-12-01,Jharkhand,724,7,719,9091,2370,1494,7.96,0,39.6,567932,4768,564830,5.98,3.77,0.22957070707070706,0.84,99.45
2021-12-02,Jharkhand,609,5,609,7151,3237,443,8.52,0,39.6,568541,4773,565439,8.17,1.12,0.1805808080808081,0.84,99.45
2021-12-03,Jharkhand,1504,14,1500,19037,1170,427,7.9,0,39.6,570045,4787,566939,2.95,1.08,0.48073232323232323,0.84,99.46
2021-12-04,Jharkhand,954,3,951,11782,3238,686,8.1,0,39.6,570999,4790,567890,8.18,1.73,0.2975252525252525,0.84,99.46
2021-12-05,Jharkhand,1018,13,1016,12694,3486,340,8.02,0,39.6,572017,4803,568906,8.8,0.86,0.32055555555555554,0.84,99.46
2021-12-06,Jharkhand,898,11,889,11285,4940,3740,7.96,0,39.6,572915,4814,569795,12.47,9.44,0.2849747474747475,0.84,99.46
2021-12-07,Jharkhand,92,0,89,1279,1199,184,7.19,3,39.6,573007,4814,569884,3.03,0.46,0.0322979797979798,0.84,99.45
2021-12-08,Jharkhand,225,2,221,2758,1372,843,8.16,2,39.6,573232,4816,570105,3.46,2.13,0.06964646464646465,0.84,99.45
2021-12-09,Jharkhand,1085,11,1076,13793,373,135,7.87,0,39.6,574317,4827,571181,0.94,0.34,0.3483080808080808,0.84,99.45
2021-12-10,Jharkhand,740,4,738,9440,3098,67,7.84,0,39.6,575057,4831,571919,7.82,0.17,0.2383838383838384,0.84,99.45
2021-12-11,Jharkhand,874,11,871,10772,3310,1901,8.11,0,39.6,575931,4842,572790,8.36,4.8,0.272020202020202,0.84,99.45
2021-12-12,Jharkhand,486,4,477,5778,2715,2262,8.41,5,39.6,576417,4846,573267,6.86,5.71,0.1459090909090909,0.84,99.45
2021-12-13,Jharkhand,51,0,48,575,3728,2486,8.87,3,39.6,576468,4846,573315,9.41,6.28,0.01452020202020202,0.84,99.45
2021-12-14,Jharkhand,1272,6,1267,15893,4187,1764,8.0,0,39.6,577740,4852,574582,10.57,4.45,0.4013383838383838,0.84,99.45
2021-12-15,Jharkhand,1134,12,1126,14504,3448,56,7.82,0,39.6,578874,4864,575708,8.71,0.14,0.3662626262626263,0.84,99.45
2021-12-16,Jharkhand,600,3,597,7582,3624,1114,7.91,0,39.6,579474,4867,576305,9.15,2.81,0.19146464646464648,0.84,99.45
2021-12-17,Jharkhand,199,1,193,2429,1623,63,8.19,5,39.6,579673,4868,576498,4.1,0.16,0.06133838383838384,0.84,99.45
2021-12-18,Jharkhand,353,1,353,4023,117,73,8.77,0,39.6,580026,4869,576851,0.3,0.18,0.10159090909090909,0.84,99.45
2021-12-19,Jharkhand,1059,9,1057,13495,4895,3240,7.85,0,39.6,581085,4878,577908,12.36,8.18,0.3407828282828283,0.84,99.45
2021-12-20,Jharkhand,680,7,678,8844,4632,1238,7.69,0,39.6,581765,4885,578586,11.7,3.13,0.22333333333333333,0.84,99.45
2021-12-21,Jharkhand,294,2,291,3580,3206,2741,8.21,1,39.6,582059,4887,578877,8.1,6.92,0.0904040404040404,0.84,99.45
2021-12-22,Jharkhand,759,8,751,9575,1075,172,7.93,0,39.6,582818,4895,579628,2.71,0.43,0.24179292929292928,0.84,99.45
2021-12-23,Jharkhand,1363,14,1356,16712,1452,918,8.16,0,39.6,584181,4909,580984,3.67,2.32,0.422020202020202,0.84,99.45
2021-12-24,Jharkhand,1076,7,1068,13532,1267,981,7.95,1,39.6,585257,4916,582052,3.2,2.48,0.3417171717171717,0.84,99.45
2021-12-25,Jharkhand,586,2,579,7204,3202,3136,8.13,5,39.6,585843,4918,582631,8.09,7.92,0.18191919191919192,0.84,99.45
2021-12-26,Jharkhand,189,1,185,1899,1668,1169,9.95,3,39.6,586032,4919,582816,4.21,2.95,0.04795454545454545,0.84,99.45
2021-12-27,Jharkhand,1244,4,1238,15550,598,294,8.0,2,39.6,587276,4923,584054,1.51,0.74,0.3926767676767677,0.84,99.45
2021-12-28,Jharkhand,208,1,201,2395,3457,1925,8.68,6,39.6,587484,4924,584255,8.73,4.86,0.06047979797979798,0.84,99.45
2021-12-29,Jharkhand,803,3,795,10073,2271,71,7.97,5,39.6,588287,4927,585050,5.73,0.18,0.25436868686868686,0.84,99.45
2021-12-30,Jharkhand,323,1,321,4006,1389,358,8.06,1,39.6,588610,4928,585371,3.51,0.9,0.10116161616161616,0.84,99.45
2021-12-31,Jharkhand,74,0,73,720,4289,3437,10.28,1,39.6,588684,4928,585444,10.83,8.68,0.01818181818181818,0.84,99.45
2022-01-01,Jharkhand,1244,7,1243,15345,1460,969,8.11,0,39.6,589928,4935,586687,3.69,2.45,0.3875,0.84,99.45
2022-01-02,Jharkhand,547,2,541,6996,2219,913,7.82,4,39.6,590475,4937,587228,5.6,2.31,0.17666666666666667,0.84,99.45
2022-01-03,Jharkhand,785,10,776,10094,2734,1875,7.78,0,39.6,591260,4947,588004,6.9,4.73,0.2548989898989899,0.84,99.45
2022-01-04,Jharkhand,1579,11,1571,19659,3635,1978,8.03,0,39.6,592839,4958,589575,9.18,4.99,0.49643939393939396,0.84,99.45
2022-01-05,Jharkhand,1302,7,1301,16771,2743,2027,7.76,0,39.6,594141,4965,590876,6.93,5.12,0.423510101010101,0.84,99.45
2022-01-06,Jharkhand,685,8,684,8854,4748,3475,7.74,0,39.6,594826,4973,591560,11.99,8.78,0.22358585858585858,0.84,99.45
2022-01-07,Jharkhand,796,4,791,10112,303,145,7.87,1,39.6,595622,4977,592351,0.77,0.37,0.25535353535353533,0.84,99.45
2022-01-08,Jharkhand,458,6,450,5884,3781,1655,7.78,2,39.6,596080,4983,592801,9.55,4.18,0.1485858585858586,0.84,99.45
2022-01-09,Jharkhand,347,3,340,4060,3369,1026,8.55,4,39.6,596427,4986,593141,8.51,2.59,0.10252525252525252,0.84,99.45
2022-01-10,Jharkhand,1197,13,1196,14738,654,194,8.12,0,39.6,597624,4999,594337,1.65,0.49,0.37217171717171715,0.84,99.45
2022-01-11,Jharkhand,67,0,67,858,3080,1959,7.81,0,39.6,597691,4999,594404,7.78,4.95,0.021666666666666667,0.84,99.45
2022-01-12,Jharkhand,929,3,923,11576,2190,173,8.03,3,39.6,598620,5002,595327,5.53,0.44,0.2923232323232323,0.84,99.45
2022-01-13,Jharkhand,234,2,228,2573,3627,1439,9.09,4,39.6,598854,5004,595555,9.16,3.63,0.06497474747474748,0.84,99.45
2022-01-14,Jharkhand,1567,7,1562,19807,1619,1242,7.91,0,39.6,600421,5011,597117,4.09,3.14,0.5001767676767677,0.83,99.45
2022-01-15,Jharkhand,285,1,277,3365,3407,1404,8.47,7,39.6,600706,5012,597394,8.6,3.55,0.08497474747474748,0.83,99.45
2022-01-16,Jharkhand,827,8,823,10270,5,0,8.05,0,39.6,601533,5020,598217,0.01,0.0,0.2593434343434343,0.83,99.45
2022-01-17,Jharkhand,512,6,511,6332,4691,4245,8.09,0,39.6,602045,5026,598728,11.85,10.72,0.1598989898989899,0.83,99.45
2022-01-18,Jharkhand,1566,12,1564,18931,956,679,8.27,0,39.6,603611,5038,600292,2.41,1.71,0.47805555555555557,0.83,99.45
2022-01-19,Jharkhand,934,12,926,11374,378,370,8.21,0,39.6,604545,5050,601218,0.95,0.93,0.2872222222222222,0.84,99.45
2022-01-20,Jharkhand,790,11,782,10029,4910,27,7.88,0,39.6,605335,5061,602000,12.4,0.07,0.25325757575757574,0.84,99.45
2022-01-21,Jharkhand,1289,18,1284,15754,4448,4286,8.18,0,39.6,606624,5079,603284,11.23,10.82,0.3978282828282828,0.84,99.45
2022-01-22,Jharkhand,1513,22,1507,19073,968,284,7.93,0,39.6,608137,5101,604791,2.44,0.72,0.48164141414141415,0.84,99.45
2022-01-23,Jharkhand,743,9,741,9405,834,331,7.9,0,39.6,608880,5110,605532,2.11,0.84,0.2375,0.84,99.45
2022-01-24,Jharkhand,268,1,262,3143,27,8,8.53,5,39.6,609148,5111,605794,0.07,0.02,0.07936868686868687,0.84,99.45
2022-01-25,Jharkhand,1035,12,1031,13227,2884,2492,7.82,0,39.6,610183,5123,606825,7.28,6.29,0.33401515151515154,0.84,99.45
2022-01-26,Jharkhand,266,1,265,3185,2405,804,8.35,0,39.6,610449,5124,607090,6.07,2.03,0.08042929292929293,0.84,99.45
2022-01-27,Jharkhand,502,1,500,6350,4530,3925,7.91,1,39.6,610951,5125,607590,11.44,9.91,0.16035353535353536,0.84,99.45
2022-01-28,Jharkhand,1376,7,1369,17045,635,107,8.07,0,39.6,612327,5132,608959,1.6,0.27,0.43042929292929294,0.84,99.45
2022-01-29,Jharkhand,1398,16,1389,17656,484,253,7.92,0,39.6,613725,5148,610348,1.22,0.64,0.44585858585858584,0.84,99.45
2022-01-30,Jharkhand,806,8,806,9862,576,415,8.17,0,39.6,614531,5156,611154,1.45,1.05,0.24904040404040403,0.84,99.45
2022-01-31,Jharkhand,1508,7,1500,19153,3348,2830,7.87,1,39.6,616039,5163,612654,8.45,7.15,0.4836616161616162,0.84,99.45
2022-02-01,Jharkhand,176,1,173,2340,100,5,7.52,2,39.6,616215,5164,612827,0.25,0.01,0.05909090909090909,0.84,99.45
2022-02-02,Jharkhand,536,2,528,6614,715,20,8.1,6,39.6,616751,5166,613355,1.81,0.05,0.167020202020202,0.84,99.45
2022-02-03,Jharkhand,340,4,334,4507,860,544,7.54,2,39.6,617091,5170,613689,2.17,1.37,0.11381313131313131,0.84,99.45
2022-02-04,Jharkhand,1027,8,1024,12805,2121,789,8.02,0,39.6,618118,5178,614713,5.36,1.99,0.32335858585858585,0.84,99.45
2022-02-05,Jharkhand,753,5,748,9379,4732,3745,8.03,0,39.6,618871,5183,615461,11.95,9.46,0.23684343434343436,0.84,99.45
2022-02-06,Jharkhand,813,7,805,10486,2715,592,7.75,1,39.6,619684,5190,616266,6.86,1.49,0.2647979797979798,0.84,99.45
2022-02-07,Jharkhand,1252,17,1248,15785,3470,3277,7.93,0,39.6,620936,5207,617514,8.76,8.28,0.39861111111111114,0.84,99.45
2022-02-08,Jharkhand,1108,11,1108,14085,2081,559,7.87,0,39.6,622044,5218,618622,5.26,1.41,0.35568181818181815,0.84,99.45
2022-02-09,Jharkhand,1438,14,1437,18079,3497,3081,7.95,0,39.6,623482,5232,620059,8.83,7.78,0.456540404040404,0.84,99.45
2022-02-10,Jharkhand,866,6,864,10553,1460,774,8.21,0,39.6,624348,5238,620923,3.69,1.95,0.266489898989899,0.84,99.45
2022-02-11,Jharkhand,134,1,126,1924,2944,886,6.96,7,39.6,624482,5239,621049,7.43,2.24,0.048585858585858586,0.84,99.45
2022-02-12,Jharkhand,1507,13,1506,18829,1480,1165,8.0,0,39.6,625989,5252,622555,3.74,2.94,0.475479797979798,0.84,99.45
2022-02-13,Jharkhand,824,3,822,10209,1870,160,8.07,0,39.6,626813,5255,623377,4.72,0.4,0.2578030303030303,0.84,99.45
2022-02-14,Jharkhand,614,8,609,7746,2446,190,7.93,0,39.6,627427,5263,623986,6.18,0.48,0.19560606060606062,0.84,99.45
2022-02-15,Jharkhand,1187,10,1184,14792,2000,165,8.02,0,39.6,628614,5273,625170,5.05,0.42,0.37353535353535355,0.84,99.45
2022-02-16,Jharkhand,128,1,119,1810,3644,2168,7.07,8,39.6,628742,5274,625289,9.2,5.47,0.04570707070707071,0.84,99.45
2022-02-17,Jharkhand,726,9,725,9198,4690,1171,7.89,0,39.6,629468,5283,626014,11.84,2.96,0.23227272727272727,0.84,99.45
2022-02-18,Jharkhand,105,1,97,924,915,265,11.36,7,39.6,629573,5284,626111,2.31,0.67,0.023333333333333334,0.84,99.45
2022-02-19,Jharkhand,844,10,843,10946,4843,1214,7.71,0,39.6,630417,5294,626954,12.23,3.07,0.2764141414141414,0.84,99.45
2022-02-20,Jharkhand,244,2,239,3298,4292,2057,7.4,3,39.6,630661,5296,627193,10.84,5.19,0.08328282828282828,0.84,99.45
2022-02-21,Jharkhand,207,1,198,2675,2810,374,7.74,8,39.6,630868,5297,627391,7.1,0.94,0.06755050505050506,0.84,99.45
2022-02-22,Jharkhand,97,0,88,796,1789,599,12.19,9,39.6,630965,5297,627479,4.52,1.51,0.020101010101010102,0.84,99.45
2022-02-23,Jharkhand,808,3,803,10607,1737,802,7.62,2,39.6,631773,5300,628282,4.39,2.03,0.26785353535353534,0.84,99.45
2022-02-24,Jharkhand,71,0,70,846,1147,727,8.39,1,39.6,631844,5300,628352,2.9,1.84,0.021363636363636362,0.84,99.45
2022-02-25,Jharkhand,1018,14,1015,12551,1256,513,8.11,0,39.6,632862,5314,629367,3.17,1.3,0.3169444444444444,0.84,99.45
2022-02-26,Jharkhand,1233,13,1225,15100,2399,1127,8.17,0,39.6,634095,5327,630592,6.06,2.85,0.3813131313131313,0.84,99.45
2022-02-27,Jharkhand,799,5,792,9769,1736,1438,8.18,2,39.6,634894,5332,631384,4.38,3.63,0.24669191919191918,0.84,99.45
2022-02-28,Jharkhand,649,4,640,8092,3633,3024,8.02,5,39.6,635543,5336,632024,9.17,7.64,0.20434343434343435,0.84,99.45
2022-03-01,Jharkhand,1091,13,1091,13531,627,55,8.06,0,39.6,636634,5349,633115,1.58,0.14,0.3416919191919192,0.84,99.45
2022-03-02,Jharkhand,95,0,91,1569,182,175,6.05,4,39.6,636729,5349,633206,0.46,0.44,0.03962121212121212,0.84,99.45
2022-03-03,Jharkhand,516,6,511,6542,3538,1599,7.89,0,39.6,637245,5355,633717,8.93,4.04,0.1652020202020202,0.84,99.45
2022-03-04,Jharkhand,844,9,838,10484,4245,3903,8.05,0,39.6,638089,5364,634555,10.72,9.86,0.26474747474747473,0.84,99.45
2022-03-05,Jharkhand,120,0,117,1417,1577,1262,8.47,3,39.6,638209,5364,634672,3.98,3.19,0.035782828282828284,0.84,99.45
2022-03-06,Jharkhand,774,2,766,9551,1533,518,8.1,6,39.6,638983,5366,635438,3.87,1.31,0.2411868686868687,0.84,99.45
2022-03-07,Jharkhand,905,9,905,11292,3054,2146,8.01,0,39.6,639888,5375,636343,7.71,5.42,0.28515151515151516,0.84,99.45
2022-03-08,Jharkhand,1542,21,1535,19205,3068,2265,8.03,0,39.6,641430,5396,637878,7.75,5.72,0.48497474747474745,0.84,99.45
2022-03-09,Jharkhand,1209,14,1208,15261,2014,734,7.92,0,39.6,642639,5410,639086,5.09,1.85,0.3853787878787879,0.84,99.45
2022-03-10,Jharkhand,1153,15,1148,14303,1906,1198,8.06,0,39.6,643792,5425,640234,4.81,3.03,0.36118686868686867,0.84,99.45
2022-03-11,Jharkhand,1397,6,1389,17336,3734,777,8.06,2,39.6,645189,5431,641623,9.43,1.96,0.43777777777777777,0.84,99.45
2022-03-12,Jharkhand,400,1,393,5121,187,104,7.81,6,39.6,645589,5432,642016,0.47,0.26,0.1293181818181818,0.84,99.45
2022-03-13,Jharkhand,208,1,202,2725,421,9,7.63,5,39.6,645797,5433,642218,1.06,0.02,0.06881313131313131,0.84,99.45
2022-03-14,Jharkhand,1159,5,1153,14280,3197,2881,8.12,1,39.6,646956,5438,643371,8.07,7.28,0.3606060606060606,0.84,99.45
2022-03-15,Jharkhand,357,4,352,4822,1172,153,7.4,1,39.6,647313,5442,643723,2.96,0.39,0.12176767676767676,0.84,99.45
2022-03-16,Jharkhand,523,4,514,6151,4043,2630,8.5,5,39.6,647836,5446,644237,10.21,6.64,0.15532828282828282,0.84,99.44
2022-03-17,Jharkhand,1314,6,1311,15866,3123,2316,8.28,0,39.6,649150,5452,645548,7.89,5.85,0.40065656565656566,0.84,99.45
2022-03-18,Jharkhand,136,1,134,1923,3741,1487,7.07,1,39.6,649286,5453,645682,9.45,3.76,0.04856060606060606,0.84,99.44
2022-03-19,Jharkhand,767,3,761,9971,4145,1006,7.69,3,39.6,650053,5456,646443,10.47,2.54,0.2517929292929293,0.84,99.44
2022-03-20,Jharkhand,1178,6,1171,14397,1654,1629,8.18,1,39.6,651231,5462,647614,4.18,4.11,0.3635606060606061,0.84,99.44
2022-03-21,Jharkhand,1298,11,1298,16078,3177,1710,8.07,0,39.6,652529,5473,648912,8.02,4.32,0.406010101010101,0.84,99.45
2022-03-22,Jharkhand,1531,5,1530,19014,4392,2565,8.05,0,39.6,654060,5478,650442,11.09,6.48,0.48015151515151516,0.84,99.45
2022-03-23,Jharkhand,1368,10,1364,16798,1950,1123,8.14,0,39.6,655428,5488,651806,4.92,2.84,0.4241919191919192,0.84,99.45
2022-03-24,Jharkhand,400,1,399,5485,4640,65,7.29,0,39.6,655828,5489,652205,11.72,0.16,0.138510101010101,0.84,99.45
2022-03-25,Jharkhand,1097,4,1092,13680,488,27,8.02,1,39.6,656925,5493,653297,1.23,0.07,0.34545454545454546,0.84,99.45
2022-03-26,Jharkhand,217,2,216,3087,1013,474,7.03,0,39.6,657142,5495,653513,2.56,1.2,0.07795454545454546,0.84,99.45
2022-03-27,Jharkhand,1516,19,1513,18330,211,70,8.27,0,39.6,658658,5514,655026,0.53,0.18,0.4628787878787879,0.84,99.45
2022-03-28,Jharkhand,1038,11,1031,13128,2461,74,7.91,0,39.6,659696,5525,656057,6.21,0.19,0.33151515151515154,0.84,99.45
2022-03-29,Jharkhand,156,1,152,1720,2642,897,9.07,3,39.6,659852,5526,656209,6.67,2.27,0.043434343434343436,0.84,99.45
2022-03-30,Jharkhand,1041,15,1040,13039,4056,1862,7.98,0,39.6,660893,5541,657249,10.24,4.7,0.32926767676767676,0.84,99.45
2022-03-31,Jharkhand,1062,12,1056,13199,179,57,8.05,0,39.6,661955,5553,658305,0.45,0.14,0.33330808080808083,0.84,99.45
2022-04-01,Jharkhand,1504,7,1499,18846,1923,835,7.98,0,39.6,663459,5560,659804,4.86,2.11,0.4759090909090909,0.84,99.45
2022-04-02,Jharkhand,1403,18,1400,17763,4055,3626,7.9,0,39.6,664862,5578,661204,10.24,9.16,0.44856060606060605,0.84,99.45
2022-04-03,Jharkhand,1130,12,1123,13975,2620,849,8.09,0,39.6,665992,5590,662327,6.62,2.14,0.3529040404040404,0.84,99.45
2022-04-04,Jharkhand,1501,4,1498,18558,4010,469,8.09,0,39.6,667493,5594,663825,10.13,1.18,0.46863636363636363,0.84,99.45
2022-04-05,Jharkhand,641,7,634,7932,4994,2944,8.08,0,39.6,668134,5601,664459,12.61,7.43,0.20030303030303032,0.84,99.45
2022-04-06,Jharkhand,1107,16,1102,13796,1319,779,8.02,0,39.6,669241,5617,665561,3.33,1.97,0.3483838383838384,0.84,99.45
2022-04-07,Jharkhand,999,9,995,12493,1500,97,8.0,0,39.6,670240,5626,666556,3.79,0.24,0.31547979797979797,0.84,99.45
2022-04-08,Jharkhand,1121,11,1119,14248,4927,2915,7.87,0,39.6,671361,5637,667675,12.44,7.36,0.3597979797979798,0.84,99.45
2022-04-09,Jharkhand,490,4,481,6168,292,83,7.94,5,39.6,671851,5641,668156,0.74,0.21,0.15575757575757576,0.84,99.45
2022-04-10,Jharkhand,935,4,935,11333,401,85,8.25,0,39.6,672786,5645,669091,1.01,0.21,0.2861868686868687,0.84,99.45
2022-04-11,Jharkhand,1208,17,1200,15241,1114,335,7.93,0,39.6,673994,5662,670291,2.81,0.85,0.38487373737373737,0.84,99.45
2022-04-12,Jharkhand,146,2,143,1529,3018,1168,9.55,1,39.6,674140,5664,670434,7.62,2.95,0.03861111111111111,0.84,99.45
2022-04-13,Jharkhand,1205,9,1200,15210,1641,476,7.92,0,39.6,675345,5673,671634,4.14,1.2,0.3840909090909091,0.84,99.45
2022-04-14,Jharkhand,1453,11,1450,17892,3600,2628,8.12,0,39.6,676798,5684,673084,9.09,6.64,0.45181818181818184,0.84,99.45
2022-04-15,Jharkhand,1123,12,1121,14298,1111,109,7.85,0,39.6,677921,5696,674205,2.81,0.28,0.3610606060606061,0.84,99.45
2022-04-16,Jharkhand,848,5,844,10675,181,168,7.94,0,39.6,678769,5701,675049,0.46,0.42,0.26957070707070707,0.84,99.45
2022-04-17,Jharkhand,1161,15,1152,14507,3907,3100,8.0,0,39.6,679930,5716,676201,9.87,7.83,0.36633838383838385,0.84,99.45
2022-04-18,Jharkhand,532,5,532,6631,2126,1635,8.02,0,39.6,680462,5721,676733,5.37,4.13,0.16744949494949496,0.84,99.45
2022-04-19,Jharkhand,1590,18,1587,19801,2090,397,8.03,0,39.6,682052,5739,678320,5.28,1.0,0.5000252525252525,0.84,99.45
2022-04-20,Jharkhand,1118,11,1116,14055,4997,3086,7.95,0,39.6,683170,5750,679436,12.62,7.79,0.3549242424242424,0.84,99.45
2022-04-21,Jharkhand,937,7,931,11453,751,152,8.18,0,39.6,684107,5757,680367,1.9,0.38,0.2892171717171717,0.84,99.45
2022-04-22,Jharkhand,631,8,631,7398,1445,431,8.53,0,39.6,684738,5765,680998,3.65,1.09,0.18681818181818183,0.84,99.45
2022-04-23,Jharkhand,1536,11,1533,19809,1533,100,7.75,0,39.6,686274,5776,682531,3.87,0.25,0.5002272727272727,0.84,99.45
2022-04-24,Jharkhand,1374,19,1365,17389,259,15,7.9,0,39.6,687648,5795,683896,0.65,0.04,0.4391161616161616,0.84,99.45
2022-04-25,Jharkhand,429,5,420,5528,3268,2481,7.76,4,39.6,688077,5800,684316,8.25,6.27,0.1395959595959596,0.84,99.45
2022-04-26,Jharkhand,385,1,380,5006,238,29,7.69,4,39.6,688462,5801,684696,0.6,0.07,0.12641414141414142,0.84,99.45
2022-04-27,Jharkhand,485,3,484,6061,1920,1046,8.0,0,39.6,688947,5804,685180,4.85,2.64,0.15305555555555556,0.84,99.45
2022-04-28,Jharkhand,1516,13,1511,18931,2505,2416,8.01,0,39.6,690463,5817,686691,6.33,6.1,0.47805555555555557,0.84,99.45
2022-04-29,Jharkhand,664,7,663,8633,4974,195,7.69,0,39.6,691127,5824,687354,12.56,0.49,0.2180050505050505,0.84,99.45
2022-04-30,Jharkhand,1505,8,1499,19215,1198,115,7.83,0,39.6,692632,5832,688853,3.03,0.29,0.48522727272727273,0.84,99.45
2022-05-01,Jharkhand,501,6,493,6328,147,21,7.92,2,39.6,693133,5838,689346,0.37,0.05,0.1597979797979798,0.84,99.45
2022-05-02,Jharkhand,1159,12,1154,14660,3348,310,7.91,0,39.6,694292,5850,690500,8.45,0.78,0.3702020202020202,0.84,99.45
2022-05-03,Jharkhand,546,6,544,7044,2520,2045,7.75,0,39.6,694838,5856,691044,6.36,5.16,0.1778787878787879,0.84,99.45
2022-05-04,Jharkhand,882,2,876,11425,667,645,7.72,4,39.6,695720,5858,691920,1.68,1.63,0.288510101010101,0.84,99.45
2022-05-05,Jharkhand,1227,15,1221,15767,1271,569,7.78,0,39.6,696947,5873,693141,3.21,1.44,0.39815656565656565,0.84,99.45
2022-05-06,Jharkhand,799,6,790,9986,3961,2640,8.0,3,39.6,697746,5879,693931,10.0,6.67,0.25217171717171716,0.84,99.45
2022-05-07,Jharkhand,302,3,294,4293,1164,218,7.03,5,39.6,698048,5882,694225,2.94,0.55,0.10840909090909091,0.84,99.45
2022-05-08,Jharkhand,117,1,115,1800,3192,1917,6.5,1,39.6,698165,5883,694340,8.06,4.84,0.045454545454545456,0.84,99.45
2022-05-09,Jharkhand,648,4,641,8492,41,1,7.63,3,39.6,698813,5887,694981,0.1,0.0,0.21444444444444444,0.84,99.45
2022-05-10,Jharkhand,1310,15,1304,16317,2406,2126,8.03,0,39.6,700123,5902,696285,6.08,5.37,0.41204545454545455,0.84,99.45
2022-05-11,Jharkhand,1204,14,1196,14945,2962,2484,8.06,0,39.6,701327,5916,697481,7.48,6.27,0.3773989898989899,0.84,99.45
2022-05-12,Jharkhand,949,12,943,11798,2938,1651,8.04,0,39.6,702276,5928,698424,7.42,4.17,0.29792929292929293,0.84,99.45
2022-05-13,Jharkhand,486,6,478,6275,3158,1718,7.75,2,39.6,702762,5934,698902,7.97,4.34,0.15845959595959597,0.84,99.45
2022-05-14,Jharkhand,1535,16,1526,19395,1642,1361,7.91,0,39.6,704297,5950,700428,4.15,3.44,0.48977272727272725,0.84,99.45
2022-05-15,Jharkhand,329,1,327,4508,3269,2010,7.3,1,39.6,704626,5951,700755,8.26,5.08,0.11383838383838384,0.84,99.45
2022-05-16,Jharkhand,1211,11,1204,15144,4909,2201,8.0,0,39.6,705837,5962,701959,12.4,5.56,0.38242424242424244,0.84,99.45
2022-05-17,Jharkhand,427,1,421,5224,3726,2449,8.17,5,39.6,706264,5963,702380,9.41,6.18,0.1319191919191919,0.84,99.45
2022-05-18,Jharkhand,1337,17,1330,17123,3145,1518,7.81,0,39.6,707601,5980,703710,7.94,3.83,0.4323989898989899,0.85,99.45
2022-05-19,Jharkhand,1400,11,1397,17804,945,181,7.86,0,39.6,709001,5991,705107,2.39,0.46,0.4495959595959596,0.84,99.45
2022-05-20,Jharkhand,719,9,716,8608,3327,2084,8.35,0,39.6,709720,6000,705823,8.4,5.26,0.21737373737373739,0.85,99.45
2022-05-21,Jharkhand,263,1,262,3260,651,377,8.07,0,39.6,709983,6001,706085,1.64,0.95,0.08232323232323233,0.85,99.45
2022-05-22,Jharkhand,356,2,354,4094,4015,3227,8.7,0,39.6,710339,6003,706439,10.14,8.15,0.10338383838383838,0.85,99.45
2022-05-23,Jharkhand,803,8,802,10235,1928,1604,7.85,0,39.6,711142,6011,707241,4.87,4.05,0.25845959595959594,0.85,99.45
2022-05-24,Jharkhand,851,5,850,10112,2218,952,8.42,0,39.6,711993,6016,708091,5.6,2.4,0.25535353535353533,0.84,99.45
2022-05-25,Jharkhand,416,2,415,5203,4840,3416,8.0,0,39.6,712409,6018,708506,12.22,8.63,0.1313888888888889,0.84,99.45
2022-05-26,Jharkhand,128,0,124,1847,2562,740,6.93,4,39.6,712537,6018,708630,6.47,1.87,0.04664141414141414,0.84,99.45
2022-05-27,Jharkhand,566,7,566,7075,4979,280,8.0,0,39.6,713103,6025,709196,12.57,0.71,0.17866161616161616,0.84,99.45
2022-05-28,Jharkhand,1342,8,1336,16720,1519,1463,8.03,0,39.6,714445,6033,710532,3.84,3.69,0.4222222222222222,0.84,99.45
2022-05-29,Jharkhand,1107,4,1107,13818,4645,2981,8.01,0,39.6,715552,6037,711639,11.73,7.53,0.34893939393939394,0.84,99.45
2022-05-30,Jharkhand,154,1,150,1733,2394,221,8.89,3,39.6,715706,6038,711789,6.05,0.56,0.04376262626262626,0.84,99.45
2022-05-31,Jharkhand,650,8,649,8341,143,143,7.79,0,39.6,716356,6046,712438,0.36,0.36,0.21063131313131314,0.84,99.45
2022-06-01,Jharkhand,1472,8,1468,18761,4042,3837,7.85,0,39.6,717828,6054,713906,10.21,9.69,0.4737626262626263,0.84,99.45
2022-06-02,Jharkhand,913,5,910,11089,1534,329,8.23,0,39.6,718741,6059,714816,3.87,0.83,0.2800252525252525,0.84,99.45
2022-06-03,Jharkhand,558,2,551,6852,4866,211,8.14,5,39.6,719299,6061,715367,12.29,0.53,0.17303030303030303,0.84,99.45
2022-06-04,Jharkhand,1241,17,1236,15625,258,110,7.94,0,39.6,720540,6078,716603,0.65,0.28,0.39457070707070707,0.84,99.45
2022-06-05,Jharkhand,436,6,427,5212,2564,524,8.37,3,39.6,720976,6084,717030,6.47,1.32,0.1316161616161616,0.84,99.45
2022-06-06,Jharkhand,1552,5,1547,19483,4907,1724,7.97,0,39.6,722528,6089,718577,12.39,4.35,0.4919949494949495,0.84,99.45
2022-06-07,Jharkhand,283,4,283,3899,3332,1652,7.26,0,39.6,722811,6093,718860,8.41,4.17,0.09845959595959596,0.84,99.45
2022-06-08,Jharkhand,520,7,514,6702,1452,538,7.76,0,39.6,723331,6100,719374,3.67,1.36,0.16924242424242425,0.84,99.45
2022-06-09,Jharkhand,794,3,792,10284,3372,3317,7.72,0,39.6,724125,6103,720166,8.52,8.38,0.2596969696969697,0.84,99.45
2022-06-10,Jharkhand,1083,6,1080,13952,2912,1849,7.76,0,39.6,725208,6109,721246,7.35,4.67,0.3523232323232323,0.84,99.45
2022-06-11,Jharkhand,1602,12,1594,19845,1479,475,8.07,0,39.6,726810,6121,722840,3.73,1.2,0.5011363636363636,0.84,99.45
2022-06-12,Jharkhand,126,0,121,1809,3413,58,6.97,5,39.6,726936,6121,722961,8.62,0.15,0.045681818181818185,0.84,99.45
2022-06-13,Jharkhand,1226,10,1225,14726,4119,2886,8.33,0,39.6,728162,6131,724186,10.4,7.29,0.37186868686868685,0.84,99.45
2022-06-14,Jharkhand,1333,4,1328,16839,29,29,7.92,1,39.6,729495,6135,725514,0.07,0.07,0.42522727272727273,0.84,99.45
2022-06-15,Jharkhand,982,7,974,12381,3749,3126,7.93,1,39.6,730477,6142,726488,9.47,7.89,0.3126515151515151,0.84,99.45
2022-06-16,Jharkhand,398,5,395,4614,775,259,8.63,0,39.6,730875,6147,726883,1.96,0.65,0.11651515151515152,0.84,99.45
2022-06-17,Jharkhand,707,4,702,8999,4272,2554,7.86,1,39.6,731582,6151,727585,10.79,6.45,0.22724747474747475,0.84,99.45
2022-06-18,Jharkhand,591,3,583,7199,1191,17,8.21,5,39.6,732173,6154,728168,3.01,0.04,0.18179292929292928,0.84,99.45
2022-06-19,Jharkhand,968,11,959,11810,1542,1299,8.2,0,39.6,733141,6165,729127,3.89,3.28,0.29823232323232324,0.84,99.45
2022-06-20,Jharkhand,868,5,867,10552,633,1,8.23,0,39.6,734009,6170,729994,1.6,0.0,0.26646464646464646,0.84,99.45
2022-06-21,Jharkhand,1328,4,1321,16623,1728,263,7.99,3,39.6,735337,6174,731315,4.36,0.66,0.4197727272727273,0.84,99.45
2022-06-22,Jharkhand,576,8,573,7381,817,376,7.8,0,39.6,735913,6182,731888,2.06,0.95,0.18638888888888888,0.84,99.45
2022-06-23,Jharkhand,113,0,111,1715,1227,445,6.59,2,39.6,736026,6182,731999,3.1,1.12,0.04330808080808081,0.84,99.45
2022-06-24,Jharkhand,732,5,729,9252,4822,1153,7.91,0,39.6,736758,6187,732728,12.18,2.91,0.23363636363636364,0.84,99.45
2022-06-25,Jharkhand,1471,6,1467,18413,3532,1470,7.99,0,39.6,738229,6193,734195,8.92,3.71,0.4649747474747475,0.84,99.45
2022-06-26,Jharkhand,399,3,391,4918,2000,1692,8.11,5,39.6,738628,6196,734586,5.05,4.27,0.12419191919191919,0.84,99.45
2022-06-27,Jharkhand,750,8,742,9357,3738,749,8.02,0,39.6,739378,6204,735328,9.44,1.89,0.2362878787878788,0.84,99.45
2022-06-28,Jharkhand,568,5,563,7480,4627,4196,7.59,0,39.6,739946,6209,735891,11.68,10.6,0.18888888888888888,0.84,99.45
2022-06-29,Jharkhand,72,0,63,802,2179,1234,8.98,9,39.6,740018,6209,735954,5.5,3.12,0.02025252525252525,0.84,99.45
2022-06-30,Jharkhand,101,1,101,1294,3081,2872,7.81,0,39.6,740119,6210,736055,7.78,7.25,0.03267676767676768,0.84,99.45
2022-07-01,Jharkhand,658,6,657,9019,874,342,7.3,0,39.6,740777,6216,736712,2.21,0.86,0.22775252525252526,0.84,99.45
2022-07-02,Jharkhand,543,7,540,6878,4560,1135,7.89,0,39.6,741320,6223,737252,11.52,2.87,0.1736868686868687,0.84,99.45
2022-07-03,Jharkhand,275,3,267,3210,4345,2568,8.57,5,39.6,741595,6226,737519,10.97,6.48,0.08106060606060606,0.84,99.45
2022-07-04,Jharkhand,957,6,950,11436,2276,100,8.37,1,39.6,742552,6232,738469,5.75,0.25,0.2887878787878788,0.84,99.45
2022-07-05,Jharkhand,924,5,920,11552,4496,1205,8.0,0,39.6,743476,6237,739389,11.35,3.04,0.2917171717171717,0.84,99.45
2022-07-06,Jharkhand,287,2,286,3305,4925,30,8.68,0,39.6,743763,6239,739675,12.44,0.08,0.08345959595959596,0.84,99.45
2022-07-07,Jharkhand,1457,6,1452,17956,4082,137,8.11,0,39.6,745220,6245,741127,10.31,0.35,0.4534343434343434,0.84,99.45
2022-07-08,Jharkhand,377,3,375,4855,1616,754,7.77,0,39.6,745597,6248,741502,4.08,1.9,0.1226010101010101,0.84,99.45
2022-07-09,Jharkhand,468,2,461,6082,1739,854,7.69,5,39.6,746065,6250,741963,4.39,2.16,0.15358585858585858,0.84,99.45
2022-07-10,Jharkhand,1106,8,1105,14169,3583,1143,7.81,0,39.6,747171,6258,743068,9.05,2.89,0.3578030303030303,0.84,99.45
2022-07-11,Jharkhand,1166,6,1166,14636,2043,1888,7.97,0,39.6,748337,6264,744234,5.16,4.77,0.3695959595959596,0.84,99.45
2022-07-12,Jharkhand,1339,16,1338,16966,992,443,7.89,0,39.6,749676,6280,745572,2.51,1.12,0.42843434343434345,0.84,99.45
2022-07-13,Jharkhand,365,2,362,4480,2019,576,8.15,1,39.6,750041,6282,745934,5.1,1.45,0.11313131313131314,0.84,99.45
2022-07-14,Jharkhand,702,6,695,9040,1481,957,7.77,1,39.6,750743,6288,746629,3.74,2.42,0.22828282828282828,0.84,99.45
2022-07-15,Jharkhand,675,6,669,8167,2211,675,8.26,0,39.6,751418,6294,747298,5.58,1.7,0.20623737373737375,0.84,99.45
2022-07-16,Jharkhand,562,5,553,7465,4494,4220,7.53,4,39.6,751980,6299,747851,11.35,10.66,0.18851010101010102,0.84,99.45
2022-07-17,Jharkhand,658,2,651,7807,300,83,8.43,5,39.6,752638,6301,748502,0.76,0.21,0.19714646464646465,0.84,99.45
2022-07-18,Jharkhand,1474,5,1471,18567,2116,289,7.94,0,39.6,754112,6306,749973,5.34,0.73,0.46886363636363637,0.84,99.45
2022-07-19,Jharkhand,201,2,201,2583,2400,845,7.78,0,39.6,754313,6308,750174,6.06,2.13,0.06522727272727273,0.84,99.45
2022-07-20,Jharkhand,1558,22,1550,19458,3225,686,8.01,0,39.6,755871,6330,751724,8.14,1.73,0.4913636363636364,0.84,99.45
2022-07-21,Jharkhand,537,5,534,6597,2034,1388,8.14,0,39.6,756408,6335,752258,5.14,3.51,0.1665909090909091,0.84,99.45
2022-07-22,Jharkhand,1454,13,1454,18052,3605,172,8.05,0,39.6,757862,6348,753712,9.1,0.43,0.45585858585858585,0.84,99.45
2022-07-23,Jharkhand,800,11,796,10082,1560,1278,7.93,0,39.6,758662,6359,754508,3.94,3.23,0.2545959595959596,0.84,99.45
2022-07-24,Jharkhand,1429,20,1425,18361,173,152,7.78,0,39.6,760091,6379,755933,0.44,0.38,0.46366161616161616,0.84,99.45
2022-07-25,Jharkhand,40,0,31,683,307,267,5.86,9,39.6,760131,6379,755964,0.78,0.67,0.017247474747474748,0.84,99.45
2022-07-26,Jharkhand,472,4,468,6327,3134,578,7.46,0,39.6,760603,6383,756432,7.91,1.46,0.15977272727272726,0.84,99.45
2022-07-27,Jharkhand,526,5,522,6446,184,114,8.16,0,39.6,761129,6388,756954,0.46,0.29,0.16277777777777777,0.84,99.45
2022-07-28,Jharkhand,392,4,385,4883,2517,1068,8.03,3,39.6,761521,6392,757339,6.36,2.7,0.12330808080808081,0.84,99.45
2022-07-29,Jharkhand,1495,15,1491,18560,928,780,8.05,0,39.6,763016,6407,758830,2.34,1.97,0.4686868686868687,0.84,99.45
2022-07-30,Jharkhand,631,7,631,8164,3608,1525,7.73,0,39.6,763647,6414,759461,9.11,3.85,0.20616161616161616,0.84,99.45
2022-07-31,Jharkhand,305,3,301,3774,256,160,8.08,1,39.6,763952,6417,759762,0.65,0.4,0.0953030303030303,0.84,99.45
2022-08-01,Jharkhand,276,4,273,3545,2563,643,7.79,0,39.6,764228,6421,760035,6.47,1.62,0.08952020202020201,0.84,99.45
2022-08-02,Jharkhand,1131,7,1131,14920,1328,330,7.58,0,39.6,765359,6428,761166,3.35,0.83,0.37676767676767675,0.84,99.45
2022-08-03,Jharkhand,1260,6,1255,15849,1948,541,7.95,0,39.6,766619,6434,762421,4.92,1.37,0.4002272727272727,0.84,99.45
2022-08-04,Jharkhand,1068,3,1060,13662,3844,424,7.82,5,39.6,767687,6437,763481,9.71,1.07,0.345,0.84,99.45
2022-08-05,Jharkhand,61,0,52,1008,3154,2950,6.05,9,39.6,767748,6437,763533,7.96,7.45,0.025454545454545455,0.84,99.45
2022-08-06,Jharkhand,729,4,727,9217,1399,629,7.91,0,39.6,768477,6441,764260,3.53,1.59,0.23275252525252527,0.84,99.45
2022-08-07,Jharkhand,1162,10,1155,14521,655,645,8.0,0,39.6,769639,6451,765415,1.65,1.63,0.3666919191919192,0.84,99.45
2022-08-08,Jharkhand,707,9,700,9074,4138,3398,7.79,0,39.6,770346,6460,766115,10.45,8.58,0.22914141414141415,0.84,99.45
2022-08-09,Jharkhand,105,0,96,1722,415,29,6.1,9,39.6,770451,6460,766211,1.05,0.07,0.04348484848484849,0.84,99.45
2022-08-10,Jharkhand,1519,16,1514,18986,701,617,8.0,0,39.6,771970,6476,767725,1.77,1.56,0.47944444444444445,0.84,99.45
2022-08-11,Jharkhand,451,1,450,5639,1978,1115,8.0,0,39.6,772421,6477,768175,4.99,2.82,0.1423989898989899,0.84,99.45
2022-08-12,Jharkhand,1290,4,1283,16223,3054,2079,7.95,3,39.6,773711,6481,769458,7.71,5.25,0.4096717171717172,0.84,99.45
2022-08-13,Jharkhand,941,10,940,11506,766,533,8.18,0,39.6,774652,6491,770398,1.93,1.35,0.29055555555555557,0.84,99.45
2022-08-14,Jharkhand,1464,19,1458,18382,4460,1091,7.96,0,39.6,776116,6510,771856,11.26,2.76,0.4641919191919192,0.84,99.45
2022-08-15,Jharkhand,1538,9,1536,19444,4015,1374,7.91,0,39.6,777654,6519,773392,10.14,3.47,0.491010101010101,0.84,99.45
2022-08-16,Jharkhand,743,5,738,9064,1392,933,8.2,0,39.6,778397,6524,774130,3.52,2.36,0.2288888888888889,0.84,99.45
2022-08-17,Jharkhand,1241,14,1239,15493,420,68,8.01,0,39.6,779638,6538,775369,1.06,0.17,0.3912373737373737,0.84,99.45
2022-08-18,Jharkhand,1519,8,1517,18876,3578,907,8.05,0,39.6,781157,6546,776886,9.04,2.29,0.4766666666666667,0.84,99.45
2022-08-19,Jharkhand,806,3,800,9817,2207,1420,8.21,3,39.6,781963,6549,777686,5.57,3.59,0.2479040404040404,0.84,99.45
2022-08-20,Jharkhand,1091,5,1088,13061,2810,1060,8.35,0,39.6,783054,6554,778774,7.1,2.68,0.3298232323232323,0.84,99.45
2022-08-21,Jharkhand,495,1,491,6207,3373,937,7.97,3,39.6,783549,6555,779265,8.52,2.37,0.15674242424242424,0.84,99.45
2022-08-22,Jharkhand,754,9,747,9165,3776,562,8.23,0,39.6,784303,6564,780012,9.54,1.42,0.23143939393939394,0.84,99.45
2022-08-23,Jharkhand,649,7,643,8575,35,4,7.57,0,39.6,784952,6571,780655,0.09,0.01,0.21654040404040403,0.84,99.45
2022-08-24,Jharkhand,868,4,860,10982,3384,2525,7.9,4,39.6,785820,6575,781515,8.55,6.38,0.2773232323232323,0.84,99.45
2022-08-25,Jharkhand,299,3,299,3909,28,13,7.65,0,39.6,786119,6578,781814,0.07,0.03,0.09871212121212121,0.84,99.45
2022-08-26,Jharkhand,835,11,833,10366,4773,1677,8.06,0,39.6,786954,6589,782647,12.05,4.23,0.26176767676767676,0.84,99.45
2022-08-27,Jharkhand,1466,11,1457,18304,523,316,8.01,0,39.6,788420,6600,784104,1.32,0.8,0.4622222222222222,0.84,99.45
2022-08-28,Jharkhand,343,4,343,3986,2104,254,8.61,0,39.6,788763,6604,784447,5.31,0.64,0.10065656565656565,0.84,99.45
2022-08-29,Jharkhand,995,4,992,12431,3847,1931,8.0,0,39.6,789758,6608,785439,9.71,4.88,0.3139141414141414,0.84,99.45
2022-08-30,Jharkhand,363,1,357,3980,3525,1432,9.12,5,39.6,790121,6609,785796,8.9,3.62,0.1005050505050505,0.84,99.45
2022-08-31,Jharkhand,686,9,686,8572,25,21,8.0,0,39.6,790807,6618,786482,0.06,0.05,0.21646464646464647,0.84,99.45
2022-09-01,Jharkhand,47,0,44,522,4765,4057,9.0,3,39.6,790854,6618,786526,12.03,10.24,0.013181818181818182,0.84,99.45
2022-09-02,Jharkhand,1414,5,1408,18114,3829,1917,7.81,1,39.6,792268,6623,787934,9.67,4.84,0.4574242424242424,0.84,99.45
2022-09-03,Jharkhand,361,3,360,4271,1188,1051,8.45,0,39.6,792629,6626,788294,3.0,2.65,0.10785353535353535,0.84,99.45
2022-09-04,Jharkhand,273,1,269,3608,680,83,7.57,3,39.6,792902,6627,788563,1.72,0.21,0.09111111111111111,0.84,99.45
2022-09-05,Jharkhand,1256,8,1247,16203,2356,2167,7.75,1,39.6,794158,6635,789810,5.95,5.47,0.4091666666666667,0.84,99.45
2022-09-06,Jharkhand,725,4,724,8943,4640,295,8.11,0,39.6,794883,6639,790534,11.72,0.74,0.22583333333333333,0.84,99.45
2022-09-07,Jharkhand,1047,4,1046,13104,1085,364,7.99,0,39.6,795930,6643,791580,2.74,0.92,0.33090909090909093,0.83,99.45
2022-09-08,Jharkhand,92,0,88,997,4023,3459,9.23,4,39.6,796022,6643,791668,10.16,8.73,0.025176767676767676,0.83,99.45
2022-09-09,Jharkhand,783,10,777,9805,2282,105,7.99,0,39.6,796805,6653,792445,5.76,0.27,0.2476010101010101,0.83,99.45
2022-09-10,Jharkhand,770,3,763,9693,2863,2217,7.94,4,39.6,797575,6656,793208,7.23,5.6,0.24477272727272728,0.83,99.45
2022-09-11,Jharkhand,75,0,68,1279,2080,1793,5.86,7,39.6,797650,6656,793276,5.25,4.53,0.0322979797979798,0.83,99.45
2022-09-12,Jharkhand,1018,9,1010,12796,1825,614,7.96,0,39.6,798668,6665,794286,4.61,1.55,0.32313131313131316,0.83,99.45
2022-09-13,Jharkhand,165,2,164,2010,2691,2011,8.21,0,39.6,798833,6667,794450,6.8,5.08,0.05075757575757576,0.83,99.45
2022-09-14,Jharkhand,1140,8,1134,14739,4299,2969,7.73,0,39.6,799973,6675,795584,10.86,7.5,0.3721969696969697,0.83,99.45
2022-09-15,Jharkhand,1429,20,1424,18217,4995,652,7.84,0,39.6,801402,6695,797008,12.61,1.65,0.4600252525252525,0.84,99.45
2022-09-16,Jharkhand,247,1,244,2959,431,120,8.35,2,39.6,801649,6696,797252,1.09,0.3,0.07472222222222222,0.84,99.45
2022-09-17,Jharkhand,1092,9,1085,13183,1892,257,8.28,0,39.6,802741,6705,798337,4.78,0.65,0.3329040404040404,0.84,99.45
2022-09-18,Jharkhand,265,3,260,3247,4174,3450,8.16,2,39.6,803006,6708,798597,10.54,8.71,0.0819949494949495,0.84,99.45
2022-09-19,Jharkhand,1497,21,1495,18950,1051,924,7.9,0,39.6,804503,6729,800092,2.65,2.33,0.47853535353535354,0.84,99.45
2022-09-20,Jharkhand,762,10,761,9774,1785,694,7.8,0,39.6,805265,6739,800853,4.51,1.75,0.24681818181818183,0.84,99.45
2022-09-21,Jharkhand,1438,14,1435,18069,3798,706,7.96,0,39.6,806703,6753,802288,9.59,1.78,0.4562878787878788,0.84,99.45
2022-09-22,Jharkhand,1303,8,1301,15832,3842,2705,8.23,0,39.6,808006,6761,803589,9.7,6.83,0.3997979797979798,0.84,99.45
2022-09-23,Jharkhand,181,2,173,1978,4825,1776,9.15,6,39.6,808187,6763,803762,12.18,4.48,0.04994949494949495,0.84,99.45
2022-09-24,Jharkhand,1165,7,1161,14613,3487,2212,7.97,0,39.6,809352,6770,804923,8.81,5.59,0.3690151515151515,0.84,99.45
2022-09-25,Jharkhand,1347,17,1342,17330,462,369,7.77,0,39.6,810699,6787,806265,1.17,0.93,0.43762626262626264,0.84,99.45
2022-09-26,Jharkhand,145,1,143,1495,2236,255,9.7,1,39.6,810844,6788,806408,5.65,0.64,0.03775252525252525,0.84,99.45
2022-09-27,Jharkhand,458,4,452,5847,1544,444,7.83,2,39.6,811302,6792,806860,3.9,1.12,0.14765151515151514,0.84,99.45
2022-09-28,Jharkhand,88,1,85,722,3279,2911,12.19,2,39.6,811390,6793,806945,8.28,7.35,0.018232323232323232,0.84,99.45
2022-09-29,Jharkhand,1352,11,1352,16702,1039,699,8.09,0,39.6,812742,6804,808297,2.62,1.77,0.4217676767676768,0.84,99.45
2022-09-30,Jharkhand,1134,5,1130,14407,2706,1861,7.87,0,39.6,813876,6809,809427,6.83,4.7,0.3638131313131313,0.84,99.45
2022-10-01,Jharkhand,1077,15,1077,13699,1149,908,7.86,0,39.6,814953,6824,810504,2.9,2.29,0.3459343434343434,0.84,99.45
2022-10-02,Jharkhand,94,1,94,1251,2554,1239,7.51,0,39.6,815047,6825,810598,6.45,3.13,0.03159090909090909,0.84,99.45
2022-10-03,Jharkhand,223,2,222,3171,3966,3752,7.03,0,39.6,815270,6827,810820,10.02,9.47,0.08007575757575758,0.84,99.45
2022-10-04,Jharkhand,329,2,327,4540,1,1,7.25,0,39.6,815599,6829,811147,0.0,0.0,0.11464646464646465,0.84,99.45
2022-10-05,Jharkhand,123,1,122,1570,1386,898,7.83,0,39.6,815722,6830,811269,3.5,2.27,0.039646464646464645,0.84,99.45
2022-10-06,Jharkhand,1078,10,1072,13604,1407,1247,7.92,0,39.6,816800,6840,812341,3.55,3.15,0.3435353535353535,0.84,99.45
2022-10-07,Jharkhand,399,5,392,4604,1654,350,8.67,2,39.6,817199,6845,812733,4.18,0.88,0.11626262626262626,0.84,99.45
2022-10-08,Jharkhand,1489,15,1482,18415,1123,625,8.09,0,39.6,818688,6860,814215,2.84,1.58,0.4650252525252525,0.84,99.45
2022-10-09,Jharkhand,521,2,514,6277,4878,2867,8.3,5,39.6,819209,6862,814729,12.32,7.24,0.15851010101010102,0.84,99.45
2022-10-10,Jharkhand,1359,7,1357,17002,2588,2460,7.99,0,39.6,820568,6869,816086,6.54,6.21,0.42934343434343436,0.84,99.45
2022-10-11,Jharkhand,549,4,543,6713,4718,281,8.18,2,39.6,821117,6873,816629,11.91,0.71,0.16952020202020202,0.84,99.45
2022-10-12,Jharkhand,1084,13,1076,13850,3934,2490,7.83,0,39.6,822201,6886,817705,9.93,6.29,0.34974747474747475,0.84,99.45
2022-10-13,Jharkhand,758,3,756,9188,1762,937,8.25,0,39.6,822959,6889,818461,4.45,2.37,0.23202020202020202,0.84,99.45
2022-10-14,Jharkhand,329,3,321,4235,857,220,7.77,5,39.6,823288,6892,818782,2.16,0.56,0.10694444444444444,0.84,99.45
2022-10-15,Jharkhand,1163,13,1157,14474,247,225,8.04,0,39.6,824451,6905,819939,0.62,0.57,0.3655050505050505,0.84,99.45
2022-10-16,Jharkhand,520,6,511,5879,2562,333,8.85,3,39.6,824971,6911,820450,6.47,0.84,0.14845959595959596,0.84,99.45
2022-10-17,Jharkhand,994,4,993,12086,1757,1506,8.22,0,39.6,825965,6915,821443,4.44,3.8,0.3052020202020202,0.84,99.45
2022-10-18,Jharkhand,117,0,108,2008,2891,1652,5.83,9,39.6,826082,6915,821551,7.3,4.17,0.05070707070707071,0.84,99.45
2022-10-19,Jharkhand,964,8,964,12102,2029,1581,7.97,0,39.6,827046,6923,822515,5.12,3.99,0.3056060606060606,0.84,99.45
2022-10-20,Jharkhand,425,5,421,5170,4996,901,8.22,0,39.6,827471,6928,822936,12.62,2.28,0.13055555555555556,0.84,99.45
2022-10-21,Jharkhand,976,10,974,12112,3885,3303,8.06,0,39.6,828447,6938,823910,9.81,8.34,0.3058585858585859,0.84,99.45
2022-10-22,Jharkhand,933,6,929,11506,3679,3593,8.11,0,39.6,829380,6944,824839,9.29,9.07,0.29055555555555557,0.84,99.45
2022-10-23,Jharkhand,678,4,676,7931,1692,800,8.55,0,39.6,830058,6948,825515,4.27,2.02,0.20027777777777778,0.84,99.45
2022-10-24,Jharkhand,1316,18,1312,16667,3731,3279,7.9,0,39.6,831374,6966,826827,9.42,8.28,0.42088383838383836,0.84,99.45
2022-10-25,Jharkhand,757,4,748,9322,4880,929,8.12,5,39.6,832131,6970,827575,12.32,2.35,0.2354040404040404,0.84,99.45
2022-10-26,Jharkhand,388,3,388,5131,2677,2286,7.56,0,39.6,832519,6973,827963,6.76,5.77,0.12957070707070706,0.84,99.45
2022-10-27,Jharkhand,1142,9,1141,14282,2581,1551,8.0,0,39.6,833661,6982,829104,6.52,3.92,0.3606565656565657,0.84,99.45
2022-10-28,Jharkhand,1180,14,1180,14251,22,0,8.28,0,39.6,834841,6996,830284,0.06,0.0,0.3598737373737374,0.84,99.45
2022-10-29,Jharkhand,1421,20,1419,17903,904,590,7.94,0,39.6,836262,7016,831703,2.28,1.49,0.4520959595959596,0.84,99.45
2022-10-30,Jharkhand,469,1,465,6119,4186,1589,7.66,3,39.6,836731,7017,832168,10.57,4.01,0.15452020202020203,0.84,99.45
2022-10-31,Jharkhand,340,4,335,4618,4820,4378,7.36,1,39.6,837071,7021,832503,12.17,11.06,0.11661616161616162,0.84,99.45
2022-11-01,Jharkhand,1001,13,1000,12609,4111,1557,7.94,0,39.6,838072,7034,833503,10.38,3.93,0.3184090909090909,0.84,99.45
2022-11-02,Jharkhand,107,1,106,1205,2131,706,8.88,0,39.6,838179,7035,833609,5.38,1.78,0.03042929292929293,0.84,99.45
2022-11-03,Jharkhand,359,5,357,4418,3388,452,8.13,0,39.6,838538,7040,833966,8.56,1.14,0.11156565656565656,0.84,99.45
2022-11-04,Jharkhand,304,2,301,3899,714,308,7.8,1,39.6,838842,7042,834267,1.8,0.78,0.09845959595959596,0.84,99.45
2022-11-05,Jharkhand,1314,15,1306,16550,453,70,7.94,0,39.6,840156,7057,835573,1.14,0.18,0.41792929292929293,0.84,99.45
2022-11-06,Jharkhand,701,2,700,8765,1836,1354,8.0,0,39.6,840857,7059,836273,4.64,3.42,0.22133838383838383,0.84,99.45
2022-11-07,Jharkhand,1299,9,1291,16083,4673,2430,8.08,0,39.6,842156,7068,837564,11.8,6.14,0.40613636363636363,0.84,99.45
2022-11-08,Jharkhand,1314,18,1308,16263,2759,2258,8.08,0,39.6,843470,7086,838872,6.97,5.7,0.4106818181818182,0.84,99.45
2022-11-09,Jharkhand,314,3,312,3782,2951,2061,8.3,0,39.6,843784,7089,839184,7.45,5.2,0.09550505050505051,0.84,99.45
2022-11-10,Jharkhand,1372,14,1363,17191,4055,3569,7.98,0,39.6,845156,7103,840547,10.24,9.01,0.4341161616161616,0.84,99.45
2022-11-11,Jharkhand,638,9,631,8223,3571,3476,7.76,0,39.6,845794,7112,841178,9.02,8.78,0.20765151515151514,0.84,99.45
2022-11-12,Jharkhand,691,3,685,8519,176,111,8.11,3,39.6,846485,7115,841863,0.44,0.28,0.21512626262626264,0.84,99.45
2022-11-13,Jharkhand,175,1,167,2263,589,218,7.73,7,39.6,846660,7116,842030,1.49,0.55,0.05714646464646465,0.84,99.45
2022-11-14,Jharkhand,545,5,538,6965,743,72,7.82,2,39.6,847205,7121,842568,1.88,0.18,0.1758838383838384,0.84,99.45
2022-11-15,Jharkhand,1567,19,1562,19329,4382,4297,8.11,0,39.6,848772,7140,844130,11.07,10.85,0.4881060606060606,0.84,99.45
2022-11-16,Jharkhand,828,11,822,10613,3536,221,7.8,0,39.6,849600,7151,844952,8.93,0.56,0.2680050505050505,0.84,99.45
2022-11-17,Jharkhand,654,6,651,8044,380,306,8.13,0,39.6,850254,7157,845603,0.96,0.77,0.20313131313131313,0.84,99.45
2022-11-18,Jharkhand,1399,16,1396,17507,2519,1946,7.99,0,39.6,851653,7173,846999,6.36,4.91,0.4420959595959596,0.84,99.45
2022-11-19,Jharkhand,167,1,162,2043,4303,3989,8.17,4,39.6,851820,7174,847161,10.87,10.07,0.05159090909090909,0.84,99.45
2022-11-20,Jharkhand,1052,14,1052,12982,3374,638,8.1,0,39.6,852872,7188,848213,8.52,1.61,0.3278282828282828,0.84,99.45
2022-11-21,Jharkhand,1099,14,1090,13671,2659,2427,8.04,0,39.6,853971,7202,849303,6.71,6.13,0.3452272727272727,0.84,99.45
2022-11-22,Jharkhand,156,1,148,1804,4222,1786,8.65,7,39.6,854127,7203,849451,10.66,4.51,0.04555555555555556,0.84,99.45
2022-11-23,Jharkhand,277,1,269,3629,3062,973,7.63,7,39.6,854404,7204,849720,7.73,2.46,0.09164141414141413,0.84,99.45
2022-11-24,Jharkhand,1064,9,1058,13244,2411,548,8.03,0,39.6,855468,7213,850778,6.09,1.38,0.33444444444444443,0.84,99.45
2022-11-25,Jharkhand,1345,14,1343,17055,3481,1808,7.89,0,39.6,856813,7227,852121,8.79,4.57,0.43068181818181817,0.84,99.45
2022-11-26,Jharkhand,1074,6,1070,13246,91,0,8.11,0,39.6,857887,7233,853191,0.23,0.0,0.3344949494949495,0.84,99.45
2022-11-27,Jharkhand,297,2,290,3622,55,50,8.2,5,39.6,858184,7235,853481,0.14,0.13,0.09146464646464647,0.84,99.45
2022-11-28,Jharkhand,163,1,160,1882,3795,1052,8.66,2,39.6,858347,7236,853641,9.58,2.66,0.047525252525252526,0.84,99.45
2022-11-29,Jharkhand,796,7,788,9957,3514,978,7.99,1,39.6,859143,7243,854429,8.87,2.47,0.25143939393939396,0.84,99.45
2022-11-30,Jharkhand,1376,11,1370,17375,3549,2238,7.92,0,39.6,860519,7254,855799,8.96,5.65,0.43876262626262624,0.84,99.45
2022-12-01,Jharkhand,299,2,291,3260,2460,885,9.17,6,39.6,860818,7256,856090,6.21,2.23,0.08232323232323233,0.84,99.45
2022-12-02,Jharkhand,1304,4,1296,16020,4961,1922,8.14,4,39.6,862122,7260,857386,12.53,4.85,0.40454545454545454,0.84,99.45
2022-12-03,Jharkhand,1111,13,1110,14145,3602,2786,7.85,0,39.6,863233,7273,858496,9.1,7.04,0.3571969696969697,0.84,99.45
2022-12-04,Jharkhand,1281,14,1275,16050,2095,724,7.98,0,39.6,864514,7287,859771,5.29,1.83,0.4053030303030303,0.84,99.45
2022-12-05,Jharkhand,62,0,61,1000,2706,2030,6.2,1,39.6,864576,7287,859832,6.83,5.13,0.025252525252525252,0.84,99.45
2022-12-06,Jharkhand,1304,14,1299,16067,3557,762,8.12,0,39.6,865880,7301,861131,8.98,1.92,0.4057323232323232,0.84,99.45
2022-12-07,Jharkhand,1175,10,1173,14559,4983,1099,8.07,0,39.6,867055,7311,862304,12.58,2.78,0.3676515151515152,0.84,99.45
2022-12-08,Jharkhand,1238,18,1232,15200,4918,2597,8.14,0,39.6,868293,7329,863536,12.42,6.56,0.3838383838383838,0.84,99.45
2022-12-09,Jharkhand,339,4,335,4446,1453,1339,7.62,0,39.6,868632,7333,863871,3.67,3.38,0.11227272727272727,0.84,99.45
2022-12-10,Jharkhand,1120,4,1116,13543,2499,478,8.27,0,39.6,869752,7337,864987,6.31,1.21,0.3419949494949495,0.84,99.45
2022-12-11,Jharkhand,1008,11,1007,12527,701,501,8.05,0,39.6,870760,7348,865994,1.77,1.27,0.31633838383838386,0.84,99.45
2022-12-12,Jharkhand,731,2,728,9160,4976,1898,7.98,1,39.6,871491,7350,866722,12.57,4.79,0.2313131313131313,0.84,99.45
2022-12-13,Jharkhand,85,1,78,1438,1789,1062,5.91,6,39.6,871576,7351,866800,4.52,2.68,0.03631313131313131,0.84,99.45
2022-12-14,Jharkhand,1297,7,1297,15741,3788,3326,8.24,0,39.6,872873,7358,868097,9.57,8.4,0.3975,0.84,99.45
2022-12-15,Jharkhand,620,5,620,7954,386,106,7.79,0,39.6,873493,7363,868717,0.97,0.27,0.20085858585858585,0.84,99.45
2022-12-16,Jharkhand,1380,11,1376,17196,2297,206,8.03,0,39.6,874873,7374,870093,5.8,0.52,0.43424242424242426,0.84,99.45
2022-12-17,Jharkhand,370,2,366,4901,4430,3034,7.55,2,39.6,875243,7376,870459,11.19,7.66,0.12376262626262627,0.84,99.45
2022-12-18,Jharkhand,426,1,417,5470,1948,585,7.79,8,39.6,875669,7377,870876,4.92,1.48,0.13813131313131313,0.84,99.45
2022-12-19,Jharkhand,193,1,193,2439,499,450,7.91,0,39.6,875862,7378,871069,1.26,1.14,0.06159090909090909,0.84,99.45
2022-12-20,Jharkhand,1255,11,1249,15715,530,305,7.99,0,39.6,877117,7389,872318,1.34,0.77,0.39684343434343433,0.84,99.45
2022-12-21,Jharkhand,705,4,702,8620,4983,899,8.18,0,39.6,877822,7393,873020,12.58,2.27,0.21767676767676766,0.84,99.45
2022-12-22,Jharkhand,1071,12,1064,13239,600,38,8.09,0,39.6,878893,7405,874084,1.52,0.1,0.3343181818181818,0.84,99.45
2022-12-23,Jharkhand,1420,17,1417,17846,1528,1388,7.96,0,39.6,880313,7422,875501,3.86,3.51,0.45065656565656564,0.84,99.45
2022-12-24,Jharkhand,1366,17,1364,17457,1193,526,7.82,0,39.6,881679,7439,876865,3.01,1.33,0.44083333333333335,0.84,99.45
2022-12-25,Jharkhand,302,1,300,3573,1824,1020,8.45,1,39.6,881981,7440,877165,4.61,2.58,0.09022727272727273,0.84,99.45
2022-12-26,Jharkhand,1183,10,1176,14679,2482,2176,8.06,0,39.6,883164,7450,878341,6.27,5.49,0.37068181818181817,0.84,99.45
2022-12-27,Jharkhand,262,1,255,3342,2994,1894,7.84,6,39.6,883426,7451,878596,7.56,4.78,0.0843939393939394,0.84,99.45
2022-12-28,Jharkhand,422,5,415,5202,1554,1146,8.11,2,39.6,883848,7456,879011,3.92,2.89,0.13136363636363638,0.84,99.45
2022-12-29,Jharkhand,506,2,503,6190,4529,2718,8.17,1,39.6,884354,7458,879514,11.44,6.86,0.15631313131313132,0.84,99.45
2022-12-30,Jharkhand,617,2,612,7879,3886,2867,7.83,3,39.6,884971,7460,880126,9.81,7.24,0.19896464646464646,0.84,99.45
2022-12-31,Jharkhand,128,0,119,1409,2527,2011,9.08,9,39.6,885099,7460,880245,6.38,5.08,0.03558080808080808,0.84,99.45
2020-01-01,Karnataka,1111,15,1103,13781,3221,1093,8.06,0,68.4,1111,15,1103,4.71,1.6,0.2014766081871345,1.35,99.28
2020-01-02,Karnataka,1082,8,1076,13682,4575,106,7.91,0,68.4,2193,23,2179,6.69,0.15,0.20002923976608186,1.05,99.36
2020-01-03,Karnataka,937,9,935,11461,3138,30,8.18,0,68.4,3130,32,3114,4.59,0.04,0.16755847953216374,1.02,99.49
2020-01-04,Karnataka,125,1,124,1319,4939,3903,9.48,0,68.4,3255,33,3238,7.22,5.71,0.019283625730994153,1.01,99.48
2020-01-05,Karnataka,1346,15,1345,16967,3827,3184,7.93,0,68.4,4601,48,4583,5.6,4.65,0.24805555555555556,1.04,99.61
2020-01-06,Karnataka,1549,17,1546,18965,867,305,8.17,0,68.4,6150,65,6129,1.27,0.45,0.27726608187134505,1.06,99.66
2020-01-07,Karnataka,1073,6,1064,13616,2240,925,7.88,3,68.4,7223,71,7193,3.27,1.35,0.1990643274853801,0.98,99.58
2020-01-08,Karnataka,674,6,666,8303,1700,927,8.12,2,68.4,7897,77,7859,2.49,1.36,0.1213888888888889,0.98,99.52
2020-01-09,Karnataka,699,6,694,8772,2458,219,7.97,0,68.4,8596,83,8553,3.59,0.32,0.12824561403508772,0.97,99.5
2020-01-10,Karnataka,571,7,566,6993,3397,2043,8.17,0,68.4,9167,90,9119,4.97,2.99,0.10223684210526315,0.98,99.48
2020-01-11,Karnataka,755,5,754,9387,297,27,8.04,0,68.4,9922,95,9873,0.43,0.04,0.13723684210526316,0.96,99.51
2020-01-12,Karnataka,1155,5,1147,14355,1632,229,8.05,3,68.4,11077,100,11020,2.39,0.33,0.20986842105263157,0.9,99.49
2020-01-13,Karnataka,620,3,617,8162,454,233,7.6,0,68.4,11697,103,11637,0.66,0.34,0.11932748538011696,0.88,99.49
2020-01-14,Karnataka,470,2,461,5845,2810,516,8.04,7,68.4,12167,105,12098,4.11,0.75,0.085453216374269,0.86,99.43
2020-01-15,Karnataka,219,2,216,2590,3014,1086,8.46,1,68.4,12386,107,12314,4.41,1.59,0.037865497076023394,0.86,99.42
2020-01-16,Karnataka,273,2,271,3412,1665,1204,8.0,0,68.4,12659,109,12585,2.43,1.76,0.049883040935672515,0.86,99.42
2020-01-17,Karnataka,957,9,954,12240,4008,1904,7.82,0,68.4,13616,118,13539,5.86,2.78,0.17894736842105263,0.87,99.43
2020-01-18,Karnataka,1541,10,1534,19195,4082,0,8.03,0,68.4,15157,128,15073,5.97,0.0,0.2806286549707602,0.84,99.45
2020-01-19,Karnataka,1543,17,1542,19404,3155,1362,7.95,0,68.4,16700,145,16615,4.61,1.99,0.2836842105263158,0.87,99.49
2020-01-20,Karnataka,679,9,674,8172,1387,1120,8.31,0,68.4,17379,154,17289,2.03,1.64,0.11947368421052632,0.89,99.48
2020-01-21,Karnataka,1471,13,1462,18534,4307,3106,7.94,0,68.4,18850,167,18751,6.3,4.54,0.27096491228070174,0.89,99.47
2020-01-22,Karnataka,721,7,714,8525,1161,185,8.46,0,68.4,19571,174,19465,1.7,0.27,0.12463450292397661,0.89,99.46
2020-01-23,Karnataka,1523,8,1516,19407,4416,1409,7.85,0,68.4,21094,182,20981,6.46,2.06,0.2837280701754386,0.86,99.46
2020-01-24,Karnataka,1057,5,1050,12997,4778,1090,8.13,2,68.4,22151,187,22031,6.99,1.59,0.19001461988304094,0.84,99.46
2020-01-25,Karnataka,1576,12,1576,19293,3998,741,8.17,0,68.4,23727,199,23607,5.85,1.08,0.28206140350877196,0.84,99.49
2020-01-26,Karnataka,1605,23,1601,19784,4178,3550,8.11,0,68.4,25332,222,25208,6.11,5.19,0.28923976608187135,0.88,99.51
2020-01-27,Karnataka,567,6,560,7037,1881,608,8.06,1,68.4,25899,228,25768,2.75,0.89,0.10288011695906432,0.88,99.49
2020-01-28,Karnataka,189,2,183,2341,3187,1515,8.07,4,68.4,26088,230,25951,4.66,2.21,0.03422514619883041,0.88,99.47
2020-01-29,Karnataka,1006,3,1002,12639,4786,407,7.96,1,68.4,27094,233,26953,7.0,0.6,0.18478070175438596,0.86,99.48
2020-01-30,Karnataka,840,10,833,10999,414,81,7.64,0,68.4,27934,243,27786,0.61,0.12,0.16080409356725145,0.87,99.47
2020-01-31,Karnataka,1381,18,1379,17444,2130,1342,7.92,0,68.4,29315,261,29165,3.11,1.96,0.2550292397660819,0.89,99.49
2020-02-01,Karnataka,1261,18,1252,15458,4844,4518,8.16,0,68.4,30576,279,30417,7.08,6.61,0.22599415204678364,0.91,99.48
2020-02-02,Karnataka,577,6,572,7100,3052,1967,8.13,0,68.4,31153,285,30989,4.46,2.88,0.10380116959064327,0.91,99.47
2020-02-03,Karnataka,951,4,943,12033,4866,3529,7.9,4,68.4,32104,289,31932,7.11,5.16,0.17592105263157895,0.9,99.46
2020-02-04,Karnataka,472,5,471,5922,1677,344,7.97,0,68.4,32576,294,32403,2.45,0.5,0.08657894736842105,0.9,99.47
2020-02-05,Karnataka,224,2,218,2867,1084,171,7.81,4,68.4,32800,296,32621,1.58,0.25,0.04191520467836257,0.9,99.45
2020-02-06,Karnataka,670,2,668,8247,30,9,8.12,0,68.4,33470,298,33289,0.04,0.01,0.1205701754385965,0.89,99.46
2020-02-07,Karnataka,1012,5,1008,13122,4620,3767,7.71,0,68.4,34482,303,34297,6.75,5.51,0.1918421052631579,0.88,99.46
2020-02-08,Karnataka,544,6,538,7006,3888,710,7.76,0,68.4,35026,309,34835,5.68,1.04,0.10242690058479532,0.88,99.45
2020-02-09,Karnataka,949,3,949,11971,1450,355,7.93,0,68.4,35975,312,35784,2.12,0.52,0.17501461988304093,0.87,99.47
2020-02-10,Karnataka,743,4,737,9479,4151,1110,7.84,2,68.4,36718,316,36521,6.07,1.62,0.13858187134502925,0.86,99.46
2020-02-11,Karnataka,1027,8,1018,12438,1161,915,8.26,1,68.4,37745,324,37539,1.7,1.34,0.1818421052631579,0.86,99.45
2020-02-12,Karnataka,840,4,839,10665,3564,933,7.88,0,68.4,38585,328,38378,5.21,1.36,0.15592105263157896,0.85,99.46
2020-02-13,Karnataka,197,2,191,2074,2469,598,9.5,4,68.4,38782,330,38569,3.61,0.87,0.030321637426900586,0.85,99.45
2020-02-14,Karnataka,356,3,355,4607,3194,1356,7.73,0,68.4,39138,333,38924,4.67,1.98,0.06735380116959064,0.85,99.45
2020-02-15,Karnataka,693,7,684,8481,1649,137,8.17,2,68.4,39831,340,39608,2.41,0.2,0.12399122807017544,0.85,99.44
2020-02-16,Karnataka,1178,4,1178,15004,1324,501,7.85,0,68.4,41009,344,40786,1.94,0.73,0.21935672514619883,0.84,99.46
2020-02-17,Karnataka,19,0,19,561,4204,839,3.39,0,68.4,41028,344,40805,6.15,1.23,0.008201754385964913,0.84,99.46
2020-02-18,Karnataka,1335,7,1333,16562,1948,1161,8.06,0,68.4,42363,351,42138,2.85,1.7,0.24213450292397662,0.83,99.47
2020-02-19,Karnataka,1408,10,1402,17493,671,515,8.05,0,68.4,43771,361,43540,0.98,0.75,0.2557456140350877,0.82,99.47
2020-02-20,Karnataka,149,2,140,1869,2599,982,7.97,7,68.4,43920,363,43680,3.8,1.44,0.027324561403508772,0.83,99.45
2020-02-21,Karnataka,1033,9,1028,12203,1339,1069,8.47,0,68.4,44953,372,44708,1.96,1.56,0.178406432748538,0.83,99.45
2020-02-22,Karnataka,1340,9,1340,16709,1880,206,8.02,0,68.4,46293,381,46048,2.75,0.3,0.24428362573099416,0.82,99.47
2020-02-23,Karnataka,1125,9,1120,14418,1840,1488,7.8,0,68.4,47418,390,47168,2.69,2.18,0.21078947368421053,0.82,99.47
2020-02-24,Karnataka,396,5,393,4622,259,212,8.57,0,68.4,47814,395,47561,0.38,0.31,0.06757309941520467,0.83,99.47
2020-02-25,Karnataka,550,5,547,6654,4538,462,8.27,0,68.4,48364,400,48108,6.63,0.68,0.09728070175438597,0.83,99.47
2020-02-26,Karnataka,1408,4,1399,17609,2172,947,8.0,5,68.4,49772,404,49507,3.18,1.38,0.25744152046783625,0.81,99.47
2020-02-27,Karnataka,661,3,652,8233,4694,1454,8.03,6,68.4,50433,407,50159,6.86,2.13,0.1203654970760234,0.81,99.46
2020-02-28,Karnataka,127,0,126,2030,4469,2335,6.26,1,68.4,50560,407,50285,6.53,3.41,0.029678362573099415,0.8,99.46
2020-02-29,Karnataka,731,8,726,8594,4604,3306,8.51,0,68.4,51291,415,51011,6.73,4.83,0.12564327485380117,0.81,99.45
2020-03-01,Karnataka,854,12,850,10805,368,85,7.9,0,68.4,52145,427,51861,0.54,0.12,0.15796783625730995,0.82,99.46
2020-03-02,Karnataka,469,2,461,5884,2234,1872,7.97,6,68.4,52614,429,52322,3.27,2.74,0.0860233918128655,0.82,99.45
2020-03-03,Karnataka,210,1,206,2913,4917,4641,7.21,3,68.4,52824,430,52528,7.19,6.79,0.04258771929824561,0.81,99.44
2020-03-04,Karnataka,1461,20,1461,18206,4951,3514,8.02,0,68.4,54285,450,53989,7.24,5.14,0.26616959064327483,0.83,99.45
2020-03-05,Karnataka,193,2,190,2561,2496,224,7.54,1,68.4,54478,452,54179,3.65,0.33,0.037441520467836255,0.83,99.45
2020-03-06,Karnataka,1359,11,1359,16880,3813,3044,8.05,0,68.4,55837,463,55538,5.57,4.45,0.24678362573099416,0.83,99.46
2020-03-07,Karnataka,1217,11,1213,15443,4707,2401,7.88,0,68.4,57054,474,56751,6.88,3.51,0.2257748538011696,0.83,99.47
2020-03-08,Karnataka,78,0,77,897,4679,4064,8.7,1,68.4,57132,474,56828,6.84,5.94,0.013114035087719298,0.83,99.47
2020-03-09,Karnataka,1351,18,1342,16789,4963,1167,8.05,0,68.4,58483,492,58170,7.26,1.71,0.245453216374269,0.84,99.46
2020-03-10,Karnataka,1128,5,1124,13950,686,335,8.09,0,68.4,59611,497,59294,1.0,0.49,0.20394736842105263,0.83,99.47
2020-03-11,Karnataka,1296,4,1291,16334,1659,341,7.93,1,68.4,60907,501,60585,2.43,0.5,0.23880116959064326,0.82,99.47
2020-03-12,Karnataka,476,2,467,5790,1386,529,8.22,7,68.4,61383,503,61052,2.03,0.77,0.08464912280701754,0.82,99.46
2020-03-13,Karnataka,1342,5,1333,16627,1634,60,8.07,4,68.4,62725,508,62385,2.39,0.09,0.24308479532163743,0.81,99.46
2020-03-14,Karnataka,1533,11,1527,19087,1919,54,8.03,0,68.4,64258,519,63912,2.81,0.08,0.27904970760233916,0.81,99.46
2020-03-15,Karnataka,204,1,196,2464,689,192,8.28,7,68.4,64462,520,64108,1.01,0.28,0.0360233918128655,0.81,99.45
2020-03-16,Karnataka,1568,10,1564,19450,4415,1162,8.06,0,68.4,66030,530,65672,6.45,1.7,0.2843567251461988,0.8,99.46
2020-03-17,Karnataka,436,3,434,5801,3094,477,7.52,0,68.4,66466,533,66106,4.52,0.7,0.08480994152046784,0.8,99.46
2020-03-18,Karnataka,1233,18,1225,15655,1993,1889,7.88,0,68.4,67699,551,67331,2.91,2.76,0.22887426900584795,0.81,99.46
2020-03-19,Karnataka,1276,17,1273,16161,1039,20,7.9,0,68.4,68975,568,68604,1.52,0.03,0.2362719298245614,0.82,99.46
2020-03-20,Karnataka,1305,7,1301,16402,1756,1287,7.96,0,68.4,70280,575,69905,2.57,1.88,0.2397953216374269,0.82,99.47
2020-03-21,Karnataka,994,10,988,12530,170,166,7.93,0,68.4,71274,585,70893,0.25,0.24,0.18318713450292398,0.82,99.47
2020-03-22,Karnataka,70,0,70,902,3464,1467,7.76,0,68.4,71344,585,70963,5.06,2.14,0.013187134502923976,0.82,99.47
2020-03-23,Karnataka,518,5,517,6435,3814,1699,8.05,0,68.4,71862,590,71480,5.58,2.48,0.09407894736842105,0.82,99.47
2020-03-24,Karnataka,369,1,364,4374,4975,3018,8.44,4,68.4,72231,591,71844,7.27,4.41,0.06394736842105263,0.82,99.46
2020-03-25,Karnataka,1236,16,1232,15496,4974,2274,7.98,0,68.4,73467,607,73076,7.27,3.32,0.22654970760233917,0.83,99.47
2020-03-26,Karnataka,1394,8,1394,17174,2560,606,8.12,0,68.4,74861,615,74470,3.74,0.89,0.25108187134502924,0.82,99.48
2020-03-27,Karnataka,955,13,949,12108,3288,2899,7.89,0,68.4,75816,628,75419,4.81,4.24,0.17701754385964913,0.83,99.48
2020-03-28,Karnataka,633,3,629,7565,2760,1867,8.37,1,68.4,76449,631,76048,4.04,2.73,0.11059941520467836,0.83,99.48
2020-03-29,Karnataka,1215,17,1213,15380,2959,2711,7.9,0,68.4,77664,648,77261,4.33,3.96,0.22485380116959064,0.83,99.48
2020-03-30,Karnataka,1591,19,1584,19579,109,89,8.13,0,68.4,79255,667,78845,0.16,0.13,0.2862426900584795,0.84,99.48
2020-03-31,Karnataka,553,5,552,6735,4937,3546,8.21,0,68.4,79808,672,79397,7.22,5.18,0.09846491228070176,0.84,99.49
2020-04-01,Karnataka,1187,16,1183,14864,2302,622,7.99,0,68.4,80995,688,80580,3.37,0.91,0.21730994152046784,0.85,99.49
2020-04-02,Karnataka,831,4,826,10478,3084,1367,7.93,1,68.4,81826,692,81406,4.51,2.0,0.15318713450292398,0.85,99.49
2020-04-03,Karnataka,1019,10,1018,12762,3308,2999,7.98,0,68.4,82845,702,82424,4.84,4.38,0.18657894736842107,0.85,99.49
2020-04-04,Karnataka,1271,13,1264,15777,451,55,8.06,0,68.4,84116,715,83688,0.66,0.08,0.23065789473684212,0.85,99.49
2020-04-05,Karnataka,478,6,470,6085,1956,98,7.86,2,68.4,84594,721,84158,2.86,0.14,0.08896198830409356,0.85,99.48
2020-04-06,Karnataka,1148,16,1148,14386,3136,2751,7.98,0,68.4,85742,737,85306,4.58,4.02,0.21032163742690058,0.86,99.49
2020-04-07,Karnataka,157,0,155,1929,605,110,8.14,2,68.4,85899,737,85461,0.88,0.16,0.028201754385964912,0.86,99.49
2020-04-08,Karnataka,112,1,110,1180,2635,2187,9.49,1,68.4,86011,738,85571,3.85,3.2,0.017251461988304094,0.86,99.49
2020-04-09,Karnataka,654,9,646,7972,3019,1551,8.2,0,68.4,86665,747,86217,4.41,2.27,0.11654970760233918,0.86,99.48
2020-04-10,Karnataka,676,8,674,8323,3108,976,8.12,0,68.4,87341,755,86891,4.54,1.43,0.1216812865497076,0.86,99.48
2020-04-11,Karnataka,936,13,935,11651,2934,1025,8.03,0,68.4,88277,768,87826,4.29,1.5,0.1703362573099415,0.87,99.49
2020-04-12,Karnataka,1430,19,1430,17461,3734,2004,8.19,0,68.4,89707,787,89256,5.46,2.93,0.25527777777777777,0.88,99.5
2020-04-13,Karnataka,73,0,70,765,331,226,9.54,3,68.4,89780,787,89326,0.48,0.33,0.01118421052631579,0.88,99.49
2020-04-14,Karnataka,1435,8,1430,18152,2847,1601,7.91,0,68.4,91215,795,90756,4.16,2.34,0.2653801169590643,0.87,99.5
2020-04-15,Karnataka,752,9,749,9422,1086,228,7.98,0,68.4,91967,804,91505,1.59,0.33,0.1377485380116959,0.87,99.5
2020-04-16,Karnataka,259,2,254,2938,4447,4134,8.82,3,68.4,92226,806,91759,6.5,6.04,0.04295321637426901,0.87,99.49
2020-04-17,Karnataka,198,1,191,2673,2251,1799,7.41,6,68.4,92424,807,91950,3.29,2.63,0.03907894736842105,0.87,99.49
2020-04-18,Karnataka,536,7,533,6797,93,54,7.89,0,68.4,92960,814,92483,0.14,0.08,0.09937134502923976,0.88,99.49
2020-04-19,Karnataka,62,0,58,812,4551,3865,7.64,4,68.4,93022,814,92541,6.65,5.65,0.011871345029239765,0.88,99.48
2020-04-20,Karnataka,333,4,330,4387,2802,2102,7.59,0,68.4,93355,818,92871,4.1,3.07,0.0641374269005848,0.88,99.48
2020-04-21,Karnataka,1062,6,1054,12959,4446,4240,8.2,2,68.4,94417,824,93925,6.5,6.2,0.18945906432748538,0.87,99.48
2020-04-22,Karnataka,1005,14,998,12068,4124,1044,8.33,0,68.4,95422,838,94923,6.03,1.53,0.1764327485380117,0.88,99.48
2020-04-23,Karnataka,681,5,672,8363,149,87,8.14,4,68.4,96103,843,95595,0.22,0.13,0.12226608187134502,0.88,99.47
2020-04-24,Karnataka,931,11,931,11453,4836,1771,8.13,0,68.4,97034,854,96526,7.07,2.59,0.16744152046783625,0.88,99.48
2020-04-25,Karnataka,970,14,963,12423,2662,2336,7.81,0,68.4,98004,868,97489,3.89,3.42,0.18162280701754385,0.89,99.47
2020-04-26,Karnataka,642,4,637,8639,2590,2178,7.43,1,68.4,98646,872,98126,3.79,3.18,0.12630116959064328,0.88,99.47
2020-04-27,Karnataka,1521,17,1515,19014,1825,1282,8.0,0,68.4,100167,889,99641,2.67,1.87,0.2779824561403509,0.89,99.47
2020-04-28,Karnataka,1311,10,1308,16486,4675,3531,7.95,0,68.4,101478,899,100949,6.83,5.16,0.2410233918128655,0.89,99.48
2020-04-29,Karnataka,249,1,249,3109,2537,1138,8.01,0,68.4,101727,900,101198,3.71,1.66,0.04545321637426901,0.88,99.48
2020-04-30,Karnataka,1179,8,1172,14530,4471,2845,8.11,0,68.4,102906,908,102370,6.54,4.16,0.21242690058479533,0.88,99.48
2020-05-01,Karnataka,134,1,132,1719,4291,2142,7.8,1,68.4,103040,909,102502,6.27,3.13,0.02513157894736842,0.88,99.48
2020-05-02,Karnataka,461,5,461,5639,4703,3344,8.18,0,68.4,103501,914,102963,6.88,4.89,0.08244152046783626,0.88,99.48
2020-05-03,Karnataka,836,5,830,10504,4969,1121,7.96,1,68.4,104337,919,103793,7.26,1.64,0.1535672514619883,0.88,99.48
2020-05-04,Karnataka,271,1,271,3604,2267,1893,7.52,0,68.4,104608,920,104064,3.31,2.77,0.05269005847953216,0.88,99.48
2020-05-05,Karnataka,1339,15,1330,17387,2085,1334,7.7,0,68.4,105947,935,105394,3.05,1.95,0.25419590643274853,0.88,99.48
2020-05-06,Karnataka,540,5,536,6264,2023,477,8.62,0,68.4,106487,940,105930,2.96,0.7,0.09157894736842105,0.88,99.48
2020-05-07,Karnataka,1521,19,1512,19176,1854,581,7.93,0,68.4,108008,959,107442,2.71,0.85,0.28035087719298246,0.89,99.48
2020-05-08,Karnataka,1125,8,1122,14001,162,18,8.04,0,68.4,109133,967,108564,0.24,0.03,0.20469298245614034,0.89,99.48
2020-05-09,Karnataka,1365,16,1364,17019,1792,749,8.02,0,68.4,110498,983,109928,2.62,1.1,0.2488157894736842,0.89,99.48
2020-05-10,Karnataka,759,8,759,9556,1949,1170,7.94,0,68.4,111257,991,110687,2.85,1.71,0.13970760233918128,0.89,99.49
2020-05-11,Karnataka,343,1,336,4469,3004,2388,7.68,6,68.4,111600,992,111023,4.39,3.49,0.06533625730994153,0.89,99.48
2020-05-12,Karnataka,859,5,857,10698,1242,188,8.03,0,68.4,112459,997,111880,1.82,0.27,0.15640350877192982,0.89,99.49
2020-05-13,Karnataka,77,0,68,1140,1752,784,6.75,9,68.4,112536,997,111948,2.56,1.15,0.016666666666666666,0.89,99.48
2020-05-14,Karnataka,931,12,929,11338,2794,867,8.21,0,68.4,113467,1009,112877,4.08,1.27,0.16576023391812866,0.89,99.48
2020-05-15,Karnataka,697,10,695,8497,4666,1696,8.2,0,68.4,114164,1019,113572,6.82,2.48,0.1242251461988304,0.89,99.48
2020-05-16,Karnataka,381,2,377,4574,647,296,8.33,2,68.4,114545,1021,113949,0.95,0.43,0.06687134502923976,0.89,99.48
2020-05-17,Karnataka,1342,6,1335,16343,3603,2695,8.21,1,68.4,115887,1027,115284,5.27,3.94,0.2389327485380117,0.89,99.48
2020-05-18,Karnataka,679,2,674,8660,3978,917,7.84,3,68.4,116566,1029,115958,5.82,1.34,0.12660818713450292,0.88,99.48
2020-05-19,Karnataka,1161,13,1157,14592,650,556,7.96,0,68.4,117727,1042,117115,0.95,0.81,0.21333333333333335,0.89,99.48
2020-05-20,Karnataka,1182,7,1176,14582,2538,1282,8.11,0,68.4,118909,1049,118291,3.71,1.87,0.21318713450292398,0.88,99.48
2020-05-21,Karnataka,71,0,68,680,1771,871,10.44,3,68.4,118980,1049,118359,2.59,1.27,0.009941520467836258,0.88,99.48
2020-05-22,Karnataka,984,14,983,12865,1179,545,7.65,0,68.4,119964,1063,119342,1.72,0.8,0.18808479532163744,0.89,99.48
2020-05-23,Karnataka,1391,18,1389,17382,2004,1561,8.0,0,68.4,121355,1081,120731,2.93,2.28,0.25412280701754386,0.89,99.49
2020-05-24,Karnataka,846,6,843,10285,2689,773,8.23,0,68.4,122201,1087,121574,3.93,1.13,0.1503654970760234,0.89,99.49
2020-05-25,Karnataka,1114,5,1108,14205,551,194,7.84,1,68.4,123315,1092,122682,0.81,0.28,0.20767543859649124,0.89,99.49
2020-05-26,Karnataka,1041,10,1035,12541,1746,6,8.3,0,68.4,124356,1102,123717,2.55,0.01,0.18334795321637426,0.89,99.49
2020-05-27,Karnataka,892,9,887,10743,1804,1145,8.3,0,68.4,125248,1111,124604,2.64,1.67,0.15706140350877193,0.89,99.49
2020-05-28,Karnataka,648,2,641,8662,2036,1743,7.48,5,68.4,125896,1113,125245,2.98,2.55,0.1266374269005848,0.88,99.48
2020-05-29,Karnataka,1313,18,1305,16817,4713,1792,7.81,0,68.4,127209,1131,126550,6.89,2.62,0.2458625730994152,0.89,99.48
2020-05-30,Karnataka,1445,4,1440,17997,3820,2210,8.03,1,68.4,128654,1135,127990,5.58,3.23,0.2631140350877193,0.88,99.48
2020-05-31,Karnataka,1429,19,1424,18007,125,78,7.94,0,68.4,130083,1154,129414,0.18,0.11,0.26326023391812864,0.89,99.49
2020-06-01,Karnataka,194,2,186,2250,577,147,8.62,6,68.4,130277,1156,129600,0.84,0.21,0.03289473684210526,0.89,99.48
2020-06-02,Karnataka,1475,18,1468,18729,3738,2859,7.88,0,68.4,131752,1174,131068,5.46,4.18,0.27381578947368423,0.89,99.48
2020-06-03,Karnataka,343,1,339,4089,2821,1558,8.39,3,68.4,132095,1175,131407,4.12,2.28,0.05978070175438596,0.89,99.48
2020-06-04,Karnataka,328,1,324,4624,2603,1289,7.09,3,68.4,132423,1176,131731,3.81,1.88,0.06760233918128655,0.89,99.48
2020-06-05,Karnataka,1404,9,1397,17433,1339,70,8.05,0,68.4,133827,1185,133128,1.96,0.1,0.2548684210526316,0.89,99.48
2020-06-06,Karnataka,1564,16,1555,19239,3021,118,8.13,0,68.4,135391,1201,134683,4.42,0.17,0.2812719298245614,0.89,99.48
2020-06-07,Karnataka,154,1,153,1647,2210,368,9.35,0,68.4,135545,1202,134836,3.23,0.54,0.024078947368421054,0.89,99.48
2020-06-08,Karnataka,1298,10,1295,16180,1027,399,8.02,0,68.4,136843,1212,136131,1.5,0.58,0.23654970760233918,0.89,99.48
2020-06-09,Karnataka,257,1,249,3519,1256,693,7.3,7,68.4,137100,1213,136380,1.84,1.01,0.05144736842105263,0.88,99.47
2020-06-10,Karnataka,366,2,362,4688,2506,1261,7.81,2,68.4,137466,1215,136742,3.66,1.84,0.06853801169590644,0.88,99.47
2020-06-11,Karnataka,375,4,374,4906,2533,2516,7.64,0,68.4,137841,1219,137116,3.7,3.68,0.07172514619883041,0.88,99.47
2020-06-12,Karnataka,1233,7,1226,15458,3298,1553,7.98,0,68.4,139074,1226,138342,4.82,2.27,0.22599415204678364,0.88,99.47
2020-06-13,Karnataka,1333,16,1333,17083,4073,2940,7.8,0,68.4,140407,1242,139675,5.95,4.3,0.24975146198830409,0.88,99.48
2020-06-14,Karnataka,475,2,475,6198,3516,875,7.66,0,68.4,140882,1244,140150,5.14,1.28,0.0906140350877193,0.88,99.48
2020-06-15,Karnataka,1181,6,1176,14369,2994,962,8.22,0,68.4,142063,1250,141326,4.38,1.41,0.2100730994152047,0.88,99.48
2020-06-16,Karnataka,169,1,168,1939,1244,522,8.72,0,68.4,142232,1251,141494,1.82,0.76,0.028347953216374268,0.88,99.48
2020-06-17,Karnataka,231,3,227,2683,387,96,8.61,1,68.4,142463,1254,141721,0.57,0.14,0.039225146198830406,0.88,99.48
2020-06-18,Karnataka,59,0,55,802,1899,501,7.36,4,68.4,142522,1254,141776,2.78,0.73,0.01172514619883041,0.88,99.48
2020-06-19,Karnataka,592,5,592,7611,2197,882,7.78,0,68.4,143114,1259,142368,3.21,1.29,0.1112719298245614,0.88,99.48
2020-06-20,Karnataka,445,2,437,5860,646,217,7.59,6,68.4,143559,1261,142805,0.94,0.32,0.08567251461988304,0.88,99.47
2020-06-21,Karnataka,1232,8,1229,15114,3054,2754,8.15,0,68.4,144791,1269,144034,4.46,4.03,0.22096491228070175,0.88,99.48
2020-06-22,Karnataka,1107,8,1101,13885,4465,4106,7.97,0,68.4,145898,1277,145135,6.53,6.0,0.20299707602339181,0.88,99.48
2020-06-23,Karnataka,1276,5,1275,15658,2133,1998,8.15,0,68.4,147174,1282,146410,3.12,2.92,0.22891812865497077,0.87,99.48
2020-06-24,Karnataka,686,3,684,8042,698,307,8.53,0,68.4,147860,1285,147094,1.02,0.45,0.11757309941520468,0.87,99.48
2020-06-25,Karnataka,1581,15,1576,19627,1475,1002,8.06,0,68.4,149441,1300,148670,2.16,1.46,0.28694444444444445,0.87,99.48
2020-06-26,Karnataka,1184,7,1178,15025,935,109,7.88,0,68.4,150625,1307,149848,1.37,0.16,0.21966374269005848,0.87,99.48
2020-06-27,Karnataka,1469,19,1461,18701,2782,871,7.86,0,68.4,152094,1326,151309,4.07,1.27,0.273406432748538,0.87,99.48
2020-06-28,Karnataka,309,4,305,4004,3327,946,7.72,0,68.4,152403,1330,151614,4.86,1.38,0.05853801169590643,0.87,99.48
2020-06-29,Karnataka,1428,16,1425,17791,803,219,8.03,0,68.4,153831,1346,153039,1.17,0.32,0.26010233918128656,0.87,99.49
2020-06-30,Karnataka,396,1,394,5302,1717,1462,7.47,1,68.4,154227,1347,153433,2.51,2.14,0.07751461988304094,0.87,99.49
2020-07-01,Karnataka,113,1,110,1055,3033,967,10.71,2,68.4,154340,1348,153543,4.43,1.41,0.015423976608187135,0.87,99.48
2020-07-02,Karnataka,1388,19,1380,17416,4594,2484,7.97,0,68.4,155728,1367,154923,6.72,3.63,0.2546198830409357,0.88,99.48
2020-07-03,Karnataka,1494,10,1492,18934,1913,725,7.89,0,68.4,157222,1377,156415,2.8,1.06,0.276812865497076,0.88,99.49
2020-07-04,Karnataka,96,1,89,1354,3459,3363,7.09,6,68.4,157318,1378,156504,5.06,4.92,0.0197953216374269,0.88,99.48
2020-07-05,Karnataka,280,1,280,3319,1503,457,8.44,0,68.4,157598,1379,156784,2.2,0.67,0.048523391812865496,0.88,99.48
2020-07-06,Karnataka,336,3,331,4121,1081,1074,8.15,2,68.4,157934,1382,157115,1.58,1.57,0.060248538011695905,0.88,99.48
2020-07-07,Karnataka,1468,21,1463,17881,955,93,8.21,0,68.4,159402,1403,158578,1.4,0.14,0.26141812865497077,0.88,99.48
2020-07-08,Karnataka,425,1,422,5128,4432,3754,8.29,2,68.4,159827,1404,159000,6.48,5.49,0.07497076023391813,0.88,99.48
2020-07-09,Karnataka,1229,6,1227,14818,751,187,8.29,0,68.4,161056,1410,160227,1.1,0.27,0.2166374269005848,0.88,99.49
2020-07-10,Karnataka,738,8,736,9195,1978,335,8.03,0,68.4,161794,1418,160963,2.89,0.49,0.1344298245614035,0.88,99.49
2020-07-11,Karnataka,300,3,298,3892,3052,2511,7.71,0,68.4,162094,1421,161261,4.46,3.67,0.05690058479532164,0.88,99.49
2020-07-12,Karnataka,1048,3,1040,13032,2592,1006,8.04,5,68.4,163142,1424,162301,3.79,1.47,0.19052631578947368,0.87,99.48
2020-07-13,Karnataka,1080,13,1077,13405,3920,1540,8.06,0,68.4,164222,1437,163378,5.73,2.25,0.1959795321637427,0.88,99.49
2020-07-14,Karnataka,876,12,868,10942,293,181,8.01,0,68.4,165098,1449,164246,0.43,0.26,0.15997076023391812,0.88,99.48
2020-07-15,Karnataka,701,5,692,8936,4414,269,7.84,4,68.4,165799,1454,164938,6.45,0.39,0.13064327485380117,0.88,99.48
2020-07-16,Karnataka,1135,13,1127,14745,3677,1415,7.7,0,68.4,166934,1467,166065,5.38,2.07,0.2155701754385965,0.88,99.48
2020-07-17,Karnataka,537,4,534,7279,2750,2359,7.38,0,68.4,167471,1471,166599,4.02,3.45,0.10641812865497076,0.88,99.48
2020-07-18,Karnataka,127,0,126,1821,2581,1012,6.97,1,68.4,167598,1471,166725,3.77,1.48,0.02662280701754386,0.88,99.48
2020-07-19,Karnataka,342,2,336,4458,3843,2880,7.67,4,68.4,167940,1473,167061,5.62,4.21,0.06517543859649123,0.88,99.48
2020-07-20,Karnataka,1583,11,1577,19505,4184,1963,8.12,0,68.4,169523,1484,168638,6.12,2.87,0.2851608187134503,0.88,99.48
2020-07-21,Karnataka,1327,10,1321,16401,1468,965,8.09,0,68.4,170850,1494,169959,2.15,1.41,0.23978070175438596,0.87,99.48
2020-07-22,Karnataka,204,2,195,2545,3277,3233,8.02,7,68.4,171054,1496,170154,4.79,4.73,0.03720760233918129,0.87,99.47
2020-07-23,Karnataka,61,0,57,1266,1266,548,4.82,4,68.4,171115,1496,170211,1.85,0.8,0.01850877192982456,0.87,99.47
2020-07-24,Karnataka,759,4,755,9715,3827,987,7.81,0,68.4,171874,1500,170966,5.6,1.44,0.14203216374269007,0.87,99.47
2020-07-25,Karnataka,63,0,59,875,1399,961,7.2,4,68.4,171937,1500,171025,2.05,1.4,0.012792397660818713,0.87,99.47
2020-07-26,Karnataka,1343,17,1337,17075,2797,2614,7.87,0,68.4,173280,1517,172362,4.09,3.82,0.2496345029239766,0.88,99.47
2020-07-27,Karnataka,1138,6,1134,14133,4522,608,8.05,0,68.4,174418,1523,173496,6.61,0.89,0.20662280701754385,0.87,99.47
2020-07-28,Karnataka,1119,6,1114,14003,2076,1155,7.99,0,68.4,175537,1529,174610,3.04,1.69,0.20472222222222222,0.87,99.47
2020-07-29,Karnataka,1148,4,1148,14718,1329,241,7.8,0,68.4,176685,1533,175758,1.94,0.35,0.21517543859649124,0.87,99.48
2020-07-30,Karnataka,66,0,58,649,1557,1078,10.17,8,68.4,176751,1533,175816,2.28,1.58,0.00948830409356725,0.87,99.47
2020-07-31,Karnataka,903,3,897,11295,3136,1733,7.99,3,68.4,177654,1536,176713,4.58,2.53,0.16513157894736843,0.86,99.47
2020-08-01,Karnataka,460,5,460,5817,2041,1289,7.91,0,68.4,178114,1541,177173,2.98,1.88,0.08504385964912281,0.87,99.47
2020-08-02,Karnataka,563,7,556,6883,1279,274,8.18,0,68.4,178677,1548,177729,1.87,0.4,0.10062865497076023,0.87,99.47
2020-08-03,Karnataka,800,7,799,10033,192,167,7.97,0,68.4,179477,1555,178528,0.28,0.24,0.1466812865497076,0.87,99.47
2020-08-04,Karnataka,132,1,125,1620,3127,1458,8.15,6,68.4,179609,1556,178653,4.57,2.13,0.02368421052631579,0.87,99.47
2020-08-05,Karnataka,617,8,609,7407,4871,4195,8.33,0,68.4,180226,1564,179262,7.12,6.13,0.10828947368421053,0.87,99.47
2020-08-06,Karnataka,492,5,491,6518,3978,2420,7.55,0,68.4,180718,1569,179753,5.82,3.54,0.09529239766081872,0.87,99.47
2020-08-07,Karnataka,1283,9,1274,15853,4993,3463,8.09,0,68.4,182001,1578,181027,7.3,5.06,0.2317690058479532,0.87,99.46
2020-08-08,Karnataka,1201,13,1195,15062,2694,1294,7.97,0,68.4,183202,1591,182222,3.94,1.89,0.2202046783625731,0.87,99.47
2020-08-09,Karnataka,1519,15,1513,18898,1546,214,8.04,0,68.4,184721,1606,183735,2.26,0.31,0.27628654970760236,0.87,99.47
2020-08-10,Karnataka,733,9,730,9323,1919,720,7.86,0,68.4,185454,1615,184465,2.81,1.05,0.13630116959064328,0.87,99.47
2020-08-11,Karnataka,109,0,108,1653,817,30,6.59,1,68.4,185563,1615,184573,1.19,0.04,0.024166666666666666,0.87,99.47
2020-08-12,Karnataka,1127,9,1118,13946,563,176,8.08,0,68.4,186690,1624,185691,0.82,0.26,0.2038888888888889,0.87,99.46
2020-08-13,Karnataka,425,1,423,5231,529,232,8.12,1,68.4,187115,1625,186114,0.77,0.34,0.0764766081871345,0.87,99.47
2020-08-14,Karnataka,1154,15,1145,14512,2565,1583,7.95,0,68.4,188269,1640,187259,3.75,2.31,0.21216374269005847,0.87,99.46
2020-08-15,Karnataka,699,8,697,8555,3160,940,8.17,0,68.4,188968,1648,187956,4.62,1.37,0.12507309941520467,0.87,99.46
2020-08-16,Karnataka,784,7,779,9629,3338,1785,8.14,0,68.4,189752,1655,188735,4.88,2.61,0.14077485380116958,0.87,99.46
2020-08-17,Karnataka,1402,17,1394,18023,3722,309,7.78,0,68.4,191154,1672,190129,5.44,0.45,0.2634941520467836,0.87,99.46
2020-08-18,Karnataka,729,4,723,8954,3031,2846,8.14,2,68.4,191883,1676,190852,4.43,4.16,0.130906432748538,0.87,99.46
2020-08-19,Karnataka,1292,17,1289,15870,3184,1375,8.14,0,68.4,193175,1693,192141,4.65,2.01,0.23201754385964912,0.88,99.46
2020-08-20,Karnataka,1186,14,1185,15302,4814,950,7.75,0,68.4,194361,1707,193326,7.04,1.39,0.22371345029239767,0.88,99.47
2020-08-21,Karnataka,1549,18,1541,19467,3852,1259,7.96,0,68.4,195910,1725,194867,5.63,1.84,0.28460526315789475,0.88,99.47
2020-08-22,Karnataka,935,3,928,11469,3663,3486,8.15,4,68.4,196845,1728,195795,5.36,5.1,0.16767543859649123,0.88,99.47
2020-08-23,Karnataka,1023,7,1022,12996,2172,81,7.87,0,68.4,197868,1735,196817,3.18,0.12,0.19,0.88,99.47
2020-08-24,Karnataka,1400,7,1396,17413,4052,1589,8.04,0,68.4,199268,1742,198213,5.92,2.32,0.25457602339181284,0.87,99.47
2020-08-25,Karnataka,684,9,681,8035,825,238,8.51,0,68.4,199952,1751,198894,1.21,0.35,0.11747076023391813,0.88,99.47
2020-08-26,Karnataka,84,0,84,851,3317,565,9.87,0,68.4,200036,1751,198978,4.85,0.83,0.012441520467836257,0.88,99.47
2020-08-27,Karnataka,1188,10,1179,14762,2662,882,8.05,0,68.4,201224,1761,200157,3.89,1.29,0.2158187134502924,0.88,99.47
2020-08-28,Karnataka,1353,7,1346,16967,4346,4056,7.97,0,68.4,202577,1768,201503,6.35,5.93,0.24805555555555556,0.87,99.47
2020-08-29,Karnataka,494,4,493,5882,1765,1688,8.4,0,68.4,203071,1772,201996,2.58,2.47,0.08599415204678362,0.87,99.47
2020-08-30,Karnataka,952,7,944,12035,2881,2453,7.91,1,68.4,204023,1779,202940,4.21,3.59,0.17595029239766083,0.87,99.47
2020-08-31,Karnataka,1321,8,1321,16621,4240,2889,7.95,0,68.4,205344,1787,204261,6.2,4.22,0.24299707602339182,0.87,99.47
2020-09-01,Karnataka,818,12,810,9697,61,54,8.44,0,68.4,206162,1799,205071,0.09,0.08,0.1417690058479532,0.87,99.47
2020-09-02,Karnataka,1208,6,1207,14642,1122,71,8.25,0,68.4,207370,1805,206278,1.64,0.1,0.21406432748538012,0.87,99.47
2020-09-03,Karnataka,193,0,184,2419,4407,1561,7.98,9,68.4,207563,1805,206462,6.44,2.28,0.03536549707602339,0.87,99.47
2020-09-04,Karnataka,230,1,230,2859,1329,729,8.04,0,68.4,207793,1806,206692,1.94,1.07,0.041798245614035084,0.87,99.47
2020-09-05,Karnataka,219,2,213,2271,875,560,9.64,4,68.4,208012,1808,206905,1.28,0.82,0.03320175438596491,0.87,99.47
2020-09-06,Karnataka,1065,10,1063,13446,1797,1580,7.92,0,68.4,209077,1818,207968,2.63,2.31,0.19657894736842105,0.87,99.47
2020-09-07,Karnataka,1294,13,1290,15856,3911,2458,8.16,0,68.4,210371,1831,209258,5.72,3.59,0.23181286549707603,0.87,99.47
2020-09-08,Karnataka,381,3,374,4842,2498,2218,7.87,4,68.4,210752,1834,209632,3.65,3.24,0.07078947368421053,0.87,99.47
2020-09-09,Karnataka,742,7,739,8951,3544,2607,8.29,0,68.4,211494,1841,210371,5.18,3.81,0.1308625730994152,0.87,99.47
2020-09-10,Karnataka,907,12,902,11549,1527,924,7.85,0,68.4,212401,1853,211273,2.23,1.35,0.16884502923976608,0.87,99.47
2020-09-11,Karnataka,933,6,926,11639,4661,272,8.02,1,68.4,213334,1859,212199,6.81,0.4,0.1701608187134503,0.87,99.47
2020-09-12,Karnataka,201,0,194,2452,3522,1277,8.2,7,68.4,213535,1859,212393,5.15,1.87,0.03584795321637427,0.87,99.47
2020-09-13,Karnataka,1570,4,1563,18947,106,70,8.29,3,68.4,215105,1863,213956,0.15,0.1,0.2770029239766082,0.87,99.47
2020-09-14,Karnataka,1322,15,1313,16542,1440,1292,7.99,0,68.4,216427,1878,215269,2.11,1.89,0.24184210526315789,0.87,99.46
2020-09-15,Karnataka,377,4,374,4635,3453,1433,8.13,0,68.4,216804,1882,215643,5.05,2.1,0.06776315789473684,0.87,99.46
2020-09-16,Karnataka,1093,8,1087,14169,1726,186,7.71,0,68.4,217897,1890,216730,2.52,0.27,0.20714912280701755,0.87,99.46
2020-09-17,Karnataka,413,4,408,5207,1806,1020,7.93,1,68.4,218310,1894,217138,2.64,1.49,0.07612573099415204,0.87,99.46
2020-09-18,Karnataka,1219,9,1211,15151,4515,28,8.05,0,68.4,219529,1903,218349,6.6,0.04,0.22150584795321637,0.87,99.46
2020-09-19,Karnataka,1108,7,1106,14246,3795,3360,7.78,0,68.4,220637,1910,219455,5.55,4.91,0.20827485380116958,0.87,99.46
2020-09-20,Karnataka,341,1,336,4112,1586,658,8.29,4,68.4,220978,1911,219791,2.32,0.96,0.060116959064327485,0.86,99.46
2020-09-21,Karnataka,1474,20,1474,18238,2293,648,8.08,0,68.4,222452,1931,221265,3.35,0.95,0.2666374269005848,0.87,99.47
2020-09-22,Karnataka,55,0,51,908,1845,22,6.06,4,68.4,222507,1931,221316,2.7,0.03,0.01327485380116959,0.87,99.46
2020-09-23,Karnataka,1071,12,1070,13858,2354,92,7.73,0,68.4,223578,1943,222386,3.44,0.13,0.20260233918128656,0.87,99.47
2020-09-24,Karnataka,304,4,297,4326,4927,2387,7.03,3,68.4,223882,1947,222683,7.2,3.49,0.06324561403508772,0.87,99.46
2020-09-25,Karnataka,157,0,150,1608,1664,1551,9.76,7,68.4,224039,1947,222833,2.43,2.27,0.023508771929824562,0.87,99.46
2020-09-26,Karnataka,1321,10,1313,16657,424,388,7.93,0,68.4,225360,1957,224146,0.62,0.57,0.2435233918128655,0.87,99.46
2020-09-27,Karnataka,221,0,218,2639,2079,1597,8.37,3,68.4,225581,1957,224364,3.04,2.33,0.03858187134502924,0.87,99.46
2020-09-28,Karnataka,1124,8,1117,14387,150,53,7.81,0,68.4,226705,1965,225481,0.22,0.08,0.21033625730994152,0.87,99.46
2020-09-29,Karnataka,186,1,180,2101,1892,646,8.85,5,68.4,226891,1966,225661,2.77,0.94,0.030716374269005847,0.87,99.46
2020-09-30,Karnataka,91,0,90,977,1651,208,9.31,1,68.4,226982,1966,225751,2.41,0.3,0.014283625730994152,0.87,99.46
2020-10-01,Karnataka,1414,16,1409,17807,4281,2127,7.94,0,68.4,228396,1982,227160,6.26,3.11,0.26033625730994153,0.87,99.46
2020-10-02,Karnataka,616,3,609,7325,629,107,8.41,4,68.4,229012,1985,227769,0.92,0.16,0.1070906432748538,0.87,99.46
2020-10-03,Karnataka,62,0,54,1073,4023,306,5.78,8,68.4,229074,1985,227823,5.88,0.45,0.015687134502923975,0.87,99.45
2020-10-04,Karnataka,55,0,52,794,2734,552,6.93,3,68.4,229129,1985,227875,4.0,0.81,0.011608187134502923,0.87,99.45
2020-10-05,Karnataka,848,4,843,10712,1978,1596,7.92,1,68.4,229977,1989,228718,2.89,2.33,0.15660818713450292,0.86,99.45
2020-10-06,Karnataka,1080,4,1076,13442,4629,2730,8.03,0,68.4,231057,1993,229794,6.77,3.99,0.19652046783625732,0.86,99.45
2020-10-07,Karnataka,1537,13,1534,19093,4702,3754,8.05,0,68.4,232594,2006,231328,6.87,5.49,0.2791374269005848,0.86,99.46
2020-10-08,Karnataka,1507,5,1506,19178,2365,1595,7.86,0,68.4,234101,2011,232834,3.46,2.33,0.28038011695906434,0.86,99.46
2020-10-09,Karnataka,928,3,922,12009,3179,601,7.73,3,68.4,235029,2014,233756,4.65,0.88,0.1755701754385965,0.86,99.46
2020-10-10,Karnataka,894,12,888,11307,2896,1171,7.91,0,68.4,235923,2026,234644,4.23,1.71,0.16530701754385965,0.86,99.46
2020-10-11,Karnataka,326,3,324,4127,590,423,7.9,0,68.4,236249,2029,234968,0.86,0.62,0.06033625730994152,0.86,99.46
2020-10-12,Karnataka,939,12,939,11506,1581,1436,8.16,0,68.4,237188,2041,235907,2.31,2.1,0.16821637426900585,0.86,99.46
2020-10-13,Karnataka,1319,17,1319,16916,1687,1211,7.8,0,68.4,238507,2058,237226,2.47,1.77,0.24730994152046784,0.86,99.46
2020-10-14,Karnataka,1401,20,1394,17289,2671,2001,8.1,0,68.4,239908,2078,238620,3.9,2.93,0.25276315789473686,0.87,99.46
2020-10-15,Karnataka,958,8,950,12193,2320,871,7.86,0,68.4,240866,2086,239570,3.39,1.27,0.17826023391812865,0.87,99.46
2020-10-16,Karnataka,726,7,720,9131,512,233,7.95,0,68.4,241592,2093,240290,0.75,0.34,0.13349415204678364,0.87,99.46
2020-10-17,Karnataka,188,2,188,2384,686,169,7.89,0,68.4,241780,2095,240478,1.0,0.25,0.034853801169590644,0.87,99.46
2020-10-18,Karnataka,1075,11,1066,13059,1566,195,8.23,0,68.4,242855,2106,241544,2.29,0.29,0.19092105263157894,0.87,99.46
2020-10-19,Karnataka,1033,15,1029,12821,172,170,8.06,0,68.4,243888,2121,242573,0.25,0.25,0.18744152046783627,0.87,99.46
2020-10-20,Karnataka,1018,13,1018,12737,4485,318,7.99,0,68.4,244906,2134,243591,6.56,0.46,0.18621345029239766,0.87,99.46
2020-10-21,Karnataka,56,0,55,923,2529,842,6.07,1,68.4,244962,2134,243646,3.7,1.23,0.013494152046783626,0.87,99.46
2020-10-22,Karnataka,188,2,183,2439,1785,1291,7.71,3,68.4,245150,2136,243829,2.61,1.89,0.035657894736842104,0.87,99.46
2020-10-23,Karnataka,1524,4,1516,18938,4584,2761,8.05,4,68.4,246674,2140,245345,6.7,4.04,0.27687134502923977,0.87,99.46
2020-10-24,Karnataka,403,1,394,4887,742,61,8.25,8,68.4,247077,2141,245739,1.08,0.09,0.07144736842105263,0.87,99.46
2020-10-25,Karnataka,1553,8,1548,19049,4112,1802,8.15,0,68.4,248630,2149,247287,6.01,2.63,0.2784941520467836,0.86,99.46
2020-10-26,Karnataka,1417,20,1411,17759,516,439,7.98,0,68.4,250047,2169,248698,0.75,0.64,0.2596345029239766,0.87,99.46
2020-10-27,Karnataka,335,4,328,4955,922,65,6.76,3,68.4,250382,2173,249026,1.35,0.1,0.07244152046783625,0.87,99.46
2020-10-28,Karnataka,588,7,579,7473,3140,2335,7.87,2,68.4,250970,2180,249605,4.59,3.41,0.10925438596491228,0.87,99.46
2020-10-29,Karnataka,991,5,989,12250,3242,1836,8.09,0,68.4,251961,2185,250594,4.74,2.68,0.179093567251462,0.87,99.46
2020-10-30,Karnataka,1143,13,1138,13962,206,74,8.19,0,68.4,253104,2198,251732,0.3,0.11,0.20412280701754387,0.87,99.46
2020-10-31,Karnataka,1110,7,1110,13776,959,843,8.06,0,68.4,254214,2205,252842,1.4,1.23,0.20140350877192983,0.87,99.46
2020-11-01,Karnataka,184,1,183,2420,1119,988,7.6,0,68.4,254398,2206,253025,1.64,1.44,0.035380116959064324,0.87,99.46
2020-11-02,Karnataka,829,8,825,10096,1471,1231,8.21,0,68.4,255227,2214,253850,2.15,1.8,0.14760233918128654,0.87,99.46
2020-11-03,Karnataka,321,3,314,3856,2544,692,8.32,4,68.4,255548,2217,254164,3.72,1.01,0.05637426900584795,0.87,99.46
2020-11-04,Karnataka,1218,5,1217,14811,3862,1887,8.22,0,68.4,256766,2222,255381,5.65,2.76,0.21653508771929825,0.87,99.46
2020-11-05,Karnataka,98,1,89,1386,3206,803,7.07,8,68.4,256864,2223,255470,4.69,1.17,0.02026315789473684,0.87,99.46
2020-11-06,Karnataka,1049,7,1045,13252,2867,318,7.92,0,68.4,257913,2230,256515,4.19,0.46,0.19374269005847952,0.86,99.46
2020-11-07,Karnataka,269,1,260,3431,4972,4953,7.84,8,68.4,258182,2231,256775,7.27,7.24,0.050160818713450295,0.86,99.46
2020-11-08,Karnataka,163,2,159,1809,2721,1661,9.01,2,68.4,258345,2233,256934,3.98,2.43,0.026447368421052633,0.86,99.45
2020-11-09,Karnataka,1033,6,1024,13089,3524,618,7.89,3,68.4,259378,2239,257958,5.15,0.9,0.191359649122807,0.86,99.45
2020-11-10,Karnataka,287,3,279,3090,1764,1108,9.29,5,68.4,259665,2242,258237,2.58,1.62,0.04517543859649123,0.86,99.45
2020-11-11,Karnataka,630,7,622,7464,493,152,8.44,1,68.4,260295,2249,258859,0.72,0.22,0.10912280701754386,0.86,99.45
2020-11-12,Karnataka,1472,7,1468,18408,4502,2892,8.0,0,68.4,261767,2256,260327,6.58,4.23,0.2691228070175439,0.86,99.45
2020-11-13,Karnataka,280,0,280,3462,4300,1328,8.09,0,68.4,262047,2256,260607,6.29,1.94,0.0506140350877193,0.86,99.45
2020-11-14,Karnataka,1396,6,1388,17630,1019,738,7.92,2,68.4,263443,2262,261995,1.49,1.08,0.2577485380116959,0.86,99.45
2020-11-15,Karnataka,765,9,762,9361,190,43,8.17,0,68.4,264208,2271,262757,0.28,0.06,0.13685672514619884,0.86,99.45
2020-11-16,Karnataka,491,5,484,6037,3094,2739,8.13,2,68.4,264699,2276,263241,4.52,4.0,0.08826023391812865,0.86,99.45
2020-11-17,Karnataka,1590,23,1582,19782,4349,1372,8.04,0,68.4,266289,2299,264823,6.36,2.01,0.2892105263157895,0.86,99.45
2020-11-18,Karnataka,1424,13,1420,17835,3043,2932,7.98,0,68.4,267713,2312,266243,4.45,4.29,0.2607456140350877,0.86,99.45
2020-11-19,Karnataka,293,3,288,3898,4590,1174,7.52,2,68.4,268006,2315,266531,6.71,1.72,0.056988304093567255,0.86,99.45
2020-11-20,Karnataka,815,9,812,10282,1566,448,7.93,0,68.4,268821,2324,267343,2.29,0.65,0.15032163742690058,0.86,99.45
2020-11-21,Karnataka,1402,12,1398,17566,1168,624,7.98,0,68.4,270223,2336,268741,1.71,0.91,0.25681286549707605,0.86,99.45
2020-11-22,Karnataka,936,9,928,11761,4142,562,7.96,0,68.4,271159,2345,269669,6.06,0.82,0.17194444444444446,0.86,99.45
2020-11-23,Karnataka,940,6,939,11498,2555,858,8.18,0,68.4,272099,2351,270608,3.74,1.25,0.16809941520467836,0.86,99.45
2020-11-24,Karnataka,199,2,199,2421,1487,917,8.22,0,68.4,272298,2353,270807,2.17,1.34,0.035394736842105264,0.86,99.45
2020-11-25,Karnataka,444,5,436,5515,3295,1073,8.05,3,68.4,272742,2358,271243,4.82,1.57,0.08062865497076023,0.86,99.45
2020-11-26,Karnataka,54,0,54,910,336,140,5.93,0,68.4,272796,2358,271297,0.49,0.2,0.013304093567251462,0.86,99.45
2020-11-27,Karnataka,542,3,542,6955,4368,3930,7.79,0,68.4,273338,2361,271839,6.39,5.75,0.10168128654970761,0.86,99.45
2020-11-28,Karnataka,716,3,707,8729,3893,1657,8.2,6,68.4,274054,2364,272546,5.69,2.42,0.1276169590643275,0.86,99.45
2020-11-29,Karnataka,179,0,178,2140,4284,1062,8.36,1,68.4,274233,2364,272724,6.26,1.55,0.03128654970760234,0.86,99.45
2020-11-30,Karnataka,215,2,208,2984,324,95,7.21,5,68.4,274448,2366,272932,0.47,0.14,0.04362573099415205,0.86,99.45
2020-12-01,Karnataka,1537,17,1529,19234,3392,3340,7.99,0,68.4,275985,2383,274461,4.96,4.88,0.2811988304093567,0.86,99.45
2020-12-02,Karnataka,1171,15,1168,15010,740,738,7.8,0,68.4,277156,2398,275629,1.08,1.08,0.21944444444444444,0.87,99.45
2020-12-03,Karnataka,592,7,588,7228,1002,153,8.19,0,68.4,277748,2405,276217,1.46,0.22,0.10567251461988304,0.87,99.45
2020-12-04,Karnataka,1546,16,1544,19621,1886,1454,7.88,0,68.4,279294,2421,277761,2.76,2.13,0.2868567251461988,0.87,99.45
2020-12-05,Karnataka,1346,9,1345,17125,1433,195,7.86,0,68.4,280640,2430,279106,2.1,0.29,0.2503654970760234,0.87,99.45
2020-12-06,Karnataka,1492,7,1483,18367,3034,358,8.12,2,68.4,282132,2437,280589,4.44,0.52,0.2685233918128655,0.86,99.45
2020-12-07,Karnataka,1437,7,1435,18181,1389,1224,7.9,0,68.4,283569,2444,282024,2.03,1.79,0.2658040935672515,0.86,99.46
2020-12-08,Karnataka,659,8,650,8385,2988,1564,7.86,1,68.4,284228,2452,282674,4.37,2.29,0.12258771929824562,0.86,99.45
2020-12-09,Karnataka,1502,10,1498,18726,2385,1352,8.02,0,68.4,285730,2462,284172,3.49,1.98,0.2737719298245614,0.86,99.45
2020-12-10,Karnataka,536,5,529,6059,1065,732,8.85,2,68.4,286266,2467,284701,1.56,1.07,0.08858187134502923,0.86,99.45
2020-12-11,Karnataka,1045,3,1038,12925,3082,2158,8.09,4,68.4,287311,2470,285739,4.51,3.15,0.18896198830409358,0.86,99.45
2020-12-12,Karnataka,1017,11,1012,12901,1676,1251,7.88,0,68.4,288328,2481,286751,2.45,1.83,0.18861111111111112,0.86,99.45
2020-12-13,Karnataka,426,3,423,5367,4293,3323,7.94,0,68.4,288754,2484,287174,6.28,4.86,0.07846491228070175,0.86,99.45
2020-12-14,Karnataka,1314,12,1313,16264,977,689,8.08,0,68.4,290068,2496,288487,1.43,1.01,0.23777777777777778,0.86,99.45
2020-12-15,Karnataka,1174,3,1166,14878,2081,1950,7.89,5,68.4,291242,2499,289653,3.04,2.85,0.21751461988304094,0.86,99.45
2020-12-16,Karnataka,1574,15,1568,19741,3259,1177,7.97,0,68.4,292816,2514,291221,4.76,1.72,0.2886111111111111,0.86,99.46
2020-12-17,Karnataka,369,3,361,4657,1330,460,7.92,5,68.4,293185,2517,291582,1.94,0.67,0.06808479532163743,0.86,99.45
2020-12-18,Karnataka,198,2,197,2776,2471,1101,7.13,0,68.4,293383,2519,291779,3.61,1.61,0.040584795321637425,0.86,99.45
2020-12-19,Karnataka,1126,9,1118,13922,2457,497,8.09,0,68.4,294509,2528,292897,3.59,0.73,0.20353801169590643,0.86,99.45
2020-12-20,Karnataka,90,1,90,1071,4045,2232,8.4,0,68.4,294599,2529,292987,5.91,3.26,0.015657894736842107,0.86,99.45
2020-12-21,Karnataka,883,9,883,11615,148,115,7.6,0,68.4,295482,2538,293870,0.22,0.17,0.16980994152046783,0.86,99.45
2020-12-22,Karnataka,1064,14,1058,13208,661,4,8.06,0,68.4,296546,2552,294928,0.97,0.01,0.19309941520467835,0.86,99.45
2020-12-23,Karnataka,1298,7,1298,16119,765,19,8.05,0,68.4,297844,2559,296226,1.12,0.03,0.2356578947368421,0.86,99.46
2020-12-24,Karnataka,1487,10,1483,18091,1529,247,8.22,0,68.4,299331,2569,297709,2.24,0.36,0.2644883040935673,0.86,99.46
2020-12-25,Karnataka,678,4,672,8333,1671,1500,8.14,2,68.4,300009,2573,298381,2.44,2.19,0.12182748538011696,0.86,99.46
2020-12-26,Karnataka,1354,19,1347,16742,4106,3814,8.09,0,68.4,301363,2592,299728,6.0,5.58,0.24476608187134502,0.86,99.46
2020-12-27,Karnataka,1477,10,1469,18957,1162,269,7.79,0,68.4,302840,2602,301197,1.7,0.39,0.27714912280701753,0.86,99.46
2020-12-28,Karnataka,35,0,31,564,3134,1417,6.21,4,68.4,302875,2602,301228,4.58,2.07,0.00824561403508772,0.86,99.46
2020-12-29,Karnataka,657,3,652,8618,3772,3341,7.62,2,68.4,303532,2605,301880,5.51,4.88,0.12599415204678363,0.86,99.46
2020-12-30,Karnataka,802,3,802,10100,1680,905,7.94,0,68.4,304334,2608,302682,2.46,1.32,0.1476608187134503,0.86,99.46
2020-12-31,Karnataka,1606,12,1597,19500,3092,326,8.24,0,68.4,305940,2620,304279,4.52,0.48,0.2850877192982456,0.86,99.46
2021-01-01,Karnataka,722,4,713,9418,4098,2247,7.67,5,68.4,306662,2624,304992,5.99,3.29,0.13769005847953217,0.86,99.46
2021-01-02,Karnataka,735,10,726,8960,4859,4114,8.2,0,68.4,307397,2634,305718,7.1,6.01,0.13099415204678364,0.86,99.45
2021-01-03,Karnataka,382,3,374,4907,1320,427,7.78,5,68.4,307779,2637,306092,1.93,0.62,0.07173976608187134,0.86,99.45
2021-01-04,Karnataka,1365,16,1359,17214,3311,3025,7.93,0,68.4,309144,2653,307451,4.84,4.42,0.25166666666666665,0.86,99.45
2021-01-05,Karnataka,196,2,192,2749,663,535,7.13,2,68.4,309340,2655,307643,0.97,0.78,0.040190058479532165,0.86,99.45
2021-01-06,Karnataka,277,4,275,3401,3231,2222,8.14,0,68.4,309617,2659,307918,4.72,3.25,0.04972222222222222,0.86,99.45
2021-01-07,Karnataka,860,10,851,10666,1748,1557,8.06,0,68.4,310477,2669,308769,2.56,2.28,0.15593567251461987,0.86,99.45
2021-01-08,Karnataka,265,3,257,3121,2098,507,8.49,5,68.4,310742,2672,309026,3.07,0.74,0.045628654970760234,0.86,99.45
2021-01-09,Karnataka,147,0,141,2041,2520,619,7.2,6,68.4,310889,2672,309167,3.68,0.9,0.029839181286549707,0.86,99.45
2021-01-10,Karnataka,1484,21,1480,18003,3921,767,8.24,0,68.4,312373,2693,310647,5.73,1.12,0.26320175438596494,0.86,99.45
2021-01-11,Karnataka,1146,6,1138,14455,4505,3114,7.93,2,68.4,313519,2699,311785,6.59,4.55,0.21133040935672515,0.86,99.45
2021-01-12,Karnataka,843,4,837,10261,2619,2590,8.22,2,68.4,314362,2703,312622,3.83,3.79,0.15001461988304093,0.86,99.45
2021-01-13,Karnataka,1515,12,1514,18684,4251,528,8.11,0,68.4,315877,2715,314136,6.21,0.77,0.2731578947368421,0.86,99.45
2021-01-14,Karnataka,1194,9,1189,14715,4186,2456,8.11,0,68.4,317071,2724,315325,6.12,3.59,0.21513157894736842,0.86,99.45
2021-01-15,Karnataka,1158,4,1156,14385,3652,2462,8.05,0,68.4,318229,2728,316481,5.34,3.6,0.21030701754385964,0.86,99.45
2021-01-16,Karnataka,1368,10,1362,17125,1475,224,7.99,0,68.4,319597,2738,317843,2.16,0.33,0.2503654970760234,0.86,99.45
2021-01-17,Karnataka,1212,17,1208,15264,1423,458,7.94,0,68.4,320809,2755,319051,2.08,0.67,0.2231578947368421,0.86,99.45
2021-01-18,Karnataka,1357,14,1355,16926,3513,1942,8.02,0,68.4,322166,2769,320406,5.14,2.84,0.24745614035087718,0.86,99.45
2021-01-19,Karnataka,1164,9,1158,14236,4576,3240,8.18,0,68.4,323330,2778,321564,6.69,4.74,0.20812865497076025,0.86,99.45
2021-01-20,Karnataka,1285,7,1279,16174,3574,148,7.94,0,68.4,324615,2785,322843,5.23,0.22,0.23646198830409357,0.86,99.45
2021-01-21,Karnataka,822,5,814,10273,885,788,8.0,3,68.4,325437,2790,323657,1.29,1.15,0.15019005847953215,0.86,99.45
2021-01-22,Karnataka,1134,15,1130,14280,550,112,7.94,0,68.4,326571,2805,324787,0.8,0.16,0.20877192982456141,0.86,99.45
2021-01-23,Karnataka,846,6,837,10860,3671,1941,7.79,3,68.4,327417,2811,325624,5.37,2.84,0.1587719298245614,0.86,99.45
2021-01-24,Karnataka,1103,10,1095,13811,2953,1972,7.99,0,68.4,328520,2821,326719,4.32,2.88,0.20191520467836258,0.86,99.45
2021-01-25,Karnataka,476,2,475,6118,110,9,7.78,0,68.4,328996,2823,327194,0.16,0.01,0.08944444444444444,0.86,99.45
2021-01-26,Karnataka,159,0,152,1938,463,293,8.2,7,68.4,329155,2823,327346,0.68,0.43,0.028333333333333332,0.86,99.45
2021-01-27,Karnataka,1241,18,1238,15895,3651,2389,7.81,0,68.4,330396,2841,328584,5.34,3.49,0.23238304093567252,0.86,99.45
2021-01-28,Karnataka,896,12,896,11155,4009,2121,8.03,0,68.4,331292,2853,329480,5.86,3.1,0.16308479532163742,0.86,99.45
2021-01-29,Karnataka,700,6,697,9013,4121,1563,7.77,0,68.4,331992,2859,330177,6.02,2.29,0.13176900584795323,0.86,99.45
2021-01-30,Karnataka,1095,8,1092,13986,1138,763,7.83,0,68.4,333087,2867,331269,1.66,1.12,0.2044736842105263,0.86,99.45
2021-01-31,Karnataka,298,1,290,3898,561,184,7.64,7,68.4,333385,2868,331559,0.82,0.27,0.056988304093567255,0.86,99.45
2021-02-01,Karnataka,1067,9,1064,13534,4245,204,7.88,0,68.4,334452,2877,332623,6.21,0.3,0.19786549707602338,0.86,99.45
2021-02-02,Karnataka,483,2,475,6516,3018,1341,7.41,6,68.4,334935,2879,333098,4.41,1.96,0.09526315789473684,0.86,99.45
2021-02-03,Karnataka,1561,6,1556,19958,1120,823,7.82,0,68.4,336496,2885,334654,1.64,1.2,0.29178362573099415,0.86,99.45
2021-02-04,Karnataka,1179,9,1179,14630,2209,1845,8.06,0,68.4,337675,2894,335833,3.23,2.7,0.21388888888888888,0.86,99.45
2021-02-05,Karnataka,1268,10,1263,15494,1310,972,8.18,0,68.4,338943,2904,337096,1.92,1.42,0.22652046783625732,0.86,99.46
2021-02-06,Karnataka,985,11,978,12236,2178,914,8.05,0,68.4,339928,2915,338074,3.18,1.34,0.17888888888888888,0.86,99.45
2021-02-07,Karnataka,983,3,983,12567,525,175,7.82,0,68.4,340911,2918,339057,0.77,0.26,0.1837280701754386,0.86,99.46
2021-02-08,Karnataka,399,4,399,5094,757,387,7.83,0,68.4,341310,2922,339456,1.11,0.57,0.07447368421052632,0.86,99.46
2021-02-09,Karnataka,697,2,690,8689,3374,2210,8.02,5,68.4,342007,2924,340146,4.93,3.23,0.12703216374269005,0.85,99.46
2021-02-10,Karnataka,342,2,337,4273,2173,1411,8.0,3,68.4,342349,2926,340483,3.18,2.06,0.06247076023391813,0.85,99.45
2021-02-11,Karnataka,1252,17,1251,15603,2578,415,8.02,0,68.4,343601,2943,341734,3.77,0.61,0.2281140350877193,0.86,99.46
2021-02-12,Karnataka,854,8,846,10442,2293,1921,8.18,0,68.4,344455,2951,342580,3.35,2.81,0.1526608187134503,0.86,99.46
2021-02-13,Karnataka,487,2,487,6043,1136,739,8.06,0,68.4,344942,2953,343067,1.66,1.08,0.08834795321637427,0.86,99.46
2021-02-14,Karnataka,573,5,568,7015,3869,1213,8.17,0,68.4,345515,2958,343635,5.66,1.77,0.10255847953216374,0.86,99.46
2021-02-15,Karnataka,1352,4,1350,16888,1703,1188,8.01,0,68.4,346867,2962,344985,2.49,1.74,0.24690058479532165,0.85,99.46
2021-02-16,Karnataka,277,2,268,3358,4388,321,8.25,7,68.4,347144,2964,345253,6.42,0.47,0.04909356725146199,0.85,99.46
2021-02-17,Karnataka,219,2,211,2511,2099,753,8.72,6,68.4,347363,2966,345464,3.07,1.1,0.03671052631578947,0.85,99.45
2021-02-18,Karnataka,706,2,701,8150,3395,375,8.66,3,68.4,348069,2968,346165,4.96,0.55,0.11915204678362573,0.85,99.45
2021-02-19,Karnataka,1088,14,1088,13929,4415,3241,7.81,0,68.4,349157,2982,347253,6.45,4.74,0.20364035087719298,0.85,99.45
2021-02-20,Karnataka,525,6,520,6311,4170,1107,8.32,0,68.4,349682,2988,347773,6.1,1.62,0.09226608187134502,0.85,99.45
2021-02-21,Karnataka,1494,10,1493,18503,148,114,8.07,0,68.4,351176,2998,349266,0.22,0.17,0.27051169590643276,0.85,99.46
2021-02-22,Karnataka,613,6,610,7593,2112,1911,8.07,0,68.4,351789,3004,349876,3.09,2.79,0.11100877192982456,0.85,99.46
2021-02-23,Karnataka,319,3,314,4233,2641,1108,7.54,2,68.4,352108,3007,350190,3.86,1.62,0.061885964912280704,0.85,99.46
2021-02-24,Karnataka,1504,11,1503,19026,4640,972,7.9,0,68.4,353612,3018,351693,6.78,1.42,0.2781578947368421,0.85,99.46
2021-02-25,Karnataka,1193,6,1189,15027,4948,3281,7.94,0,68.4,354805,3024,352882,7.23,4.8,0.21969298245614036,0.85,99.46
2021-02-26,Karnataka,146,1,146,2115,505,35,6.9,0,68.4,354951,3025,353028,0.74,0.05,0.030921052631578946,0.85,99.46
2021-02-27,Karnataka,1031,12,1029,12585,1309,1174,8.19,0,68.4,355982,3037,354057,1.91,1.72,0.18399122807017543,0.85,99.46
2021-02-28,Karnataka,1619,23,1614,19950,455,319,8.12,0,68.4,357601,3060,355671,0.67,0.47,0.2916666666666667,0.86,99.46
2021-03-01,Karnataka,549,3,543,6917,2415,1896,7.94,3,68.4,358150,3063,356214,3.53,2.77,0.10112573099415205,0.86,99.46
2021-03-02,Karnataka,729,4,721,9478,4025,2314,7.69,4,68.4,358879,3067,356935,5.88,3.38,0.1385672514619883,0.85,99.46
2021-03-03,Karnataka,1576,17,1571,19581,422,132,8.05,0,68.4,360455,3084,358506,0.62,0.19,0.2862719298245614,0.86,99.46
2021-03-04,Karnataka,1414,6,1413,17449,3890,3027,8.1,0,68.4,361869,3090,359919,5.69,4.43,0.25510233918128655,0.85,99.46
2021-03-05,Karnataka,1057,10,1055,12934,3898,1747,8.17,0,68.4,362926,3100,360974,5.7,2.55,0.18909356725146198,0.85,99.46
2021-03-06,Karnataka,1023,12,1019,12789,2260,1494,8.0,0,68.4,363949,3112,361993,3.3,2.18,0.18697368421052632,0.86,99.46
2021-03-07,Karnataka,178,0,176,2197,3790,1425,8.1,2,68.4,364127,3112,362169,5.54,2.08,0.03211988304093567,0.85,99.46
2021-03-08,Karnataka,434,5,426,5109,3735,200,8.49,3,68.4,364561,3117,362595,5.46,0.29,0.07469298245614035,0.86,99.46
2021-03-09,Karnataka,962,4,961,12037,2107,1791,7.99,0,68.4,365523,3121,363556,3.08,2.62,0.17597953216374268,0.85,99.46
2021-03-10,Karnataka,780,9,774,10064,2129,136,7.75,0,68.4,366303,3130,364330,3.11,0.2,0.14713450292397662,0.85,99.46
2021-03-11,Karnataka,1082,7,1080,13668,3787,3527,7.92,0,68.4,367385,3137,365410,5.54,5.16,0.19982456140350877,0.85,99.46
2021-03-12,Karnataka,573,8,569,7738,4440,2478,7.41,0,68.4,367958,3145,365979,6.49,3.62,0.11312865497076023,0.85,99.46
2021-03-13,Karnataka,540,5,534,6564,2403,1244,8.23,1,68.4,368498,3150,366513,3.51,1.82,0.09596491228070175,0.85,99.46
2021-03-14,Karnataka,1046,7,1038,12992,3546,354,8.05,1,68.4,369544,3157,367551,5.18,0.52,0.18994152046783624,0.85,99.46
2021-03-15,Karnataka,1143,11,1138,14541,4131,3542,7.86,0,68.4,370687,3168,368689,6.04,5.18,0.2125877192982456,0.85,99.46
2021-03-16,Karnataka,1043,11,1034,12976,647,135,8.04,0,68.4,371730,3179,369723,0.95,0.2,0.1897076023391813,0.86,99.46
2021-03-17,Karnataka,487,4,478,6510,907,200,7.48,5,68.4,372217,3183,370201,1.33,0.29,0.09517543859649123,0.86,99.46
2021-03-18,Karnataka,909,3,908,11650,3806,2099,7.8,0,68.4,373126,3186,371109,5.56,3.07,0.1703216374269006,0.85,99.46
2021-03-19,Karnataka,343,4,339,4197,2869,2604,8.17,0,68.4,373469,3190,371448,4.19,3.81,0.06135964912280702,0.85,99.46
2021-03-20,Karnataka,1616,12,1613,19812,3218,2544,8.16,0,68.4,375085,3202,373061,4.7,3.72,0.28964912280701754,0.85,99.46
2021-03-21,Karnataka,1279,17,1274,16357,2720,2539,7.82,0,68.4,376364,3219,374335,3.98,3.71,0.2391374269005848,0.86,99.46
2021-03-22,Karnataka,1550,12,1545,19544,2544,2400,7.93,0,68.4,377914,3231,375880,3.72,3.51,0.2857309941520468,0.85,99.46
2021-03-23,Karnataka,1204,9,1201,14985,933,704,8.03,0,68.4,379118,3240,377081,1.36,1.03,0.21907894736842104,0.85,99.46
2021-03-24,Karnataka,656,4,648,8215,1175,225,7.99,4,68.4,379774,3244,377729,1.72,0.33,0.12010233918128654,0.85,99.46
2021-03-25,Karnataka,1514,19,1507,18960,4930,760,7.99,0,68.4,381288,3263,379236,7.21,1.11,0.2771929824561403,0.86,99.46
2021-03-26,Karnataka,715,9,710,9599,1565,1453,7.45,0,68.4,382003,3272,379946,2.29,2.12,0.1403362573099415,0.86,99.46
2021-03-27,Karnataka,720,7,715,9164,2755,903,7.86,0,68.4,382723,3279,380661,4.03,1.32,0.1339766081871345,0.86,99.46
2021-03-28,Karnataka,1464,19,1464,18442,2813,106,7.94,0,68.4,384187,3298,382125,4.11,0.15,0.26961988304093565,0.86,99.46
2021-03-29,Karnataka,1221,14,1213,15390,1239,1114,7.93,0,68.4,385408,3312,383338,1.81,1.63,0.225,0.86,99.46
2021-03-30,Karnataka,969,4,964,11926,1485,223,8.13,1,68.4,386377,3316,384302,2.17,0.33,0.17435672514619882,0.86,99.46
2021-03-31,Karnataka,224,2,215,2714,1564,847,8.25,7,68.4,386601,3318,384517,2.29,1.24,0.03967836257309942,0.86,99.46
2021-04-01,Karnataka,988,13,988,12573,2937,1333,7.86,0,68.4,387589,3331,385505,4.29,1.95,0.1838157894736842,0.86,99.46
2021-04-02,Karnataka,1441,13,1436,17556,4254,1067,8.21,0,68.4,389030,3344,386941,6.22,1.56,0.25666666666666665,0.86,99.46
2021-04-03,Karnataka,494,3,491,6217,1627,1173,7.95,0,68.4,389524,3347,387432,2.38,1.71,0.09089181286549708,0.86,99.46
2021-04-04,Karnataka,787,4,783,10013,4411,972,7.86,0,68.4,390311,3351,388215,6.45,1.42,0.1463888888888889,0.86,99.46
2021-04-05,Karnataka,501,6,498,6166,1196,1086,8.13,0,68.4,390812,3357,388713,1.75,1.59,0.09014619883040936,0.86,99.46
2021-04-06,Karnataka,514,1,513,6411,1310,479,8.02,0,68.4,391326,3358,389226,1.92,0.7,0.09372807017543859,0.86,99.46
2021-04-07,Karnataka,1119,14,1116,14076,2834,802,7.95,0,68.4,392445,3372,390342,4.14,1.17,0.20578947368421052,0.86,99.46
2021-04-08,Karnataka,351,1,346,4588,1655,863,7.65,4,68.4,392796,3373,390688,2.42,1.26,0.06707602339181287,0.86,99.46
2021-04-09,Karnataka,690,8,685,8653,4384,619,7.97,0,68.4,393486,3381,391373,6.41,0.9,0.12650584795321637,0.86,99.46
2021-04-10,Karnataka,362,4,358,4947,2236,1784,7.32,0,68.4,393848,3385,391731,3.27,2.61,0.07232456140350878,0.86,99.46
2021-04-11,Karnataka,154,1,147,1902,85,84,8.1,6,68.4,394002,3386,391878,0.12,0.12,0.027807017543859648,0.86,99.46
2021-04-12,Karnataka,462,1,455,6071,668,353,7.61,6,68.4,394464,3387,392333,0.98,0.52,0.08875730994152047,0.86,99.46
2021-04-13,Karnataka,64,0,58,752,132,116,8.51,6,68.4,394528,3387,392391,0.19,0.17,0.010994152046783626,0.86,99.46
2021-04-14,Karnataka,757,7,748,9184,1584,329,8.24,2,68.4,395285,3394,393139,2.32,0.48,0.1342690058479532,0.86,99.46
2021-04-15,Karnataka,1136,12,1135,13887,3596,2152,8.18,0,68.4,396421,3406,394274,5.26,3.15,0.2030263157894737,0.86,99.46
2021-04-16,Karnataka,1123,12,1122,13949,255,211,8.05,0,68.4,397544,3418,395396,0.37,0.31,0.2039327485380117,0.86,99.46
2021-04-17,Karnataka,749,2,741,9227,3175,2534,8.12,6,68.4,398293,3420,396137,4.64,3.7,0.13489766081871346,0.86,99.46
2021-04-18,Karnataka,534,7,531,6494,4314,3541,8.22,0,68.4,398827,3427,396668,6.31,5.18,0.09494152046783626,0.86,99.46
2021-04-19,Karnataka,1578,10,1577,19914,268,105,7.92,0,68.4,400405,3437,398245,0.39,0.15,0.291140350877193,0.86,99.46
2021-04-20,Karnataka,505,4,498,6488,3420,2775,7.78,3,68.4,400910,3441,398743,5.0,4.06,0.09485380116959065,0.86,99.46
2021-04-21,Karnataka,97,0,91,808,3032,366,12.0,6,68.4,401007,3441,398834,4.43,0.54,0.011812865497076023,0.86,99.46
2021-04-22,Karnataka,602,3,593,7501,1583,1251,8.03,6,68.4,401609,3444,399427,2.31,1.83,0.10966374269005848,0.86,99.46
2021-04-23,Karnataka,247,0,239,3064,3997,2574,8.06,8,68.4,401856,3444,399666,5.84,3.76,0.0447953216374269,0.86,99.46
2021-04-24,Karnataka,1015,8,1011,13189,1549,878,7.7,0,68.4,402871,3452,400677,2.26,1.28,0.1928216374269006,0.86,99.46
2021-04-25,Karnataka,138,1,132,1409,838,96,9.79,5,68.4,403009,3453,400809,1.23,0.14,0.020599415204678364,0.86,99.45
2021-04-26,Karnataka,105,0,99,1213,2050,1990,8.66,6,68.4,403114,3453,400908,3.0,2.91,0.01773391812865497,0.86,99.45
2021-04-27,Karnataka,1299,16,1291,16139,3047,2910,8.05,0,68.4,404413,3469,402199,4.45,4.25,0.23595029239766083,0.86,99.45
2021-04-28,Karnataka,1502,5,1499,18669,4598,4174,8.05,0,68.4,405915,3474,403698,6.72,6.1,0.2729385964912281,0.86,99.45
2021-04-29,Karnataka,1006,3,1005,12794,4271,3548,7.86,0,68.4,406921,3477,404703,6.24,5.19,0.187046783625731,0.85,99.45
2021-04-30,Karnataka,475,5,473,5774,4965,3932,8.23,0,68.4,407396,3482,405176,7.26,5.75,0.08441520467836257,0.85,99.46
2021-05-01,Karnataka,1377,15,1370,17593,62,14,7.83,0,68.4,408773,3497,406546,0.09,0.02,0.2572076023391813,0.86,99.46
2021-05-02,Karnataka,1047,9,1047,13158,2936,2897,7.96,0,68.4,409820,3506,407593,4.29,4.24,0.19236842105263158,0.86,99.46
2021-05-03,Karnataka,803,9,800,10246,1138,1120,7.84,0,68.4,410623,3515,408393,1.66,1.64,0.1497953216374269,0.86,99.46
2021-05-04,Karnataka,120,0,111,1834,312,274,6.54,9,68.4,410743,3515,408504,0.46,0.4,0.026812865497076024,0.86,99.45
2021-05-05,Karnataka,775,9,768,9838,675,11,7.88,0,68.4,411518,3524,409272,0.99,0.02,0.14383040935672514,0.86,99.45
2021-05-06,Karnataka,287,1,285,3331,1591,1382,8.62,1,68.4,411805,3525,409557,2.33,2.02,0.04869883040935673,0.86,99.45
2021-05-07,Karnataka,1504,9,1499,18731,3575,1466,8.03,0,68.4,413309,3534,411056,5.23,2.14,0.27384502923976606,0.86,99.45
2021-05-08,Karnataka,1571,21,1563,19933,4838,3800,7.88,0,68.4,414880,3555,412619,7.07,5.56,0.29141812865497074,0.86,99.46
2021-05-09,Karnataka,758,3,757,9854,4986,1508,7.69,0,68.4,415638,3558,413376,7.29,2.2,0.14406432748538012,0.86,99.46
2021-05-10,Karnataka,239,1,232,2944,2025,1107,8.12,6,68.4,415877,3559,413608,2.96,1.62,0.04304093567251462,0.86,99.45
2021-05-11,Karnataka,432,4,425,4953,2996,238,8.72,3,68.4,416309,3563,414033,4.38,0.35,0.07241228070175439,0.86,99.45
2021-05-12,Karnataka,602,2,593,7491,2618,1247,8.04,7,68.4,416911,3565,414626,3.83,1.82,0.10951754385964912,0.86,99.45
2021-05-13,Karnataka,1338,10,1331,16900,1280,60,7.92,0,68.4,418249,3575,415957,1.87,0.09,0.24707602339181287,0.85,99.45
2021-05-14,Karnataka,1081,4,1073,13919,4557,1338,7.77,4,68.4,419330,3579,417030,6.66,1.96,0.20349415204678362,0.85,99.45
2021-05-15,Karnataka,1396,10,1395,17692,1243,190,7.89,0,68.4,420726,3589,418425,1.82,0.28,0.2586549707602339,0.85,99.45
2021-05-16,Karnataka,857,11,856,11039,1594,338,7.76,0,68.4,421583,3600,419281,2.33,0.49,0.1613888888888889,0.85,99.45
2021-05-17,Karnataka,994,11,994,11987,4548,694,8.29,0,68.4,422577,3611,420275,6.65,1.01,0.1752485380116959,0.85,99.46
2021-05-18,Karnataka,718,9,712,9197,4526,632,7.81,0,68.4,423295,3620,420987,6.62,0.92,0.1344590643274854,0.86,99.45
2021-05-19,Karnataka,1507,22,1504,19163,2629,1953,7.86,0,68.4,424802,3642,422491,3.84,2.86,0.2801608187134503,0.86,99.46
2021-05-20,Karnataka,777,6,775,10204,2880,852,7.61,0,68.4,425579,3648,423266,4.21,1.25,0.1491812865497076,0.86,99.46
2021-05-21,Karnataka,365,2,361,4452,2502,2260,8.2,2,68.4,425944,3650,423627,3.66,3.3,0.06508771929824561,0.86,99.46
2021-05-22,Karnataka,199,1,193,2410,1393,223,8.26,5,68.4,426143,3651,423820,2.04,0.33,0.03523391812865497,0.86,99.45
2021-05-23,Karnataka,1355,15,1351,17332,4955,2111,7.82,0,68.4,427498,3666,425171,7.24,3.09,0.25339181286549706,0.86,99.46
2021-05-24,Karnataka,1169,11,1166,14445,2715,673,8.09,0,68.4,428667,3677,426337,3.97,0.98,0.21118421052631578,0.86,99.46
2021-05-25,Karnataka,629,2,620,8133,688,318,7.73,7,68.4,429296,3679,426957,1.01,0.46,0.11890350877192983,0.86,99.46
2021-05-26,Karnataka,1005,3,1001,12370,831,461,8.12,1,68.4,430301,3682,427958,1.21,0.67,0.18084795321637426,0.86,99.46
2021-05-27,Karnataka,897,9,889,11212,3211,2435,8.0,0,68.4,431198,3691,428847,4.69,3.56,0.16391812865497077,0.86,99.45
2021-05-28,Karnataka,1117,7,1116,13852,1712,1143,8.06,0,68.4,432315,3698,429963,2.5,1.67,0.20251461988304092,0.86,99.46
2021-05-29,Karnataka,1088,12,1079,13883,1121,347,7.84,0,68.4,433403,3710,431042,1.64,0.51,0.20296783625730994,0.86,99.46
2021-05-30,Karnataka,211,1,203,2536,84,61,8.32,7,68.4,433614,3711,431245,0.12,0.09,0.037076023391812866,0.86,99.45
2021-05-31,Karnataka,1551,22,1545,19313,548,85,8.03,0,68.4,435165,3733,432790,0.8,0.12,0.28235380116959063,0.86,99.45
2021-06-01,Karnataka,1054,10,1048,12927,4405,1453,8.15,0,68.4,436219,3743,433838,6.44,2.12,0.18899122807017543,0.86,99.45
2021-06-02,Karnataka,1359,19,1353,17239,194,155,7.88,0,68.4,437578,3762,435191,0.28,0.23,0.25203216374269005,0.86,99.45
2021-06-03,Karnataka,1077,14,1068,13820,4049,1844,7.79,0,68.4,438655,3776,436259,5.92,2.7,0.202046783625731,0.86,99.45
2021-06-04,Karnataka,1588,14,1583,19531,2768,692,8.13,0,68.4,440243,3790,437842,4.05,1.01,0.2855409356725146,0.86,99.45
2021-06-05,Karnataka,1571,12,1568,19907,1043,803,7.89,0,68.4,441814,3802,439410,1.52,1.17,0.29103801169590643,0.86,99.46
2021-06-06,Karnataka,984,6,980,12178,4124,221,8.08,0,68.4,442798,3808,440390,6.03,0.32,0.1780409356725146,0.86,99.46
2021-06-07,Karnataka,1008,11,1001,12509,1029,644,8.06,0,68.4,443806,3819,441391,1.5,0.94,0.18288011695906434,0.86,99.46
2021-06-08,Karnataka,328,2,320,4202,3243,904,7.81,6,68.4,444134,3821,441711,4.74,1.32,0.06143274853801169,0.86,99.45
2021-06-09,Karnataka,1077,7,1077,13033,1622,1191,8.26,0,68.4,445211,3828,442788,2.37,1.74,0.19054093567251462,0.86,99.46
2021-06-10,Karnataka,170,1,168,2159,1030,253,7.87,1,68.4,445381,3829,442956,1.51,0.37,0.031564327485380114,0.86,99.46
2021-06-11,Karnataka,1077,5,1069,13491,805,330,7.98,3,68.4,446458,3834,444025,1.18,0.48,0.19723684210526315,0.86,99.46
2021-06-12,Karnataka,1070,9,1069,13539,987,22,7.9,0,68.4,447528,3843,445094,1.44,0.03,0.19793859649122808,0.86,99.46
2021-06-13,Karnataka,522,2,520,6407,1103,611,8.15,0,68.4,448050,3845,445614,1.61,0.89,0.09366959064327485,0.86,99.46
2021-06-14,Karnataka,213,0,212,2898,2355,118,7.35,1,68.4,448263,3845,445826,3.44,0.17,0.042368421052631576,0.86,99.46
2021-06-15,Karnataka,289,2,282,3278,3049,1065,8.82,5,68.4,448552,3847,446108,4.46,1.56,0.04792397660818713,0.86,99.46
2021-06-16,Karnataka,1558,5,1550,19001,3776,3183,8.2,3,68.4,450110,3852,447658,5.52,4.65,0.2777923976608187,0.86,99.46
2021-06-17,Karnataka,49,0,44,780,576,234,6.28,5,68.4,450159,3852,447702,0.84,0.34,0.011403508771929825,0.86,99.45
2021-06-18,Karnataka,1047,4,1045,13231,4687,4014,7.91,0,68.4,451206,3856,448747,6.85,5.87,0.19343567251461988,0.85,99.46
2021-06-19,Karnataka,425,5,418,5347,4920,330,7.95,2,68.4,451631,3861,449165,7.19,0.48,0.07817251461988305,0.85,99.45
2021-06-20,Karnataka,477,6,468,6091,4355,1810,7.83,3,68.4,452108,3867,449633,6.37,2.65,0.08904970760233918,0.86,99.45
2021-06-21,Karnataka,432,2,426,5193,2490,1359,8.32,4,68.4,452540,3869,450059,3.64,1.99,0.07592105263157894,0.85,99.45
2021-06-22,Karnataka,1528,21,1525,19576,3993,2985,7.81,0,68.4,454068,3890,451584,5.84,4.36,0.28619883040935673,0.86,99.45
2021-06-23,Karnataka,1491,12,1490,18714,51,32,7.97,0,68.4,455559,3902,453074,0.07,0.05,0.27359649122807017,0.86,99.45
2021-06-24,Karnataka,1375,16,1369,17184,1180,84,8.0,0,68.4,456934,3918,454443,1.73,0.12,0.2512280701754386,0.86,99.45
2021-06-25,Karnataka,483,3,474,5838,3175,76,8.27,6,68.4,457417,3921,454917,4.64,0.11,0.08535087719298246,0.86,99.45
2021-06-26,Karnataka,392,1,384,4393,3467,2821,8.92,7,68.4,457809,3922,455301,5.07,4.12,0.06422514619883041,0.86,99.45
2021-06-27,Karnataka,1225,16,1225,15286,1917,366,8.01,0,68.4,459034,3938,456526,2.8,0.54,0.2234795321637427,0.86,99.45
2021-06-28,Karnataka,1321,11,1314,16453,3134,2434,8.03,0,68.4,460355,3949,457840,4.58,3.56,0.2405409356725146,0.86,99.45
2021-06-29,Karnataka,1409,14,1404,17349,3462,2808,8.12,0,68.4,461764,3963,459244,5.06,4.11,0.253640350877193,0.86,99.45
2021-06-30,Karnataka,1473,7,1465,18464,3666,1983,7.98,1,68.4,463237,3970,460709,5.36,2.9,0.26994152046783626,0.86,99.45
2021-07-01,Karnataka,1198,17,1194,15016,4332,4133,7.98,0,68.4,464435,3987,461903,6.33,6.04,0.21953216374269005,0.86,99.45
2021-07-02,Karnataka,101,1,97,1437,3615,926,7.03,3,68.4,464536,3988,462000,5.29,1.35,0.02100877192982456,0.86,99.45
2021-07-03,Karnataka,797,10,790,10487,4631,846,7.6,0,68.4,465333,3998,462790,6.77,1.24,0.1533187134502924,0.86,99.45
2021-07-04,Karnataka,1435,14,1429,18127,3461,1281,7.92,0,68.4,466768,4012,464219,5.06,1.87,0.2650146198830409,0.86,99.45
2021-07-05,Karnataka,667,2,663,8735,2770,2334,7.64,2,68.4,467435,4014,464882,4.05,3.41,0.1277046783625731,0.86,99.45
2021-07-06,Karnataka,741,6,740,9641,2746,1262,7.69,0,68.4,468176,4020,465622,4.01,1.85,0.14095029239766083,0.86,99.45
2021-07-07,Karnataka,1299,9,1294,16297,1372,1348,7.97,0,68.4,469475,4029,466916,2.01,1.97,0.23826023391812864,0.86,99.45
2021-07-08,Karnataka,850,12,841,10798,2596,540,7.87,0,68.4,470325,4041,467757,3.8,0.79,0.1578654970760234,0.86,99.45
2021-07-09,Karnataka,157,1,157,1614,419,304,9.73,0,68.4,470482,4042,467914,0.61,0.44,0.023596491228070175,0.86,99.45
2021-07-10,Karnataka,959,3,954,12260,1810,1188,7.82,2,68.4,471441,4045,468868,2.65,1.74,0.17923976608187134,0.86,99.45
2021-07-11,Karnataka,476,6,476,6102,4345,3428,7.8,0,68.4,471917,4051,469344,6.35,5.01,0.08921052631578948,0.86,99.45
2021-07-12,Karnataka,947,9,944,11501,4885,4751,8.23,0,68.4,472864,4060,470288,7.14,6.95,0.16814327485380118,0.86,99.46
2021-07-13,Karnataka,795,8,791,10082,4742,1492,7.89,0,68.4,473659,4068,471079,6.93,2.18,0.14739766081871344,0.86,99.46
2021-07-14,Karnataka,1388,4,1385,17194,4523,256,8.07,0,68.4,475047,4072,472464,6.61,0.37,0.251374269005848,0.86,99.46
2021-07-15,Karnataka,488,3,482,5970,2259,611,8.17,3,68.4,475535,4075,472946,3.3,0.89,0.08728070175438596,0.86,99.46
2021-07-16,Karnataka,691,6,686,8445,827,726,8.18,0,68.4,476226,4081,473632,1.21,1.06,0.12346491228070175,0.86,99.46
2021-07-17,Karnataka,1054,9,1047,13109,3690,1316,8.04,0,68.4,477280,4090,474679,5.39,1.92,0.19165204678362574,0.86,99.46
2021-07-18,Karnataka,576,3,569,7218,3357,2678,7.98,4,68.4,477856,4093,475248,4.91,3.92,0.10552631578947369,0.86,99.45
2021-07-19,Karnataka,428,4,425,5392,1815,1657,7.94,0,68.4,478284,4097,475673,2.65,2.42,0.07883040935672514,0.86,99.45
2021-07-20,Karnataka,1272,17,1271,15571,2896,695,8.17,0,68.4,479556,4114,476944,4.23,1.02,0.22764619883040935,0.86,99.46
2021-07-21,Karnataka,1259,9,1254,16029,1479,227,7.85,0,68.4,480815,4123,478198,2.16,0.33,0.2343421052631579,0.86,99.46
2021-07-22,Karnataka,814,4,814,9681,1794,582,8.41,0,68.4,481629,4127,479012,2.62,0.85,0.14153508771929824,0.86,99.46
2021-07-23,Karnataka,1542,11,1542,19118,10,1,8.07,0,68.4,483171,4138,480554,0.01,0.0,0.2795029239766082,0.86,99.46
2021-07-24,Karnataka,783,5,778,10002,444,247,7.83,0,68.4,483954,4143,481332,0.65,0.36,0.1462280701754386,0.86,99.46
2021-07-25,Karnataka,1365,15,1360,17326,2043,1298,7.88,0,68.4,485319,4158,482692,2.99,1.9,0.2533040935672515,0.86,99.46
2021-07-26,Karnataka,1106,4,1101,14184,1784,797,7.8,1,68.4,486425,4162,483793,2.61,1.17,0.2073684210526316,0.86,99.46
2021-07-27,Karnataka,581,3,581,7426,4943,3723,7.82,0,68.4,487006,4165,484374,7.23,5.44,0.1085672514619883,0.86,99.46
2021-07-28,Karnataka,519,3,518,6424,3026,188,8.08,0,68.4,487525,4168,484892,4.42,0.27,0.09391812865497076,0.85,99.46
2021-07-29,Karnataka,246,0,243,3034,3237,2254,8.11,3,68.4,487771,4168,485135,4.73,3.3,0.04435672514619883,0.85,99.46
2021-07-30,Karnataka,550,2,545,7169,4549,791,7.67,3,68.4,488321,4170,485680,6.65,1.16,0.10480994152046784,0.85,99.46
2021-07-31,Karnataka,775,3,775,9577,2952,1370,8.09,0,68.4,489096,4173,486455,4.32,2.0,0.14001461988304092,0.85,99.46
2021-08-01,Karnataka,345,1,344,4649,318,2,7.42,0,68.4,489441,4174,486799,0.46,0.0,0.06796783625730994,0.85,99.46
2021-08-02,Karnataka,721,9,716,9364,2243,1389,7.7,0,68.4,490162,4183,487515,3.28,2.03,0.13690058479532163,0.85,99.46
2021-08-03,Karnataka,1325,14,1319,16339,2751,2059,8.11,0,68.4,491487,4197,488834,4.02,3.01,0.23887426900584796,0.85,99.46
2021-08-04,Karnataka,1457,17,1449,18042,154,80,8.08,0,68.4,492944,4214,490283,0.23,0.12,0.2637719298245614,0.85,99.46
2021-08-05,Karnataka,1565,12,1557,19541,3407,934,8.01,0,68.4,494509,4226,491840,4.98,1.37,0.285687134502924,0.85,99.46
2021-08-06,Karnataka,1338,16,1337,16771,2517,2504,7.98,0,68.4,495847,4242,493177,3.68,3.66,0.24519005847953215,0.86,99.46
2021-08-07,Karnataka,1282,11,1277,16472,488,327,7.78,0,68.4,497129,4253,494454,0.71,0.48,0.2408187134502924,0.86,99.46
2021-08-08,Karnataka,638,5,629,8061,2930,2153,7.91,4,68.4,497767,4258,495083,4.28,3.15,0.11785087719298246,0.86,99.46
2021-08-09,Karnataka,878,4,875,10481,4747,2715,8.38,0,68.4,498645,4262,495958,6.94,3.97,0.15323099415204677,0.85,99.46
2021-08-10,Karnataka,756,6,756,9322,475,307,8.11,0,68.4,499401,4268,496714,0.69,0.45,0.13628654970760234,0.85,99.46
2021-08-11,Karnataka,335,1,331,3854,3170,2158,8.69,3,68.4,499736,4269,497045,4.63,3.15,0.05634502923976608,0.85,99.46
2021-08-12,Karnataka,987,7,979,12461,2830,320,7.92,1,68.4,500723,4276,498024,4.14,0.47,0.1821783625730994,0.85,99.46
2021-08-13,Karnataka,1349,14,1345,16720,1698,1231,8.07,0,68.4,502072,4290,499369,2.48,1.8,0.24444444444444444,0.85,99.46
2021-08-14,Karnataka,883,2,878,11002,4616,3691,8.03,3,68.4,502955,4292,500247,6.75,5.4,0.16084795321637427,0.85,99.46
2021-08-15,Karnataka,1001,12,993,12698,1576,708,7.88,0,68.4,503956,4304,501240,2.3,1.04,0.18564327485380117,0.85,99.46
2021-08-16,Karnataka,1506,8,1503,18985,4997,4764,7.93,0,68.4,505462,4312,502743,7.31,6.96,0.2775584795321637,0.85,99.46
2021-08-17,Karnataka,1229,5,1229,15497,1549,902,7.93,0,68.4,506691,4317,503972,2.26,1.32,0.2265643274853801,0.85,99.46
2021-08-18,Karnataka,558,2,556,6822,1817,1305,8.18,0,68.4,507249,4319,504528,2.66,1.91,0.09973684210526315,0.85,99.46
2021-08-19,Karnataka,245,0,243,3354,572,195,7.3,2,68.4,507494,4319,504771,0.84,0.29,0.049035087719298244,0.85,99.46
2021-08-20,Karnataka,558,8,556,6868,3607,2353,8.12,0,68.4,508052,4327,505327,5.27,3.44,0.1004093567251462,0.85,99.46
2021-08-21,Karnataka,1503,19,1503,18807,4589,1263,7.99,0,68.4,509555,4346,506830,6.71,1.85,0.2749561403508772,0.85,99.47
2021-08-22,Karnataka,738,10,738,8958,2513,899,8.24,0,68.4,510293,4356,507568,3.67,1.31,0.13096491228070176,0.85,99.47
2021-08-23,Karnataka,269,0,262,3233,3208,991,8.32,7,68.4,510562,4356,507830,4.69,1.45,0.04726608187134503,0.85,99.46
2021-08-24,Karnataka,1092,11,1085,13756,4914,2885,7.94,0,68.4,511654,4367,508915,7.18,4.22,0.2011111111111111,0.85,99.46
2021-08-25,Karnataka,392,5,391,5088,357,7,7.7,0,68.4,512046,4372,509306,0.52,0.01,0.07438596491228071,0.85,99.46
2021-08-26,Karnataka,269,1,269,3659,2486,2126,7.35,0,68.4,512315,4373,509575,3.63,3.11,0.05349415204678363,0.85,99.47
2021-08-27,Karnataka,1428,7,1427,17628,2481,122,8.1,0,68.4,513743,4380,511002,3.63,0.18,0.257719298245614,0.85,99.47
2021-08-28,Karnataka,890,9,885,11167,3988,232,7.97,0,68.4,514633,4389,511887,5.83,0.34,0.16326023391812866,0.85,99.47
2021-08-29,Karnataka,1428,14,1426,17741,4402,1913,8.05,0,68.4,516061,4403,513313,6.44,2.8,0.25937134502923975,0.85,99.47
2021-08-30,Karnataka,1341,13,1341,16670,1743,1015,8.04,0,68.4,517402,4416,514654,2.55,1.48,0.24371345029239766,0.85,99.47
2021-08-31,Karnataka,1341,18,1333,16613,3709,1438,8.07,0,68.4,518743,4434,515987,5.42,2.1,0.24288011695906433,0.85,99.47
2021-09-01,Karnataka,214,1,210,2332,276,188,9.18,3,68.4,518957,4435,516197,0.4,0.27,0.03409356725146199,0.85,99.47
2021-09-02,Karnataka,771,4,767,9759,726,573,7.9,0,68.4,519728,4439,516964,1.06,0.84,0.14267543859649123,0.85,99.47
2021-09-03,Karnataka,1426,12,1424,17527,3937,1461,8.14,0,68.4,521154,4451,518388,5.76,2.14,0.25624269005847955,0.85,99.47
2021-09-04,Karnataka,794,10,785,9891,4527,4054,8.03,0,68.4,521948,4461,519173,6.62,5.93,0.14460526315789474,0.85,99.47
2021-09-05,Karnataka,490,5,485,6075,127,90,8.07,0,68.4,522438,4466,519658,0.19,0.13,0.08881578947368421,0.85,99.47
2021-09-06,Karnataka,229,1,226,2678,1072,244,8.55,2,68.4,522667,4467,519884,1.57,0.36,0.03915204678362573,0.85,99.47
2021-09-07,Karnataka,483,4,483,5636,4347,1860,8.57,0,68.4,523150,4471,520367,6.36,2.72,0.08239766081871346,0.85,99.47
2021-09-08,Karnataka,928,8,925,11566,3011,2639,8.02,0,68.4,524078,4479,521292,4.4,3.86,0.169093567251462,0.85,99.47
2021-09-09,Karnataka,876,10,872,10928,4488,674,8.02,0,68.4,524954,4489,522164,6.56,0.99,0.15976608187134503,0.86,99.47
2021-09-10,Karnataka,1365,18,1361,16617,1520,1487,8.21,0,68.4,526319,4507,523525,2.22,2.17,0.24293859649122806,0.86,99.47
2021-09-11,Karnataka,1527,12,1518,19254,4318,2028,7.93,0,68.4,527846,4519,525043,6.31,2.96,0.28149122807017546,0.86,99.47
2021-09-12,Karnataka,545,3,536,6833,667,80,7.98,6,68.4,528391,4522,525579,0.98,0.12,0.09989766081871344,0.86,99.47
2021-09-13,Karnataka,430,3,425,5752,3386,159,7.48,2,68.4,528821,4525,526004,4.95,0.23,0.08409356725146198,0.86,99.47
2021-09-14,Karnataka,892,11,887,11228,1689,1294,7.94,0,68.4,529713,4536,526891,2.47,1.89,0.16415204678362574,0.86,99.47
2021-09-15,Karnataka,1132,11,1130,14091,1060,273,8.03,0,68.4,530845,4547,528021,1.55,0.4,0.20600877192982456,0.86,99.47
2021-09-16,Karnataka,1113,13,1104,14087,3951,3445,7.9,0,68.4,531958,4560,529125,5.78,5.04,0.20595029239766083,0.86,99.47
2021-09-17,Karnataka,769,8,768,9705,4402,3687,7.92,0,68.4,532727,4568,529893,6.44,5.39,0.1418859649122807,0.86,99.47
2021-09-18,Karnataka,680,9,678,8856,3834,1357,7.68,0,68.4,533407,4577,530571,5.61,1.98,0.12947368421052632,0.86,99.47
2021-09-19,Karnataka,202,2,198,2863,3555,408,7.06,2,68.4,533609,4579,530769,5.2,0.6,0.04185672514619883,0.86,99.47
2021-09-20,Karnataka,734,5,731,9260,1053,894,7.93,0,68.4,534343,4584,531500,1.54,1.31,0.13538011695906432,0.86,99.47
2021-09-21,Karnataka,764,11,760,9802,39,7,7.79,0,68.4,535107,4595,532260,0.06,0.01,0.14330409356725146,0.86,99.47
2021-09-22,Karnataka,988,3,981,12514,947,815,7.9,4,68.4,536095,4598,533241,1.38,1.19,0.182953216374269,0.86,99.47
2021-09-23,Karnataka,6,0,0,776,1751,191,0.77,6,68.4,536101,4598,533241,2.56,0.28,0.011345029239766082,0.86,99.47
2021-09-24,Karnataka,1087,11,1087,13751,2465,1882,7.9,0,68.4,537188,4609,534328,3.6,2.75,0.20103801169590643,0.86,99.47
2021-09-25,Karnataka,335,3,326,4145,3711,145,8.08,6,68.4,537523,4612,534654,5.43,0.21,0.06059941520467836,0.86,99.47
2021-09-26,Karnataka,1504,16,1502,18649,1515,1102,8.06,0,68.4,539027,4628,536156,2.21,1.61,0.27264619883040936,0.86,99.47
2021-09-27,Karnataka,1057,5,1057,13558,1324,819,7.8,0,68.4,540084,4633,537213,1.94,1.2,0.19821637426900585,0.86,99.47
2021-09-28,Karnataka,333,1,332,3717,1578,1101,8.96,0,68.4,540417,4634,537545,2.31,1.61,0.05434210526315789,0.86,99.47
2021-09-29,Karnataka,159,0,154,2156,4825,4534,7.37,5,68.4,540576,4634,537699,7.05,6.63,0.03152046783625731,0.86,99.47
2021-09-30,Karnataka,589,7,589,7296,2985,2433,8.07,0,68.4,541165,4641,538288,4.36,3.56,0.10666666666666667,0.86,99.47
2021-10-01,Karnataka,1164,9,1159,14690,1574,97,7.92,0,68.4,542329,4650,539447,2.3,0.14,0.21476608187134502,0.86,99.47
2021-10-02,Karnataka,887,7,879,10986,1376,1225,8.07,1,68.4,543216,4657,540326,2.01,1.79,0.1606140350877193,0.86,99.47
2021-10-03,Karnataka,1127,15,1121,13942,775,306,8.08,0,68.4,544343,4672,541447,1.13,0.45,0.20383040935672514,0.86,99.47
2021-10-04,Karnataka,94,1,88,931,1233,386,10.1,5,68.4,544437,4673,541535,1.8,0.56,0.01361111111111111,0.86,99.47
2021-10-05,Karnataka,1181,6,1177,15176,3183,2347,7.78,0,68.4,545618,4679,542712,4.65,3.43,0.22187134502923977,0.86,99.47
2021-10-06,Karnataka,544,7,537,6549,3752,235,8.31,0,68.4,546162,4686,543249,5.49,0.34,0.09574561403508772,0.86,99.47
2021-10-07,Karnataka,1098,16,1098,13352,4728,2960,8.22,0,68.4,547260,4702,544347,6.91,4.33,0.1952046783625731,0.86,99.47
2021-10-08,Karnataka,555,5,553,6729,4270,876,8.25,0,68.4,547815,4707,544900,6.24,1.28,0.09837719298245615,0.86,99.47
2021-10-09,Karnataka,1000,7,996,12396,204,143,8.07,0,68.4,548815,4714,545896,0.3,0.21,0.1812280701754386,0.86,99.47
2021-10-10,Karnataka,341,1,338,4260,36,26,8.0,2,68.4,549156,4715,546234,0.05,0.04,0.062280701754385964,0.86,99.47
2021-10-11,Karnataka,1583,20,1582,19991,1731,1089,7.92,0,68.4,550739,4735,547816,2.53,1.59,0.292266081871345,0.86,99.47
2021-10-12,Karnataka,588,2,581,7297,1544,194,8.06,5,68.4,551327,4737,548397,2.26,0.28,0.1066812865497076,0.86,99.47
2021-10-13,Karnataka,172,0,166,2707,474,206,6.35,6,68.4,551499,4737,548563,0.69,0.3,0.03957602339181287,0.86,99.47
2021-10-14,Karnataka,1353,13,1345,17475,3061,87,7.74,0,68.4,552852,4750,549908,4.48,0.13,0.25548245614035087,0.86,99.47
2021-10-15,Karnataka,1385,13,1380,17098,1161,662,8.1,0,68.4,554237,4763,551288,1.7,0.97,0.24997076023391812,0.86,99.47
2021-10-16,Karnataka,814,11,813,9976,3360,1699,8.16,0,68.4,555051,4774,552101,4.91,2.48,0.14584795321637428,0.86,99.47
2021-10-17,Karnataka,219,1,218,2372,4889,614,9.23,0,68.4,555270,4775,552319,7.15,0.9,0.03467836257309941,0.86,99.47
2021-10-18,Karnataka,462,2,456,5941,4995,2174,7.78,4,68.4,555732,4777,552775,7.3,3.18,0.08685672514619883,0.86,99.47
2021-10-19,Karnataka,1240,12,1237,15264,508,230,8.12,0,68.4,556972,4789,554012,0.74,0.34,0.2231578947368421,0.86,99.47
2021-10-20,Karnataka,1330,14,1328,16328,2750,323,8.15,0,68.4,558302,4803,555340,4.02,0.47,0.23871345029239766,0.86,99.47
2021-10-21,Karnataka,687,4,686,8725,1458,354,7.87,0,68.4,558989,4807,556026,2.13,0.52,0.12755847953216373,0.86,99.47
2021-10-22,Karnataka,373,3,372,4997,1428,1066,7.46,0,68.4,559362,4810,556398,2.09,1.56,0.07305555555555555,0.86,99.47
2021-10-23,Karnataka,436,5,432,5736,697,670,7.6,0,68.4,559798,4815,556830,1.02,0.98,0.08385964912280702,0.86,99.47
2021-10-24,Karnataka,640,8,638,7660,233,225,8.36,0,68.4,560438,4823,557468,0.34,0.33,0.11198830409356725,0.86,99.47
2021-10-25,Karnataka,228,2,226,2751,4106,4051,8.29,0,68.4,560666,4825,557694,6.0,5.92,0.04021929824561404,0.86,99.47
2021-10-26,Karnataka,952,11,946,11937,272,32,7.98,0,68.4,561618,4836,558640,0.4,0.05,0.17451754385964913,0.86,99.47
2021-10-27,Karnataka,651,8,648,8426,3392,2515,7.73,0,68.4,562269,4844,559288,4.96,3.68,0.12318713450292397,0.86,99.47
2021-10-28,Karnataka,1389,13,1386,16837,923,473,8.25,0,68.4,563658,4857,560674,1.35,0.69,0.2461549707602339,0.86,99.47
2021-10-29,Karnataka,628,5,623,7735,4839,4747,8.12,0,68.4,564286,4862,561297,7.07,6.94,0.11308479532163743,0.86,99.47
2021-10-30,Karnataka,648,6,644,7983,1230,162,8.12,0,68.4,564934,4868,561941,1.8,0.24,0.11671052631578947,0.86,99.47
2021-10-31,Karnataka,1203,4,1194,15015,4784,1611,8.01,5,68.4,566137,4872,563135,6.99,2.36,0.2195175438596491,0.86,99.47
2021-11-01,Karnataka,927,4,925,11612,198,82,7.98,0,68.4,567064,4876,564060,0.29,0.12,0.16976608187134504,0.86,99.47
2021-11-02,Karnataka,1227,9,1224,15494,2814,1855,7.92,0,68.4,568291,4885,565284,4.11,2.71,0.22652046783625732,0.86,99.47
2021-11-03,Karnataka,572,3,565,7638,2518,1897,7.49,4,68.4,568863,4888,565849,3.68,2.77,0.11166666666666666,0.86,99.47
2021-11-04,Karnataka,822,2,821,10021,3183,1724,8.2,0,68.4,569685,4890,566670,4.65,2.52,0.14650584795321636,0.86,99.47
2021-11-05,Karnataka,868,9,860,11300,2594,321,7.68,0,68.4,570553,4899,567530,3.79,0.47,0.1652046783625731,0.86,99.47
2021-11-06,Karnataka,617,5,615,7467,1428,1289,8.26,0,68.4,571170,4904,568145,2.09,1.88,0.10916666666666666,0.86,99.47
2021-11-07,Karnataka,1518,16,1510,18833,3093,1335,8.06,0,68.4,572688,4920,569655,4.52,1.95,0.27533625730994155,0.86,99.47
2021-11-08,Karnataka,1038,13,1031,13173,392,234,7.88,0,68.4,573726,4933,570686,0.57,0.34,0.1925877192982456,0.86,99.47
2021-11-09,Karnataka,538,4,530,6538,3577,1660,8.23,4,68.4,574264,4937,571216,5.23,2.43,0.09558479532163743,0.86,99.47
2021-11-10,Karnataka,1096,10,1094,13645,844,788,8.03,0,68.4,575360,4947,572310,1.23,1.15,0.19948830409356724,0.86,99.47
2021-11-11,Karnataka,268,1,268,3577,2287,1475,7.49,0,68.4,575628,4948,572578,3.34,2.16,0.0522953216374269,0.86,99.47
2021-11-12,Karnataka,565,2,564,7307,2158,2039,7.73,0,68.4,576193,4950,573142,3.15,2.98,0.10682748538011697,0.86,99.47
2021-11-13,Karnataka,836,6,833,10273,35,0,8.14,0,68.4,577029,4956,573975,0.05,0.0,0.15019005847953215,0.86,99.47
2021-11-14,Karnataka,1318,7,1313,16810,4858,3504,7.84,0,68.4,578347,4963,575288,7.1,5.12,0.24576023391812865,0.86,99.47
2021-11-15,Karnataka,1482,17,1473,18616,2010,1885,7.96,0,68.4,579829,4980,576761,2.94,2.76,0.2721637426900585,0.86,99.47
2021-11-16,Karnataka,306,2,302,4042,525,158,7.57,2,68.4,580135,4982,577063,0.77,0.23,0.05909356725146199,0.86,99.47
2021-11-17,Karnataka,1081,8,1081,13654,147,138,7.92,0,68.4,581216,4990,578144,0.21,0.2,0.19961988304093567,0.86,99.47
2021-11-18,Karnataka,1461,19,1459,18749,764,87,7.79,0,68.4,582677,5009,579603,1.12,0.13,0.2741081871345029,0.86,99.47
2021-11-19,Karnataka,1329,18,1323,16742,3393,342,7.94,0,68.4,584006,5027,580926,4.96,0.5,0.24476608187134502,0.86,99.47
2021-11-20,Karnataka,92,0,83,1180,689,331,7.8,9,68.4,584098,5027,581009,1.01,0.48,0.017251461988304094,0.86,99.47
2021-11-21,Karnataka,929,3,922,11485,2471,2261,8.09,4,68.4,585027,5030,581931,3.61,3.31,0.1679093567251462,0.86,99.47
2021-11-22,Karnataka,1306,16,1301,16596,3522,3255,7.87,0,68.4,586333,5046,583232,5.15,4.76,0.24263157894736842,0.86,99.47
2021-11-23,Karnataka,1411,12,1404,17493,3646,2238,8.07,0,68.4,587744,5058,584636,5.33,3.27,0.2557456140350877,0.86,99.47
2021-11-24,Karnataka,1483,13,1476,18410,2011,1386,8.06,0,68.4,589227,5071,586112,2.94,2.03,0.26915204678362575,0.86,99.47
2021-11-25,Karnataka,990,10,987,12482,4215,1722,7.93,0,68.4,590217,5081,587099,6.16,2.52,0.18248538011695906,0.86,99.47
2021-11-26,Karnataka,1458,13,1452,18238,207,163,7.99,0,68.4,591675,5094,588551,0.3,0.24,0.2666374269005848,0.86,99.47
2021-11-27,Karnataka,1310,9,1302,16598,2799,2288,7.89,0,68.4,592985,5103,589853,4.09,3.35,0.2426608187134503,0.86,99.47
2021-11-28,Karnataka,1404,12,1399,17862,3202,2844,7.86,0,68.4,594389,5115,591252,4.68,4.16,0.261140350877193,0.86,99.47
2021-11-29,Karnataka,1371,4,1367,16993,1609,124,8.07,0,68.4,595760,5119,592619,2.35,0.18,0.24843567251461987,0.86,99.47
2021-11-30,Karnataka,519,7,516,6126,3352,469,8.47,0,68.4,596279,5126,593135,4.9,0.69,0.08956140350877193,0.86,99.47
2021-12-01,Karnataka,933,10,929,11943,1421,306,7.81,0,68.4,597212,5136,594064,2.08,0.45,0.17460526315789474,0.86,99.47
2021-12-02,Karnataka,1295,18,1287,16219,2737,2241,7.98,0,68.4,598507,5154,595351,4.0,3.28,0.23711988304093568,0.86,99.47
2021-12-03,Karnataka,666,3,658,8332,4260,1748,7.99,5,68.4,599173,5157,596009,6.23,2.56,0.12181286549707603,0.86,99.47
2021-12-04,Karnataka,734,5,733,8899,4775,3252,8.25,0,68.4,599907,5162,596742,6.98,4.75,0.13010233918128655,0.86,99.47
2021-12-05,Karnataka,1355,11,1351,16673,4462,3093,8.13,0,68.4,601262,5173,598093,6.52,4.52,0.24375730994152048,0.86,99.47
2021-12-06,Karnataka,1215,6,1209,15268,2557,537,7.96,0,68.4,602477,5179,599302,3.74,0.79,0.22321637426900584,0.86,99.47
2021-12-07,Karnataka,225,2,221,2898,3067,2513,7.76,2,68.4,602702,5181,599523,4.48,3.67,0.042368421052631576,0.86,99.47
2021-12-08,Karnataka,1375,12,1368,17102,2129,413,8.04,0,68.4,604077,5193,600891,3.11,0.6,0.2500292397660819,0.86,99.47
2021-12-09,Karnataka,1341,10,1334,16878,4052,1623,7.95,0,68.4,605418,5203,602225,5.92,2.37,0.24675438596491228,0.86,99.47
2021-12-10,Karnataka,1309,15,1305,16724,4309,2352,7.83,0,68.4,606727,5218,603530,6.3,3.44,0.2445029239766082,0.86,99.47
2021-12-11,Karnataka,494,3,485,6197,4641,3548,7.97,6,68.4,607221,5221,604015,6.79,5.19,0.09059941520467836,0.86,99.47
2021-12-12,Karnataka,944,4,935,11840,994,802,7.97,5,68.4,608165,5225,604950,1.45,1.17,0.17309941520467836,0.86,99.47
2021-12-13,Karnataka,1135,12,1126,14029,857,603,8.09,0,68.4,609300,5237,606076,1.25,0.88,0.20510233918128654,0.86,99.47
2021-12-14,Karnataka,423,4,414,5694,1802,1483,7.43,5,68.4,609723,5241,606490,2.63,2.17,0.08324561403508772,0.86,99.47
2021-12-15,Karnataka,99,1,91,1550,4056,810,6.39,7,68.4,609822,5242,606581,5.93,1.18,0.02266081871345029,0.86,99.47
2021-12-16,Karnataka,851,4,846,10620,1271,1002,8.01,1,68.4,610673,5246,607427,1.86,1.46,0.15526315789473685,0.86,99.47
2021-12-17,Karnataka,1581,7,1572,19271,1599,784,8.2,2,68.4,612254,5253,608999,2.34,1.15,0.28173976608187135,0.86,99.47
2021-12-18,Karnataka,755,6,752,9603,1991,744,7.86,0,68.4,613009,5259,609751,2.91,1.09,0.14039473684210527,0.86,99.47
2021-12-19,Karnataka,474,5,468,5753,1927,1425,8.24,1,68.4,613483,5264,610219,2.82,2.08,0.08410818713450292,0.86,99.47
2021-12-20,Karnataka,207,2,204,2974,4930,335,6.96,1,68.4,613690,5266,610423,7.21,0.49,0.04347953216374269,0.86,99.47
2021-12-21,Karnataka,73,0,65,1157,175,128,6.31,8,68.4,613763,5266,610488,0.26,0.19,0.016915204678362574,0.86,99.47
2021-12-22,Karnataka,542,2,542,6992,4395,648,7.75,0,68.4,614305,5268,611030,6.43,0.95,0.10222222222222223,0.86,99.47
2021-12-23,Karnataka,204,2,201,2555,1766,285,7.98,1,68.4,614509,5270,611231,2.58,0.42,0.037353801169590646,0.86,99.47
2021-12-24,Karnataka,673,10,667,8577,3966,2340,7.85,0,68.4,615182,5280,611898,5.8,3.42,0.12539473684210525,0.86,99.47
2021-12-25,Karnataka,763,2,757,9418,4976,470,8.1,4,68.4,615945,5282,612655,7.27,0.69,0.13769005847953217,0.86,99.47
2021-12-26,Karnataka,75,0,71,1298,103,43,5.78,4,68.4,616020,5282,612726,0.15,0.06,0.0189766081871345,0.86,99.47
2021-12-27,Karnataka,883,3,878,10872,3526,1933,8.12,2,68.4,616903,5285,613604,5.15,2.83,0.15894736842105264,0.86,99.47
2021-12-28,Karnataka,1435,14,1433,17950,1498,716,7.99,0,68.4,618338,5299,615037,2.19,1.05,0.26242690058479534,0.86,99.47
2021-12-29,Karnataka,1294,18,1287,16112,3429,745,8.03,0,68.4,619632,5317,616324,5.01,1.09,0.23555555555555555,0.86,99.47
2021-12-30,Karnataka,1067,6,1060,13444,2169,647,7.94,1,68.4,620699,5323,617384,3.17,0.95,0.19654970760233917,0.86,99.47
2021-12-31,Karnataka,431,1,423,5536,1938,1132,7.79,7,68.4,621130,5324,617807,2.83,1.65,0.08093567251461989,0.86,99.47
2022-01-01,Karnataka,888,5,882,11175,4729,3438,7.95,1,68.4,622018,5329,618689,6.91,5.03,0.16337719298245615,0.86,99.46
2022-01-02,Karnataka,1599,18,1598,19770,3450,2658,8.09,0,68.4,623617,5347,620287,5.04,3.89,0.28903508771929826,0.86,99.47
2022-01-03,Karnataka,109,0,100,1278,223,86,8.53,9,68.4,623726,5347,620387,0.33,0.13,0.01868421052631579,0.86,99.46
2022-01-04,Karnataka,879,2,871,11131,4571,1858,7.9,6,68.4,624605,5349,621258,6.68,2.72,0.16273391812865498,0.86,99.46
2022-01-05,Karnataka,1270,18,1263,15517,215,209,8.18,0,68.4,625875,5367,622521,0.31,0.31,0.22685672514619884,0.86,99.46
2022-01-06,Karnataka,253,2,246,3341,3931,486,7.57,5,68.4,626128,5369,622767,5.75,0.71,0.04884502923976608,0.86,99.46
2022-01-07,Karnataka,221,3,212,2788,1278,618,7.93,6,68.4,626349,5372,622979,1.87,0.9,0.040760233918128656,0.86,99.46
2022-01-08,Karnataka,1506,12,1503,18851,961,785,7.99,0,68.4,627855,5384,624482,1.4,1.15,0.27559941520467834,0.86,99.46
2022-01-09,Karnataka,394,3,394,5280,2688,1793,7.46,0,68.4,628249,5387,624876,3.93,2.62,0.07719298245614035,0.86,99.46
2022-01-10,Karnataka,1497,13,1490,18890,1492,1394,7.92,0,68.4,629746,5400,626366,2.18,2.04,0.27616959064327484,0.86,99.46
2022-01-11,Karnataka,650,3,642,8067,960,241,8.06,5,68.4,630396,5403,627008,1.4,0.35,0.11793859649122806,0.86,99.46
2022-01-12,Karnataka,343,2,334,4702,1149,500,7.29,7,68.4,630739,5405,627342,1.68,0.73,0.06874269005847954,0.86,99.46
2022-01-13,Karnataka,684,7,680,9243,849,204,7.4,0,68.4,631423,5412,628022,1.24,0.3,0.1351315789473684,0.86,99.46
2022-01-14,Karnataka,1144,8,1140,14300,4556,3620,8.0,0,68.4,632567,5420,629162,6.66,5.29,0.20906432748538012,0.86,99.46
2022-01-15,Karnataka,879,6,873,10868,23,6,8.09,0,68.4,633446,5426,630035,0.03,0.01,0.15888888888888889,0.86,99.46
2022-01-16,Karnataka,575,7,575,7176,1550,848,8.01,0,68.4,634021,5433,630610,2.27,1.24,0.10491228070175439,0.86,99.46
2022-01-17,Karnataka,575,4,568,7060,4297,2348,8.14,3,68.4,634596,5437,631178,6.28,3.43,0.10321637426900584,0.86,99.46
2022-01-18,Karnataka,1188,16,1184,14835,2526,496,8.01,0,68.4,635784,5453,632362,3.69,0.73,0.2168859649122807,0.86,99.46
2022-01-19,Karnataka,1013,13,1011,12933,3993,2799,7.83,0,68.4,636797,5466,633373,5.84,4.09,0.18907894736842104,0.86,99.46
2022-01-20,Karnataka,909,7,908,11325,3860,1979,8.03,0,68.4,637706,5473,634281,5.64,2.89,0.16557017543859648,0.86,99.46
2022-01-21,Karnataka,585,4,583,7419,3857,115,7.89,0,68.4,638291,5477,634864,5.64,0.17,0.10846491228070175,0.86,99.46
2022-01-22,Karnataka,190,2,183,2467,4081,1107,7.7,5,68.4,638481,5479,635047,5.97,1.62,0.0360672514619883,0.86,99.46
2022-01-23,Karnataka,1353,6,1345,16824,3408,1146,8.04,2,68.4,639834,5485,636392,4.98,1.68,0.24596491228070175,0.86,99.46
2022-01-24,Karnataka,639,7,638,7714,1130,544,8.28,0,68.4,640473,5492,637030,1.65,0.8,0.11277777777777778,0.86,99.46
2022-01-25,Karnataka,1382,11,1377,17467,1692,935,7.91,0,68.4,641855,5503,638407,2.47,1.37,0.2553654970760234,0.86,99.46
2022-01-26,Karnataka,892,3,889,11443,686,551,7.8,0,68.4,642747,5506,639296,1.0,0.81,0.1672953216374269,0.86,99.46
2022-01-27,Karnataka,1462,8,1459,17973,132,109,8.13,0,68.4,644209,5514,640755,0.19,0.16,0.26276315789473687,0.86,99.46
2022-01-28,Karnataka,810,3,810,9972,576,417,8.12,0,68.4,645019,5517,641565,0.84,0.61,0.14578947368421052,0.86,99.46
2022-01-29,Karnataka,1222,10,1216,15429,2179,1288,7.92,0,68.4,646241,5527,642781,3.19,1.88,0.2255701754385965,0.86,99.46
2022-01-30,Karnataka,303,0,302,4207,4425,22,7.2,1,68.4,646544,5527,643083,6.47,0.03,0.061505847953216376,0.85,99.46
2022-01-31,Karnataka,399,1,392,5148,2390,1009,7.75,6,68.4,646943,5528,643475,3.49,1.48,0.07526315789473684,0.85,99.46
2022-02-01,Karnataka,1591,10,1586,19849,3420,3121,8.02,0,68.4,648534,5538,645061,5.0,4.56,0.29019005847953216,0.85,99.46
2022-02-02,Karnataka,661,2,654,8485,3295,612,7.79,5,68.4,649195,5540,645715,4.82,0.89,0.12404970760233919,0.85,99.46
2022-02-03,Karnataka,239,1,233,2727,1947,396,8.76,5,68.4,649434,5541,645948,2.85,0.58,0.03986842105263158,0.85,99.46
2022-02-04,Karnataka,944,7,942,11919,3927,18,7.92,0,68.4,650378,5548,646890,5.74,0.03,0.17425438596491227,0.85,99.46
2022-02-05,Karnataka,972,8,968,12411,4681,926,7.83,0,68.4,651350,5556,647858,6.84,1.35,0.18144736842105263,0.85,99.46
2022-02-06,Karnataka,196,1,196,2238,4549,149,8.76,0,68.4,651546,5557,648054,6.65,0.22,0.03271929824561404,0.85,99.46
2022-02-07,Karnataka,1419,19,1411,17596,751,617,8.06,0,68.4,652965,5576,649465,1.1,0.9,0.2572514619883041,0.85,99.46
2022-02-08,Karnataka,619,3,619,7421,3412,598,8.34,0,68.4,653584,5579,650084,4.99,0.87,0.10849415204678363,0.85,99.46
2022-02-09,Karnataka,1512,9,1509,19204,1810,796,7.87,0,68.4,655096,5588,651593,2.65,1.16,0.28076023391812865,0.85,99.47
2022-02-10,Karnataka,887,3,882,11239,3649,606,7.89,2,68.4,655983,5591,652475,5.33,0.89,0.16431286549707602,0.85,99.47
2022-02-11,Karnataka,268,3,259,3583,2613,1068,7.48,6,68.4,656251,5594,652734,3.82,1.56,0.05238304093567252,0.85,99.46
2022-02-12,Karnataka,951,12,951,11777,3417,2185,8.08,0,68.4,657202,5606,653685,5.0,3.19,0.1721783625730994,0.85,99.46
2022-02-13,Karnataka,1490,9,1483,18613,1742,1523,8.01,0,68.4,658692,5615,655168,2.55,2.23,0.27211988304093565,0.85,99.47
2022-02-14,Karnataka,421,4,420,5459,1907,1859,7.71,0,68.4,659113,5619,655588,2.79,2.72,0.07980994152046783,0.85,99.47
2022-02-15,Karnataka,1566,16,1563,19654,3223,1800,7.97,0,68.4,660679,5635,657151,4.71,2.63,0.2873391812865497,0.85,99.47
2022-02-16,Karnataka,829,8,824,10250,324,190,8.09,0,68.4,661508,5643,657975,0.47,0.28,0.14985380116959066,0.85,99.47
2022-02-17,Karnataka,879,9,871,11063,3768,1088,7.95,0,68.4,662387,5652,658846,5.51,1.59,0.16173976608187135,0.85,99.47
2022-02-18,Karnataka,561,1,560,7230,2297,873,7.76,0,68.4,662948,5653,659406,3.36,1.28,0.10570175438596491,0.85,99.47
2022-02-19,Karnataka,352,4,351,4173,881,152,8.44,0,68.4,663300,5657,659757,1.29,0.22,0.06100877192982456,0.85,99.47
2022-02-20,Karnataka,304,2,295,3958,2015,1650,7.68,7,68.4,663604,5659,660052,2.95,2.41,0.05786549707602339,0.85,99.46
2022-02-21,Karnataka,852,12,851,10888,3570,2150,7.83,0,68.4,664456,5671,660903,5.22,3.14,0.1591812865497076,0.85,99.47
2022-02-22,Karnataka,1325,4,1317,16862,2527,1793,7.86,4,68.4,665781,5675,662220,3.69,2.62,0.2465204678362573,0.85,99.47
2022-02-23,Karnataka,416,2,415,5024,4415,871,8.28,0,68.4,666197,5677,662635,6.45,1.27,0.07345029239766082,0.85,99.47
2022-02-24,Karnataka,479,6,471,5832,3943,2082,8.21,2,68.4,666676,5683,663106,5.76,3.04,0.08526315789473685,0.85,99.46
2022-02-25,Karnataka,668,3,668,8356,1763,1220,7.99,0,68.4,667344,5686,663774,2.58,1.78,0.12216374269005847,0.85,99.47
2022-02-26,Karnataka,1550,15,1549,19440,1359,1188,7.97,0,68.4,668894,5701,665323,1.99,1.74,0.28421052631578947,0.85,99.47
2022-02-27,Karnataka,790,10,785,9807,2720,570,8.06,0,68.4,669684,5711,666108,3.98,0.83,0.14337719298245613,0.85,99.47
2022-02-28,Karnataka,323,1,314,4079,2489,1000,7.92,8,68.4,670007,5712,666422,3.64,1.46,0.05963450292397661,0.85,99.46
2022-03-01,Karnataka,1522,18,1521,19020,2304,564,8.0,0,68.4,671529,5730,667943,3.37,0.82,0.27807017543859647,0.85,99.47
2022-03-02,Karnataka,273,1,272,3511,4505,3196,7.78,0,68.4,671802,5731,668215,6.59,4.67,0.05133040935672514,0.85,99.47
2022-03-03,Karnataka,198,2,198,2466,757,420,8.03,0,68.4,672000,5733,668413,1.11,0.61,0.03605263157894737,0.85,99.47
2022-03-04,Karnataka,1059,10,1052,13826,4306,2277,7.66,0,68.4,673059,5743,669465,6.3,3.33,0.2021345029239766,0.85,99.47
2022-03-05,Karnataka,592,7,588,8085,4117,2051,7.32,0,68.4,673651,5750,670053,6.02,3.0,0.11820175438596492,0.85,99.47
2022-03-06,Karnataka,519,2,518,6246,2401,1487,8.31,0,68.4,674170,5752,670571,3.51,2.17,0.09131578947368421,0.85,99.47
2022-03-07,Karnataka,743,10,741,9213,3590,3519,8.06,0,68.4,674913,5762,671312,5.25,5.14,0.13469298245614036,0.85,99.47
2022-03-08,Karnataka,494,5,489,6204,504,376,7.96,0,68.4,675407,5767,671801,0.74,0.55,0.09070175438596491,0.85,99.47
2022-03-09,Karnataka,712,5,711,8914,1480,658,7.99,0,68.4,676119,5772,672512,2.16,0.96,0.1303216374269006,0.85,99.47
2022-03-10,Karnataka,89,1,80,1309,3895,3552,6.8,8,68.4,676208,5773,672592,5.69,5.19,0.019137426900584797,0.85,99.47
2022-03-11,Karnataka,1212,12,1209,14867,3887,3244,8.15,0,68.4,677420,5785,673801,5.68,4.74,0.21735380116959063,0.85,99.47
2022-03-12,Karnataka,1433,10,1429,17777,4049,1569,8.06,0,68.4,678853,5795,675230,5.92,2.29,0.25989766081871346,0.85,99.47
2022-03-13,Karnataka,999,6,998,11971,944,749,8.35,0,68.4,679852,5801,676228,1.38,1.1,0.17501461988304093,0.85,99.47
2022-03-14,Karnataka,626,6,618,8051,3914,254,7.78,2,68.4,680478,5807,676846,5.72,0.37,0.1177046783625731,0.85,99.47
2022-03-15,Karnataka,99,1,91,1115,3591,925,8.88,7,68.4,680577,5808,676937,5.25,1.35,0.016301169590643275,0.85,99.47
2022-03-16,Karnataka,587,4,582,7135,1105,294,8.23,1,68.4,681164,5812,677519,1.62,0.43,0.10431286549707602,0.85,99.46
2022-03-17,Karnataka,335,1,330,4083,1453,38,8.2,4,68.4,681499,5813,677849,2.12,0.06,0.05969298245614035,0.85,99.46
2022-03-18,Karnataka,987,8,985,12444,4418,147,7.93,0,68.4,682486,5821,678834,6.46,0.21,0.1819298245614035,0.85,99.46
2022-03-19,Karnataka,93,0,86,1532,3778,1767,6.07,7,68.4,682579,5821,678920,5.52,2.58,0.02239766081871345,0.85,99.46
2022-03-20,Karnataka,1085,13,1079,13198,3270,1009,8.22,0,68.4,683664,5834,679999,4.78,1.48,0.19295321637426902,0.85,99.46
2022-03-21,Karnataka,836,6,831,10586,2594,2538,7.9,0,68.4,684500,5840,680830,3.79,3.71,0.15476608187134502,0.85,99.46
2022-03-22,Karnataka,473,3,464,5922,3002,2682,7.99,6,68.4,684973,5843,681294,4.39,3.92,0.08657894736842105,0.85,99.46
2022-03-23,Karnataka,477,6,474,5692,796,104,8.38,0,68.4,685450,5849,681768,1.16,0.15,0.08321637426900584,0.85,99.46
2022-03-24,Karnataka,292,3,289,4150,4384,2981,7.04,0,68.4,685742,5852,682057,6.41,4.36,0.06067251461988304,0.85,99.46
2022-03-25,Karnataka,549,4,547,6914,3440,1820,7.94,0,68.4,686291,5856,682604,5.03,2.66,0.10108187134502924,0.85,99.46
2022-03-26,Karnataka,75,1,67,1127,2514,367,6.65,7,68.4,686366,5857,682671,3.68,0.54,0.016476608187134503,0.85,99.46
2022-03-27,Karnataka,55,0,47,659,2999,2900,8.35,8,68.4,686421,5857,682718,4.38,4.24,0.009634502923976608,0.85,99.46
2022-03-28,Karnataka,860,9,851,10847,991,275,7.93,0,68.4,687281,5866,683569,1.45,0.4,0.15858187134502924,0.85,99.46
2022-03-29,Karnataka,1298,14,1296,16543,3461,470,7.85,0,68.4,688579,5880,684865,5.06,0.69,0.24185672514619883,0.85,99.46
2022-03-30,Karnataka,1482,20,1477,18462,290,61,8.03,0,68.4,690061,5900,686342,0.42,0.09,0.2699122807017544,0.85,99.46
2022-03-31,Karnataka,193,1,187,2386,4777,4677,8.09,5,68.4,690254,5901,686529,6.98,6.84,0.034883040935672516,0.85,99.46
2022-04-01,Karnataka,1024,12,1018,12920,1248,434,7.93,0,68.4,691278,5913,687547,1.82,0.63,0.18888888888888888,0.86,99.46
2022-04-02,Karnataka,1084,4,1078,13852,523,409,7.83,2,68.4,692362,5917,688625,0.76,0.6,0.20251461988304092,0.85,99.46
2022-04-03,Karnataka,510,2,501,6196,1408,473,8.23,7,68.4,692872,5919,689126,2.06,0.69,0.09058479532163742,0.85,99.46
2022-04-04,Karnataka,1587,13,1580,19665,2268,43,8.07,0,68.4,694459,5932,690706,3.32,0.06,0.2875,0.85,99.46
2022-04-05,Karnataka,339,4,336,3968,842,413,8.54,0,68.4,694798,5936,691042,1.23,0.6,0.05801169590643275,0.85,99.46
2022-04-06,Karnataka,819,5,810,10262,3083,2712,7.98,4,68.4,695617,5941,691852,4.51,3.96,0.15002923976608187,0.85,99.46
2022-04-07,Karnataka,497,1,488,6429,4256,1411,7.73,8,68.4,696114,5942,692340,6.22,2.06,0.09399122807017544,0.85,99.46
2022-04-08,Karnataka,1100,16,1093,13884,2779,918,7.92,0,68.4,697214,5958,693433,4.06,1.34,0.20298245614035088,0.85,99.46
2022-04-09,Karnataka,115,1,107,1731,4067,2304,6.64,7,68.4,697329,5959,693540,5.95,3.37,0.02530701754385965,0.85,99.46
2022-04-10,Karnataka,1445,18,1440,18136,3607,3265,7.97,0,68.4,698774,5977,694980,5.27,4.77,0.26514619883040935,0.86,99.46
2022-04-11,Karnataka,763,8,757,9867,2599,963,7.73,0,68.4,699537,5985,695737,3.8,1.41,0.14425438596491227,0.86,99.46
2022-04-12,Karnataka,890,3,887,10957,2601,1947,8.12,0,68.4,700427,5988,696624,3.8,2.85,0.16019005847953216,0.85,99.46
2022-04-13,Karnataka,783,3,778,9706,2108,625,8.07,2,68.4,701210,5991,697402,3.08,0.91,0.14190058479532164,0.85,99.46
2022-04-14,Karnataka,1487,16,1478,18471,588,94,8.05,0,68.4,702697,6007,698880,0.86,0.14,0.2700438596491228,0.85,99.46
2022-04-15,Karnataka,1348,4,1341,16853,1463,1186,8.0,3,68.4,704045,6011,700221,2.14,1.73,0.24638888888888888,0.85,99.46
2022-04-16,Karnataka,540,1,539,7008,1438,70,7.71,0,68.4,704585,6012,700760,2.1,0.1,0.10245614035087719,0.85,99.46
2022-04-17,Karnataka,1391,15,1385,17738,2175,45,7.84,0,68.4,705976,6027,702145,3.18,0.07,0.25932748538011696,0.85,99.46
2022-04-18,Karnataka,1303,14,1294,16360,1049,368,7.96,0,68.4,707279,6041,703439,1.53,0.54,0.2391812865497076,0.85,99.46
2022-04-19,Karnataka,1415,19,1412,17735,3030,2540,7.98,0,68.4,708694,6060,704851,4.43,3.71,0.25928362573099417,0.86,99.46
2022-04-20,Karnataka,1117,13,1113,13747,4335,2683,8.13,0,68.4,709811,6073,705964,6.34,3.92,0.2009795321637427,0.86,99.46
2022-04-21,Karnataka,239,3,238,2700,1036,398,8.85,0,68.4,710050,6076,706202,1.51,0.58,0.039473684210526314,0.86,99.46
2022-04-22,Karnataka,1313,5,1305,16348,2026,1533,8.03,3,68.4,711363,6081,707507,2.96,2.24,0.23900584795321636,0.85,99.46
2022-04-23,Karnataka,1092,11,1083,13429,323,313,8.13,0,68.4,712455,6092,708590,0.47,0.46,0.19633040935672513,0.86,99.46
2022-04-24,Karnataka,1180,5,1174,14627,4125,3587,8.07,1,68.4,713635,6097,709764,6.03,5.24,0.2138450292397661,0.85,99.46
2022-04-25,Karnataka,1352,19,1348,16968,2223,1490,7.97,0,68.4,714987,6116,711112,3.25,2.18,0.2480701754385965,0.86,99.46
2022-04-26,Karnataka,1436,4,1431,18342,4108,3451,7.83,1,68.4,716423,6120,712543,6.01,5.05,0.2681578947368421,0.85,99.46
2022-04-27,Karnataka,268,3,264,3145,4103,2945,8.52,1,68.4,716691,6123,712807,6.0,4.31,0.04597953216374269,0.85,99.46
2022-04-28,Karnataka,760,7,758,9330,2869,90,8.15,0,68.4,717451,6130,713565,4.19,0.13,0.13640350877192983,0.85,99.46
2022-04-29,Karnataka,851,8,845,10628,4381,1731,8.01,0,68.4,718302,6138,714410,6.4,2.53,0.15538011695906434,0.85,99.46
2022-04-30,Karnataka,655,6,655,8468,3150,2785,7.74,0,68.4,718957,6144,715065,4.61,4.07,0.12380116959064327,0.85,99.46
2022-05-01,Karnataka,434,5,429,5388,935,902,8.05,0,68.4,719391,6149,715494,1.37,1.32,0.07877192982456141,0.85,99.46
2022-05-02,Karnataka,1379,18,1379,16999,3423,944,8.11,0,68.4,720770,6167,716873,5.0,1.38,0.2485233918128655,0.86,99.46
2022-05-03,Karnataka,1169,17,1162,14386,4869,2375,8.13,0,68.4,721939,6184,718035,7.12,3.47,0.21032163742690058,0.86,99.46
2022-05-04,Karnataka,1412,19,1404,17658,4214,1499,8.0,0,68.4,723351,6203,719439,6.16,2.19,0.2581578947368421,0.86,99.46
2022-05-05,Karnataka,261,2,257,3342,498,223,7.81,2,68.4,723612,6205,719696,0.73,0.33,0.04885964912280702,0.86,99.46
2022-05-06,Karnataka,1480,11,1473,18449,1968,717,8.02,0,68.4,725092,6216,721169,2.88,1.05,0.2697222222222222,0.86,99.46
2022-05-07,Karnataka,442,4,440,5758,1349,298,7.68,0,68.4,725534,6220,721609,1.97,0.44,0.0841812865497076,0.86,99.46
2022-05-08,Karnataka,536,7,528,6619,1168,434,8.1,1,68.4,726070,6227,722137,1.71,0.63,0.09676900584795321,0.86,99.46
2022-05-09,Karnataka,998,4,993,12600,2800,2614,7.92,1,68.4,727068,6231,723130,4.09,3.82,0.18421052631578946,0.86,99.46
2022-05-10,Karnataka,1302,4,1294,16075,2492,976,8.1,4,68.4,728370,6235,724424,3.64,1.43,0.23501461988304093,0.86,99.46
2022-05-11,Karnataka,725,2,718,9544,551,308,7.6,5,68.4,729095,6237,725142,0.81,0.45,0.13953216374269006,0.86,99.46
2022-05-12,Karnataka,376,2,374,4973,2007,1423,7.56,0,68.4,729471,6239,725516,2.93,2.08,0.0727046783625731,0.86,99.46
2022-05-13,Karnataka,1518,12,1515,18912,4557,4287,8.03,0,68.4,730989,6251,727031,6.66,6.27,0.27649122807017545,0.86,99.46
2022-05-14,Karnataka,790,9,785,9635,655,57,8.2,0,68.4,731779,6260,727816,0.96,0.08,0.14086257309941522,0.86,99.46
2022-05-15,Karnataka,1201,3,1199,14778,1808,217,8.13,0,68.4,732980,6263,729015,2.64,0.32,0.21605263157894736,0.85,99.46
2022-05-16,Karnataka,806,11,801,10250,1019,728,7.86,0,68.4,733786,6274,729816,1.49,1.06,0.14985380116959066,0.86,99.46
2022-05-17,Karnataka,1078,6,1077,13459,2684,2468,8.01,0,68.4,734864,6280,730893,3.92,3.61,0.1967690058479532,0.85,99.46
2022-05-18,Karnataka,1063,12,1054,13089,1513,420,8.12,0,68.4,735927,6292,731947,2.21,0.61,0.191359649122807,0.85,99.46
2022-05-19,Karnataka,1035,11,1026,12578,2409,328,8.23,0,68.4,736962,6303,732973,3.52,0.48,0.18388888888888888,0.86,99.46
2022-05-20,Karnataka,238,3,229,2946,744,494,8.08,6,68.4,737200,6306,733202,1.09,0.72,0.043070175438596495,0.86,99.46
2022-05-21,Karnataka,1035,10,1033,12464,4012,480,8.3,0,68.4,738235,6316,734235,5.87,0.7,0.18222222222222223,0.86,99.46
2022-05-22,Karnataka,226,2,224,2660,802,154,8.5,0,68.4,738461,6318,734459,1.17,0.23,0.03888888888888889,0.86,99.46
2022-05-23,Karnataka,423,1,423,5486,329,55,7.71,0,68.4,738884,6319,734882,0.48,0.08,0.0802046783625731,0.86,99.46
2022-05-24,Karnataka,644,7,642,8427,2638,2304,7.64,0,68.4,739528,6326,735524,3.86,3.37,0.12320175438596491,0.86,99.46
2022-05-25,Karnataka,550,2,546,7225,294,155,7.61,2,68.4,740078,6328,736070,0.43,0.23,0.10562865497076024,0.86,99.46
2022-05-26,Karnataka,959,11,950,11740,400,262,8.17,0,68.4,741037,6339,737020,0.58,0.38,0.17163742690058478,0.86,99.46
2022-05-27,Karnataka,984,3,984,12018,2256,2245,8.19,0,68.4,742021,6342,738004,3.3,3.28,0.17570175438596491,0.85,99.46
2022-05-28,Karnataka,1478,19,1477,18294,2093,723,8.08,0,68.4,743499,6361,739481,3.06,1.06,0.26745614035087717,0.86,99.46
2022-05-29,Karnataka,1447,21,1438,18282,1029,775,7.91,0,68.4,744946,6382,740919,1.5,1.13,0.26728070175438595,0.86,99.46
2022-05-30,Karnataka,1221,12,1215,15508,2357,2327,7.87,0,68.4,746167,6394,742134,3.45,3.4,0.2267251461988304,0.86,99.46
2022-05-31,Karnataka,1295,7,1287,15999,591,529,8.09,1,68.4,747462,6401,743421,0.86,0.77,0.23390350877192984,0.86,99.46
2022-06-01,Karnataka,1458,15,1451,18551,3123,2276,7.86,0,68.4,748920,6416,744872,4.57,3.33,0.2712134502923977,0.86,99.46
2022-06-02,Karnataka,1252,13,1248,15635,1744,870,8.01,0,68.4,750172,6429,746120,2.55,1.27,0.22858187134502925,0.86,99.46
2022-06-03,Karnataka,920,13,913,11402,4675,4673,8.07,0,68.4,751092,6442,747033,6.83,6.83,0.16669590643274854,0.86,99.46
2022-06-04,Karnataka,981,3,973,12237,3812,3779,8.02,5,68.4,752073,6445,748006,5.57,5.52,0.17890350877192981,0.86,99.46
2022-06-05,Karnataka,1484,16,1480,18630,2111,258,7.97,0,68.4,753557,6461,749486,3.09,0.38,0.2723684210526316,0.86,99.46
2022-06-06,Karnataka,1329,12,1325,16309,1873,288,8.15,0,68.4,754886,6473,750811,2.74,0.42,0.2384356725146199,0.86,99.46
2022-06-07,Karnataka,1097,7,1091,13984,644,382,7.84,0,68.4,755983,6480,751902,0.94,0.56,0.20444444444444446,0.86,99.46
2022-06-08,Karnataka,137,1,129,1639,4437,692,8.36,7,68.4,756120,6481,752031,6.49,1.01,0.023961988304093566,0.86,99.46
2022-06-09,Karnataka,629,7,622,7393,4819,3346,8.51,0,68.4,756749,6488,752653,7.05,4.89,0.10808479532163742,0.86,99.46
2022-06-10,Karnataka,277,1,268,3014,1228,929,9.19,8,68.4,757026,6489,752921,1.8,1.36,0.04406432748538012,0.86,99.46
2022-06-11,Karnataka,558,3,556,7027,3505,1819,7.94,0,68.4,757584,6492,753477,5.12,2.66,0.10273391812865497,0.86,99.46
2022-06-12,Karnataka,1559,12,1558,19078,3343,1937,8.17,0,68.4,759143,6504,755035,4.89,2.83,0.2789181286549708,0.86,99.46
2022-06-13,Karnataka,1415,5,1406,17777,43,36,7.96,4,68.4,760558,6509,756441,0.06,0.05,0.25989766081871346,0.86,99.46
2022-06-14,Karnataka,1284,10,1278,15821,836,57,8.12,0,68.4,761842,6519,757719,1.22,0.08,0.23130116959064329,0.86,99.46
2022-06-15,Karnataka,294,4,289,3379,1188,763,8.7,1,68.4,762136,6523,758008,1.74,1.12,0.04940058479532164,0.86,99.46
2022-06-16,Karnataka,157,0,155,2430,1111,150,6.46,2,68.4,762293,6523,758163,1.62,0.22,0.035526315789473684,0.86,99.46
2022-06-17,Karnataka,725,7,723,9234,851,96,7.85,0,68.4,763018,6530,758886,1.24,0.14,0.135,0.86,99.46
2022-06-18,Karnataka,59,0,56,1101,4769,833,5.36,3,68.4,763077,6530,758942,6.97,1.22,0.016096491228070175,0.86,99.46
2022-06-19,Karnataka,1536,5,1529,19181,1550,31,8.01,2,68.4,764613,6535,760471,2.27,0.05,0.28042397660818713,0.85,99.46
2022-06-20,Karnataka,704,6,700,8567,2036,284,8.22,0,68.4,765317,6541,761171,2.98,0.42,0.12524853801169591,0.85,99.46
2022-06-21,Karnataka,458,6,452,5772,367,229,7.93,0,68.4,765775,6547,761623,0.54,0.33,0.0843859649122807,0.85,99.46
2022-06-22,Karnataka,1315,17,1312,16679,313,42,7.88,0,68.4,767090,6564,762935,0.46,0.06,0.2438450292397661,0.86,99.46
2022-06-23,Karnataka,993,5,986,12445,1302,628,7.98,2,68.4,768083,6569,763921,1.9,0.92,0.18194444444444444,0.86,99.46
2022-06-24,Karnataka,1527,4,1518,18949,2306,468,8.06,5,68.4,769610,6573,765439,3.37,0.68,0.2770321637426901,0.85,99.46
2022-06-25,Karnataka,1192,11,1185,14671,4583,409,8.12,0,68.4,770802,6584,766624,6.7,0.6,0.21448830409356726,0.85,99.46
2022-06-26,Karnataka,1572,12,1569,19585,274,259,8.03,0,68.4,772374,6596,768193,0.4,0.38,0.28633040935672516,0.85,99.46
2022-06-27,Karnataka,765,6,758,9495,1545,677,8.06,1,68.4,773139,6602,768951,2.26,0.99,0.1388157894736842,0.85,99.46
2022-06-28,Karnataka,1463,11,1456,18609,2936,514,7.86,0,68.4,774602,6613,770407,4.29,0.75,0.27206140350877195,0.85,99.46
2022-06-29,Karnataka,815,7,814,10085,3196,1236,8.08,0,68.4,775417,6620,771221,4.67,1.81,0.14744152046783626,0.85,99.46
2022-06-30,Karnataka,1333,13,1324,16238,432,119,8.21,0,68.4,776750,6633,772545,0.63,0.17,0.23739766081871344,0.85,99.46
2022-07-01,Karnataka,1237,14,1234,15451,453,268,8.01,0,68.4,777987,6647,773779,0.66,0.39,0.2258918128654971,0.85,99.46
2022-07-02,Karnataka,1172,16,1171,14583,1716,1115,8.04,0,68.4,779159,6663,774950,2.51,1.63,0.21320175438596492,0.86,99.46
2022-07-03,Karnataka,1416,10,1414,17482,644,336,8.1,0,68.4,780575,6673,776364,0.94,0.49,0.2555847953216374,0.85,99.46
2022-07-04,Karnataka,468,3,467,6222,3391,1707,7.52,0,68.4,781043,6676,776831,4.96,2.5,0.09096491228070175,0.85,99.46
2022-07-05,Karnataka,1125,8,1120,13972,3320,1648,8.05,0,68.4,782168,6684,777951,4.85,2.41,0.2042690058479532,0.85,99.46
2022-07-06,Karnataka,191,1,186,2387,1482,230,8.0,4,68.4,782359,6685,778137,2.17,0.34,0.03489766081871345,0.85,99.46
2022-07-07,Karnataka,399,5,398,4945,1625,604,8.07,0,68.4,782758,6690,778535,2.38,0.88,0.0722953216374269,0.85,99.46
2022-07-08,Karnataka,1538,16,1537,19110,2983,1464,8.05,0,68.4,784296,6706,780072,4.36,2.14,0.2793859649122807,0.86,99.46
2022-07-09,Karnataka,297,2,292,3948,1600,748,7.52,3,68.4,784593,6708,780364,2.34,1.09,0.05771929824561404,0.85,99.46
2022-07-10,Karnataka,1071,14,1069,13309,4391,3446,8.05,0,68.4,785664,6722,781433,6.42,5.04,0.19457602339181287,0.86,99.46
2022-07-11,Karnataka,1434,18,1427,17573,2900,1270,8.16,0,68.4,787098,6740,782860,4.24,1.86,0.2569152046783626,0.86,99.46
2022-07-12,Karnataka,378,4,371,4712,3293,1935,8.02,3,68.4,787476,6744,783231,4.81,2.83,0.06888888888888889,0.86,99.46
2022-07-13,Karnataka,1291,17,1286,16102,1085,925,8.02,0,68.4,788767,6761,784517,1.59,1.35,0.2354093567251462,0.86,99.46
2022-07-14,Karnataka,684,7,678,8918,4132,3895,7.67,0,68.4,789451,6768,785195,6.04,5.69,0.13038011695906432,0.86,99.46
2022-07-15,Karnataka,915,6,907,11477,4591,202,7.97,2,68.4,790366,6774,786102,6.71,0.3,0.16779239766081872,0.86,99.46
2022-07-16,Karnataka,1196,11,1190,14611,1830,0,8.19,0,68.4,791562,6785,787292,2.68,0.0,0.2136111111111111,0.86,99.46
2022-07-17,Karnataka,1365,9,1358,17114,48,21,7.98,0,68.4,792927,6794,788650,0.07,0.03,0.2502046783625731,0.86,99.46
2022-07-18,Karnataka,1207,15,1202,15063,4774,815,8.01,0,68.4,794134,6809,789852,6.98,1.19,0.22021929824561404,0.86,99.46
2022-07-19,Karnataka,103,0,96,1702,882,531,6.05,7,68.4,794237,6809,789948,1.29,0.78,0.024883040935672514,0.86,99.46
2022-07-20,Karnataka,174,1,170,1961,3185,3036,8.87,3,68.4,794411,6810,790118,4.66,4.44,0.028669590643274855,0.86,99.46
2022-07-21,Karnataka,258,1,252,3380,1386,1093,7.63,5,68.4,794669,6811,790370,2.03,1.6,0.04941520467836257,0.86,99.46
2022-07-22,Karnataka,244,2,238,2876,195,39,8.48,4,68.4,794913,6813,790608,0.29,0.06,0.04204678362573099,0.86,99.46
2022-07-23,Karnataka,173,1,166,1770,930,643,9.77,6,68.4,795086,6814,790774,1.36,0.94,0.02587719298245614,0.86,99.46
2022-07-24,Karnataka,436,6,435,5524,676,586,7.89,0,68.4,795522,6820,791209,0.99,0.86,0.08076023391812866,0.86,99.46
2022-07-25,Karnataka,622,5,615,8138,3348,433,7.64,2,68.4,796144,6825,791824,4.89,0.63,0.1189766081871345,0.86,99.46
2022-07-26,Karnataka,827,6,823,10706,2980,287,7.72,0,68.4,796971,6831,792647,4.36,0.42,0.1565204678362573,0.86,99.46
2022-07-27,Karnataka,876,10,876,10879,2440,384,8.05,0,68.4,797847,6841,793523,3.57,0.56,0.1590497076023392,0.86,99.46
2022-07-28,Karnataka,1141,4,1137,14324,3530,2284,7.97,0,68.4,798988,6845,794660,5.16,3.34,0.20941520467836258,0.86,99.46
2022-07-29,Karnataka,349,2,347,4082,1884,1343,8.55,0,68.4,799337,6847,795007,2.75,1.96,0.059678362573099414,0.86,99.46
2022-07-30,Karnataka,743,8,736,9235,1913,1002,8.05,0,68.4,800080,6855,795743,2.8,1.46,0.13501461988304095,0.86,99.46
2022-07-31,Karnataka,526,5,518,6480,235,27,8.12,3,68.4,800606,6860,796261,0.34,0.04,0.09473684210526316,0.86,99.46
2022-08-01,Karnataka,566,2,563,6919,43,0,8.18,1,68.4,801172,6862,796824,0.06,0.0,0.10115497076023391,0.86,99.46
2022-08-02,Karnataka,926,12,922,11715,2963,155,7.9,0,68.4,802098,6874,797746,4.33,0.23,0.1712719298245614,0.86,99.46
2022-08-03,Karnataka,734,4,725,8803,1282,1013,8.34,5,68.4,802832,6878,798471,1.87,1.48,0.12869883040935673,0.86,99.46
2022-08-04,Karnataka,105,0,101,1462,742,740,7.18,4,68.4,802937,6878,798572,1.08,1.08,0.021374269005847952,0.86,99.46
2022-08-05,Karnataka,1469,18,1465,18342,2647,615,8.01,0,68.4,804406,6896,800037,3.87,0.9,0.2681578947368421,0.86,99.46
2022-08-06,Karnataka,478,2,475,6128,2447,1696,7.8,1,68.4,804884,6898,800512,3.58,2.48,0.0895906432748538,0.86,99.46
2022-08-07,Karnataka,603,3,596,7771,660,503,7.76,4,68.4,805487,6901,801108,0.96,0.74,0.11361111111111111,0.86,99.46
2022-08-08,Karnataka,262,1,262,3353,1479,785,7.81,0,68.4,805749,6902,801370,2.16,1.15,0.04902046783625731,0.86,99.46
2022-08-09,Karnataka,583,2,579,7379,3067,506,7.9,2,68.4,806332,6904,801949,4.48,0.74,0.10788011695906433,0.86,99.46
2022-08-10,Karnataka,593,4,587,6921,789,350,8.57,2,68.4,806925,6908,802536,1.15,0.51,0.1011842105263158,0.86,99.46
2022-08-11,Karnataka,523,5,514,6622,4009,974,7.9,4,68.4,807448,6913,803050,5.86,1.42,0.09681286549707602,0.86,99.46
2022-08-12,Karnataka,825,11,824,10535,4806,841,7.83,0,68.4,808273,6924,803874,7.03,1.23,0.1540204678362573,0.86,99.46
2022-08-13,Karnataka,658,4,652,8486,1392,5,7.75,2,68.4,808931,6928,804526,2.04,0.01,0.12406432748538011,0.86,99.46
2022-08-14,Karnataka,252,0,244,3029,3052,171,8.32,8,68.4,809183,6928,804770,4.46,0.25,0.044283625730994154,0.86,99.45
2022-08-15,Karnataka,1429,16,1428,18343,4383,1827,7.79,0,68.4,810612,6944,806198,6.41,2.67,0.26817251461988306,0.86,99.46
2022-08-16,Karnataka,1261,10,1257,16227,3999,3601,7.77,0,68.4,811873,6954,807455,5.85,5.26,0.23723684210526316,0.86,99.46
2022-08-17,Karnataka,454,1,454,5766,236,113,7.87,0,68.4,812327,6955,807909,0.35,0.17,0.0842982456140351,0.86,99.46
2022-08-18,Karnataka,1356,4,1356,16828,3620,3127,8.06,0,68.4,813683,6959,809265,5.29,4.57,0.2460233918128655,0.86,99.46
2022-08-19,Karnataka,78,1,75,1291,917,95,6.04,2,68.4,813761,6960,809340,1.34,0.14,0.018874269005847953,0.86,99.46
2022-08-20,Karnataka,995,8,994,12737,3170,2104,7.81,0,68.4,814756,6968,810334,4.63,3.08,0.18621345029239766,0.86,99.46
2022-08-21,Karnataka,40,0,34,666,196,179,6.01,6,68.4,814796,6968,810368,0.29,0.26,0.009736842105263158,0.86,99.46
2022-08-22,Karnataka,316,3,309,3706,1573,1272,8.53,4,68.4,815112,6971,810677,2.3,1.86,0.0541812865497076,0.86,99.46
2022-08-23,Karnataka,342,2,341,3822,4276,2416,8.95,0,68.4,815454,6973,811018,6.25,3.53,0.05587719298245614,0.86,99.46
2022-08-24,Karnataka,947,10,945,12141,4739,1853,7.8,0,68.4,816401,6983,811963,6.93,2.71,0.1775,0.86,99.46
2022-08-25,Karnataka,890,6,881,11390,4065,1616,7.81,3,68.4,817291,6989,812844,5.94,2.36,0.16652046783625732,0.86,99.46
2022-08-26,Karnataka,966,10,961,11873,3179,2766,8.14,0,68.4,818257,6999,813805,4.65,4.04,0.17358187134502923,0.86,99.46
2022-08-27,Karnataka,1309,4,1308,16762,1076,445,7.81,0,68.4,819566,7003,815113,1.57,0.65,0.24505847953216375,0.85,99.46
2022-08-28,Karnataka,1547,18,1541,19387,559,300,7.98,0,68.4,821113,7021,816654,0.82,0.44,0.2834356725146199,0.86,99.46
2022-08-29,Karnataka,560,6,556,7406,3488,1348,7.56,0,68.4,821673,7027,817210,5.1,1.97,0.1082748538011696,0.86,99.46
2022-08-30,Karnataka,1213,8,1210,15354,3855,1705,7.9,0,68.4,822886,7035,818420,5.64,2.49,0.22447368421052633,0.85,99.46
2022-08-31,Karnataka,311,3,309,3892,2265,2215,7.99,0,68.4,823197,7038,818729,3.31,3.24,0.05690058479532164,0.85,99.46
2022-09-01,Karnataka,363,5,362,4546,822,342,7.99,0,68.4,823560,7043,819091,1.2,0.5,0.06646198830409357,0.86,99.46
2022-09-02,Karnataka,546,3,537,6949,881,539,7.86,6,68.4,824106,7046,819628,1.29,0.79,0.10159356725146199,0.85,99.46
2022-09-03,Karnataka,42,0,42,699,2967,2767,6.01,0,68.4,824148,7046,819670,4.34,4.05,0.010219298245614034,0.85,99.46
2022-09-04,Karnataka,521,4,520,6711,3873,35,7.76,0,68.4,824669,7050,820190,5.66,0.05,0.09811403508771929,0.85,99.46
2022-09-05,Karnataka,1163,10,1154,14223,1172,163,8.18,0,68.4,825832,7060,821344,1.71,0.24,0.20793859649122806,0.85,99.46
2022-09-06,Karnataka,1260,12,1251,15980,4318,355,7.88,0,68.4,827092,7072,822595,6.31,0.52,0.23362573099415204,0.86,99.46
2022-09-07,Karnataka,339,3,334,4532,1079,473,7.48,2,68.4,827431,7075,822929,1.58,0.69,0.06625730994152047,0.86,99.46
2022-09-08,Karnataka,243,3,235,3286,1898,586,7.4,5,68.4,827674,7078,823164,2.77,0.86,0.04804093567251462,0.86,99.46
2022-09-09,Karnataka,65,0,62,818,3965,2852,7.95,3,68.4,827739,7078,823226,5.8,4.17,0.011959064327485381,0.86,99.45
2022-09-10,Karnataka,401,2,392,5025,46,27,7.98,7,68.4,828140,7080,823618,0.07,0.04,0.07346491228070176,0.85,99.45
2022-09-11,Karnataka,339,4,336,4510,2046,1820,7.52,0,68.4,828479,7084,823954,2.99,2.66,0.06593567251461989,0.86,99.45
2022-09-12,Karnataka,1546,5,1546,19602,1539,1391,7.89,0,68.4,830025,7089,825500,2.25,2.03,0.28657894736842104,0.85,99.45
2022-09-13,Karnataka,1525,22,1525,18929,4488,3237,8.06,0,68.4,831550,7111,827025,6.56,4.73,0.27673976608187134,0.86,99.46
2022-09-14,Karnataka,771,5,771,9561,622,498,8.06,0,68.4,832321,7116,827796,0.91,0.73,0.13978070175438598,0.85,99.46
2022-09-15,Karnataka,985,11,983,12028,2315,414,8.19,0,68.4,833306,7127,828779,3.38,0.61,0.17584795321637428,0.86,99.46
2022-09-16,Karnataka,1588,22,1586,19572,3135,434,8.11,0,68.4,834894,7149,830365,4.58,0.63,0.286140350877193,0.86,99.46
2022-09-17,Karnataka,511,5,507,6341,1760,1626,8.06,0,68.4,835405,7154,830872,2.57,2.38,0.0927046783625731,0.86,99.46
2022-09-18,Karnataka,858,2,851,10404,2533,1897,8.25,5,68.4,836263,7156,831723,3.7,2.77,0.15210526315789474,0.86,99.46
2022-09-19,Karnataka,745,3,737,9345,3410,740,7.97,5,68.4,837008,7159,832460,4.99,1.08,0.13662280701754387,0.86,99.46
2022-09-20,Karnataka,684,8,681,8569,3654,840,7.98,0,68.4,837692,7167,833141,5.34,1.23,0.12527777777777777,0.86,99.46
2022-09-21,Karnataka,604,2,604,7026,2702,1476,8.6,0,68.4,838296,7169,833745,3.95,2.16,0.10271929824561403,0.86,99.46
2022-09-22,Karnataka,1060,6,1051,13353,4575,602,7.94,3,68.4,839356,7175,834796,6.69,0.88,0.19521929824561404,0.85,99.46
2022-09-23,Karnataka,115,1,109,1434,2237,1889,8.02,5,68.4,839471,7176,834905,3.27,2.76,0.020964912280701756,0.85,99.46
2022-09-24,Karnataka,1285,4,1279,16150,3494,449,7.96,2,68.4,840756,7180,836184,5.11,0.66,0.2361111111111111,0.85,99.46
2022-09-25,Karnataka,153,1,150,2054,3027,2051,7.45,2,68.4,840909,7181,836334,4.43,3.0,0.03002923976608187,0.85,99.46
2022-09-26,Karnataka,670,5,662,7781,2604,2136,8.61,3,68.4,841579,7186,836996,3.81,3.12,0.11375730994152047,0.85,99.46
2022-09-27,Karnataka,73,0,68,813,4155,1375,8.98,5,68.4,841652,7186,837064,6.07,2.01,0.011885964912280701,0.85,99.45
2022-09-28,Karnataka,209,0,201,2992,4688,1482,6.99,8,68.4,841861,7186,837265,6.85,2.17,0.043742690058479534,0.85,99.45
2022-09-29,Karnataka,626,9,618,7954,2471,1862,7.87,0,68.4,842487,7195,837883,3.61,2.72,0.11628654970760234,0.85,99.45
2022-09-30,Karnataka,391,4,388,4870,2834,900,8.03,0,68.4,842878,7199,838271,4.14,1.32,0.07119883040935672,0.85,99.45
2022-10-01,Karnataka,682,5,677,8482,1570,445,8.04,0,68.4,843560,7204,838948,2.3,0.65,0.12400584795321637,0.85,99.45
2022-10-02,Karnataka,459,5,459,5403,892,24,8.5,0,68.4,844019,7209,839407,1.3,0.04,0.07899122807017545,0.85,99.45
2022-10-03,Karnataka,1346,18,1340,16743,36,2,8.04,0,68.4,845365,7227,840747,0.05,0.0,0.24478070175438596,0.85,99.45
2022-10-04,Karnataka,207,1,201,2432,3072,2343,8.51,5,68.4,845572,7228,840948,4.49,3.43,0.035555555555555556,0.85,99.45
2022-10-05,Karnataka,306,1,299,3086,4388,3324,9.92,6,68.4,845878,7229,841247,6.42,4.86,0.045116959064327486,0.85,99.45
2022-10-06,Karnataka,1126,14,1124,14074,3356,1956,8.0,0,68.4,847004,7243,842371,4.91,2.86,0.20576023391812864,0.86,99.45
2022-10-07,Karnataka,562,6,554,6982,4117,2237,8.05,2,68.4,847566,7249,842925,6.02,3.27,0.10207602339181286,0.86,99.45
2022-10-08,Karnataka,618,2,617,8281,3141,651,7.46,0,68.4,848184,7251,843542,4.59,0.95,0.12106725146198831,0.85,99.45
2022-10-09,Karnataka,888,13,883,11048,1387,225,8.04,0,68.4,849072,7264,844425,2.03,0.33,0.16152046783625731,0.86,99.45
2022-10-10,Karnataka,175,0,174,2451,640,636,7.14,1,68.4,849247,7264,844599,0.94,0.93,0.035833333333333335,0.86,99.45
2022-10-11,Karnataka,1200,15,1194,14921,729,50,8.04,0,68.4,850447,7279,845793,1.07,0.07,0.21814327485380117,0.86,99.45
2022-10-12,Karnataka,410,4,404,5269,1946,876,7.78,2,68.4,850857,7283,846197,2.85,1.28,0.07703216374269006,0.86,99.45
2022-10-13,Karnataka,259,2,252,3198,2050,1409,8.1,5,68.4,851116,7285,846449,3.0,2.06,0.04675438596491228,0.86,99.45
2022-10-14,Karnataka,608,5,600,7657,4110,2400,7.94,3,68.4,851724,7290,847049,6.01,3.51,0.11194444444444444,0.86,99.45
2022-10-15,Karnataka,1543,9,1535,19362,130,2,7.97,0,68.4,853267,7299,848584,0.19,0.0,0.28307017543859647,0.86,99.45
2022-10-16,Karnataka,143,1,141,2002,1435,1295,7.14,1,68.4,853410,7300,848725,2.1,1.89,0.029269005847953215,0.86,99.45
2022-10-17,Karnataka,1077,12,1077,12901,192,19,8.35,0,68.4,854487,7312,849802,0.28,0.03,0.18861111111111112,0.86,99.45
2022-10-18,Karnataka,130,0,129,1886,4749,1890,6.89,1,68.4,854617,7312,849931,6.94,2.76,0.02757309941520468,0.86,99.45
2022-10-19,Karnataka,21,0,13,713,2077,573,2.95,8,68.4,854638,7312,849944,3.04,0.84,0.010423976608187134,0.86,99.45
2022-10-20,Karnataka,1544,11,1544,19343,1852,172,7.98,0,68.4,856182,7323,851488,2.71,0.25,0.2827923976608187,0.86,99.45
2022-10-21,Karnataka,927,9,923,11276,1123,738,8.22,0,68.4,857109,7332,852411,1.64,1.08,0.16485380116959064,0.86,99.45
2022-10-22,Karnataka,1256,17,1250,15772,4489,2042,7.96,0,68.4,858365,7349,853661,6.56,2.99,0.23058479532163742,0.86,99.45
2022-10-23,Karnataka,1336,14,1335,16415,3154,991,8.14,0,68.4,859701,7363,854996,4.61,1.45,0.23998538011695905,0.86,99.45
2022-10-24,Karnataka,909,8,906,11496,558,451,7.91,0,68.4,860610,7371,855902,0.82,0.66,0.16807017543859648,0.86,99.45
2022-10-25,Karnataka,246,3,239,3080,4475,2458,7.99,4,68.4,860856,7374,856141,6.54,3.59,0.04502923976608187,0.86,99.45
2022-10-26,Karnataka,692,10,688,9201,4680,1214,7.52,0,68.4,861548,7384,856829,6.84,1.77,0.13451754385964912,0.86,99.45
2022-10-27,Karnataka,857,9,849,10662,1957,1802,8.04,0,68.4,862405,7393,857678,2.86,2.63,0.15587719298245614,0.86,99.45
2022-10-28,Karnataka,644,2,640,8171,4681,2332,7.88,2,68.4,863049,7395,858318,6.84,3.41,0.11945906432748538,0.86,99.45
2022-10-29,Karnataka,809,8,804,10145,124,91,7.97,0,68.4,863858,7403,859122,0.18,0.13,0.1483187134502924,0.86,99.45
2022-10-30,Karnataka,1528,8,1526,19635,4522,1577,7.78,0,68.4,865386,7411,860648,6.61,2.31,0.2870614035087719,0.86,99.45
2022-10-31,Karnataka,812,10,803,9903,3328,498,8.2,0,68.4,866198,7421,861451,4.87,0.73,0.14478070175438595,0.86,99.45
2022-11-01,Karnataka,867,3,863,11014,1905,1011,7.87,1,68.4,867065,7424,862314,2.79,1.48,0.16102339181286549,0.86,99.45
2022-11-02,Karnataka,1002,12,993,12334,4188,3249,8.12,0,68.4,868067,7436,863307,6.12,4.75,0.18032163742690058,0.86,99.45
2022-11-03,Karnataka,550,3,543,6878,4747,1768,8.0,4,68.4,868617,7439,863850,6.94,2.58,0.10055555555555555,0.86,99.45
2022-11-04,Karnataka,1084,10,1077,13719,2074,1871,7.9,0,68.4,869701,7449,864927,3.03,2.74,0.20057017543859648,0.86,99.45
2022-11-05,Karnataka,454,5,450,5593,3962,3294,8.12,0,68.4,870155,7454,865377,5.79,4.82,0.08176900584795321,0.86,99.45
2022-11-06,Karnataka,548,2,541,6643,3530,2109,8.25,5,68.4,870703,7456,865918,5.16,3.08,0.09711988304093568,0.86,99.45
2022-11-07,Karnataka,579,7,575,7304,1417,567,7.93,0,68.4,871282,7463,866493,2.07,0.83,0.10678362573099415,0.86,99.45
2022-11-08,Karnataka,1103,5,1094,13655,4230,1613,8.08,4,68.4,872385,7468,867587,6.18,2.36,0.1996345029239766,0.86,99.45
2022-11-09,Karnataka,1598,6,1597,19857,2779,2579,8.05,0,68.4,873983,7474,869184,4.06,3.77,0.2903070175438596,0.86,99.45
2022-11-10,Karnataka,1033,8,1024,12404,426,248,8.33,1,68.4,875016,7482,870208,0.62,0.36,0.1813450292397661,0.86,99.45
2022-11-11,Karnataka,990,5,988,12436,4999,3620,7.96,0,68.4,876006,7487,871196,7.31,5.29,0.18181286549707604,0.85,99.45
2022-11-12,Karnataka,1415,12,1414,17847,3444,3038,7.93,0,68.4,877421,7499,872610,5.04,4.44,0.26092105263157894,0.85,99.45
2022-11-13,Karnataka,685,6,678,8682,3628,1191,7.89,1,68.4,878106,7505,873288,5.3,1.74,0.1269298245614035,0.85,99.45
2022-11-14,Karnataka,816,7,814,10356,4283,3060,7.88,0,68.4,878922,7512,874102,6.26,4.47,0.15140350877192982,0.85,99.45
2022-11-15,Karnataka,251,1,243,2866,2943,35,8.76,7,68.4,879173,7513,874345,4.3,0.05,0.04190058479532164,0.85,99.45
2022-11-16,Karnataka,552,5,543,6690,837,427,8.25,4,68.4,879725,7518,874888,1.22,0.62,0.09780701754385965,0.85,99.45
2022-11-17,Karnataka,1043,11,1034,13251,2102,1070,7.87,0,68.4,880768,7529,875922,3.07,1.56,0.1937280701754386,0.85,99.45
2022-11-18,Karnataka,1494,12,1489,18770,1776,462,7.96,0,68.4,882262,7541,877411,2.6,0.68,0.27441520467836256,0.85,99.45
2022-11-19,Karnataka,1387,15,1386,17627,1486,488,7.87,0,68.4,883649,7556,878797,2.17,0.71,0.2577046783625731,0.86,99.45
2022-11-20,Karnataka,1274,15,1274,15959,2926,211,7.98,0,68.4,884923,7571,880071,4.28,0.31,0.2333187134502924,0.86,99.45
2022-11-21,Karnataka,1338,18,1331,16796,4318,3145,7.97,0,68.4,886261,7589,881402,6.31,4.6,0.24555555555555555,0.86,99.45
2022-11-22,Karnataka,116,1,116,1610,3338,1454,7.2,0,68.4,886377,7590,881518,4.88,2.13,0.023538011695906434,0.86,99.45
2022-11-23,Karnataka,130,1,129,1220,4345,4,10.66,0,68.4,886507,7591,881647,6.35,0.01,0.01783625730994152,0.86,99.45
2022-11-24,Karnataka,733,6,729,9067,4572,2578,8.08,0,68.4,887240,7597,882376,6.68,3.77,0.13255847953216374,0.86,99.45
2022-11-25,Karnataka,116,0,109,1164,4180,1534,9.97,7,68.4,887356,7597,882485,6.11,2.24,0.017017543859649122,0.86,99.45
2022-11-26,Karnataka,432,4,425,6035,1149,387,7.16,3,68.4,887788,7601,882910,1.68,0.57,0.08823099415204678,0.86,99.45
2022-11-27,Karnataka,465,4,458,5939,2020,726,7.83,3,68.4,888253,7605,883368,2.95,1.06,0.08682748538011696,0.86,99.45
2022-11-28,Karnataka,782,6,774,9764,4836,4707,8.01,2,68.4,889035,7611,884142,7.07,6.88,0.1427485380116959,0.86,99.45
2022-11-29,Karnataka,1424,18,1415,17512,588,497,8.13,0,68.4,890459,7629,885557,0.86,0.73,0.2560233918128655,0.86,99.45
2022-11-30,Karnataka,44,0,40,733,333,34,6.0,4,68.4,890503,7629,885597,0.49,0.05,0.010716374269005848,0.86,99.45
2022-12-01,Karnataka,1489,6,1481,18379,2865,600,8.1,2,68.4,891992,7635,887078,4.19,0.88,0.2686988304093567,0.86,99.45
2022-12-02,Karnataka,953,3,947,11546,3659,1038,8.25,3,68.4,892945,7638,888025,5.35,1.52,0.16880116959064329,0.86,99.45
2022-12-03,Karnataka,1043,11,1040,12964,597,29,8.05,0,68.4,893988,7649,889065,0.87,0.04,0.18953216374269005,0.86,99.45
2022-12-04,Karnataka,46,0,39,622,2572,300,7.4,7,68.4,894034,7649,889104,3.76,0.44,0.009093567251461989,0.86,99.45
2022-12-05,Karnataka,460,2,456,6138,2513,2184,7.49,2,68.4,894494,7651,889560,3.67,3.19,0.08973684210526316,0.86,99.45
2022-12-06,Karnataka,509,4,508,6426,787,333,7.92,0,68.4,895003,7655,890068,1.15,0.49,0.09394736842105263,0.86,99.45
2022-12-07,Karnataka,744,7,736,9237,2457,380,8.05,1,68.4,895747,7662,890804,3.59,0.56,0.1350438596491228,0.86,99.45
2022-12-08,Karnataka,143,2,142,2177,1262,32,6.57,0,68.4,895890,7664,890946,1.85,0.05,0.03182748538011696,0.86,99.45
2022-12-09,Karnataka,424,4,419,5336,739,380,7.95,1,68.4,896314,7668,891365,1.08,0.56,0.07801169590643275,0.86,99.45
2022-12-10,Karnataka,76,0,76,828,231,214,9.18,0,68.4,896390,7668,891441,0.34,0.31,0.012105263157894737,0.86,99.45
2022-12-11,Karnataka,1510,22,1502,18862,1171,190,8.01,0,68.4,897900,7690,892943,1.71,0.28,0.27576023391812865,0.86,99.45
2022-12-12,Karnataka,878,4,869,10963,4846,2817,8.01,5,68.4,898778,7694,893812,7.08,4.12,0.16027777777777777,0.86,99.45
2022-12-13,Karnataka,1191,3,1190,15030,2688,1812,7.92,0,68.4,899969,7697,895002,3.93,2.65,0.21973684210526315,0.86,99.45
2022-12-14,Karnataka,1108,9,1105,13786,37,25,8.04,0,68.4,901077,7706,896107,0.05,0.04,0.20154970760233917,0.86,99.45
2022-12-15,Karnataka,951,5,950,11827,4013,365,8.04,0,68.4,902028,7711,897057,5.87,0.53,0.1729093567251462,0.85,99.45
2022-12-16,Karnataka,1442,16,1441,18043,1533,752,7.99,0,68.4,903470,7727,898498,2.24,1.1,0.26378654970760235,0.86,99.45
2022-12-17,Karnataka,532,6,532,6443,2232,137,8.26,0,68.4,904002,7733,899030,3.26,0.2,0.09419590643274854,0.86,99.45
2022-12-18,Karnataka,338,1,329,4172,145,33,8.1,8,68.4,904340,7734,899359,0.21,0.05,0.06099415204678363,0.86,99.45
2022-12-19,Karnataka,182,2,173,2239,1836,1068,8.13,7,68.4,904522,7736,899532,2.68,1.56,0.03273391812865497,0.86,99.45
2022-12-20,Karnataka,1605,21,1605,19616,3597,1736,8.18,0,68.4,906127,7757,901137,5.26,2.54,0.28678362573099414,0.86,99.45
2022-12-21,Karnataka,1501,19,1492,18465,4266,1763,8.13,0,68.4,907628,7776,902629,6.24,2.58,0.26995614035087717,0.86,99.45
2022-12-22,Karnataka,1066,15,1063,13714,117,102,7.77,0,68.4,908694,7791,903692,0.17,0.15,0.2004970760233918,0.86,99.45
2022-12-23,Karnataka,522,6,522,6489,289,30,8.04,0,68.4,909216,7797,904214,0.42,0.04,0.09486842105263157,0.86,99.45
2022-12-24,Karnataka,15,0,14,538,3437,997,2.79,1,68.4,909231,7797,904228,5.02,1.46,0.007865497076023392,0.86,99.45
2022-12-25,Karnataka,646,9,637,7606,4122,3919,8.49,0,68.4,909877,7806,904865,6.03,5.73,0.11119883040935673,0.86,99.45
2022-12-26,Karnataka,495,3,488,6919,648,273,7.15,4,68.4,910372,7809,905353,0.95,0.4,0.10115497076023391,0.86,99.45
2022-12-27,Karnataka,1143,15,1141,14354,3640,1053,7.96,0,68.4,911515,7824,906494,5.32,1.54,0.20985380116959065,0.86,99.45
2022-12-28,Karnataka,235,3,229,3501,4046,1262,6.71,3,68.4,911750,7827,906723,5.92,1.85,0.05118421052631579,0.86,99.45
2022-12-29,Karnataka,1158,4,1155,14013,4975,1561,8.26,0,68.4,912908,7831,907878,7.27,2.28,0.2048684210526316,0.86,99.45
2022-12-30,Karnataka,1345,7,1343,17088,3053,423,7.87,0,68.4,914253,7838,909221,4.46,0.62,0.24982456140350878,0.86,99.45
2022-12-31,Karnataka,971,11,963,11647,3166,48,8.34,0,68.4,915224,7849,910184,4.63,0.07,0.17027777777777778,0.86,99.45
2020-01-01,Kerala,152,0,147,1266,1957,514,12.01,5,35.3,152,0,147,5.54,1.46,0.035864022662889516,0.0,96.71
2020-01-02,Kerala,761,8,753,9529,3551,471,7.99,0,35.3,913,8,900,10.06,1.33,0.26994334277620397,0.88,98.58
2020-01-03,Kerala,1416,8,1409,17720,4372,360,7.99,0,35.3,2329,16,2309,12.39,1.02,0.5019830028328612,0.69,99.14
2020-01-04,Kerala,66,0,64,794,4674,4256,8.31,2,35.3,2395,16,2373,13.24,12.06,0.022492917847025496,0.67,99.08
2020-01-05,Kerala,532,5,532,6800,382,176,7.82,0,35.3,2927,21,2905,1.08,0.5,0.19263456090651557,0.72,99.25
2020-01-06,Kerala,843,7,839,10210,3151,1417,8.26,0,35.3,3770,28,3744,8.93,4.01,0.2892351274787535,0.74,99.31
2020-01-07,Kerala,427,2,426,5201,3391,3162,8.21,0,35.3,4197,30,4170,9.61,8.96,0.1473371104815864,0.71,99.36
2020-01-08,Kerala,36,0,36,713,1507,907,5.05,0,35.3,4233,30,4206,4.27,2.57,0.02019830028328612,0.71,99.36
2020-01-09,Kerala,1354,4,1353,17198,2211,2114,7.87,0,35.3,5587,34,5559,6.26,5.99,0.4871954674220963,0.61,99.5
2020-01-10,Kerala,468,1,464,5505,1246,1084,8.5,3,35.3,6055,35,6023,3.53,3.07,0.15594900849858356,0.58,99.47
2020-01-11,Kerala,821,5,814,10050,4263,3648,8.17,2,35.3,6876,40,6837,12.08,10.33,0.2847025495750708,0.58,99.43
2020-01-12,Kerala,1408,15,1403,17292,737,178,8.14,0,35.3,8284,55,8240,2.09,0.5,0.48985835694050994,0.66,99.47
2020-01-13,Kerala,343,3,342,4674,4558,2868,7.34,0,35.3,8627,58,8582,12.91,8.12,0.13240793201133144,0.67,99.48
2020-01-14,Kerala,997,4,997,12713,36,29,7.84,0,35.3,9624,62,9579,0.1,0.08,0.3601416430594901,0.64,99.53
2020-01-15,Kerala,1394,20,1385,17476,2297,1917,7.98,0,35.3,11018,82,10964,6.51,5.43,0.495070821529745,0.74,99.51
2020-01-16,Kerala,230,2,226,2805,2891,496,8.2,2,35.3,11248,84,11190,8.19,1.41,0.07946175637393768,0.75,99.48
2020-01-17,Kerala,629,7,620,8294,1989,759,7.58,2,35.3,11877,91,11810,5.63,2.15,0.23495750708215296,0.77,99.44
2020-01-18,Kerala,349,1,341,4708,4422,1666,7.41,7,35.3,12226,92,12151,12.53,4.72,0.13337110481586403,0.75,99.39
2020-01-19,Kerala,928,7,924,11554,3174,594,8.03,0,35.3,13154,99,13075,8.99,1.68,0.32730878186968837,0.75,99.4
2020-01-20,Kerala,232,0,224,2603,2935,2765,8.91,8,35.3,13386,99,13299,8.31,7.83,0.07373937677053824,0.74,99.35
2020-01-21,Kerala,1327,15,1324,16388,2454,578,8.1,0,35.3,14713,114,14623,6.95,1.64,0.46424929178470253,0.77,99.39
2020-01-22,Kerala,193,2,190,2207,3808,2555,8.74,1,35.3,14906,116,14813,10.79,7.24,0.06252124645892351,0.78,99.38
2020-01-23,Kerala,373,4,372,4353,4027,2048,8.57,0,35.3,15279,120,15185,11.41,5.8,0.12331444759206799,0.79,99.38
2020-01-24,Kerala,417,4,415,5069,4085,58,8.23,0,35.3,15696,124,15600,11.57,0.16,0.14359773371104817,0.79,99.39
2020-01-25,Kerala,937,13,929,11835,1453,105,7.92,0,35.3,16633,137,16529,4.12,0.3,0.33526912181303115,0.82,99.37
2020-01-26,Kerala,1490,7,1484,18621,147,84,8.0,0,35.3,18123,144,18013,0.42,0.24,0.5275070821529745,0.79,99.39
2020-01-27,Kerala,748,9,741,9349,616,171,8.0,0,35.3,18871,153,18754,1.75,0.48,0.2648441926345609,0.81,99.38
2020-01-28,Kerala,1456,15,1450,18427,799,628,7.9,0,35.3,20327,168,20204,2.26,1.78,0.5220113314447592,0.83,99.39
2020-01-29,Kerala,983,4,975,12005,4969,360,8.19,4,35.3,21310,172,21179,14.08,1.02,0.3400849858356941,0.81,99.39
2020-01-30,Kerala,1315,17,1309,16324,3181,3181,8.06,0,35.3,22625,189,22488,9.01,9.01,0.46243626062322946,0.84,99.39
2020-01-31,Kerala,521,4,520,6316,4237,1370,8.25,0,35.3,23146,193,23008,12.0,3.88,0.17892351274787535,0.83,99.4
2020-02-01,Kerala,46,0,43,652,4386,3292,7.06,3,35.3,23192,193,23051,12.42,9.33,0.018470254957507082,0.83,99.39
2020-02-02,Kerala,989,13,988,11907,1219,335,8.31,0,35.3,24181,206,24039,3.45,0.95,0.3373087818696884,0.85,99.41
2020-02-03,Kerala,1185,8,1179,15013,2916,1665,7.89,0,35.3,25366,214,25218,8.26,4.72,0.42529745042492917,0.84,99.42
2020-02-04,Kerala,1185,11,1183,14542,1639,1263,8.15,0,35.3,26551,225,26401,4.64,3.58,0.41195467422096316,0.85,99.44
2020-02-05,Kerala,1312,15,1310,16947,4635,4126,7.74,0,35.3,27863,240,27711,13.13,11.69,0.48008498583569403,0.86,99.45
2020-02-06,Kerala,751,9,745,9508,637,569,7.9,0,35.3,28614,249,28456,1.8,1.61,0.2693484419263456,0.87,99.45
2020-02-07,Kerala,988,8,985,12518,4865,3056,7.89,0,35.3,29602,257,29441,13.78,8.66,0.35461756373937675,0.87,99.46
2020-02-08,Kerala,968,4,963,12049,4440,116,8.03,1,35.3,30570,261,30404,12.58,0.33,0.3413314447592068,0.85,99.46
2020-02-09,Kerala,673,3,669,8738,2043,843,7.7,1,35.3,31243,264,31073,5.79,2.39,0.2475354107648725,0.84,99.46
2020-02-10,Kerala,1519,20,1517,19318,2067,300,7.86,0,35.3,32762,284,32590,5.86,0.85,0.5472521246458923,0.87,99.48
2020-02-11,Kerala,523,3,514,6532,3295,2309,8.01,6,35.3,33285,287,33104,9.33,6.54,0.18504249291784702,0.86,99.46
2020-02-12,Kerala,608,8,599,7552,2529,2474,8.05,1,35.3,33893,295,33703,7.16,7.01,0.21393767705382435,0.87,99.44
2020-02-13,Kerala,661,8,661,8110,3248,3126,8.15,0,35.3,34554,303,34364,9.2,8.86,0.22974504249291786,0.88,99.45
2020-02-14,Kerala,525,7,519,6714,3986,3758,7.82,0,35.3,35079,310,34883,11.29,10.65,0.19019830028328613,0.88,99.44
2020-02-15,Kerala,1217,10,1214,15156,3653,2880,8.03,0,35.3,36296,320,36097,10.35,8.16,0.42934844192634564,0.88,99.45
2020-02-16,Kerala,708,6,705,8531,2568,148,8.3,0,35.3,37004,326,36802,7.27,0.42,0.241671388101983,0.88,99.45
2020-02-17,Kerala,1095,12,1093,13539,2434,862,8.09,0,35.3,38099,338,37895,6.9,2.44,0.3835410764872521,0.89,99.46
2020-02-18,Kerala,740,5,739,8983,4781,2603,8.24,0,35.3,38839,343,38634,13.54,7.37,0.25447592067988667,0.88,99.47
2020-02-19,Kerala,1616,7,1607,19949,4389,2232,8.1,2,35.3,40455,350,40241,12.43,6.32,0.5651274787535411,0.87,99.47
2020-02-20,Kerala,33,0,32,785,4198,3784,4.2,1,35.3,40488,350,40273,11.89,10.72,0.022237960339943342,0.86,99.47
2020-02-21,Kerala,1167,13,1158,14782,3869,156,7.89,0,35.3,41655,363,41431,10.96,0.44,0.41875354107648727,0.87,99.46
2020-02-22,Kerala,762,5,760,9451,2999,2095,8.06,0,35.3,42417,368,42191,8.5,5.93,0.26773371104815863,0.87,99.47
2020-02-23,Kerala,760,3,751,9326,4342,3593,8.15,6,35.3,43177,371,42942,12.3,10.18,0.2641926345609065,0.86,99.46
2020-02-24,Kerala,953,11,953,11791,1909,1006,8.08,0,35.3,44130,382,43895,5.41,2.85,0.33402266288951843,0.87,99.47
2020-02-25,Kerala,694,10,687,8442,3418,2118,8.22,0,35.3,44824,392,44582,9.68,6.0,0.23915014164305948,0.87,99.46
2020-02-26,Kerala,1596,22,1594,19959,3726,1762,8.0,0,35.3,46420,414,46176,10.56,4.99,0.5654107648725213,0.89,99.47
2020-02-27,Kerala,1216,11,1212,15275,3191,2510,7.96,0,35.3,47636,425,47388,9.04,7.11,0.43271954674220964,0.89,99.48
2020-02-28,Kerala,1477,7,1477,18726,2998,1879,7.89,0,35.3,49113,432,48865,8.49,5.32,0.5304815864022663,0.88,99.5
2020-02-29,Kerala,502,3,499,5859,3670,2145,8.57,0,35.3,49615,435,49364,10.4,6.08,0.1659773371104816,0.88,99.49
2020-03-01,Kerala,307,2,302,4418,3935,3542,6.95,3,35.3,49922,437,49666,11.15,10.03,0.1251558073654391,0.88,99.49
2020-03-02,Kerala,921,3,919,11459,286,85,8.04,0,35.3,50843,440,50585,0.81,0.24,0.3246175637393768,0.87,99.49
2020-03-03,Kerala,1369,10,1364,16714,1824,938,8.19,0,35.3,52212,450,51949,5.17,2.66,0.4734844192634561,0.86,99.5
2020-03-04,Kerala,1566,14,1563,19097,222,175,8.2,0,35.3,53778,464,53512,0.63,0.5,0.5409915014164306,0.86,99.51
2020-03-05,Kerala,110,1,107,1376,1167,83,7.99,2,35.3,53888,465,53619,3.31,0.24,0.03898016997167139,0.86,99.5
2020-03-06,Kerala,324,1,316,4252,430,324,7.62,7,35.3,54212,466,53935,1.22,0.92,0.12045325779036828,0.86,99.49
2020-03-07,Kerala,350,2,347,4278,3699,3522,8.18,1,35.3,54562,468,54282,10.48,9.98,0.12118980169971671,0.86,99.49
2020-03-08,Kerala,108,1,108,1292,1730,1144,8.36,0,35.3,54670,469,54390,4.9,3.24,0.03660056657223796,0.86,99.49
2020-03-09,Kerala,127,1,125,1388,1991,1274,9.15,1,35.3,54797,470,54515,5.64,3.61,0.03932011331444759,0.86,99.49
2020-03-10,Kerala,870,5,863,10565,4641,3853,8.23,2,35.3,55667,475,55378,13.15,10.92,0.2992917847025496,0.85,99.48
2020-03-11,Kerala,1313,17,1311,16298,2925,51,8.06,0,35.3,56980,492,56689,8.29,0.14,0.461699716713881,0.86,99.49
2020-03-12,Kerala,883,4,874,10891,952,806,8.11,5,35.3,57863,496,57563,2.7,2.28,0.3085269121813031,0.86,99.48
2020-03-13,Kerala,1184,17,1178,14786,3724,3437,8.01,0,35.3,59047,513,58741,10.55,9.74,0.4188668555240793,0.87,99.48
2020-03-14,Kerala,1485,14,1485,18604,4394,922,7.98,0,35.3,60532,527,60226,12.45,2.61,0.5270254957507082,0.87,99.49
2020-03-15,Kerala,88,1,86,1107,2982,1476,7.95,1,35.3,60620,528,60312,8.45,4.18,0.031359773371104814,0.87,99.49
2020-03-16,Kerala,298,3,298,3151,335,240,9.46,0,35.3,60918,531,60610,0.95,0.68,0.08926345609065156,0.87,99.49
2020-03-17,Kerala,492,6,492,6078,1699,145,8.09,0,35.3,61410,537,61102,4.81,0.41,0.17218130311614732,0.87,99.5
2020-03-18,Kerala,251,1,250,3579,3092,2185,7.01,0,35.3,61661,538,61352,8.76,6.19,0.10138810198300283,0.87,99.5
2020-03-19,Kerala,1487,15,1478,18711,3672,2671,7.95,0,35.3,63148,553,62830,10.4,7.57,0.530056657223796,0.88,99.5
2020-03-20,Kerala,1526,19,1522,19452,1534,275,7.84,0,35.3,64674,572,64352,4.35,0.78,0.5510481586402266,0.88,99.5
2020-03-21,Kerala,857,5,857,11019,1115,739,7.78,0,35.3,65531,577,65209,3.16,2.09,0.3121529745042493,0.88,99.51
2020-03-22,Kerala,989,6,982,12405,3197,1208,7.97,1,35.3,66520,583,66191,9.06,3.42,0.35141643059490085,0.88,99.51
2020-03-23,Kerala,304,3,299,4479,4210,868,6.79,2,35.3,66824,586,66490,11.93,2.46,0.12688385269121813,0.88,99.5
2020-03-24,Kerala,1351,19,1342,16931,2896,2671,7.98,0,35.3,68175,605,67832,8.2,7.57,0.4796317280453258,0.89,99.5
2020-03-25,Kerala,1386,14,1386,17240,754,176,8.04,0,35.3,69561,619,69218,2.14,0.5,0.488385269121813,0.89,99.51
2020-03-26,Kerala,804,6,804,10105,3419,1089,7.96,0,35.3,70365,625,70022,9.69,3.08,0.2862606232294618,0.89,99.51
2020-03-27,Kerala,1568,6,1562,19307,3243,1222,8.12,0,35.3,71933,631,71584,9.19,3.46,0.5469405099150142,0.88,99.51
2020-03-28,Kerala,936,8,928,11458,2042,409,8.17,0,35.3,72869,639,72512,5.78,1.16,0.3245892351274788,0.88,99.51
2020-03-29,Kerala,78,0,71,850,1148,1026,9.18,7,35.3,72947,639,72583,3.25,2.91,0.024079320113314446,0.88,99.5
2020-03-30,Kerala,142,1,135,1813,3116,2322,7.83,6,35.3,73089,640,72718,8.83,6.58,0.05135977337110482,0.88,99.49
2020-03-31,Kerala,190,2,184,2219,1076,255,8.56,4,35.3,73279,642,72902,3.05,0.72,0.06286118980169972,0.88,99.49
2020-04-01,Kerala,521,5,515,6201,494,230,8.4,1,35.3,73800,647,73417,1.4,0.65,0.1756657223796034,0.88,99.48
2020-04-02,Kerala,1432,8,1427,18179,2809,874,7.88,0,35.3,75232,655,74844,7.96,2.48,0.514985835694051,0.87,99.48
2020-04-03,Kerala,1136,3,1128,13697,4718,2818,8.29,5,35.3,76368,658,75972,13.37,7.98,0.38801699716713883,0.86,99.48
2020-04-04,Kerala,840,11,838,10622,391,270,7.91,0,35.3,77208,669,76810,1.11,0.76,0.30090651558073656,0.87,99.48
2020-04-05,Kerala,1209,14,1206,14648,4072,1711,8.25,0,35.3,78417,683,78016,11.54,4.85,0.41495750708215295,0.87,99.49
2020-04-06,Kerala,756,3,749,9562,4374,3730,7.91,4,35.3,79173,686,78765,12.39,10.57,0.27087818696883853,0.87,99.48
2020-04-07,Kerala,1053,15,1048,13116,758,249,8.03,0,35.3,80226,701,79813,2.15,0.71,0.3715580736543909,0.87,99.49
2020-04-08,Kerala,920,7,915,10889,1150,459,8.45,0,35.3,81146,708,80728,3.26,1.3,0.3084702549575071,0.87,99.48
2020-04-09,Kerala,1241,13,1241,15673,4403,1963,7.92,0,35.3,82387,721,81969,12.47,5.56,0.4439943342776204,0.88,99.49
2020-04-10,Kerala,857,12,853,10791,562,141,7.94,0,35.3,83244,733,82822,1.59,0.4,0.30569405099150143,0.88,99.49
2020-04-11,Kerala,1100,13,1092,13654,780,372,8.06,0,35.3,84344,746,83914,2.21,1.05,0.38679886685552406,0.88,99.49
2020-04-12,Kerala,1079,4,1074,13174,452,277,8.19,1,35.3,85423,750,84988,1.28,0.78,0.3732011331444759,0.88,99.49
2020-04-13,Kerala,1438,9,1429,17896,3103,1220,8.04,0,35.3,86861,759,86417,8.79,3.46,0.5069688385269122,0.87,99.49
2020-04-14,Kerala,730,10,721,8986,794,101,8.12,0,35.3,87591,769,87138,2.25,0.29,0.2545609065155807,0.88,99.48
2020-04-15,Kerala,1165,16,1156,14863,4687,3464,7.84,0,35.3,88756,785,88294,13.28,9.81,0.42104815864022666,0.88,99.48
2020-04-16,Kerala,820,7,814,9889,2541,2093,8.29,0,35.3,89576,792,89108,7.2,5.93,0.2801416430594901,0.88,99.48
2020-04-17,Kerala,1010,3,1010,12948,3169,2691,7.8,0,35.3,90586,795,90118,8.98,7.62,0.3667988668555241,0.88,99.48
2020-04-18,Kerala,1189,10,1186,14973,4141,1923,7.94,0,35.3,91775,805,91304,11.73,5.45,0.4241643059490085,0.88,99.49
2020-04-19,Kerala,161,1,159,2180,1180,885,7.39,1,35.3,91936,806,91463,3.34,2.51,0.06175637393767705,0.88,99.49
2020-04-20,Kerala,320,2,320,3770,738,561,8.49,0,35.3,92256,808,91783,2.09,1.59,0.10679886685552407,0.88,99.49
2020-04-21,Kerala,1082,4,1077,13956,1092,183,7.75,1,35.3,93338,812,92860,3.09,0.52,0.3953541076487252,0.87,99.49
2020-04-22,Kerala,971,10,970,12735,4156,687,7.62,0,35.3,94309,822,93830,11.77,1.95,0.36076487252124645,0.87,99.49
2020-04-23,Kerala,272,1,268,3349,2231,1958,8.12,3,35.3,94581,823,94098,6.32,5.55,0.09487252124645892,0.87,99.49
2020-04-24,Kerala,534,6,529,6595,4774,2589,8.1,0,35.3,95115,829,94627,13.52,7.33,0.1868271954674221,0.87,99.49
2020-04-25,Kerala,892,4,885,11258,2929,686,7.92,3,35.3,96007,833,95512,8.3,1.94,0.31892351274787534,0.87,99.48
2020-04-26,Kerala,1396,20,1390,16899,3949,3423,8.26,0,35.3,97403,853,96902,11.19,9.7,0.4787252124645892,0.88,99.49
2020-04-27,Kerala,1226,3,1217,15139,4457,2014,8.1,6,35.3,98629,856,98119,12.63,5.71,0.4288668555240793,0.87,99.48
2020-04-28,Kerala,276,3,274,3628,2181,2024,7.61,0,35.3,98905,859,98393,6.18,5.73,0.10277620396600566,0.87,99.48
2020-04-29,Kerala,441,4,432,5684,3234,831,7.76,5,35.3,99346,863,98825,9.16,2.35,0.16101983002832862,0.87,99.48
2020-04-30,Kerala,649,7,642,8076,1941,925,8.04,0,35.3,99995,870,99467,5.5,2.62,0.22878186968838526,0.87,99.47
2020-05-01,Kerala,274,1,267,3242,260,33,8.45,6,35.3,100269,871,99734,0.74,0.09,0.0918413597733711,0.87,99.47
2020-05-02,Kerala,911,4,910,11554,4463,3824,7.88,0,35.3,101180,875,100644,12.64,10.83,0.32730878186968837,0.86,99.47
2020-05-03,Kerala,1553,22,1544,19454,3501,435,7.98,0,35.3,102733,897,102188,9.92,1.23,0.5511048158640227,0.87,99.47
2020-05-04,Kerala,521,6,521,6509,2746,709,8.0,0,35.3,103254,903,102709,7.78,2.01,0.18439093484419264,0.87,99.47
2020-05-05,Kerala,1042,7,1035,12678,743,628,8.22,0,35.3,104296,910,103744,2.1,1.78,0.3591501416430595,0.87,99.47
2020-05-06,Kerala,1380,7,1378,17113,2626,1050,8.06,0,35.3,105676,917,105122,7.44,2.97,0.48478753541076486,0.87,99.48
2020-05-07,Kerala,914,2,905,11519,4961,132,7.93,7,35.3,106590,919,106027,14.05,0.37,0.3263172804532578,0.86,99.47
2020-05-08,Kerala,767,10,762,9475,1599,398,8.09,0,35.3,107357,929,106789,4.53,1.13,0.26841359773371104,0.87,99.47
2020-05-09,Kerala,506,5,505,6508,3766,3437,7.78,0,35.3,107863,934,107294,10.67,9.74,0.1843626062322946,0.87,99.47
2020-05-10,Kerala,285,2,278,3788,254,182,7.52,5,35.3,108148,936,107572,0.72,0.52,0.10730878186968838,0.87,99.47
2020-05-11,Kerala,271,1,263,3378,1247,1244,8.02,7,35.3,108419,937,107835,3.53,3.52,0.09569405099150141,0.86,99.46
2020-05-12,Kerala,417,3,415,4942,2485,2075,8.44,0,35.3,108836,940,108250,7.04,5.88,0.14,0.86,99.46
2020-05-13,Kerala,860,6,858,10543,2121,1756,8.16,0,35.3,109696,946,109108,6.01,4.97,0.2986685552407932,0.86,99.46
2020-05-14,Kerala,58,0,53,789,4631,1862,7.35,5,35.3,109754,946,109161,13.12,5.27,0.02235127478753541,0.86,99.46
2020-05-15,Kerala,476,6,468,6321,3579,977,7.53,2,35.3,110230,952,109629,10.14,2.77,0.17906515580736543,0.86,99.45
2020-05-16,Kerala,388,2,388,4989,1377,629,7.78,0,35.3,110618,954,110017,3.9,1.78,0.1413314447592068,0.86,99.46
2020-05-17,Kerala,1566,7,1557,19683,2219,1200,7.96,2,35.3,112184,961,111574,6.29,3.4,0.5575920679886686,0.86,99.46
2020-05-18,Kerala,328,3,321,4151,3256,2561,7.9,4,35.3,112512,964,111895,9.22,7.25,0.11759206798866856,0.86,99.45
2020-05-19,Kerala,1036,3,1032,12928,724,275,8.01,1,35.3,113548,967,112927,2.05,0.78,0.36623229461756374,0.85,99.45
2020-05-20,Kerala,1514,9,1505,18881,4546,2426,8.02,0,35.3,115062,976,114432,12.88,6.87,0.5348725212464589,0.85,99.45
2020-05-21,Kerala,145,1,141,1555,2446,995,9.32,3,35.3,115207,977,114573,6.93,2.82,0.044050991501416434,0.85,99.45
2020-05-22,Kerala,1046,12,1042,13518,752,170,7.74,0,35.3,116253,989,115615,2.13,0.48,0.38294617563739375,0.85,99.45
2020-05-23,Kerala,897,3,889,11483,2564,1136,7.81,5,35.3,117150,992,116504,7.26,3.22,0.3252974504249292,0.85,99.45
2020-05-24,Kerala,464,4,461,5356,4550,2169,8.66,0,35.3,117614,996,116965,12.89,6.14,0.15172804532577905,0.85,99.45
2020-05-25,Kerala,917,4,908,11475,4069,3775,7.99,5,35.3,118531,1000,117873,11.53,10.69,0.32507082152974504,0.84,99.44
2020-05-26,Kerala,1590,13,1589,19516,4374,3017,8.15,0,35.3,120121,1013,119462,12.39,8.55,0.5528611898016997,0.84,99.45
2020-05-27,Kerala,922,11,916,11068,334,80,8.33,0,35.3,121043,1024,120378,0.95,0.23,0.3135410764872521,0.85,99.45
2020-05-28,Kerala,338,4,332,4467,3988,1152,7.57,2,35.3,121381,1028,120710,11.3,3.26,0.12654390934844192,0.85,99.45
2020-05-29,Kerala,1335,7,1326,16685,1882,1450,8.0,2,35.3,122716,1035,122036,5.33,4.11,0.4726628895184136,0.84,99.45
2020-05-30,Kerala,1190,9,1187,15221,3626,2401,7.82,0,35.3,123906,1044,123223,10.27,6.8,0.4311898016997167,0.84,99.45
2020-05-31,Kerala,1429,9,1422,17897,3321,3156,7.98,0,35.3,125335,1053,124645,9.41,8.94,0.5069971671388102,0.84,99.45
2020-06-01,Kerala,1242,4,1236,15631,4389,1386,7.95,2,35.3,126577,1057,125881,12.43,3.93,0.4428045325779037,0.84,99.45
2020-06-02,Kerala,1278,6,1272,16211,2140,2029,7.88,0,35.3,127855,1063,127153,6.06,5.75,0.45923512747875356,0.83,99.45
2020-06-03,Kerala,653,4,644,7814,697,669,8.36,5,35.3,128508,1067,127797,1.97,1.9,0.22135977337110482,0.83,99.45
2020-06-04,Kerala,440,1,440,5283,4822,1785,8.33,0,35.3,128948,1068,128237,13.66,5.06,0.1496600566572238,0.83,99.45
2020-06-05,Kerala,1130,4,1124,14075,3718,330,8.03,2,35.3,130078,1072,129361,10.53,0.93,0.39872521246458925,0.82,99.45
2020-06-06,Kerala,946,12,937,11673,4377,388,8.1,0,35.3,131024,1084,130298,12.4,1.1,0.3306798866855524,0.83,99.45
2020-06-07,Kerala,822,9,818,9882,535,130,8.32,0,35.3,131846,1093,131116,1.52,0.37,0.279943342776204,0.83,99.45
2020-06-08,Kerala,502,5,496,6269,703,541,8.01,1,35.3,132348,1098,131612,1.99,1.53,0.17759206798866856,0.83,99.44
2020-06-09,Kerala,393,1,390,5014,3632,734,7.84,2,35.3,132741,1099,132002,10.29,2.08,0.14203966005665722,0.83,99.44
2020-06-10,Kerala,366,4,365,4293,4449,2954,8.53,0,35.3,133107,1103,132367,12.6,8.37,0.12161473087818697,0.83,99.44
2020-06-11,Kerala,447,3,439,5112,972,669,8.74,5,35.3,133554,1106,132806,2.75,1.9,0.1448158640226629,0.83,99.44
2020-06-12,Kerala,251,1,242,3252,3621,2785,7.72,8,35.3,133805,1107,133048,10.26,7.89,0.09212464589235128,0.83,99.43
2020-06-13,Kerala,1254,15,1249,15713,3146,2741,7.98,0,35.3,135059,1122,134297,8.91,7.76,0.4451274787535411,0.83,99.44
2020-06-14,Kerala,1072,14,1066,13253,4061,3734,8.09,0,35.3,136131,1136,135363,11.5,10.58,0.3754390934844193,0.83,99.44
2020-06-15,Kerala,46,0,37,678,2332,1570,6.78,9,35.3,136177,1136,135400,6.61,4.45,0.019206798866855525,0.83,99.43
2020-06-16,Kerala,400,1,397,4787,3495,701,8.36,2,35.3,136577,1137,135797,9.9,1.99,0.13560906515580737,0.83,99.43
2020-06-17,Kerala,1108,13,1103,13437,4740,1858,8.25,0,35.3,137685,1150,136900,13.43,5.26,0.3806515580736544,0.84,99.43
2020-06-18,Kerala,620,5,617,7857,3225,890,7.89,0,35.3,138305,1155,137517,9.14,2.52,0.22257790368271954,0.84,99.43
2020-06-19,Kerala,1398,15,1389,18024,1810,1672,7.76,0,35.3,139703,1170,138906,5.13,4.74,0.5105949008498584,0.84,99.43
2020-06-20,Kerala,933,6,924,11596,4261,1551,8.05,3,35.3,140636,1176,139830,12.07,4.39,0.3284985835694051,0.84,99.43
2020-06-21,Kerala,1391,8,1387,17379,3016,911,8.0,0,35.3,142027,1184,141217,8.54,2.58,0.4923229461756374,0.83,99.43
2020-06-22,Kerala,1123,11,1121,13771,2093,1374,8.15,0,35.3,143150,1195,142338,5.93,3.89,0.39011331444759206,0.83,99.43
2020-06-23,Kerala,576,2,568,7350,4187,9,7.84,6,35.3,143726,1197,142906,11.86,0.03,0.20821529745042494,0.83,99.43
2020-06-24,Kerala,1055,9,1046,12994,428,198,8.12,0,35.3,144781,1206,143952,1.21,0.56,0.36810198300283287,0.83,99.43
2020-06-25,Kerala,668,4,665,8248,3239,2474,8.1,0,35.3,145449,1210,144617,9.18,7.01,0.2336543909348442,0.83,99.43
2020-06-26,Kerala,1142,4,1138,14264,106,102,8.01,0,35.3,146591,1214,145755,0.3,0.29,0.40407932011331443,0.83,99.43
2020-06-27,Kerala,773,10,765,9370,871,117,8.25,0,35.3,147364,1224,146520,2.47,0.33,0.26543909348441924,0.83,99.43
2020-06-28,Kerala,693,5,684,8285,2456,749,8.36,4,35.3,148057,1229,147204,6.96,2.12,0.23470254957507083,0.83,99.42
2020-06-29,Kerala,207,1,202,2743,3443,1625,7.55,4,35.3,148264,1230,147406,9.75,4.6,0.07770538243626063,0.83,99.42
2020-06-30,Kerala,122,1,113,1541,569,559,7.92,8,35.3,148386,1231,147519,1.61,1.58,0.04365439093484419,0.83,99.42
2020-07-01,Kerala,505,6,503,6072,550,242,8.32,0,35.3,148891,1237,148022,1.56,0.69,0.17201133144475922,0.83,99.42
2020-07-02,Kerala,370,1,365,4481,4053,3716,8.26,4,35.3,149261,1238,148387,11.48,10.53,0.12694050991501415,0.83,99.41
2020-07-03,Kerala,226,0,224,2697,931,900,8.38,2,35.3,149487,1238,148611,2.64,2.55,0.07640226628895185,0.83,99.41
2020-07-04,Kerala,174,0,166,2259,2279,1119,7.7,8,35.3,149661,1238,148777,6.46,3.17,0.0639943342776204,0.83,99.41
2020-07-05,Kerala,30,0,26,1053,2404,496,2.85,4,35.3,149691,1238,148803,6.81,1.41,0.0298300283286119,0.83,99.41
2020-07-06,Kerala,627,4,620,7762,4659,2193,8.08,3,35.3,150318,1242,149423,13.2,6.21,0.21988668555240792,0.83,99.4
2020-07-07,Kerala,1269,16,1265,16054,1226,335,7.9,0,35.3,151587,1258,150688,3.47,0.95,0.4547875354107649,0.83,99.41
2020-07-08,Kerala,161,2,159,1472,2280,1323,10.94,0,35.3,151748,1260,150847,6.46,3.75,0.04169971671388102,0.83,99.41
2020-07-09,Kerala,223,2,217,2844,3409,1305,7.84,4,35.3,151971,1262,151064,9.66,3.7,0.08056657223796033,0.83,99.4
2020-07-10,Kerala,1550,11,1545,19412,3564,2279,7.98,0,35.3,153521,1273,152609,10.1,6.46,0.549915014164306,0.83,99.41
2020-07-11,Kerala,1000,14,993,12618,522,91,7.93,0,35.3,154521,1287,153602,1.48,0.26,0.35745042492917845,0.83,99.41
2020-07-12,Kerala,677,2,676,8060,1929,959,8.4,0,35.3,155198,1289,154278,5.46,2.72,0.228328611898017,0.83,99.41
2020-07-13,Kerala,315,4,315,4085,1197,499,7.71,0,35.3,155513,1293,154593,3.39,1.41,0.11572237960339943,0.83,99.41
2020-07-14,Kerala,761,8,754,9666,593,187,7.87,0,35.3,156274,1301,155347,1.68,0.53,0.2738243626062323,0.83,99.41
2020-07-15,Kerala,944,8,940,11712,2464,1822,8.06,0,35.3,157218,1309,156287,6.98,5.16,0.3317847025495751,0.83,99.41
2020-07-16,Kerala,115,1,113,1042,1335,771,11.04,1,35.3,157333,1310,156400,3.78,2.18,0.02951841359773371,0.83,99.41
2020-07-17,Kerala,222,2,221,2711,1661,1305,8.19,0,35.3,157555,1312,156621,4.71,3.7,0.07679886685552408,0.83,99.41
2020-07-18,Kerala,1120,13,1119,13887,437,59,8.07,0,35.3,158675,1325,157740,1.24,0.17,0.393399433427762,0.84,99.41
2020-07-19,Kerala,1189,5,1185,14691,3765,3257,8.09,0,35.3,159864,1330,158925,10.67,9.23,0.41617563739376773,0.83,99.41
2020-07-20,Kerala,1001,5,993,12128,12,4,8.25,3,35.3,160865,1335,159918,0.03,0.01,0.3435694050991501,0.83,99.41
2020-07-21,Kerala,741,5,740,9422,1227,14,7.86,0,35.3,161606,1340,160658,3.48,0.04,0.26691218130311617,0.83,99.41
2020-07-22,Kerala,1386,14,1382,17587,2791,2610,7.88,0,35.3,162992,1354,162040,7.91,7.39,0.4982152974504249,0.83,99.42
2020-07-23,Kerala,976,10,969,12649,2074,1262,7.72,0,35.3,163968,1364,163009,5.88,3.58,0.358328611898017,0.83,99.42
2020-07-24,Kerala,330,1,329,4031,3945,3759,8.19,0,35.3,164298,1365,163338,11.18,10.65,0.11419263456090652,0.83,99.42
2020-07-25,Kerala,186,1,177,2361,1381,425,7.88,8,35.3,164484,1366,163515,3.91,1.2,0.06688385269121813,0.83,99.41
2020-07-26,Kerala,217,0,212,2908,1779,450,7.46,5,35.3,164701,1366,163727,5.04,1.27,0.08237960339943343,0.83,99.41
2020-07-27,Kerala,7,0,0,559,2356,1475,1.25,7,35.3,164708,1366,163727,6.67,4.18,0.0158356940509915,0.83,99.4
2020-07-28,Kerala,671,4,666,8640,1949,1052,7.77,1,35.3,165379,1370,164393,5.52,2.98,0.24475920679886687,0.83,99.4
2020-07-29,Kerala,1068,15,1063,13291,4113,3692,8.04,0,35.3,166447,1385,165456,11.65,10.46,0.3765155807365439,0.83,99.4
2020-07-30,Kerala,810,4,810,9974,4040,1646,8.12,0,35.3,167257,1389,166266,11.44,4.66,0.2825495750708215,0.83,99.41
2020-07-31,Kerala,853,5,848,10388,804,616,8.21,0,35.3,168110,1394,167114,2.28,1.75,0.29427762039660055,0.83,99.41
2020-08-01,Kerala,1315,8,1311,16310,1146,51,8.06,0,35.3,169425,1402,168425,3.25,0.14,0.4620396600566572,0.83,99.41
2020-08-02,Kerala,976,9,972,12345,214,86,7.91,0,35.3,170401,1411,169397,0.61,0.24,0.3497167138810198,0.83,99.41
2020-08-03,Kerala,1434,15,1433,17644,1589,424,8.13,0,35.3,171835,1426,170830,4.5,1.2,0.4998300283286119,0.83,99.42
2020-08-04,Kerala,988,6,981,12433,2986,469,7.95,1,35.3,172823,1432,171811,8.46,1.33,0.3522096317280453,0.83,99.41
2020-08-05,Kerala,536,5,529,6879,2146,2087,7.79,2,35.3,173359,1437,172340,6.08,5.91,0.19487252124645893,0.83,99.41
2020-08-06,Kerala,1232,17,1231,15797,4304,3295,7.8,0,35.3,174591,1454,173571,12.19,9.33,0.4475070821529745,0.83,99.42
2020-08-07,Kerala,693,3,689,8596,4138,1409,8.06,1,35.3,175284,1457,174260,11.72,3.99,0.2435127478753541,0.83,99.42
2020-08-08,Kerala,1320,4,1319,16595,666,67,7.95,0,35.3,176604,1461,175579,1.89,0.19,0.4701133144475921,0.83,99.42
2020-08-09,Kerala,290,3,290,3244,462,280,8.94,0,35.3,176894,1464,175869,1.31,0.79,0.09189801699716714,0.83,99.42
2020-08-10,Kerala,204,2,196,2270,2168,1580,8.99,6,35.3,177098,1466,176065,6.14,4.48,0.06430594900849858,0.83,99.42
2020-08-11,Kerala,181,2,178,2571,2089,355,7.04,1,35.3,177279,1468,176243,5.92,1.01,0.0728328611898017,0.83,99.42
2020-08-12,Kerala,1303,15,1294,15951,2778,115,8.17,0,35.3,178582,1483,177537,7.87,0.33,0.45186968838526914,0.83,99.41
2020-08-13,Kerala,1466,16,1465,18411,4001,690,7.96,0,35.3,180048,1499,179002,11.33,1.95,0.5215580736543909,0.83,99.42
2020-08-14,Kerala,1362,16,1356,16528,3611,3164,8.24,0,35.3,181410,1515,180358,10.23,8.96,0.46821529745042495,0.84,99.42
2020-08-15,Kerala,764,11,760,9708,1534,903,7.87,0,35.3,182174,1526,181118,4.35,2.56,0.275014164305949,0.84,99.42
2020-08-16,Kerala,604,5,598,7613,2560,238,7.93,1,35.3,182778,1531,181716,7.25,0.67,0.2156657223796034,0.84,99.42
2020-08-17,Kerala,678,9,671,8914,2532,511,7.61,0,35.3,183456,1540,182387,7.17,1.45,0.2525212464589235,0.84,99.42
2020-08-18,Kerala,537,5,529,6378,617,234,8.42,3,35.3,183993,1545,182916,1.75,0.66,0.1806798866855524,0.84,99.41
2020-08-19,Kerala,1209,17,1204,15135,787,538,7.99,0,35.3,185202,1562,184120,2.23,1.52,0.4287535410764873,0.84,99.42
2020-08-20,Kerala,648,7,643,7841,2112,301,8.26,0,35.3,185850,1569,184763,5.98,0.85,0.22212464589235129,0.84,99.42
2020-08-21,Kerala,1499,18,1498,18913,870,681,7.93,0,35.3,187349,1587,186261,2.46,1.93,0.5357790368271955,0.85,99.42
2020-08-22,Kerala,681,3,672,8791,2474,1647,7.75,6,35.3,188030,1590,186933,7.01,4.67,0.2490368271954674,0.85,99.42
2020-08-23,Kerala,126,0,125,1749,640,125,7.2,1,35.3,188156,1590,187058,1.81,0.35,0.049546742209631726,0.85,99.42
2020-08-24,Kerala,198,1,190,2499,1770,1658,7.92,7,35.3,188354,1591,187248,5.01,4.7,0.07079320113314448,0.84,99.41
2020-08-25,Kerala,596,4,595,7740,3400,249,7.7,0,35.3,188950,1595,187843,9.63,0.71,0.21926345609065157,0.84,99.41
2020-08-26,Kerala,918,2,914,11735,651,294,7.82,2,35.3,189868,1597,188757,1.84,0.83,0.33243626062322945,0.84,99.41
2020-08-27,Kerala,390,4,390,4821,2318,598,8.09,0,35.3,190258,1601,189147,6.57,1.69,0.13657223796033993,0.84,99.42
2020-08-28,Kerala,1165,8,1165,14544,2430,877,8.01,0,35.3,191423,1609,190312,6.88,2.48,0.4120113314447592,0.84,99.42
2020-08-29,Kerala,820,7,816,9821,342,291,8.35,0,35.3,192243,1616,191128,0.97,0.82,0.27821529745042495,0.84,99.42
2020-08-30,Kerala,685,7,680,8752,3491,2494,7.83,0,35.3,192928,1623,191808,9.89,7.07,0.24793201133144477,0.84,99.42
2020-08-31,Kerala,171,2,163,2213,4334,847,7.73,6,35.3,193099,1625,191971,12.28,2.4,0.06269121813031162,0.84,99.42
2020-09-01,Kerala,990,11,989,12177,3145,3018,8.13,0,35.3,194089,1636,192960,8.91,8.55,0.34495750708215295,0.84,99.42
2020-09-02,Kerala,1169,14,1169,14048,1260,355,8.32,0,35.3,195258,1650,194129,3.57,1.01,0.3979603399433428,0.85,99.42
2020-09-03,Kerala,1017,13,1008,12795,778,33,7.95,0,35.3,196275,1663,195137,2.2,0.09,0.3624645892351275,0.85,99.42
2020-09-04,Kerala,604,3,597,7676,2466,774,7.87,4,35.3,196879,1666,195734,6.99,2.19,0.21745042492917846,0.85,99.42
2020-09-05,Kerala,476,2,470,5651,4775,1423,8.42,4,35.3,197355,1668,196204,13.53,4.03,0.16008498583569405,0.85,99.42
2020-09-06,Kerala,1469,5,1467,19035,1042,99,7.72,0,35.3,198824,1673,197671,2.95,0.28,0.5392351274787536,0.84,99.42
2020-09-07,Kerala,1075,10,1069,13467,4554,3077,7.98,0,35.3,199899,1683,198740,12.9,8.72,0.3815014164305949,0.84,99.42
2020-09-08,Kerala,469,6,462,5480,4712,4642,8.56,1,35.3,200368,1689,199202,13.35,13.15,0.15524079320113315,0.84,99.42
2020-09-09,Kerala,349,4,342,4206,4939,4502,8.3,3,35.3,200717,1693,199544,13.99,12.75,0.1191501416430595,0.84,99.42
2020-09-10,Kerala,979,11,973,12011,2061,1456,8.15,0,35.3,201696,1704,200517,5.84,4.12,0.3402549575070822,0.84,99.42
2020-09-11,Kerala,527,2,521,6580,321,118,8.01,4,35.3,202223,1706,201038,0.91,0.33,0.18640226628895185,0.84,99.41
2020-09-12,Kerala,560,3,560,6857,1812,587,8.17,0,35.3,202783,1709,201598,5.13,1.66,0.19424929178470254,0.84,99.42
2020-09-13,Kerala,76,0,74,919,2101,1686,8.27,2,35.3,202859,1709,201672,5.95,4.78,0.02603399433427762,0.84,99.41
2020-09-14,Kerala,1320,4,1316,16423,4494,1960,8.04,0,35.3,204179,1713,202988,12.73,5.55,0.46524079320113315,0.84,99.42
2020-09-15,Kerala,1551,4,1549,19187,1520,1318,8.08,0,35.3,205730,1717,204537,4.31,3.73,0.5435410764872521,0.83,99.42
2020-09-16,Kerala,393,3,386,4888,2443,1069,8.04,4,35.3,206123,1720,204923,6.92,3.03,0.1384702549575071,0.83,99.42
2020-09-17,Kerala,631,5,624,7989,3023,153,7.9,2,35.3,206754,1725,205547,8.56,0.43,0.2263172804532578,0.83,99.42
2020-09-18,Kerala,782,8,775,10049,2937,1203,7.78,0,35.3,207536,1733,206322,8.32,3.41,0.2846742209631728,0.84,99.42
2020-09-19,Kerala,1373,17,1370,17796,1771,1398,7.72,0,35.3,208909,1750,207692,5.02,3.96,0.5041359773371105,0.84,99.42
2020-09-20,Kerala,1298,12,1296,15805,4634,788,8.21,0,35.3,210207,1762,208988,13.13,2.23,0.4477337110481586,0.84,99.42
2020-09-21,Kerala,205,0,202,2287,663,489,8.96,3,35.3,210412,1762,209190,1.88,1.39,0.06478753541076487,0.84,99.42
2020-09-22,Kerala,1221,8,1219,14990,1172,159,8.15,0,35.3,211633,1770,210409,3.32,0.45,0.4246458923512748,0.84,99.42
2020-09-23,Kerala,627,4,620,7393,3427,472,8.48,3,35.3,212260,1774,211029,9.71,1.34,0.20943342776203966,0.84,99.42
2020-09-24,Kerala,554,6,552,6791,1819,1199,8.16,0,35.3,212814,1780,211581,5.15,3.4,0.19237960339943344,0.84,99.42
2020-09-25,Kerala,1525,11,1525,19240,3457,906,7.93,0,35.3,214339,1791,213106,9.79,2.57,0.545042492917847,0.84,99.42
2020-09-26,Kerala,268,3,268,3316,2245,23,8.08,0,35.3,214607,1794,213374,6.36,0.07,0.09393767705382436,0.84,99.43
2020-09-27,Kerala,1342,13,1335,16537,285,147,8.12,0,35.3,215949,1807,214709,0.81,0.42,0.4684702549575071,0.84,99.43
2020-09-28,Kerala,1420,4,1416,17730,633,508,8.01,0,35.3,217369,1811,216125,1.79,1.44,0.5022662889518413,0.83,99.43
2020-09-29,Kerala,813,7,805,10517,1693,1554,7.73,1,35.3,218182,1818,216930,4.8,4.4,0.29793201133144476,0.83,99.43
2020-09-30,Kerala,649,2,645,8232,720,31,7.88,2,35.3,218831,1820,217575,2.04,0.09,0.2332011331444759,0.83,99.43
2020-10-01,Kerala,1307,5,1299,16217,1286,232,8.06,3,35.3,220138,1825,218874,3.64,0.66,0.45940509915014166,0.83,99.43
2020-10-02,Kerala,1228,12,1219,15606,1199,513,7.87,0,35.3,221366,1837,220093,3.4,1.45,0.44209631728045323,0.83,99.42
2020-10-03,Kerala,1305,11,1299,16249,4773,4195,8.03,0,35.3,222671,1848,221392,13.52,11.88,0.46031161473087817,0.83,99.43
2020-10-04,Kerala,1113,14,1107,13583,1338,1010,8.19,0,35.3,223784,1862,222499,3.79,2.86,0.3847875354107649,0.83,99.43
2020-10-05,Kerala,1151,11,1144,14503,1421,210,7.94,0,35.3,224935,1873,223643,4.03,0.59,0.4108498583569405,0.83,99.43
2020-10-06,Kerala,966,9,966,11721,3801,2866,8.24,0,35.3,225901,1882,224609,10.77,8.12,0.33203966005665725,0.83,99.43
2020-10-07,Kerala,332,4,330,4148,3419,74,8.0,0,35.3,226233,1886,224939,9.69,0.21,0.1175070821529745,0.83,99.43
2020-10-08,Kerala,617,2,615,7734,2239,312,7.98,0,35.3,226850,1888,225554,6.34,0.88,0.21909348441926346,0.83,99.43
2020-10-09,Kerala,1392,11,1385,17703,3556,1283,7.86,0,35.3,228242,1899,226939,10.07,3.63,0.5015014164305949,0.83,99.43
2020-10-10,Kerala,1204,4,1204,15097,2472,1999,7.98,0,35.3,229446,1903,228143,7.0,5.66,0.4276770538243626,0.83,99.43
2020-10-11,Kerala,423,5,415,5433,3220,1597,7.79,3,35.3,229869,1908,228558,9.12,4.52,0.15390934844192636,0.83,99.43
2020-10-12,Kerala,326,3,319,3735,2032,1554,8.73,4,35.3,230195,1911,228877,5.76,4.4,0.10580736543909348,0.83,99.43
2020-10-13,Kerala,1345,6,1340,16978,4452,2886,7.92,0,35.3,231540,1917,230217,12.61,8.18,0.4809631728045326,0.83,99.43
2020-10-14,Kerala,1494,13,1490,18754,398,298,7.97,0,35.3,233034,1930,231707,1.13,0.84,0.5312747875354108,0.83,99.43
2020-10-15,Kerala,1530,15,1528,18934,1950,873,8.08,0,35.3,234564,1945,233235,5.52,2.47,0.5363739376770538,0.83,99.43
2020-10-16,Kerala,1331,10,1324,16675,4626,1071,7.98,0,35.3,235895,1955,234559,13.1,3.03,0.4723796033994334,0.83,99.43
2020-10-17,Kerala,270,3,262,3101,3388,2121,8.71,5,35.3,236165,1958,234821,9.6,6.01,0.08784702549575071,0.83,99.43
2020-10-18,Kerala,888,9,887,10688,2322,1441,8.31,0,35.3,237053,1967,235708,6.58,4.08,0.3027762039660057,0.83,99.43
2020-10-19,Kerala,1199,16,1193,15091,3292,1367,7.95,0,35.3,238252,1983,236901,9.33,3.87,0.4275070821529745,0.83,99.43
2020-10-20,Kerala,1535,4,1527,18902,1713,1068,8.12,4,35.3,239787,1987,238428,4.85,3.03,0.5354674220963173,0.83,99.43
2020-10-21,Kerala,344,3,338,4347,2926,7,7.91,3,35.3,240131,1990,238766,8.29,0.02,0.12314447592067988,0.83,99.43
2020-10-22,Kerala,790,2,788,9707,703,221,8.14,0,35.3,240921,1992,239554,1.99,0.63,0.274985835694051,0.83,99.43
2020-10-23,Kerala,736,8,730,9334,4719,4222,7.89,0,35.3,241657,2000,240284,13.37,11.96,0.2644192634560906,0.83,99.43
2020-10-24,Kerala,583,1,576,7458,607,537,7.82,6,35.3,242240,2001,240860,1.72,1.52,0.21127478753541076,0.83,99.43
2020-10-25,Kerala,59,0,56,1331,4607,2024,4.43,3,35.3,242299,2001,240916,13.05,5.73,0.03770538243626062,0.83,99.43
2020-10-26,Kerala,396,2,392,5051,155,142,7.84,2,35.3,242695,2003,241308,0.44,0.4,0.14308781869688386,0.83,99.43
2020-10-27,Kerala,409,1,405,5241,2328,681,7.8,3,35.3,243104,2004,241713,6.59,1.93,0.14847025495750707,0.82,99.43
2020-10-28,Kerala,151,1,149,1699,672,196,8.89,1,35.3,243255,2005,241862,1.9,0.56,0.04813031161473088,0.82,99.43
2020-10-29,Kerala,246,1,239,2669,496,404,9.22,6,35.3,243501,2006,242101,1.41,1.14,0.07560906515580737,0.82,99.43
2020-10-30,Kerala,92,0,89,1554,3741,3260,5.92,3,35.3,243593,2006,242190,10.6,9.24,0.044022662889518414,0.82,99.42
2020-10-31,Kerala,263,3,259,3372,3245,2316,7.8,1,35.3,243856,2009,242449,9.19,6.56,0.09552407932011331,0.82,99.42
2020-11-01,Kerala,941,7,933,11892,4876,2701,7.91,1,35.3,244797,2016,243382,13.81,7.65,0.3368838526912181,0.82,99.42
2020-11-02,Kerala,532,6,524,6686,4447,2791,7.96,2,35.3,245329,2022,243906,12.6,7.91,0.18940509915014164,0.82,99.42
2020-11-03,Kerala,1360,19,1352,17286,1123,248,7.87,0,35.3,246689,2041,245258,3.18,0.7,0.48968838526912184,0.83,99.42
2020-11-04,Kerala,257,1,251,3135,2239,657,8.2,5,35.3,246946,2042,245509,6.34,1.86,0.08881019830028329,0.83,99.42
2020-11-05,Kerala,596,8,590,7489,604,377,7.96,0,35.3,247542,2050,246099,1.71,1.07,0.2121529745042493,0.83,99.42
2020-11-06,Kerala,1384,8,1376,17132,2251,484,8.08,0,35.3,248926,2058,247475,6.38,1.37,0.4853257790368272,0.83,99.42
2020-11-07,Kerala,1111,9,1104,14044,1462,1220,7.91,0,35.3,250037,2067,248579,4.14,3.46,0.3978470254957507,0.83,99.42
2020-11-08,Kerala,502,6,500,6088,4603,1171,8.25,0,35.3,250539,2073,249079,13.04,3.32,0.17246458923512747,0.83,99.42
2020-11-09,Kerala,195,1,190,2319,4564,3845,8.41,4,35.3,250734,2074,249269,12.93,10.89,0.06569405099150141,0.83,99.42
2020-11-10,Kerala,977,12,968,12054,658,446,8.11,0,35.3,251711,2086,250237,1.86,1.26,0.3414730878186969,0.83,99.41
2020-11-11,Kerala,369,4,362,4463,379,334,8.27,3,35.3,252080,2090,250599,1.07,0.95,0.12643059490084985,0.83,99.41
2020-11-12,Kerala,859,4,850,10945,1287,545,7.85,5,35.3,252939,2094,251449,3.65,1.54,0.31005665722379605,0.83,99.41
2020-11-13,Kerala,464,5,463,5976,560,191,7.76,0,35.3,253403,2099,251912,1.59,0.54,0.16929178470254957,0.83,99.41
2020-11-14,Kerala,575,4,574,7323,1699,697,7.85,0,35.3,253978,2103,252486,4.81,1.97,0.20745042492917848,0.83,99.41
2020-11-15,Kerala,1178,10,1178,15041,4387,368,7.83,0,35.3,255156,2113,253664,12.43,1.04,0.42609065155807363,0.83,99.42
2020-11-16,Kerala,495,4,486,6196,3022,81,7.99,5,35.3,255651,2117,254150,8.56,0.23,0.17552407932011332,0.83,99.41
2020-11-17,Kerala,219,2,219,2651,60,13,8.26,0,35.3,255870,2119,254369,0.17,0.04,0.07509915014164306,0.83,99.41
2020-11-18,Kerala,456,2,448,5634,3831,1599,8.09,6,35.3,256326,2121,254817,10.85,4.53,0.15960339943342777,0.83,99.41
2020-11-19,Kerala,522,3,514,6542,1693,1323,7.98,5,35.3,256848,2124,255331,4.8,3.75,0.1853257790368272,0.83,99.41
2020-11-20,Kerala,600,8,593,7912,186,56,7.58,0,35.3,257448,2132,255924,0.53,0.16,0.2241359773371105,0.83,99.41
2020-11-21,Kerala,640,4,637,8105,102,2,7.9,0,35.3,258088,2136,256561,0.29,0.01,0.22960339943342775,0.83,99.41
2020-11-22,Kerala,398,3,395,4912,562,457,8.1,0,35.3,258486,2139,256956,1.59,1.29,0.1391501416430595,0.83,99.41
2020-11-23,Kerala,39,0,33,794,4453,2652,4.91,6,35.3,258525,2139,256989,12.61,7.51,0.022492917847025496,0.83,99.41
2020-11-24,Kerala,931,11,930,10899,3570,3421,8.54,0,35.3,259456,2150,257919,10.11,9.69,0.3087535410764872,0.83,99.41
2020-11-25,Kerala,833,6,833,10612,26,23,7.85,0,35.3,260289,2156,258752,0.07,0.07,0.30062322946175635,0.83,99.41
2020-11-26,Kerala,562,5,560,6899,4405,3804,8.15,0,35.3,260851,2161,259312,12.48,10.78,0.19543909348441926,0.83,99.41
2020-11-27,Kerala,1327,8,1318,16216,3807,1829,8.18,1,35.3,262178,2169,260630,10.78,5.18,0.4593767705382436,0.83,99.41
2020-11-28,Kerala,1163,8,1157,14218,1744,1238,8.18,0,35.3,263341,2177,261787,4.94,3.51,0.40277620396600566,0.83,99.41
2020-11-29,Kerala,829,4,825,10652,528,156,7.78,0,35.3,264170,2181,262612,1.5,0.44,0.30175637393767707,0.83,99.41
2020-11-30,Kerala,1178,15,1178,14743,1894,1046,7.99,0,35.3,265348,2196,263790,5.37,2.96,0.4176487252124646,0.83,99.41
2020-12-01,Kerala,652,6,643,8170,1783,144,7.98,3,35.3,266000,2202,264433,5.05,0.41,0.23144475920679886,0.83,99.41
2020-12-02,Kerala,417,2,413,5229,1270,833,7.97,2,35.3,266417,2204,264846,3.6,2.36,0.1481303116147309,0.83,99.41
2020-12-03,Kerala,876,7,869,11222,851,667,7.81,0,35.3,267293,2211,265715,2.41,1.89,0.3179036827195467,0.83,99.41
2020-12-04,Kerala,888,12,881,11541,2100,420,7.69,0,35.3,268181,2223,266596,5.95,1.19,0.32694050991501417,0.83,99.41
2020-12-05,Kerala,633,3,630,7724,81,3,8.2,0,35.3,268814,2226,267226,0.23,0.01,0.21881019830028328,0.83,99.41
2020-12-06,Kerala,76,0,69,937,4292,2517,8.11,7,35.3,268890,2226,267295,12.16,7.13,0.026543909348441926,0.83,99.41
2020-12-07,Kerala,320,3,313,3887,934,747,8.23,4,35.3,269210,2229,267608,2.65,2.12,0.11011331444759206,0.83,99.4
2020-12-08,Kerala,770,6,768,9972,1802,45,7.72,0,35.3,269980,2235,268376,5.1,0.13,0.2824929178470255,0.83,99.41
2020-12-09,Kerala,439,3,435,5839,2546,1495,7.52,1,35.3,270419,2238,268811,7.21,4.24,0.16541076487252124,0.83,99.41
2020-12-10,Kerala,1447,13,1440,18504,3016,202,7.82,0,35.3,271866,2251,270251,8.54,0.57,0.5241926345609065,0.83,99.41
2020-12-11,Kerala,1025,10,1017,13123,109,14,7.81,0,35.3,272891,2261,271268,0.31,0.04,0.3717563739376771,0.83,99.41
2020-12-12,Kerala,903,7,903,11323,1082,840,7.97,0,35.3,273794,2268,272171,3.07,2.38,0.32076487252124647,0.83,99.41
2020-12-13,Kerala,1291,17,1282,15697,1359,32,8.22,0,35.3,275085,2285,273453,3.85,0.09,0.44467422096317283,0.83,99.41
2020-12-14,Kerala,499,6,495,5982,260,76,8.34,0,35.3,275584,2291,273948,0.74,0.22,0.16946175637393768,0.83,99.41
2020-12-15,Kerala,545,3,543,6948,1925,1895,7.84,0,35.3,276129,2294,274491,5.45,5.37,0.19682719546742208,0.83,99.41
2020-12-16,Kerala,693,8,690,8219,2796,1778,8.43,0,35.3,276822,2302,275181,7.92,5.04,0.2328328611898017,0.83,99.41
2020-12-17,Kerala,95,0,90,686,3175,1949,13.85,5,35.3,276917,2302,275271,8.99,5.52,0.01943342776203966,0.83,99.41
2020-12-18,Kerala,870,7,861,10934,858,384,7.96,2,35.3,277787,2309,276132,2.43,1.09,0.30974504249291784,0.83,99.4
2020-12-19,Kerala,144,0,138,1782,3191,1029,8.08,6,35.3,277931,2309,276270,9.04,2.92,0.05048158640226629,0.83,99.4
2020-12-20,Kerala,704,3,702,9001,4608,2038,7.82,0,35.3,278635,2312,276972,13.05,5.77,0.254985835694051,0.83,99.4
2020-12-21,Kerala,92,1,89,1075,4839,3288,8.56,2,35.3,278727,2313,277061,13.71,9.31,0.030453257790368272,0.83,99.4
2020-12-22,Kerala,232,3,227,2811,806,529,8.25,2,35.3,278959,2316,277288,2.28,1.5,0.07963172804532578,0.83,99.4
2020-12-23,Kerala,491,1,485,6202,792,370,7.92,5,35.3,279450,2317,277773,2.24,1.05,0.17569405099150143,0.83,99.4
2020-12-24,Kerala,267,2,260,3175,2095,2067,8.41,5,35.3,279717,2319,278033,5.93,5.86,0.08994334277620397,0.83,99.4
2020-12-25,Kerala,218,1,217,2397,2202,1309,9.09,0,35.3,279935,2320,278250,6.24,3.71,0.06790368271954675,0.83,99.4
2020-12-26,Kerala,1425,19,1416,17938,148,99,7.94,0,35.3,281360,2339,279666,0.42,0.28,0.5081586402266289,0.83,99.4
2020-12-27,Kerala,164,0,158,2315,1984,1885,7.08,6,35.3,281524,2339,279824,5.62,5.34,0.06558073654390935,0.83,99.4
2020-12-28,Kerala,82,0,80,924,4527,760,8.87,2,35.3,281606,2339,279904,12.82,2.15,0.026175637393767704,0.83,99.4
2020-12-29,Kerala,1572,11,1568,19521,2998,933,8.05,0,35.3,283178,2350,281472,8.49,2.64,0.5530028328611898,0.83,99.4
2020-12-30,Kerala,1191,14,1189,14865,887,26,8.01,0,35.3,284369,2364,282661,2.51,0.07,0.42110481586402265,0.83,99.4
2020-12-31,Kerala,833,12,827,10380,4298,1437,8.03,0,35.3,285202,2376,283488,12.18,4.07,0.29405099150141645,0.83,99.4
2021-01-01,Kerala,412,2,407,4973,4608,3584,8.28,3,35.3,285614,2378,283895,13.05,10.15,0.14087818696883853,0.83,99.4
2021-01-02,Kerala,50,0,47,726,3089,2772,6.89,3,35.3,285664,2378,283942,8.75,7.85,0.02056657223796034,0.83,99.4
2021-01-03,Kerala,1548,6,1545,19193,1299,69,8.07,0,35.3,287212,2384,285487,3.68,0.2,0.5437110481586402,0.83,99.4
2021-01-04,Kerala,1201,5,1199,14795,1562,773,8.12,0,35.3,288413,2389,286686,4.42,2.19,0.41912181303116147,0.83,99.4
2021-01-05,Kerala,1552,16,1547,19856,190,21,7.82,0,35.3,289965,2405,288233,0.54,0.06,0.5624929178470255,0.83,99.4
2021-01-06,Kerala,853,9,852,10880,4537,4289,7.84,0,35.3,290818,2414,289085,12.85,12.15,0.3082152974504249,0.83,99.4
2021-01-07,Kerala,982,8,976,12099,872,618,8.12,0,35.3,291800,2422,290061,2.47,1.75,0.34274787535410767,0.83,99.4
2021-01-08,Kerala,1362,16,1359,16918,1439,137,8.05,0,35.3,293162,2438,291420,4.08,0.39,0.4792634560906516,0.83,99.41
2021-01-09,Kerala,128,0,127,1272,4890,2031,10.06,1,35.3,293290,2438,291547,13.85,5.75,0.03603399433427762,0.83,99.41
2021-01-10,Kerala,1417,14,1417,17737,3638,1135,7.99,0,35.3,294707,2452,292964,10.31,3.22,0.5024645892351275,0.83,99.41
2021-01-11,Kerala,657,8,649,8233,108,82,7.98,0,35.3,295364,2460,293613,0.31,0.23,0.23322946175637393,0.83,99.41
2021-01-12,Kerala,1585,13,1584,19927,3713,1571,7.95,0,35.3,296949,2473,295197,10.52,4.45,0.5645042492917847,0.83,99.41
2021-01-13,Kerala,861,9,856,10540,4803,1062,8.17,0,35.3,297810,2482,296053,13.61,3.01,0.29858356940509917,0.83,99.41
2021-01-14,Kerala,224,1,217,2622,1998,710,8.54,6,35.3,298034,2483,296270,5.66,2.01,0.07427762039660056,0.83,99.41
2021-01-15,Kerala,1261,14,1260,15511,128,28,8.13,0,35.3,299295,2497,297530,0.36,0.08,0.43940509915014164,0.83,99.41
2021-01-16,Kerala,1530,16,1529,18790,4604,3504,8.14,0,35.3,300825,2513,299059,13.04,9.93,0.5322946175637394,0.84,99.41
2021-01-17,Kerala,878,11,877,10993,3811,1247,7.99,0,35.3,301703,2524,299936,10.8,3.53,0.3114164305949009,0.84,99.41
2021-01-18,Kerala,632,4,626,7975,3882,243,7.92,2,35.3,302335,2528,300562,11.0,0.69,0.22592067988668554,0.84,99.41
2021-01-19,Kerala,1168,15,1160,14767,1893,927,7.91,0,35.3,303503,2543,301722,5.36,2.63,0.418328611898017,0.84,99.41
2021-01-20,Kerala,1370,13,1368,16723,1823,754,8.19,0,35.3,304873,2556,303090,5.16,2.14,0.47373937677053823,0.84,99.42
2021-01-21,Kerala,256,3,248,3271,2941,685,7.83,5,35.3,305129,2559,303338,8.33,1.94,0.0926628895184136,0.84,99.41
2021-01-22,Kerala,431,1,423,5260,927,437,8.19,7,35.3,305560,2560,303761,2.63,1.24,0.1490084985835694,0.84,99.41
2021-01-23,Kerala,126,0,117,1308,2673,1960,9.63,9,35.3,305686,2560,303878,7.57,5.55,0.03705382436260623,0.84,99.41
2021-01-24,Kerala,807,3,804,10123,1459,1103,7.97,0,35.3,306493,2563,304682,4.13,3.12,0.2867705382436261,0.84,99.41
2021-01-25,Kerala,588,7,584,7406,2132,808,7.94,0,35.3,307081,2570,305266,6.04,2.29,0.2098016997167139,0.84,99.41
2021-01-26,Kerala,1193,15,1184,14587,4094,2147,8.18,0,35.3,308274,2585,306450,11.6,6.08,0.41322946175637393,0.84,99.41
2021-01-27,Kerala,52,0,48,504,3235,835,10.32,4,35.3,308326,2585,306498,9.16,2.37,0.014277620396600566,0.84,99.41
2021-01-28,Kerala,525,4,521,6967,982,13,7.54,0,35.3,308851,2589,307019,2.78,0.04,0.19736543909348442,0.84,99.41
2021-01-29,Kerala,1149,6,1148,14059,2967,2296,8.17,0,35.3,310000,2595,308167,8.41,6.5,0.39827195467422094,0.84,99.41
2021-01-30,Kerala,121,0,117,1348,2079,384,8.98,4,35.3,310121,2595,308284,5.89,1.09,0.03818696883852691,0.84,99.41
2021-01-31,Kerala,1163,7,1156,14617,508,372,7.96,0,35.3,311284,2602,309440,1.44,1.05,0.41407932011331444,0.84,99.41
2021-02-01,Kerala,1512,6,1505,18732,1639,18,8.07,1,35.3,312796,2608,310945,4.64,0.05,0.5306515580736544,0.83,99.41
2021-02-02,Kerala,710,4,703,8591,2952,1874,8.26,3,35.3,313506,2612,311648,8.36,5.31,0.24337110481586402,0.83,99.41
2021-02-03,Kerala,316,3,309,3817,4387,855,8.28,4,35.3,313822,2615,311957,12.43,2.42,0.10813031161473088,0.83,99.41
2021-02-04,Kerala,1005,4,1003,12628,3210,2455,7.96,0,35.3,314827,2619,312960,9.09,6.95,0.35773371104815865,0.83,99.41
2021-02-05,Kerala,779,8,770,10056,1197,446,7.75,1,35.3,315606,2627,313730,3.39,1.26,0.2848725212464589,0.83,99.41
2021-02-06,Kerala,809,11,806,10481,1374,69,7.72,0,35.3,316415,2638,314536,3.89,0.2,0.29691218130311614,0.83,99.41
2021-02-07,Kerala,614,7,609,7605,3250,629,8.07,0,35.3,317029,2645,315145,9.21,1.78,0.21543909348441925,0.83,99.41
2021-02-08,Kerala,1440,11,1439,17914,4197,579,8.04,0,35.3,318469,2656,316584,11.89,1.64,0.5074787535410765,0.83,99.41
2021-02-09,Kerala,682,5,676,9265,742,201,7.36,1,35.3,319151,2661,317260,2.1,0.57,0.2624645892351275,0.83,99.41
2021-02-10,Kerala,1116,16,1110,13760,4650,969,8.11,0,35.3,320267,2677,318370,13.17,2.75,0.38980169971671386,0.84,99.41
2021-02-11,Kerala,472,4,467,6086,2528,1103,7.76,1,35.3,320739,2681,318837,7.16,3.12,0.17240793201133145,0.84,99.41
2021-02-12,Kerala,409,3,401,4873,2108,1995,8.39,5,35.3,321148,2684,319238,5.97,5.65,0.13804532577903683,0.84,99.41
2021-02-13,Kerala,1121,6,1118,14053,4319,2360,7.98,0,35.3,322269,2690,320356,12.24,6.69,0.39810198300283284,0.83,99.41
2021-02-14,Kerala,1188,16,1183,15064,1492,758,7.89,0,35.3,323457,2706,321539,4.23,2.15,0.42674220963172804,0.84,99.41
2021-02-15,Kerala,392,4,385,5194,4824,3911,7.55,3,35.3,323849,2710,321924,13.67,11.08,0.14713881019830027,0.84,99.41
2021-02-16,Kerala,17,0,10,555,2493,967,3.06,7,35.3,323866,2710,321934,7.06,2.74,0.015722379603399433,0.84,99.4
2021-02-17,Kerala,223,2,216,2984,128,28,7.47,5,35.3,324089,2712,322150,0.36,0.08,0.08453257790368272,0.84,99.4
2021-02-18,Kerala,1296,5,1293,16055,1666,506,8.07,0,35.3,325385,2717,323443,4.72,1.43,0.4548158640226629,0.84,99.4
2021-02-19,Kerala,356,2,356,4288,4121,1043,8.3,0,35.3,325741,2719,323799,11.67,2.95,0.12147308781869688,0.83,99.4
2021-02-20,Kerala,1540,20,1537,19404,895,142,7.94,0,35.3,327281,2739,325336,2.54,0.4,0.5496883852691218,0.84,99.41
2021-02-21,Kerala,1135,9,1127,14509,3605,2483,7.82,0,35.3,328416,2748,326463,10.21,7.03,0.4110198300283286,0.84,99.41
2021-02-22,Kerala,269,2,268,3167,2064,180,8.49,0,35.3,328685,2750,326731,5.85,0.51,0.08971671388101983,0.84,99.41
2021-02-23,Kerala,1357,15,1357,17228,2662,2207,7.88,0,35.3,330042,2765,328088,7.54,6.25,0.4880453257790368,0.84,99.41
2021-02-24,Kerala,1500,17,1499,18814,232,136,7.97,0,35.3,331542,2782,329587,0.66,0.39,0.5329745042492918,0.84,99.41
2021-02-25,Kerala,1583,14,1580,19817,2637,1623,7.99,0,35.3,333125,2796,331167,7.47,4.6,0.5613881019830028,0.84,99.41
2021-02-26,Kerala,160,1,158,1781,353,318,8.98,1,35.3,333285,2797,331325,1.0,0.9,0.05045325779036827,0.84,99.41
2021-02-27,Kerala,710,10,706,9269,4966,3237,7.66,0,35.3,333995,2807,332031,14.07,9.17,0.26257790368271955,0.84,99.41
2021-02-28,Kerala,93,1,87,1424,2528,235,6.53,5,35.3,334088,2808,332118,7.16,0.67,0.040339943342776206,0.84,99.41
2021-03-01,Kerala,1291,13,1283,15625,2225,1559,8.26,0,35.3,335379,2821,333401,6.3,4.42,0.4426345609065156,0.84,99.41
2021-03-02,Kerala,1093,5,1092,13884,4540,2044,7.87,0,35.3,336472,2826,334493,12.86,5.79,0.39331444759206796,0.84,99.41
2021-03-03,Kerala,1562,15,1559,19738,3382,2721,7.91,0,35.3,338034,2841,336052,9.58,7.71,0.5591501416430595,0.84,99.41
2021-03-04,Kerala,1364,11,1360,17227,4305,602,7.92,0,35.3,339398,2852,337412,12.2,1.71,0.4880169971671388,0.84,99.41
2021-03-05,Kerala,199,0,193,2360,1125,577,8.43,6,35.3,339597,2852,337605,3.19,1.63,0.06685552407932012,0.84,99.41
2021-03-06,Kerala,553,5,553,6513,3750,3441,8.49,0,35.3,340150,2857,338158,10.62,9.75,0.1845042492917847,0.84,99.41
2021-03-07,Kerala,896,13,891,11444,1387,690,7.83,0,35.3,341046,2870,339049,3.93,1.95,0.3241926345609065,0.84,99.41
2021-03-08,Kerala,1451,13,1447,17736,1974,541,8.18,0,35.3,342497,2883,340496,5.59,1.53,0.5024362606232294,0.84,99.42
2021-03-09,Kerala,1331,18,1331,16687,3042,2444,7.98,0,35.3,343828,2901,341827,8.62,6.92,0.4727195467422096,0.84,99.42
2021-03-10,Kerala,267,2,265,3673,1866,1745,7.27,0,35.3,344095,2903,342092,5.29,4.94,0.10405099150141643,0.84,99.42
2021-03-11,Kerala,585,3,583,7089,2424,1351,8.25,0,35.3,344680,2906,342675,6.87,3.83,0.2008215297450425,0.84,99.42
2021-03-12,Kerala,479,4,472,6149,4200,352,7.79,3,35.3,345159,2910,343147,11.9,1.0,0.17419263456090653,0.84,99.42
2021-03-13,Kerala,1121,8,1121,14127,4326,3675,7.94,0,35.3,346280,2918,344268,12.25,10.41,0.4001983002832861,0.84,99.42
2021-03-14,Kerala,988,10,981,12429,907,152,7.95,0,35.3,347268,2928,345249,2.57,0.43,0.35209631728045326,0.84,99.42
2021-03-15,Kerala,748,6,746,10023,4700,2490,7.46,0,35.3,348016,2934,345995,13.31,7.05,0.2839376770538244,0.84,99.42
2021-03-16,Kerala,646,6,642,8302,1270,1200,7.78,0,35.3,348662,2940,346637,3.6,3.4,0.23518413597733712,0.84,99.42
2021-03-17,Kerala,115,1,107,1576,1024,717,7.3,7,35.3,348777,2941,346744,2.9,2.03,0.04464589235127479,0.84,99.42
2021-03-18,Kerala,350,4,350,4402,2891,1459,7.95,0,35.3,349127,2945,347094,8.19,4.13,0.12470254957507082,0.84,99.42
2021-03-19,Kerala,1206,13,1206,14643,3603,1947,8.24,0,35.3,350333,2958,348300,10.21,5.52,0.4148158640226629,0.84,99.42
2021-03-20,Kerala,1596,15,1594,19931,4432,2270,8.01,0,35.3,351929,2973,349894,12.56,6.43,0.5646175637393768,0.84,99.42
2021-03-21,Kerala,643,4,636,8135,46,22,7.9,3,35.3,352572,2977,350530,0.13,0.06,0.23045325779036827,0.84,99.42
2021-03-22,Kerala,1087,15,1082,13483,1172,523,8.06,0,35.3,353659,2992,351612,3.32,1.48,0.3819546742209632,0.85,99.42
2021-03-23,Kerala,953,6,944,11990,545,70,7.95,3,35.3,354612,2998,352556,1.54,0.2,0.3396600566572238,0.85,99.42
2021-03-24,Kerala,633,8,624,7962,3593,3417,7.95,1,35.3,355245,3006,353180,10.18,9.68,0.22555240793201134,0.85,99.42
2021-03-25,Kerala,1424,9,1418,17758,2398,1255,8.02,0,35.3,356669,3015,354598,6.79,3.56,0.5030594900849858,0.85,99.42
2021-03-26,Kerala,132,1,128,1773,3759,3457,7.45,3,35.3,356801,3016,354726,10.65,9.79,0.05022662889518414,0.85,99.42
2021-03-27,Kerala,471,5,468,5945,1923,673,7.92,0,35.3,357272,3021,355194,5.45,1.91,0.16841359773371103,0.85,99.42
2021-03-28,Kerala,1395,5,1395,17323,572,42,8.05,0,35.3,358667,3026,356589,1.62,0.12,0.49073654390934845,0.84,99.42
2021-03-29,Kerala,918,8,911,11820,4410,3880,7.77,0,35.3,359585,3034,357500,12.49,10.99,0.3348441926345609,0.84,99.42
2021-03-30,Kerala,404,2,401,5076,821,756,7.96,1,35.3,359989,3036,357901,2.33,2.14,0.14379603399433427,0.84,99.42
2021-03-31,Kerala,668,5,662,8310,1115,96,8.04,1,35.3,360657,3041,358563,3.16,0.27,0.23541076487252124,0.84,99.42
2021-04-01,Kerala,1272,8,1265,15953,2172,1035,7.97,0,35.3,361929,3049,359828,6.15,2.93,0.45192634560906514,0.84,99.42
2021-04-02,Kerala,1040,9,1035,12941,3840,3603,8.04,0,35.3,362969,3058,360863,10.88,10.21,0.36660056657223794,0.84,99.42
2021-04-03,Kerala,69,1,64,587,4686,2274,11.75,4,35.3,363038,3059,360927,13.27,6.44,0.01662889518413598,0.84,99.42
2021-04-04,Kerala,347,4,346,4415,1563,198,7.86,0,35.3,363385,3063,361273,4.43,0.56,0.12507082152974505,0.84,99.42
2021-04-05,Kerala,729,6,727,9183,3269,974,7.94,0,35.3,364114,3069,362000,9.26,2.76,0.26014164305949006,0.84,99.42
2021-04-06,Kerala,205,2,203,2634,3725,1907,7.78,0,35.3,364319,3071,362203,10.55,5.4,0.07461756373937677,0.84,99.42
2021-04-07,Kerala,917,5,909,11583,2353,1282,7.92,3,35.3,365236,3076,363112,6.67,3.63,0.3281303116147309,0.84,99.42
2021-04-08,Kerala,594,5,593,7435,3411,1974,7.99,0,35.3,365830,3081,363705,9.66,5.59,0.21062322946175638,0.84,99.42
2021-04-09,Kerala,1363,8,1357,16571,2771,857,8.23,0,35.3,367193,3089,365062,7.85,2.43,0.46943342776203967,0.84,99.42
2021-04-10,Kerala,852,6,848,10390,2930,1780,8.2,0,35.3,368045,3095,365910,8.3,5.04,0.2943342776203966,0.84,99.42
2021-04-11,Kerala,409,5,407,5122,4387,3013,7.99,0,35.3,368454,3100,366317,12.43,8.54,0.14509915014164307,0.84,99.42
2021-04-12,Kerala,704,10,696,8874,4158,2075,7.93,0,35.3,369158,3110,367013,11.78,5.88,0.2513881019830028,0.84,99.42
2021-04-13,Kerala,1151,13,1142,15034,4483,2409,7.66,0,35.3,370309,3123,368155,12.7,6.82,0.42589235127478753,0.84,99.42
2021-04-14,Kerala,1294,13,1290,16226,624,356,7.97,0,35.3,371603,3136,369445,1.77,1.01,0.4596600566572238,0.84,99.42
2021-04-15,Kerala,769,9,761,9164,2602,1045,8.39,0,35.3,372372,3145,370206,7.37,2.96,0.25960339943342775,0.84,99.42
2021-04-16,Kerala,132,1,128,1971,4653,2072,6.7,3,35.3,372504,3146,370334,13.18,5.87,0.0558356940509915,0.84,99.42
2021-04-17,Kerala,725,6,721,8846,2453,2121,8.2,0,35.3,373229,3152,371055,6.95,6.01,0.25059490084985836,0.84,99.42
2021-04-18,Kerala,1178,14,1177,14848,1158,408,7.93,0,35.3,374407,3166,372232,3.28,1.16,0.4206232294617564,0.85,99.42
2021-04-19,Kerala,1323,7,1315,16107,3463,764,8.21,1,35.3,375730,3173,373547,9.81,2.16,0.45628895184135976,0.84,99.42
2021-04-20,Kerala,249,3,246,3587,1729,222,6.94,0,35.3,375979,3176,373793,4.9,0.63,0.10161473087818697,0.84,99.42
2021-04-21,Kerala,1303,17,1295,16078,1546,614,8.1,0,35.3,377282,3193,375088,4.38,1.74,0.4554674220963173,0.85,99.42
2021-04-22,Kerala,933,9,924,11761,3872,430,7.93,0,35.3,378215,3202,376012,10.97,1.22,0.3331728045325779,0.85,99.42
2021-04-23,Kerala,173,1,166,2440,2858,2814,7.09,6,35.3,378388,3203,376178,8.1,7.97,0.06912181303116147,0.85,99.42
2021-04-24,Kerala,414,1,413,5308,2907,2411,7.8,0,35.3,378802,3204,376591,8.24,6.83,0.15036827195467423,0.85,99.42
2021-04-25,Kerala,1139,15,1135,14357,1251,222,7.93,0,35.3,379941,3219,377726,3.54,0.63,0.40671388101983,0.85,99.42
2021-04-26,Kerala,1463,13,1461,17877,2150,180,8.18,0,35.3,381404,3232,379187,6.09,0.51,0.5064305949008499,0.85,99.42
2021-04-27,Kerala,819,2,810,10212,920,492,8.02,7,35.3,382223,3234,379997,2.61,1.39,0.28929178470254957,0.85,99.42
2021-04-28,Kerala,1355,10,1354,16986,3746,1297,7.98,0,35.3,383578,3244,381351,10.61,3.67,0.4811898016997167,0.85,99.42
2021-04-29,Kerala,1181,16,1178,14477,1734,1277,8.16,0,35.3,384759,3260,382529,4.91,3.62,0.4101133144475921,0.85,99.42
2021-04-30,Kerala,834,4,830,10642,705,57,7.84,0,35.3,385593,3264,383359,2.0,0.16,0.30147308781869686,0.85,99.42
2021-05-01,Kerala,249,2,248,2802,4816,1974,8.89,0,35.3,385842,3266,383607,13.64,5.59,0.07937677053824363,0.85,99.42
2021-05-02,Kerala,1443,10,1438,18502,1275,206,7.8,0,35.3,387285,3276,385045,3.61,0.58,0.5241359773371105,0.85,99.42
2021-05-03,Kerala,1197,5,1192,14548,1499,571,8.23,0,35.3,388482,3281,386237,4.25,1.62,0.41212464589235126,0.84,99.42
2021-05-04,Kerala,250,1,247,3125,3146,2937,8.0,2,35.3,388732,3282,386484,8.91,8.32,0.08852691218130311,0.84,99.42
2021-05-05,Kerala,1458,18,1458,17794,1025,760,8.19,0,35.3,390190,3300,387942,2.9,2.15,0.5040793201133145,0.85,99.42
2021-05-06,Kerala,1273,10,1268,15897,769,68,8.01,0,35.3,391463,3310,389210,2.18,0.19,0.4503399433427762,0.85,99.42
2021-05-07,Kerala,855,5,849,10969,4624,4034,7.79,1,35.3,392318,3315,390059,13.1,11.43,0.31073654390934846,0.84,99.42
2021-05-08,Kerala,1200,5,1199,15042,3845,3045,7.98,0,35.3,393518,3320,391258,10.89,8.63,0.4261189801699717,0.84,99.43
2021-05-09,Kerala,858,12,857,10549,2916,1594,8.13,0,35.3,394376,3332,392115,8.26,4.52,0.2988385269121813,0.84,99.43
2021-05-10,Kerala,527,2,523,6920,1702,876,7.62,2,35.3,394903,3334,392638,4.82,2.48,0.19603399433427762,0.84,99.43
2021-05-11,Kerala,290,3,286,3739,3061,457,7.76,1,35.3,395193,3337,392924,8.67,1.29,0.10592067988668555,0.84,99.43
2021-05-12,Kerala,362,3,360,4552,3411,2268,7.95,0,35.3,395555,3340,393284,9.66,6.42,0.12895184135977336,0.84,99.43
2021-05-13,Kerala,478,5,473,5978,4571,2020,8.0,0,35.3,396033,3345,393757,12.95,5.72,0.1693484419263456,0.84,99.43
2021-05-14,Kerala,1213,11,1212,15218,4277,3887,7.97,0,35.3,397246,3356,394969,12.12,11.01,0.43110481586402266,0.84,99.43
2021-05-15,Kerala,123,0,123,1320,3155,972,9.32,0,35.3,397369,3356,395092,8.94,2.75,0.037393767705382434,0.84,99.43
2021-05-16,Kerala,1378,13,1370,17012,1868,1491,8.1,0,35.3,398747,3369,396462,5.29,4.22,0.48192634560906517,0.84,99.43
2021-05-17,Kerala,229,1,225,2677,268,265,8.55,3,35.3,398976,3370,396687,0.76,0.75,0.0758356940509915,0.84,99.43
2021-05-18,Kerala,252,3,246,3243,36,0,7.77,3,35.3,399228,3373,396933,0.1,0.0,0.09186968838526913,0.84,99.43
2021-05-19,Kerala,113,0,109,1739,3265,301,6.5,4,35.3,399341,3373,397042,9.25,0.85,0.04926345609065156,0.84,99.42
2021-05-20,Kerala,1133,13,1126,14019,1847,1835,8.08,0,35.3,400474,3386,398168,5.23,5.2,0.3971388101983003,0.85,99.42
2021-05-21,Kerala,1229,13,1224,15430,3107,308,7.97,0,35.3,401703,3399,399392,8.8,0.87,0.43711048158640226,0.85,99.42
2021-05-22,Kerala,788,10,782,9790,972,133,8.05,0,35.3,402491,3409,400174,2.75,0.38,0.2773371104815864,0.85,99.42
2021-05-23,Kerala,153,1,147,1762,1698,1602,8.68,5,35.3,402644,3410,400321,4.81,4.54,0.04991501416430595,0.85,99.42
2021-05-24,Kerala,1051,10,1042,12973,1291,56,8.1,0,35.3,403695,3420,401363,3.66,0.16,0.3675070821529745,0.85,99.42
2021-05-25,Kerala,1155,8,1151,14296,1565,1141,8.08,0,35.3,404850,3428,402514,4.43,3.23,0.404985835694051,0.85,99.42
2021-05-26,Kerala,958,10,949,12059,3898,1603,7.94,0,35.3,405808,3438,403463,11.04,4.54,0.34161473087818695,0.85,99.42
2021-05-27,Kerala,202,0,201,2380,4126,1528,8.49,1,35.3,406010,3438,403664,11.69,4.33,0.06742209631728045,0.85,99.42
2021-05-28,Kerala,1111,4,1106,13853,3954,2054,8.02,1,35.3,407121,3442,404770,11.2,5.82,0.39243626062322945,0.85,99.42
2021-05-29,Kerala,1103,5,1099,13933,4557,1748,7.92,0,35.3,408224,3447,405869,12.91,4.95,0.39470254957507084,0.84,99.42
2021-05-30,Kerala,1226,9,1221,15255,3968,3467,8.04,0,35.3,409450,3456,407090,11.24,9.82,0.4321529745042493,0.84,99.42
2021-05-31,Kerala,1478,13,1475,18691,4098,2623,7.91,0,35.3,410928,3469,408565,11.61,7.43,0.5294900849858357,0.84,99.42
2021-06-01,Kerala,875,10,875,10486,2226,121,8.34,0,35.3,411803,3479,409440,6.31,0.34,0.29705382436260624,0.84,99.43
2021-06-02,Kerala,391,2,391,4932,1740,1434,7.93,0,35.3,412194,3481,409831,4.93,4.06,0.13971671388101983,0.84,99.43
2021-06-03,Kerala,1559,5,1552,19536,1147,191,7.98,2,35.3,413753,3486,411383,3.25,0.54,0.55342776203966,0.84,99.43
2021-06-04,Kerala,1339,19,1334,16606,1257,146,8.06,0,35.3,415092,3505,412717,3.56,0.41,0.47042492917847023,0.84,99.43
2021-06-05,Kerala,518,3,513,6677,2744,2733,7.76,2,35.3,415610,3508,413230,7.77,7.74,0.1891501416430595,0.84,99.43
2021-06-06,Kerala,317,4,311,3938,63,5,8.05,2,35.3,415927,3512,413541,0.18,0.01,0.11155807365439094,0.84,99.43
2021-06-07,Kerala,655,6,650,8389,793,64,7.81,0,35.3,416582,3518,414191,2.25,0.18,0.23764872521246458,0.84,99.43
2021-06-08,Kerala,286,2,284,3793,4466,3245,7.54,0,35.3,416868,3520,414475,12.65,9.19,0.10745042492917847,0.84,99.43
2021-06-09,Kerala,595,4,592,7289,1970,298,8.16,0,35.3,417463,3524,415067,5.58,0.84,0.2064872521246459,0.84,99.43
2021-06-10,Kerala,363,1,355,5065,4033,2897,7.17,7,35.3,417826,3525,415422,11.42,8.21,0.1434844192634561,0.84,99.42
2021-06-11,Kerala,181,0,179,2286,673,668,7.92,2,35.3,418007,3525,415601,1.91,1.89,0.06475920679886686,0.84,99.42
2021-06-12,Kerala,414,4,413,5460,4512,4022,7.58,0,35.3,418421,3529,416014,12.78,11.39,0.1546742209631728,0.84,99.42
2021-06-13,Kerala,1274,15,1271,16266,2661,293,7.83,0,35.3,419695,3544,417285,7.54,0.83,0.4607932011331445,0.84,99.43
2021-06-14,Kerala,1176,16,1173,14437,2554,1497,8.15,0,35.3,420871,3560,418458,7.24,4.24,0.4089801699716714,0.85,99.43
2021-06-15,Kerala,943,8,940,11489,4713,4024,8.21,0,35.3,421814,3568,419398,13.35,11.4,0.3254674220963173,0.85,99.43
2021-06-16,Kerala,970,10,966,11893,2512,2184,8.16,0,35.3,422784,3578,420364,7.12,6.19,0.3369121813031161,0.85,99.43
2021-06-17,Kerala,1227,9,1222,15253,1413,1009,8.04,0,35.3,424011,3587,421586,4.0,2.86,0.4320963172804533,0.85,99.43
2021-06-18,Kerala,1135,13,1129,14246,3556,3130,7.97,0,35.3,425146,3600,422715,10.07,8.87,0.4035694050991501,0.85,99.43
2021-06-19,Kerala,1252,4,1244,15583,1974,1377,8.03,4,35.3,426398,3604,423959,5.59,3.9,0.4414447592067989,0.85,99.43
2021-06-20,Kerala,445,5,444,5514,4853,2682,8.07,0,35.3,426843,3609,424403,13.75,7.6,0.15620396600566572,0.85,99.43
2021-06-21,Kerala,1578,16,1572,19753,4953,2900,7.99,0,35.3,428421,3625,425975,14.03,8.22,0.5595750708215298,0.85,99.43
2021-06-22,Kerala,1332,12,1324,16751,3402,664,7.95,0,35.3,429753,3637,427299,9.64,1.88,0.4745325779036827,0.85,99.43
2021-06-23,Kerala,1215,8,1207,15113,454,200,8.04,0,35.3,430968,3645,428506,1.29,0.57,0.42813031161473086,0.85,99.43
2021-06-24,Kerala,1368,7,1365,17201,1233,882,7.95,0,35.3,432336,3652,429871,3.49,2.5,0.48728045325779035,0.84,99.43
2021-06-25,Kerala,1503,12,1497,18778,2888,694,8.0,0,35.3,433839,3664,431368,8.18,1.97,0.5319546742209632,0.84,99.43
2021-06-26,Kerala,848,11,843,10498,867,544,8.08,0,35.3,434687,3675,432211,2.46,1.54,0.29739376770538245,0.85,99.43
2021-06-27,Kerala,1582,6,1579,19717,440,368,8.02,0,35.3,436269,3681,433790,1.25,1.04,0.5585552407932012,0.84,99.43
2021-06-28,Kerala,461,3,452,5560,2022,1859,8.29,6,35.3,436730,3684,434242,5.73,5.27,0.15750708215297451,0.84,99.43
2021-06-29,Kerala,1161,12,1153,14319,4444,53,8.11,0,35.3,437891,3696,435395,12.59,0.15,0.40563739376770536,0.84,99.43
2021-06-30,Kerala,832,11,828,10556,2735,2565,7.88,0,35.3,438723,3707,436223,7.75,7.27,0.2990368271954674,0.84,99.43
2021-07-01,Kerala,217,2,215,2601,4369,1360,8.34,0,35.3,438940,3709,436438,12.38,3.85,0.07368271954674221,0.84,99.43
2021-07-02,Kerala,601,6,599,7062,2715,2200,8.51,0,35.3,439541,3715,437037,7.69,6.23,0.20005665722379604,0.85,99.43
2021-07-03,Kerala,776,8,769,9707,3444,2764,7.99,0,35.3,440317,3723,437806,9.76,7.83,0.274985835694051,0.85,99.43
2021-07-04,Kerala,1506,21,1506,18706,3168,1724,8.05,0,35.3,441823,3744,439312,8.97,4.88,0.529915014164306,0.85,99.43
2021-07-05,Kerala,324,3,321,3975,3537,469,8.15,0,35.3,442147,3747,439633,10.02,1.33,0.11260623229461757,0.85,99.43
2021-07-06,Kerala,194,1,192,2439,2024,161,7.95,1,35.3,442341,3748,439825,5.73,0.46,0.06909348441926345,0.85,99.43
2021-07-07,Kerala,1582,22,1581,19382,2497,91,8.16,0,35.3,443923,3770,441406,7.07,0.26,0.5490651558073655,0.85,99.43
2021-07-08,Kerala,812,8,810,10235,4515,2259,7.93,0,35.3,444735,3778,442216,12.79,6.4,0.289943342776204,0.85,99.43
2021-07-09,Kerala,372,1,366,4566,1040,368,8.15,5,35.3,445107,3779,442582,2.95,1.04,0.12934844192634562,0.85,99.43
2021-07-10,Kerala,338,3,331,3784,3860,1704,8.93,4,35.3,445445,3782,442913,10.93,4.83,0.10719546742209632,0.85,99.43
2021-07-11,Kerala,1537,10,1536,19443,3099,2723,7.91,0,35.3,446982,3792,444449,8.78,7.71,0.5507932011331444,0.85,99.43
2021-07-12,Kerala,173,1,166,2186,1796,360,7.91,6,35.3,447155,3793,444615,5.09,1.02,0.06192634560906515,0.85,99.43
2021-07-13,Kerala,956,7,954,12220,1271,97,7.82,0,35.3,448111,3800,445569,3.6,0.27,0.3461756373937677,0.85,99.43
2021-07-14,Kerala,43,0,38,530,1160,357,8.11,5,35.3,448154,3800,445607,3.29,1.01,0.01501416430594901,0.85,99.43
2021-07-15,Kerala,358,2,353,4541,2008,1064,7.88,3,35.3,448512,3802,445960,5.69,3.01,0.12864022662889518,0.85,99.43
2021-07-16,Kerala,232,2,226,2683,1463,653,8.65,4,35.3,448744,3804,446186,4.14,1.85,0.0760056657223796,0.85,99.43
2021-07-17,Kerala,949,3,941,11579,2591,1050,8.2,5,35.3,449693,3807,447127,7.34,2.97,0.32801699716713884,0.85,99.43
2021-07-18,Kerala,678,9,673,8704,2789,2517,7.79,0,35.3,450371,3816,447800,7.9,7.13,0.24657223796033995,0.85,99.43
2021-07-19,Kerala,1381,17,1381,17118,110,84,8.07,0,35.3,451752,3833,449181,0.31,0.24,0.48492917847025496,0.85,99.43
2021-07-20,Kerala,459,2,458,5963,3101,704,7.7,0,35.3,452211,3835,449639,8.78,1.99,0.16892351274787534,0.85,99.43
2021-07-21,Kerala,1234,8,1225,15185,2167,2145,8.13,1,35.3,453445,3843,450864,6.14,6.08,0.4301699716713881,0.85,99.43
2021-07-22,Kerala,1172,16,1172,14691,4474,4244,7.98,0,35.3,454617,3859,452036,12.67,12.02,0.41617563739376773,0.85,99.43
2021-07-23,Kerala,303,1,294,3763,3865,2131,8.05,8,35.3,454920,3860,452330,10.95,6.04,0.10660056657223796,0.85,99.43
2021-07-24,Kerala,464,6,458,6060,1653,945,7.66,0,35.3,455384,3866,452788,4.68,2.68,0.171671388101983,0.85,99.43
2021-07-25,Kerala,74,0,70,916,2966,2923,8.08,4,35.3,455458,3866,452858,8.4,8.28,0.02594900849858357,0.85,99.43
2021-07-26,Kerala,1357,9,1354,17120,3233,407,7.93,0,35.3,456815,3875,454212,9.16,1.15,0.484985835694051,0.85,99.43
2021-07-27,Kerala,288,3,285,3381,3085,2623,8.52,0,35.3,457103,3878,454497,8.74,7.43,0.09577903682719546,0.85,99.43
2021-07-28,Kerala,388,1,383,4566,2508,80,8.5,4,35.3,457491,3879,454880,7.1,0.23,0.12934844192634562,0.85,99.43
2021-07-29,Kerala,690,8,682,8256,1368,1008,8.36,0,35.3,458181,3887,455562,3.88,2.86,0.23388101983002832,0.85,99.43
2021-07-30,Kerala,266,1,266,3722,3373,2901,7.15,0,35.3,458447,3888,455828,9.56,8.22,0.10543909348441927,0.85,99.43
2021-07-31,Kerala,115,1,113,1826,1896,204,6.3,1,35.3,458562,3889,455941,5.37,0.58,0.051728045325779036,0.85,99.43
2021-08-01,Kerala,1170,12,1161,14399,3152,1328,8.13,0,35.3,459732,3901,457102,8.93,3.76,0.40790368271954675,0.85,99.43
2021-08-02,Kerala,1267,9,1261,16104,384,162,7.87,0,35.3,460999,3910,458363,1.09,0.46,0.4562039660056657,0.85,99.43
2021-08-03,Kerala,840,5,832,10082,920,509,8.33,3,35.3,461839,3915,459195,2.61,1.44,0.28560906515580736,0.85,99.43
2021-08-04,Kerala,1348,11,1345,16912,869,273,7.97,0,35.3,463187,3926,460540,2.46,0.77,0.47909348441926347,0.85,99.43
2021-08-05,Kerala,1130,10,1122,14361,3018,957,7.87,0,35.3,464317,3936,461662,8.55,2.71,0.4068271954674221,0.85,99.43
2021-08-06,Kerala,610,4,605,7503,1070,818,8.13,1,35.3,464927,3940,462267,3.03,2.32,0.21254957507082153,0.85,99.43
2021-08-07,Kerala,1074,8,1072,13369,3799,1709,8.03,0,35.3,466001,3948,463339,10.76,4.84,0.37872521246458923,0.85,99.43
2021-08-08,Kerala,1350,8,1345,16860,2445,2352,8.01,0,35.3,467351,3956,464684,6.93,6.66,0.4776203966005666,0.85,99.43
2021-08-09,Kerala,1432,19,1426,17795,3193,221,8.05,0,35.3,468783,3975,466110,9.05,0.63,0.5041076487252124,0.85,99.43
2021-08-10,Kerala,1500,10,1498,18585,4972,3009,8.07,0,35.3,470283,3985,467608,14.08,8.52,0.5264872521246459,0.85,99.43
2021-08-11,Kerala,877,4,870,10583,4464,2311,8.29,3,35.3,471160,3989,468478,12.65,6.55,0.2998016997167139,0.85,99.43
2021-08-12,Kerala,845,10,838,10643,1030,385,7.94,0,35.3,472005,3999,469316,2.92,1.09,0.3015014164305949,0.85,99.43
2021-08-13,Kerala,961,14,958,11876,1316,166,8.09,0,35.3,472966,4013,470274,3.73,0.47,0.33643059490084987,0.85,99.43
2021-08-14,Kerala,953,8,948,12163,3114,1335,7.84,0,35.3,473919,4021,471222,8.82,3.78,0.34456090651558074,0.85,99.43
2021-08-15,Kerala,1181,4,1177,14884,4256,411,7.93,0,35.3,475100,4025,472399,12.06,1.16,0.42164305949008496,0.85,99.43
2021-08-16,Kerala,1316,4,1316,16567,1222,132,7.94,0,35.3,476416,4029,473715,3.46,0.37,0.4693201133144476,0.85,99.43
2021-08-17,Kerala,1322,9,1317,16533,4277,408,8.0,0,35.3,477738,4038,475032,12.12,1.16,0.468356940509915,0.85,99.43
2021-08-18,Kerala,1252,12,1249,15541,403,7,8.06,0,35.3,478990,4050,476281,1.14,0.02,0.44025495750708216,0.85,99.43
2021-08-19,Kerala,383,1,382,4354,3821,311,8.8,0,35.3,479373,4051,476663,10.82,0.88,0.12334277620396601,0.85,99.43
2021-08-20,Kerala,858,11,854,11102,2389,496,7.73,0,35.3,480231,4062,477517,6.77,1.41,0.3145042492917847,0.85,99.43
2021-08-21,Kerala,901,12,898,11512,1144,710,7.83,0,35.3,481132,4074,478415,3.24,2.01,0.32611898016997165,0.85,99.44
2021-08-22,Kerala,1333,13,1327,16524,1600,933,8.07,0,35.3,482465,4087,479742,4.53,2.64,0.46810198300283284,0.85,99.44
2021-08-23,Kerala,1131,15,1131,14049,3785,1826,8.05,0,35.3,483596,4102,480873,10.72,5.17,0.3979886685552408,0.85,99.44
2021-08-24,Kerala,1309,9,1305,16457,3390,673,7.95,0,35.3,484905,4111,482178,9.6,1.91,0.4662039660056657,0.85,99.44
2021-08-25,Kerala,964,5,961,11898,2897,1259,8.1,0,35.3,485869,4116,483139,8.21,3.57,0.3370538243626062,0.85,99.44
2021-08-26,Kerala,517,6,517,6628,465,149,7.8,0,35.3,486386,4122,483656,1.32,0.42,0.18776203966005667,0.85,99.44
2021-08-27,Kerala,781,4,773,9685,2155,492,8.06,4,35.3,487167,4126,484429,6.1,1.39,0.27436260623229464,0.85,99.44
2021-08-28,Kerala,1408,18,1400,17363,3069,840,8.11,0,35.3,488575,4144,485829,8.69,2.38,0.4918696883852691,0.85,99.44
2021-08-29,Kerala,1015,12,1011,11977,488,173,8.47,0,35.3,489590,4156,486840,1.38,0.49,0.33929178470254956,0.85,99.44
2021-08-30,Kerala,1203,7,1201,15032,4527,3903,8.0,0,35.3,490793,4163,488041,12.82,11.06,0.4258356940509915,0.85,99.44
2021-08-31,Kerala,914,12,913,11158,4038,1323,8.19,0,35.3,491707,4175,488954,11.44,3.75,0.31609065155807364,0.85,99.44
2021-09-01,Kerala,1261,18,1255,15539,310,195,8.12,0,35.3,492968,4193,490209,0.88,0.55,0.4401983002832861,0.85,99.44
2021-09-02,Kerala,675,9,671,8450,4555,281,7.99,0,35.3,493643,4202,490880,12.9,0.8,0.23937677053824363,0.85,99.44
2021-09-03,Kerala,766,2,766,9569,454,110,8.01,0,35.3,494409,4204,491646,1.29,0.31,0.27107648725212463,0.85,99.44
2021-09-04,Kerala,822,4,814,10076,3573,2707,8.16,4,35.3,495231,4208,492460,10.12,7.67,0.28543909348441926,0.85,99.44
2021-09-05,Kerala,1333,7,1328,17109,4937,1397,7.79,0,35.3,496564,4215,493788,13.99,3.96,0.4846742209631728,0.85,99.44
2021-09-06,Kerala,516,6,511,6858,3946,2356,7.52,0,35.3,497080,4221,494299,11.18,6.67,0.19427762039660057,0.85,99.44
2021-09-07,Kerala,434,2,426,5694,480,232,7.62,6,35.3,497514,4223,494725,1.36,0.66,0.16130311614730877,0.85,99.44
2021-09-08,Kerala,598,5,592,7913,2444,1694,7.56,1,35.3,498112,4228,495317,6.92,4.8,0.2241643059490085,0.85,99.44
2021-09-09,Kerala,1531,21,1529,19233,805,462,7.96,0,35.3,499643,4249,496846,2.28,1.31,0.5448441926345609,0.85,99.44
2021-09-10,Kerala,1173,9,1172,14056,12,11,8.35,0,35.3,500816,4258,498018,0.03,0.03,0.3981869688385269,0.85,99.44
2021-09-11,Kerala,213,0,213,2628,525,20,8.11,0,35.3,501029,4258,498231,1.49,0.06,0.07444759206798866,0.85,99.44
2021-09-12,Kerala,259,3,251,3142,415,145,8.24,5,35.3,501288,4261,498482,1.18,0.41,0.0890084985835694,0.85,99.44
2021-09-13,Kerala,1021,15,1018,13064,3585,974,7.82,0,35.3,502309,4276,499500,10.16,2.76,0.37008498583569405,0.85,99.44
2021-09-14,Kerala,326,3,321,4334,3228,3023,7.52,2,35.3,502635,4279,499821,9.14,8.56,0.12277620396600566,0.85,99.44
2021-09-15,Kerala,1422,4,1414,17409,4205,838,8.17,4,35.3,504057,4283,501235,11.91,2.37,0.4931728045325779,0.85,99.44
2021-09-16,Kerala,1079,4,1070,13578,462,28,7.95,5,35.3,505136,4287,502305,1.31,0.08,0.3846458923512748,0.85,99.44
2021-09-17,Kerala,881,2,872,10846,1589,1552,8.12,7,35.3,506017,4289,503177,4.5,4.4,0.30725212464589235,0.85,99.44
2021-09-18,Kerala,175,0,169,1976,842,437,8.86,6,35.3,506192,4289,503346,2.39,1.24,0.055977337110481584,0.85,99.44
2021-09-19,Kerala,229,3,228,2443,1954,1062,9.37,0,35.3,506421,4292,503574,5.54,3.01,0.06920679886685552,0.85,99.44
2021-09-20,Kerala,902,3,894,11413,3904,2983,7.9,5,35.3,507323,4295,504468,11.06,8.45,0.323314447592068,0.85,99.44
2021-09-21,Kerala,220,1,216,2865,958,255,7.68,3,35.3,507543,4296,504684,2.71,0.72,0.0811614730878187,0.85,99.44
2021-09-22,Kerala,1265,11,1261,15960,3059,1420,7.93,0,35.3,508808,4307,505945,8.67,4.02,0.4521246458923513,0.85,99.44
2021-09-23,Kerala,987,5,978,12272,3485,1239,8.04,4,35.3,509795,4312,506923,9.87,3.51,0.3476487252124646,0.85,99.44
2021-09-24,Kerala,1185,14,1184,14866,4769,1988,7.97,0,35.3,510980,4326,508107,13.51,5.63,0.4211331444759207,0.85,99.44
2021-09-25,Kerala,868,11,860,10768,1070,574,8.06,0,35.3,511848,4337,508967,3.03,1.63,0.305042492917847,0.85,99.44
2021-09-26,Kerala,677,2,671,8501,3544,369,7.96,4,35.3,512525,4339,509638,10.04,1.05,0.2408215297450425,0.85,99.44
2021-09-27,Kerala,208,1,206,2961,1040,299,7.02,1,35.3,512733,4340,509844,2.95,0.85,0.08388101983002832,0.85,99.44
2021-09-28,Kerala,848,8,846,10139,1773,1367,8.36,0,35.3,513581,4348,510690,5.02,3.87,0.28722379603399434,0.85,99.44
2021-09-29,Kerala,758,6,751,9669,2328,651,7.84,1,35.3,514339,4354,511441,6.59,1.84,0.2739093484419263,0.85,99.44
2021-09-30,Kerala,673,5,671,8195,2186,1840,8.21,0,35.3,515012,4359,512112,6.19,5.21,0.2321529745042493,0.85,99.44
2021-10-01,Kerala,1449,12,1440,17837,1865,1235,8.12,0,35.3,516461,4371,513552,5.28,3.5,0.5052974504249291,0.85,99.44
2021-10-02,Kerala,842,10,833,10167,4515,1255,8.28,0,35.3,517303,4381,514385,12.79,3.56,0.2880169971671388,0.85,99.44
2021-10-03,Kerala,330,4,329,4369,2303,1763,7.55,0,35.3,517633,4385,514714,6.52,4.99,0.12376770538243625,0.85,99.44
2021-10-04,Kerala,1395,18,1389,17359,225,173,8.04,0,35.3,519028,4403,516103,0.64,0.49,0.49175637393767707,0.85,99.44
2021-10-05,Kerala,1217,5,1212,15227,2044,1097,7.99,0,35.3,520245,4408,517315,5.79,3.11,0.4313597733711048,0.85,99.44
2021-10-06,Kerala,726,8,717,8836,4814,896,8.22,1,35.3,520971,4416,518032,13.64,2.54,0.2503116147308782,0.85,99.44
2021-10-07,Kerala,299,4,297,4181,112,18,7.15,0,35.3,521270,4420,518329,0.32,0.05,0.11844192634560907,0.85,99.44
2021-10-08,Kerala,645,7,637,8253,265,142,7.82,1,35.3,521915,4427,518966,0.75,0.4,0.23379603399433427,0.85,99.43
2021-10-09,Kerala,1493,9,1486,18918,4159,3870,7.89,0,35.3,523408,4436,520452,11.78,10.96,0.5359206798866856,0.85,99.44
2021-10-10,Kerala,241,2,240,3180,1481,1266,7.58,0,35.3,523649,4438,520692,4.2,3.59,0.09008498583569405,0.85,99.44
2021-10-11,Kerala,461,6,457,5722,2777,2349,8.06,0,35.3,524110,4444,521149,7.87,6.65,0.16209631728045326,0.85,99.44
2021-10-12,Kerala,1594,21,1589,19984,3431,2750,7.98,0,35.3,525704,4465,522738,9.72,7.79,0.5661189801699716,0.85,99.44
2021-10-13,Kerala,355,2,350,4625,239,155,7.68,3,35.3,526059,4467,523088,0.68,0.44,0.13101983002832862,0.85,99.44
2021-10-14,Kerala,1283,11,1283,15884,951,469,8.08,0,35.3,527342,4478,524371,2.69,1.33,0.44997167138810196,0.85,99.44
2021-10-15,Kerala,1478,20,1477,18586,4980,368,7.95,0,35.3,528820,4498,525848,14.11,1.04,0.5265155807365439,0.85,99.44
2021-10-16,Kerala,588,6,586,7611,1612,8,7.73,0,35.3,529408,4504,526434,4.57,0.02,0.21560906515580736,0.85,99.44
2021-10-17,Kerala,565,5,558,6785,4503,1401,8.33,2,35.3,529973,4509,526992,12.76,3.97,0.19220963172804534,0.85,99.44
2021-10-18,Kerala,1355,20,1354,16907,4718,2269,8.01,0,35.3,531328,4529,528346,13.37,6.43,0.47895184135977337,0.85,99.44
2021-10-19,Kerala,975,10,966,12282,4307,2426,7.94,0,35.3,532303,4539,529312,12.2,6.87,0.34793201133144475,0.85,99.44
2021-10-20,Kerala,344,3,343,4568,2732,1982,7.53,0,35.3,532647,4542,529655,7.74,5.61,0.12940509915014164,0.85,99.44
2021-10-21,Kerala,798,9,794,10348,2121,1216,7.71,0,35.3,533445,4551,530449,6.01,3.44,0.2931444759206799,0.85,99.44
2021-10-22,Kerala,1215,14,1213,15230,1570,1315,7.98,0,35.3,534660,4565,531662,4.45,3.73,0.43144475920679887,0.85,99.44
2021-10-23,Kerala,801,10,800,9984,4490,1689,8.02,0,35.3,535461,4575,532462,12.72,4.78,0.2828328611898017,0.85,99.44
2021-10-24,Kerala,67,0,66,1267,4591,3821,5.29,1,35.3,535528,4575,532528,13.01,10.82,0.035892351274787536,0.85,99.44
2021-10-25,Kerala,160,1,156,2119,1964,1202,7.55,3,35.3,535688,4576,532684,5.56,3.41,0.06002832861189802,0.85,99.44
2021-10-26,Kerala,727,2,718,9072,2605,1535,8.01,7,35.3,536415,4578,533402,7.38,4.35,0.2569971671388102,0.85,99.44
2021-10-27,Kerala,514,5,513,5822,3793,135,8.83,0,35.3,536929,4583,533915,10.75,0.38,0.16492917847025496,0.85,99.44
2021-10-28,Kerala,542,3,536,6819,2264,589,7.95,3,35.3,537471,4586,534451,6.41,1.67,0.1931728045325779,0.85,99.44
2021-10-29,Kerala,373,2,368,4604,2493,2232,8.1,3,35.3,537844,4588,534819,7.06,6.32,0.13042492917847026,0.85,99.44
2021-10-30,Kerala,1198,16,1198,15143,381,191,7.91,0,35.3,539042,4604,536017,1.08,0.54,0.4289801699716714,0.85,99.44
2021-10-31,Kerala,100,0,97,1356,790,382,7.37,3,35.3,539142,4604,536114,2.24,1.08,0.03841359773371105,0.85,99.44
2021-11-01,Kerala,976,13,969,12045,2989,29,8.1,0,35.3,540118,4617,537083,8.47,0.08,0.34121813031161474,0.85,99.44
2021-11-02,Kerala,824,3,822,10057,4421,3908,8.19,0,35.3,540942,4620,537905,12.52,11.07,0.28490084985835695,0.85,99.44
2021-11-03,Kerala,1518,14,1518,18806,1904,221,8.07,0,35.3,542460,4634,539423,5.39,0.63,0.5327478753541076,0.85,99.44
2021-11-04,Kerala,1447,17,1438,17453,2149,77,8.29,0,35.3,543907,4651,540861,6.09,0.22,0.49441926345609066,0.86,99.44
2021-11-05,Kerala,1405,14,1402,17198,1140,335,8.17,0,35.3,545312,4665,542263,3.23,0.95,0.4871954674220963,0.86,99.44
2021-11-06,Kerala,1290,6,1285,16096,803,320,8.01,0,35.3,546602,4671,543548,2.27,0.91,0.4559773371104816,0.85,99.44
2021-11-07,Kerala,524,2,520,6472,4516,3064,8.1,2,35.3,547126,4673,544068,12.79,8.68,0.183342776203966,0.85,99.44
2021-11-08,Kerala,1474,16,1467,18284,2331,1485,8.06,0,35.3,548600,4689,545535,6.6,4.21,0.5179603399433428,0.85,99.44
2021-11-09,Kerala,660,5,659,8156,455,55,8.09,0,35.3,549260,4694,546194,1.29,0.16,0.23104815864022663,0.85,99.44
2021-11-10,Kerala,78,0,73,897,525,119,8.7,5,35.3,549338,4694,546267,1.49,0.34,0.025410764872521245,0.85,99.44
2021-11-11,Kerala,306,3,300,3491,760,19,8.77,3,35.3,549644,4697,546567,2.15,0.05,0.09889518413597734,0.85,99.44
2021-11-12,Kerala,927,4,923,11676,331,315,7.94,0,35.3,550571,4701,547490,0.94,0.89,0.3307648725212465,0.85,99.44
2021-11-13,Kerala,1610,7,1605,19151,4490,939,8.41,0,35.3,552181,4708,549095,12.72,2.66,0.5425212464589235,0.85,99.44
2021-11-14,Kerala,560,5,553,6976,4739,3481,8.03,2,35.3,552741,4713,549648,13.42,9.86,0.19762039660056657,0.85,99.44
2021-11-15,Kerala,268,3,265,3165,4628,3255,8.47,0,35.3,553009,4716,549913,13.11,9.22,0.08966005665722379,0.85,99.44
2021-11-16,Kerala,91,1,85,859,1854,776,10.59,5,35.3,553100,4717,549998,5.25,2.2,0.0243342776203966,0.85,99.44
2021-11-17,Kerala,1576,9,1573,19706,4430,3274,8.0,0,35.3,554676,4726,551571,12.55,9.27,0.5582436260623229,0.85,99.44
2021-11-18,Kerala,897,7,893,11671,4445,1479,7.69,0,35.3,555573,4733,552464,12.59,4.19,0.3306232294617564,0.85,99.44
2021-11-19,Kerala,1421,14,1415,17826,4849,4750,7.97,0,35.3,556994,4747,553879,13.74,13.46,0.504985835694051,0.85,99.44
2021-11-20,Kerala,913,5,907,11745,121,27,7.77,1,35.3,557907,4752,554786,0.34,0.08,0.3327195467422096,0.85,99.44
2021-11-21,Kerala,1366,14,1358,17333,3781,3755,7.88,0,35.3,559273,4766,556144,10.71,10.64,0.4910198300283286,0.85,99.44
2021-11-22,Kerala,1398,17,1391,17260,16,13,8.1,0,35.3,560671,4783,557535,0.05,0.04,0.4889518413597734,0.85,99.44
2021-11-23,Kerala,781,10,773,9870,4464,1758,7.91,0,35.3,561452,4793,558308,12.65,4.98,0.27960339943342777,0.85,99.44
2021-11-24,Kerala,916,5,915,11725,631,220,7.81,0,35.3,562368,4798,559223,1.79,0.62,0.3321529745042493,0.85,99.44
2021-11-25,Kerala,485,5,485,6304,2905,2707,7.69,0,35.3,562853,4803,559708,8.23,7.67,0.17858356940509915,0.85,99.44
2021-11-26,Kerala,1221,8,1219,15267,1456,618,8.0,0,35.3,564074,4811,560927,4.12,1.75,0.4324929178470255,0.85,99.44
2021-11-27,Kerala,94,1,89,1172,3083,2286,8.02,4,35.3,564168,4812,561016,8.73,6.48,0.03320113314447592,0.85,99.44
2021-11-28,Kerala,447,4,444,5287,3998,2664,8.45,0,35.3,564615,4816,561460,11.33,7.55,0.14977337110481587,0.85,99.44
2021-11-29,Kerala,1572,7,1567,19959,964,830,7.88,0,35.3,566187,4823,563027,2.73,2.35,0.5654107648725213,0.85,99.44
2021-11-30,Kerala,1565,8,1556,19558,3299,2813,8.0,1,35.3,567752,4831,564583,9.35,7.97,0.5540509915014165,0.85,99.44
2021-12-01,Kerala,1536,11,1534,19025,3901,2705,8.07,0,35.3,569288,4842,566117,11.05,7.66,0.5389518413597734,0.85,99.44
2021-12-02,Kerala,842,6,837,10653,990,374,7.9,0,35.3,570130,4848,566954,2.8,1.06,0.30178470254957507,0.85,99.44
2021-12-03,Kerala,288,1,286,3361,4513,1131,8.57,1,35.3,570418,4849,567240,12.78,3.2,0.09521246458923513,0.85,99.44
2021-12-04,Kerala,1074,12,1069,13690,2492,3,7.85,0,35.3,571492,4861,568309,7.06,0.01,0.3878186968838527,0.85,99.44
2021-12-05,Kerala,422,1,413,5444,4483,1928,7.75,8,35.3,571914,4862,568722,12.7,5.46,0.15422096317280454,0.85,99.44
2021-12-06,Kerala,882,11,874,10597,4541,3842,8.32,0,35.3,572796,4873,569596,12.86,10.88,0.30019830028328615,0.85,99.44
2021-12-07,Kerala,1028,9,1024,13025,185,103,7.89,0,35.3,573824,4882,570620,0.52,0.29,0.3689801699716714,0.85,99.44
2021-12-08,Kerala,754,10,754,9421,2533,449,8.0,0,35.3,574578,4892,571374,7.18,1.27,0.2668838526912181,0.85,99.44
2021-12-09,Kerala,1306,9,1304,16239,4831,1888,8.04,0,35.3,575884,4901,572678,13.69,5.35,0.460028328611898,0.85,99.44
2021-12-10,Kerala,645,4,638,8632,3897,3668,7.47,3,35.3,576529,4905,573316,11.04,10.39,0.2445325779036827,0.85,99.44
2021-12-11,Kerala,1547,5,1545,19539,2049,911,7.92,0,35.3,578076,4910,574861,5.8,2.58,0.5535127478753541,0.85,99.44
2021-12-12,Kerala,1052,9,1049,13347,462,119,7.88,0,35.3,579128,4919,575910,1.31,0.34,0.3781019830028329,0.85,99.44
2021-12-13,Kerala,1191,16,1187,15139,649,364,7.87,0,35.3,580319,4935,577097,1.84,1.03,0.4288668555240793,0.85,99.44
2021-12-14,Kerala,1192,8,1188,14757,538,449,8.08,0,35.3,581511,4943,578285,1.52,1.27,0.4180453257790368,0.85,99.45
2021-12-15,Kerala,1263,9,1256,16000,4295,2782,7.89,0,35.3,582774,4952,579541,12.17,7.88,0.45325779036827196,0.85,99.45
2021-12-16,Kerala,382,5,378,5354,77,38,7.13,0,35.3,583156,4957,579919,0.22,0.11,0.151671388101983,0.85,99.44
2021-12-17,Kerala,210,2,203,2984,4047,3911,7.04,5,35.3,583366,4959,580122,11.46,11.08,0.08453257790368272,0.85,99.44
2021-12-18,Kerala,154,2,148,1807,1310,599,8.52,4,35.3,583520,4961,580270,3.71,1.7,0.051189801699716715,0.85,99.44
2021-12-19,Kerala,626,1,623,7928,3042,1091,7.9,2,35.3,584146,4962,580893,8.62,3.09,0.22458923512747875,0.85,99.44
2021-12-20,Kerala,336,2,334,4618,4020,1332,7.28,0,35.3,584482,4964,581227,11.39,3.77,0.1308215297450425,0.85,99.44
2021-12-21,Kerala,638,5,629,7890,3957,730,8.09,4,35.3,585120,4969,581856,11.21,2.07,0.2235127478753541,0.85,99.44
2021-12-22,Kerala,1274,16,1270,16036,3133,2250,7.94,0,35.3,586394,4985,583126,8.88,6.37,0.4542776203966006,0.85,99.44
2021-12-23,Kerala,779,10,773,9717,4094,209,8.02,0,35.3,587173,4995,583899,11.6,0.59,0.27526912181303115,0.85,99.44
2021-12-24,Kerala,1173,8,1166,15146,3159,1261,7.74,0,35.3,588346,5003,585065,8.95,3.57,0.42906515580736543,0.85,99.44
2021-12-25,Kerala,1076,14,1073,13169,3078,789,8.17,0,35.3,589422,5017,586138,8.72,2.24,0.37305949008498585,0.85,99.44
2021-12-26,Kerala,197,2,197,2619,4083,2347,7.52,0,35.3,589619,5019,586335,11.57,6.65,0.07419263456090651,0.85,99.44
2021-12-27,Kerala,1064,15,1057,13050,3069,864,8.15,0,35.3,590683,5034,587392,8.69,2.45,0.3696883852691218,0.85,99.44
2021-12-28,Kerala,1221,9,1219,15151,969,593,8.06,0,35.3,591904,5043,588611,2.75,1.68,0.42920679886685553,0.85,99.44
2021-12-29,Kerala,656,8,651,8791,308,61,7.46,0,35.3,592560,5051,589262,0.87,0.17,0.2490368271954674,0.85,99.44
2021-12-30,Kerala,377,4,375,5220,1305,362,7.22,0,35.3,592937,5055,589637,3.7,1.03,0.14787535410764874,0.85,99.44
2021-12-31,Kerala,488,6,482,5954,1276,1115,8.2,0,35.3,593425,5061,590119,3.61,3.16,0.1686685552407932,0.85,99.44
2022-01-01,Kerala,919,12,914,11708,3383,3041,7.85,0,35.3,594344,5073,591033,9.58,8.61,0.331671388101983,0.85,99.44
2022-01-02,Kerala,775,8,771,9767,3451,2187,7.93,0,35.3,595119,5081,591804,9.78,6.2,0.276685552407932,0.85,99.44
2022-01-03,Kerala,454,6,448,5731,1587,81,7.92,0,35.3,595573,5087,592252,4.5,0.23,0.16235127478753542,0.85,99.44
2022-01-04,Kerala,80,0,77,1226,1206,906,6.53,3,35.3,595653,5087,592329,3.42,2.57,0.034730878186968836,0.85,99.44
2022-01-05,Kerala,676,6,675,8147,2542,809,8.3,0,35.3,596329,5093,593004,7.2,2.29,0.23079320113314447,0.85,99.44
2022-01-06,Kerala,1376,6,1368,16947,4644,3968,8.12,2,35.3,597705,5099,594372,13.16,11.24,0.48008498583569403,0.85,99.44
2022-01-07,Kerala,214,1,205,2722,1019,950,7.86,8,35.3,597919,5100,594577,2.89,2.69,0.07711048158640227,0.85,99.44
2022-01-08,Kerala,1492,9,1486,18716,1987,1772,7.97,0,35.3,599411,5109,596063,5.63,5.02,0.5301983002832861,0.85,99.44
2022-01-09,Kerala,1215,5,1215,14378,361,51,8.45,0,35.3,600626,5114,597278,1.02,0.14,0.4073087818696884,0.85,99.44
2022-01-10,Kerala,689,5,688,8832,4136,1265,7.8,0,35.3,601315,5119,597966,11.72,3.58,0.2501983002832861,0.85,99.44
2022-01-11,Kerala,144,1,143,1610,980,194,8.94,0,35.3,601459,5120,598109,2.78,0.55,0.045609065155807364,0.85,99.44
2022-01-12,Kerala,701,2,695,8654,3866,38,8.1,4,35.3,602160,5122,598804,10.95,0.11,0.2451558073654391,0.85,99.44
2022-01-13,Kerala,664,7,659,8025,3343,2014,8.27,0,35.3,602824,5129,599463,9.47,5.71,0.2273371104815864,0.85,99.44
2022-01-14,Kerala,1246,6,1238,15997,1259,1040,7.79,2,35.3,604070,5135,600701,3.57,2.95,0.4531728045325779,0.85,99.44
2022-01-15,Kerala,861,6,855,10331,2861,1297,8.33,0,35.3,604931,5141,601556,8.1,3.67,0.29266288951841357,0.85,99.44
2022-01-16,Kerala,1393,10,1388,17082,4640,2148,8.15,0,35.3,606324,5151,602944,13.14,6.08,0.48390934844192635,0.85,99.44
2022-01-17,Kerala,608,1,604,8007,3931,1398,7.59,3,35.3,606932,5152,603548,11.14,3.96,0.22682719546742208,0.85,99.44
2022-01-18,Kerala,1548,22,1539,19243,2365,742,8.04,0,35.3,608480,5174,605087,6.7,2.1,0.5451274787535411,0.85,99.44
2022-01-19,Kerala,1238,14,1231,15271,3432,16,8.11,0,35.3,609718,5188,606318,9.72,0.05,0.4326062322946176,0.85,99.44
2022-01-20,Kerala,878,11,876,11465,2557,662,7.66,0,35.3,610596,5199,607194,7.24,1.88,0.3247875354107649,0.85,99.44
2022-01-21,Kerala,559,6,554,7188,4809,2181,7.78,0,35.3,611155,5205,607748,13.62,6.18,0.20362606232294617,0.85,99.44
2022-01-22,Kerala,697,6,690,8321,3094,2442,8.38,1,35.3,611852,5211,608438,8.76,6.92,0.23572237960339942,0.85,99.44
2022-01-23,Kerala,142,0,133,1712,3867,130,8.29,9,35.3,611994,5211,608571,10.95,0.37,0.0484985835694051,0.85,99.44
2022-01-24,Kerala,381,4,379,4816,1606,837,7.91,0,35.3,612375,5215,608950,4.55,2.37,0.13643059490084986,0.85,99.44
2022-01-25,Kerala,698,8,696,8892,1391,1336,7.85,0,35.3,613073,5223,609646,3.94,3.78,0.25189801699716713,0.85,99.44
2022-01-26,Kerala,1475,16,1472,18356,3670,396,8.04,0,35.3,614548,5239,611118,10.4,1.12,0.52,0.85,99.44
2022-01-27,Kerala,1066,15,1065,13654,5,3,7.81,0,35.3,615614,5254,612183,0.01,0.01,0.38679886685552406,0.85,99.44
2022-01-28,Kerala,1261,3,1259,15632,1984,457,8.07,0,35.3,616875,5257,613442,5.62,1.29,0.4428328611898017,0.85,99.44
2022-01-29,Kerala,71,0,66,906,4224,405,7.84,5,35.3,616946,5257,613508,11.97,1.15,0.0256657223796034,0.85,99.44
2022-01-30,Kerala,1250,3,1250,15489,3507,2252,8.07,0,35.3,618196,5260,614758,9.93,6.38,0.4387818696883853,0.85,99.44
2022-01-31,Kerala,961,6,961,11868,4654,1319,8.1,0,35.3,619157,5266,615719,13.18,3.74,0.3362039660056657,0.85,99.44
2022-02-01,Kerala,1117,7,1111,13844,3384,792,8.07,0,35.3,620274,5273,616830,9.59,2.24,0.3921813031161473,0.85,99.44
2022-02-02,Kerala,932,11,930,11750,1170,674,7.93,0,35.3,621206,5284,617760,3.31,1.91,0.3328611898016997,0.85,99.45
2022-02-03,Kerala,612,5,603,7492,258,162,8.17,4,35.3,621818,5289,618363,0.73,0.46,0.21223796033994335,0.85,99.44
2022-02-04,Kerala,774,7,771,9532,441,219,8.12,0,35.3,622592,5296,619134,1.25,0.62,0.270028328611898,0.85,99.44
2022-02-05,Kerala,405,4,398,4626,3798,1589,8.75,3,35.3,622997,5300,619532,10.76,4.5,0.13104815864022662,0.85,99.44
2022-02-06,Kerala,654,2,646,7862,2170,22,8.32,6,35.3,623651,5302,620178,6.15,0.06,0.22271954674220965,0.85,99.44
2022-02-07,Kerala,630,6,625,8111,3143,1662,7.77,0,35.3,624281,5308,620803,8.9,4.71,0.22977337110481585,0.85,99.44
2022-02-08,Kerala,1561,10,1557,19413,4204,282,8.04,0,35.3,625842,5318,622360,11.91,0.8,0.5499433427762039,0.85,99.44
2022-02-09,Kerala,733,8,733,9170,2683,1260,7.99,0,35.3,626575,5326,623093,7.6,3.57,0.25977337110481585,0.85,99.44
2022-02-10,Kerala,902,9,897,11321,1425,623,7.97,0,35.3,627477,5335,623990,4.04,1.76,0.3207082152974504,0.85,99.44
2022-02-11,Kerala,1214,6,1214,15213,1250,688,7.98,0,35.3,628691,5341,625204,3.54,1.95,0.43096317280453256,0.85,99.45
2022-02-12,Kerala,1534,22,1529,19062,4877,3981,8.05,0,35.3,630225,5363,626733,13.82,11.28,0.54,0.85,99.45
2022-02-13,Kerala,454,4,454,5370,770,550,8.45,0,35.3,630679,5367,627187,2.18,1.56,0.15212464589235128,0.85,99.45
2022-02-14,Kerala,298,1,294,4203,2036,1519,7.09,3,35.3,630977,5368,627481,5.77,4.3,0.11906515580736544,0.85,99.45
2022-02-15,Kerala,542,2,541,7083,1357,817,7.65,0,35.3,631519,5370,628022,3.84,2.31,0.2006515580736544,0.85,99.45
2022-02-16,Kerala,1372,8,1364,16893,3054,540,8.12,0,35.3,632891,5378,629386,8.65,1.53,0.4785552407932011,0.85,99.45
2022-02-17,Kerala,678,9,671,8261,1282,566,8.21,0,35.3,633569,5387,630057,3.63,1.6,0.23402266288951842,0.85,99.45
2022-02-18,Kerala,1009,9,1009,12903,4843,3870,7.82,0,35.3,634578,5396,631066,13.72,10.96,0.3655240793201133,0.85,99.45
2022-02-19,Kerala,805,9,797,10238,431,270,7.86,0,35.3,635383,5405,631863,1.22,0.76,0.29002832861189803,0.85,99.45
2022-02-20,Kerala,1406,16,1406,17485,3484,2263,8.04,0,35.3,636789,5421,633269,9.87,6.41,0.4953257790368272,0.85,99.45
2022-02-21,Kerala,1521,11,1515,19143,164,81,7.95,0,35.3,638310,5432,634784,0.46,0.23,0.5422946175637394,0.85,99.45
2022-02-22,Kerala,1051,3,1042,13156,1846,803,7.99,6,35.3,639361,5435,635826,5.23,2.27,0.37269121813031164,0.85,99.45
2022-02-23,Kerala,586,5,578,7108,4438,2529,8.24,3,35.3,639947,5440,636404,12.57,7.16,0.2013597733711048,0.85,99.45
2022-02-24,Kerala,714,3,705,8803,4868,1345,8.11,6,35.3,640661,5443,637109,13.79,3.81,0.24937677053824361,0.85,99.45
2022-02-25,Kerala,1500,14,1500,18375,4372,796,8.16,0,35.3,642161,5457,638609,12.39,2.25,0.5205382436260623,0.85,99.45
2022-02-26,Kerala,734,5,733,9540,4273,1201,7.69,0,35.3,642895,5462,639342,12.1,3.4,0.27025495750708217,0.85,99.45
2022-02-27,Kerala,576,7,570,7005,1141,666,8.22,0,35.3,643471,5469,639912,3.23,1.89,0.19844192634560906,0.85,99.45
2022-02-28,Kerala,925,9,921,11509,3283,2951,8.04,0,35.3,644396,5478,640833,9.3,8.36,0.3260339943342776,0.85,99.45
2022-03-01,Kerala,99,0,92,1087,3362,1065,9.11,7,35.3,644495,5478,640925,9.52,3.02,0.030793201133144477,0.85,99.45
2022-03-02,Kerala,1524,4,1518,19189,403,225,7.94,2,35.3,646019,5482,642443,1.14,0.64,0.5435977337110481,0.85,99.45
2022-03-03,Kerala,1532,10,1526,19464,863,39,7.87,0,35.3,647551,5492,643969,2.44,0.11,0.5513881019830028,0.85,99.45
2022-03-04,Kerala,584,2,583,7118,3032,1253,8.2,0,35.3,648135,5494,644552,8.59,3.55,0.20164305949008499,0.85,99.45
2022-03-05,Kerala,666,9,665,9080,374,89,7.33,0,35.3,648801,5503,645217,1.06,0.25,0.2572237960339943,0.85,99.45
2022-03-06,Kerala,609,7,606,7684,3342,3288,7.93,0,35.3,649410,5510,645823,9.47,9.31,0.21767705382436262,0.85,99.45
2022-03-07,Kerala,1564,5,1558,19783,4100,2116,7.91,1,35.3,650974,5515,647381,11.61,5.99,0.5604249291784703,0.85,99.45
2022-03-08,Kerala,515,2,506,6384,2143,450,8.07,7,35.3,651489,5517,647887,6.07,1.27,0.1808498583569405,0.85,99.45
2022-03-09,Kerala,1214,15,1212,15429,1292,940,7.87,0,35.3,652703,5532,649099,3.66,2.66,0.43708215297450426,0.85,99.45
2022-03-10,Kerala,440,5,438,5492,2668,276,8.01,0,35.3,653143,5537,649537,7.56,0.78,0.15558073654390936,0.85,99.45
2022-03-11,Kerala,260,2,259,3106,2726,1854,8.37,0,35.3,653403,5539,649796,7.72,5.25,0.08798866855524079,0.85,99.45
2022-03-12,Kerala,1410,20,1402,17357,3848,2702,8.12,0,35.3,654813,5559,651198,10.9,7.65,0.491699716713881,0.85,99.45
2022-03-13,Kerala,1326,11,1324,16308,3923,478,8.13,0,35.3,656139,5570,652522,11.11,1.35,0.4619830028328612,0.85,99.45
2022-03-14,Kerala,1207,11,1204,14799,1778,321,8.16,0,35.3,657346,5581,653726,5.04,0.91,0.4192351274787535,0.85,99.45
2022-03-15,Kerala,77,0,70,752,3933,3891,10.24,7,35.3,657423,5581,653796,11.14,11.02,0.02130311614730878,0.85,99.45
2022-03-16,Kerala,1366,17,1365,17272,1214,1086,7.91,0,35.3,658789,5598,655161,3.44,3.08,0.4892917847025496,0.85,99.45
2022-03-17,Kerala,470,4,466,5676,2373,917,8.28,0,35.3,659259,5602,655627,6.72,2.6,0.16079320113314446,0.85,99.45
2022-03-18,Kerala,785,6,782,10118,94,49,7.76,0,35.3,660044,5608,656409,0.27,0.14,0.286628895184136,0.85,99.45
2022-03-19,Kerala,957,12,951,11993,3075,3063,7.98,0,35.3,661001,5620,657360,8.71,8.68,0.33974504249291787,0.85,99.45
2022-03-20,Kerala,1113,6,1106,13637,1447,648,8.16,1,35.3,662114,5626,658466,4.1,1.84,0.3863172804532578,0.85,99.45
2022-03-21,Kerala,582,6,582,7842,4280,2959,7.42,0,35.3,662696,5632,659048,12.12,8.38,0.22215297450424928,0.85,99.45
2022-03-22,Kerala,947,13,947,11692,828,203,8.1,0,35.3,663643,5645,659995,2.35,0.58,0.33121813031161473,0.85,99.45
2022-03-23,Kerala,1509,17,1501,18970,4847,2165,7.95,0,35.3,665152,5662,661496,13.73,6.13,0.5373937677053824,0.85,99.45
2022-03-24,Kerala,1379,7,1374,16776,401,374,8.22,0,35.3,666531,5669,662870,1.14,1.06,0.47524079320113316,0.85,99.45
2022-03-25,Kerala,1199,4,1199,15252,186,77,7.86,0,35.3,667730,5673,664069,0.53,0.22,0.4320679886685552,0.85,99.45
2022-03-26,Kerala,394,1,386,4711,598,219,8.36,7,35.3,668124,5674,664455,1.69,0.62,0.13345609065155808,0.85,99.45
2022-03-27,Kerala,1609,18,1604,19842,1053,536,8.11,0,35.3,669733,5692,666059,2.98,1.52,0.5620963172804533,0.85,99.45
2022-03-28,Kerala,1461,12,1460,18188,4800,3002,8.03,0,35.3,671194,5704,667519,13.6,8.5,0.5152407932011331,0.85,99.45
2022-03-29,Kerala,249,3,240,2875,2658,1579,8.66,6,35.3,671443,5707,667759,7.53,4.47,0.08144475920679886,0.85,99.45
2022-03-30,Kerala,819,6,816,9803,3052,236,8.35,0,35.3,672262,5713,668575,8.65,0.67,0.27770538243626064,0.85,99.45
2022-03-31,Kerala,1378,14,1369,17120,1166,478,8.05,0,35.3,673640,5727,669944,3.3,1.35,0.484985835694051,0.85,99.45
2022-04-01,Kerala,96,0,93,1088,3786,1715,8.82,3,35.3,673736,5727,670037,10.73,4.86,0.030821529745042493,0.85,99.45
2022-04-02,Kerala,500,6,495,6402,2952,2162,7.81,0,35.3,674236,5733,670532,8.36,6.12,0.18135977337110482,0.85,99.45
2022-04-03,Kerala,287,3,282,3229,3922,1614,8.89,2,35.3,674523,5736,670814,11.11,4.57,0.09147308781869688,0.85,99.45
2022-04-04,Kerala,655,6,646,8195,2999,564,7.99,3,35.3,675178,5742,671460,8.5,1.6,0.2321529745042493,0.85,99.45
2022-04-05,Kerala,1119,12,1119,13891,1158,459,8.06,0,35.3,676297,5754,672579,3.28,1.3,0.3935127478753541,0.85,99.45
2022-04-06,Kerala,326,4,322,4063,1719,735,8.02,0,35.3,676623,5758,672901,4.87,2.08,0.11509915014164306,0.85,99.45
2022-04-07,Kerala,1285,6,1278,15622,3437,3154,8.23,1,35.3,677908,5764,674179,9.74,8.93,0.44254957507082154,0.85,99.45
2022-04-08,Kerala,854,7,851,11000,2853,282,7.76,0,35.3,678762,5771,675030,8.08,0.8,0.311614730878187,0.85,99.45
2022-04-09,Kerala,1113,12,1104,13911,1493,1006,8.0,0,35.3,679875,5783,676134,4.23,2.85,0.3940793201133144,0.85,99.45
2022-04-10,Kerala,552,7,547,6879,754,203,8.02,0,35.3,680427,5790,676681,2.14,0.58,0.19487252124645893,0.85,99.45
2022-04-11,Kerala,630,5,623,7391,4723,1372,8.52,2,35.3,681057,5795,677304,13.38,3.89,0.20937677053824363,0.85,99.45
2022-04-12,Kerala,229,1,223,2850,1141,58,8.04,5,35.3,681286,5796,677527,3.23,0.16,0.08073654390934844,0.85,99.45
2022-04-13,Kerala,692,9,685,9093,496,431,7.61,0,35.3,681978,5805,678212,1.41,1.22,0.25759206798866857,0.85,99.45
2022-04-14,Kerala,1384,20,1378,17573,1924,1374,7.88,0,35.3,683362,5825,679590,5.45,3.89,0.4978186968838527,0.85,99.45
2022-04-15,Kerala,903,4,903,11416,434,122,7.91,0,35.3,684265,5829,680493,1.23,0.35,0.32339943342776206,0.85,99.45
2022-04-16,Kerala,838,11,830,10214,3122,1792,8.2,0,35.3,685103,5840,681323,8.84,5.08,0.2893484419263456,0.85,99.45
2022-04-17,Kerala,910,4,910,11221,1580,47,8.11,0,35.3,686013,5844,682233,4.48,0.13,0.3178753541076487,0.85,99.45
2022-04-18,Kerala,732,6,728,9287,1460,399,7.88,0,35.3,686745,5850,682961,4.14,1.13,0.26308781869688386,0.85,99.45
2022-04-19,Kerala,850,5,842,10243,2014,523,8.3,3,35.3,687595,5855,683803,5.71,1.48,0.2901699716713881,0.85,99.45
2022-04-20,Kerala,1478,12,1476,18588,933,270,7.95,0,35.3,689073,5867,685279,2.64,0.76,0.5265722379603399,0.85,99.45
2022-04-21,Kerala,519,7,513,6328,2041,158,8.2,0,35.3,689592,5874,685792,5.78,0.45,0.17926345609065156,0.85,99.45
2022-04-22,Kerala,245,1,240,2665,675,638,9.19,4,35.3,689837,5875,686032,1.91,1.81,0.07549575070821529,0.85,99.45
2022-04-23,Kerala,1289,11,1287,15767,2857,2676,8.18,0,35.3,691126,5886,687319,8.09,7.58,0.446657223796034,0.85,99.45
2022-04-24,Kerala,533,3,525,6644,295,239,8.02,5,35.3,691659,5889,687844,0.84,0.68,0.18821529745042492,0.85,99.45
2022-04-25,Kerala,1105,16,1103,13844,3436,2666,7.98,0,35.3,692764,5905,688947,9.73,7.55,0.3921813031161473,0.85,99.45
2022-04-26,Kerala,1431,14,1431,17790,2808,936,8.04,0,35.3,694195,5919,690378,7.95,2.65,0.5039660056657224,0.85,99.45
2022-04-27,Kerala,115,0,112,1690,293,244,6.8,3,35.3,694310,5919,690490,0.83,0.69,0.047875354107648725,0.85,99.45
2022-04-28,Kerala,420,6,417,5473,3343,1835,7.67,0,35.3,694730,5925,690907,9.47,5.2,0.15504249291784702,0.85,99.45
2022-04-29,Kerala,1451,15,1442,18463,3730,401,7.86,0,35.3,696181,5940,692349,10.57,1.14,0.5230311614730878,0.85,99.45
2022-04-30,Kerala,1500,22,1492,18516,4308,2398,8.1,0,35.3,697681,5962,693841,12.2,6.79,0.5245325779036827,0.85,99.45
2022-05-01,Kerala,494,3,492,6395,479,438,7.72,0,35.3,698175,5965,694333,1.36,1.24,0.1811614730878187,0.85,99.45
2022-05-02,Kerala,1496,6,1493,18030,1265,1215,8.3,0,35.3,699671,5971,695826,3.58,3.44,0.5107648725212465,0.85,99.45
2022-05-03,Kerala,421,5,415,4836,4997,3612,8.71,1,35.3,700092,5976,696241,14.16,10.23,0.1369971671388102,0.85,99.45
2022-05-04,Kerala,1238,15,1229,15478,4293,1264,8.0,0,35.3,701330,5991,697470,12.16,3.58,0.4384702549575071,0.85,99.45
2022-05-05,Kerala,754,5,748,9126,4749,3080,8.26,1,35.3,702084,5996,698218,13.45,8.73,0.25852691218130314,0.85,99.45
2022-05-06,Kerala,359,2,358,4575,749,101,7.85,0,35.3,702443,5998,698576,2.12,0.29,0.12960339943342777,0.85,99.45
2022-05-07,Kerala,1402,17,1400,17712,4205,552,7.92,0,35.3,703845,6015,699976,11.91,1.56,0.501756373937677,0.85,99.45
2022-05-08,Kerala,1497,10,1488,18728,2044,1381,7.99,0,35.3,705342,6025,701464,5.79,3.91,0.5305382436260623,0.85,99.45
2022-05-09,Kerala,487,5,479,6334,3387,2280,7.69,3,35.3,705829,6030,701943,9.59,6.46,0.17943342776203966,0.85,99.45
2022-05-10,Kerala,1062,10,1053,13334,864,10,7.96,0,35.3,706891,6040,702996,2.45,0.03,0.3777337110481586,0.85,99.45
2022-05-11,Kerala,761,4,754,9849,1543,982,7.73,3,35.3,707652,6044,703750,4.37,2.78,0.2790084985835694,0.85,99.45
2022-05-12,Kerala,558,8,549,6982,1993,1647,7.99,1,35.3,708210,6052,704299,5.65,4.67,0.19779036827195468,0.85,99.45
2022-05-13,Kerala,891,4,882,10800,853,338,8.25,5,35.3,709101,6056,705181,2.42,0.96,0.3059490084985836,0.85,99.45
2022-05-14,Kerala,1293,10,1289,16161,3557,682,8.0,0,35.3,710394,6066,706470,10.08,1.93,0.4578186968838527,0.85,99.45
2022-05-15,Kerala,1171,14,1169,14962,3203,786,7.83,0,35.3,711565,6080,707639,9.07,2.23,0.4238526912181303,0.85,99.45
2022-05-16,Kerala,1023,6,1021,12734,3911,2625,8.03,0,35.3,712588,6086,708660,11.08,7.44,0.36073654390934845,0.85,99.45
2022-05-17,Kerala,1250,13,1244,15932,459,169,7.85,0,35.3,713838,6099,709904,1.3,0.48,0.4513314447592068,0.85,99.45
2022-05-18,Kerala,431,2,423,5331,4410,211,8.08,6,35.3,714269,6101,710327,12.49,0.6,0.1510198300283286,0.85,99.45
2022-05-19,Kerala,1409,9,1406,18123,1610,72,7.77,0,35.3,715678,6110,711733,4.56,0.2,0.5133994334277621,0.85,99.45
2022-05-20,Kerala,1025,14,1022,12856,4317,3923,7.97,0,35.3,716703,6124,712755,12.23,11.11,0.3641926345609065,0.85,99.45
2022-05-21,Kerala,930,9,923,11949,4340,2533,7.78,0,35.3,717633,6133,713678,12.29,7.18,0.3384985835694051,0.85,99.45
2022-05-22,Kerala,1582,17,1576,19536,4373,1763,8.1,0,35.3,719215,6150,715254,12.39,4.99,0.55342776203966,0.86,99.45
2022-05-23,Kerala,1433,17,1431,18283,1173,547,7.84,0,35.3,720648,6167,716685,3.32,1.55,0.5179320113314447,0.86,99.45
2022-05-24,Kerala,1314,16,1305,16257,1353,447,8.08,0,35.3,721962,6183,717990,3.83,1.27,0.4605382436260623,0.86,99.45
2022-05-25,Kerala,160,0,153,1743,4012,1273,9.18,7,35.3,722122,6183,718143,11.37,3.61,0.049376770538243624,0.86,99.45
2022-05-26,Kerala,366,4,362,4962,2148,1971,7.38,0,35.3,722488,6187,718505,6.08,5.58,0.14056657223796035,0.86,99.45
2022-05-27,Kerala,925,11,918,11735,76,39,7.88,0,35.3,723413,6198,719423,0.22,0.11,0.33243626062322945,0.86,99.45
2022-05-28,Kerala,361,2,352,4863,2505,1196,7.42,7,35.3,723774,6200,719775,7.1,3.39,0.13776203966005665,0.86,99.45
2022-05-29,Kerala,164,1,156,2080,379,179,7.88,7,35.3,723938,6201,719931,1.07,0.51,0.058923512747875356,0.86,99.45
2022-05-30,Kerala,1218,4,1215,15363,2449,2400,7.93,0,35.3,725156,6205,721146,6.94,6.8,0.4352124645892351,0.86,99.45
2022-05-31,Kerala,1464,18,1459,18686,1002,668,7.83,0,35.3,726620,6223,722605,2.84,1.89,0.5293484419263456,0.86,99.45
2022-06-01,Kerala,1510,11,1509,18681,1189,965,8.08,0,35.3,728130,6234,724114,3.37,2.73,0.5292067988668555,0.86,99.45
2022-06-02,Kerala,530,3,528,7137,2486,785,7.43,0,35.3,728660,6237,724642,7.04,2.22,0.20218130311614732,0.86,99.45
2022-06-03,Kerala,391,2,383,4948,2903,2464,7.9,6,35.3,729051,6239,725025,8.22,6.98,0.1401699716713881,0.86,99.45
2022-06-04,Kerala,104,0,95,1287,4104,1889,8.08,9,35.3,729155,6239,725120,11.63,5.35,0.036458923512747876,0.86,99.45
2022-06-05,Kerala,771,8,766,9518,915,283,8.1,0,35.3,729926,6247,725886,2.59,0.8,0.26963172804532576,0.86,99.45
2022-06-06,Kerala,588,3,581,7614,3395,208,7.72,4,35.3,730514,6250,726467,9.62,0.59,0.2156940509915014,0.86,99.45
2022-06-07,Kerala,970,9,963,12275,914,77,7.9,0,35.3,731484,6259,727430,2.59,0.22,0.34773371104815864,0.86,99.45
2022-06-08,Kerala,907,9,898,10975,2906,373,8.26,0,35.3,732391,6268,728328,8.23,1.06,0.31090651558073656,0.86,99.45
2022-06-09,Kerala,595,8,594,7682,778,139,7.75,0,35.3,732986,6276,728922,2.2,0.39,0.21762039660056656,0.86,99.45
2022-06-10,Kerala,1285,8,1279,15722,3525,532,8.17,0,35.3,734271,6284,730201,9.99,1.51,0.44538243626062324,0.86,99.45
2022-06-11,Kerala,1073,4,1066,13679,4615,4420,7.84,3,35.3,735344,6288,731267,13.07,12.52,0.3875070821529745,0.86,99.45
2022-06-12,Kerala,216,1,215,2636,3428,874,8.19,0,35.3,735560,6289,731482,9.71,2.48,0.0746742209631728,0.85,99.45
2022-06-13,Kerala,917,7,913,11763,1287,7,7.8,0,35.3,736477,6296,732395,3.65,0.02,0.3332294617563739,0.85,99.45
2022-06-14,Kerala,648,8,646,8023,3368,600,8.08,0,35.3,737125,6304,733041,9.54,1.7,0.22728045325779037,0.86,99.45
2022-06-15,Kerala,625,3,619,7335,2296,1726,8.52,3,35.3,737750,6307,733660,6.5,4.89,0.20779036827195468,0.85,99.45
2022-06-16,Kerala,46,0,37,901,636,420,5.11,9,35.3,737796,6307,733697,1.8,1.19,0.025524079320113316,0.85,99.44
2022-06-17,Kerala,1502,15,1493,19217,2062,1212,7.82,0,35.3,739298,6322,735190,5.84,3.43,0.5443909348441927,0.86,99.44
2022-06-18,Kerala,1188,12,1179,14408,794,539,8.25,0,35.3,740486,6334,736369,2.25,1.53,0.4081586402266289,0.86,99.44
2022-06-19,Kerala,92,0,86,1579,1891,1725,5.83,6,35.3,740578,6334,736455,5.36,4.89,0.04473087818696884,0.86,99.44
2022-06-20,Kerala,1470,17,1468,17980,1051,59,8.18,0,35.3,742048,6351,737923,2.98,0.17,0.5093484419263457,0.86,99.44
2022-06-21,Kerala,1080,13,1075,13212,4312,442,8.17,0,35.3,743128,6364,738998,12.22,1.25,0.37427762039660056,0.86,99.44
2022-06-22,Kerala,1585,23,1585,19910,3482,2752,7.96,0,35.3,744713,6387,740583,9.86,7.8,0.5640226628895184,0.86,99.45
2022-06-23,Kerala,1346,12,1344,17649,4391,2467,7.63,0,35.3,746059,6399,741927,12.44,6.99,0.499971671388102,0.86,99.45
2022-06-24,Kerala,1018,3,1010,12549,1926,417,8.11,5,35.3,747077,6402,742937,5.46,1.18,0.3554957507082153,0.86,99.45
2022-06-25,Kerala,1013,7,1011,12188,1167,679,8.31,0,35.3,748090,6409,743948,3.31,1.92,0.34526912181303115,0.86,99.45
2022-06-26,Kerala,1049,10,1044,12958,3215,1353,8.1,0,35.3,749139,6419,744992,9.11,3.83,0.36708215297450425,0.86,99.45
2022-06-27,Kerala,1421,10,1421,17715,4098,2998,8.02,0,35.3,750560,6429,746413,11.61,8.49,0.5018413597733711,0.86,99.45
2022-06-28,Kerala,633,4,630,7703,3443,2553,8.22,0,35.3,751193,6433,747043,9.75,7.23,0.21821529745042492,0.86,99.45
2022-06-29,Kerala,361,1,358,4736,1255,1254,7.62,2,35.3,751554,6434,747401,3.56,3.55,0.1341643059490085,0.86,99.45
2022-06-30,Kerala,1341,4,1336,16826,1349,774,7.97,1,35.3,752895,6438,748737,3.82,2.19,0.476657223796034,0.86,99.45
2022-07-01,Kerala,665,3,663,8063,71,2,8.25,0,35.3,753560,6441,749400,0.2,0.01,0.22841359773371106,0.85,99.45
2022-07-02,Kerala,222,2,215,3108,4045,3581,7.14,5,35.3,753782,6443,749615,11.46,10.14,0.08804532577903683,0.85,99.45
2022-07-03,Kerala,321,3,318,3940,4015,223,8.15,0,35.3,754103,6446,749933,11.37,0.63,0.11161473087818696,0.85,99.45
2022-07-04,Kerala,773,3,772,9212,2842,1482,8.39,0,35.3,754876,6449,750705,8.05,4.2,0.2609631728045326,0.85,99.45
2022-07-05,Kerala,541,4,532,6896,3448,2996,7.85,5,35.3,755417,6453,751237,9.77,8.49,0.1953541076487252,0.85,99.45
2022-07-06,Kerala,699,3,695,8678,3581,1196,8.05,1,35.3,756116,6456,751932,10.14,3.39,0.2458356940509915,0.85,99.45
2022-07-07,Kerala,107,0,106,1158,3957,348,9.24,1,35.3,756223,6456,752038,11.21,0.99,0.03280453257790368,0.85,99.45
2022-07-08,Kerala,660,2,656,8221,3247,638,8.03,2,35.3,756883,6458,752694,9.2,1.81,0.23288951841359773,0.85,99.45
2022-07-09,Kerala,1095,10,1091,13455,2332,1002,8.14,0,35.3,757978,6468,753785,6.61,2.84,0.38116147308781867,0.85,99.45
2022-07-10,Kerala,748,9,748,9016,1138,88,8.3,0,35.3,758726,6477,754533,3.22,0.25,0.25541076487252123,0.85,99.45
2022-07-11,Kerala,534,7,532,6387,2609,532,8.36,0,35.3,759260,6484,755065,7.39,1.51,0.18093484419263456,0.85,99.45
2022-07-12,Kerala,410,4,410,5302,4245,3198,7.73,0,35.3,759670,6488,755475,12.03,9.06,0.15019830028328612,0.85,99.45
2022-07-13,Kerala,1277,13,1271,16112,4550,2278,7.93,0,35.3,760947,6501,756746,12.89,6.45,0.45643059490084986,0.85,99.45
2022-07-14,Kerala,336,4,336,4148,484,310,8.1,0,35.3,761283,6505,757082,1.37,0.88,0.1175070821529745,0.85,99.45
2022-07-15,Kerala,798,5,794,9590,4776,4114,8.32,0,35.3,762081,6510,757876,13.53,11.65,0.271671388101983,0.85,99.45
2022-07-16,Kerala,883,10,883,11048,1816,580,7.99,0,35.3,762964,6520,758759,5.14,1.64,0.3129745042492918,0.85,99.45
2022-07-17,Kerala,1433,20,1432,17805,109,109,8.05,0,35.3,764397,6540,760191,0.31,0.31,0.5043909348441926,0.86,99.45
2022-07-18,Kerala,507,5,505,5892,95,54,8.6,0,35.3,764904,6545,760696,0.27,0.15,0.16691218130311614,0.86,99.45
2022-07-19,Kerala,45,0,41,596,197,86,7.55,4,35.3,764949,6545,760737,0.56,0.24,0.01688385269121813,0.86,99.45
2022-07-20,Kerala,652,8,644,8296,3712,2416,7.86,0,35.3,765601,6553,761381,10.52,6.84,0.235014164305949,0.86,99.45
2022-07-21,Kerala,1247,4,1242,15340,655,76,8.13,1,35.3,766848,6557,762623,1.86,0.22,0.4345609065155807,0.86,99.45
2022-07-22,Kerala,1474,16,1466,18301,1570,442,8.05,0,35.3,768322,6573,764089,4.45,1.25,0.518441926345609,0.86,99.45
2022-07-23,Kerala,266,1,266,3386,3180,747,7.86,0,35.3,768588,6574,764355,9.01,2.12,0.09592067988668555,0.86,99.45
2022-07-24,Kerala,189,1,185,2561,4716,85,7.38,3,35.3,768777,6575,764540,13.36,0.24,0.07254957507082153,0.86,99.45
2022-07-25,Kerala,786,3,786,9491,4521,1195,8.28,0,35.3,769563,6578,765326,12.81,3.39,0.2688668555240793,0.85,99.45
2022-07-26,Kerala,694,8,690,8815,2848,528,7.87,0,35.3,770257,6586,766016,8.07,1.5,0.24971671388101982,0.86,99.45
2022-07-27,Kerala,988,14,986,12473,4970,2373,7.92,0,35.3,771245,6600,767002,14.08,6.72,0.353342776203966,0.86,99.45
2022-07-28,Kerala,606,1,602,7783,2402,336,7.79,3,35.3,771851,6601,767604,6.8,0.95,0.22048158640226628,0.86,99.45
2022-07-29,Kerala,431,2,424,5312,3418,1940,8.11,5,35.3,772282,6603,768028,9.68,5.5,0.15048158640226628,0.85,99.45
2022-07-30,Kerala,1523,9,1520,18986,2435,1482,8.02,0,35.3,773805,6612,769548,6.9,4.2,0.5378470254957507,0.85,99.45
2022-07-31,Kerala,706,9,705,9136,3142,1223,7.73,0,35.3,774511,6621,770253,8.9,3.46,0.2588101983002833,0.85,99.45
2022-08-01,Kerala,1446,19,1441,17794,3315,1930,8.13,0,35.3,775957,6640,771694,9.39,5.47,0.5040793201133145,0.86,99.45
2022-08-02,Kerala,365,3,364,4918,37,26,7.42,0,35.3,776322,6643,772058,0.1,0.07,0.1393201133144476,0.86,99.45
2022-08-03,Kerala,1366,18,1363,16839,2397,1643,8.11,0,35.3,777688,6661,773421,6.79,4.65,0.47702549575070824,0.86,99.45
2022-08-04,Kerala,1159,12,1159,14656,182,133,7.91,0,35.3,778847,6673,774580,0.52,0.38,0.4151841359773371,0.86,99.45
2022-08-05,Kerala,446,1,438,5452,2705,1744,8.18,7,35.3,779293,6674,775018,7.66,4.94,0.15444759206798866,0.86,99.45
2022-08-06,Kerala,765,3,763,9541,1712,110,8.02,0,35.3,780058,6677,775781,4.85,0.31,0.27028328611898017,0.86,99.45
2022-08-07,Kerala,698,5,691,8962,3846,2584,7.79,2,35.3,780756,6682,776472,10.9,7.32,0.2538810198300283,0.86,99.45
2022-08-08,Kerala,395,4,390,4934,836,654,8.01,1,35.3,781151,6686,776862,2.37,1.85,0.13977337110481586,0.86,99.45
2022-08-09,Kerala,203,2,201,2538,2739,2532,8.0,0,35.3,781354,6688,777063,7.76,7.17,0.07189801699716714,0.86,99.45
2022-08-10,Kerala,652,5,648,8290,3395,2377,7.86,0,35.3,782006,6693,777711,9.62,6.73,0.2348441926345609,0.86,99.45
2022-08-11,Kerala,124,0,117,1539,3923,394,8.06,7,35.3,782130,6693,777828,11.11,1.12,0.04359773371104816,0.86,99.45
2022-08-12,Kerala,647,9,646,8136,372,44,7.95,0,35.3,782777,6702,778474,1.05,0.12,0.2304815864022663,0.86,99.45
2022-08-13,Kerala,398,3,397,5079,4697,2481,7.84,0,35.3,783175,6705,778871,13.31,7.03,0.14388101983002832,0.86,99.45
2022-08-14,Kerala,687,7,679,8770,3613,1601,7.83,1,35.3,783862,6712,779550,10.24,4.54,0.24844192634560908,0.86,99.45
2022-08-15,Kerala,390,3,390,4771,2135,833,8.17,0,35.3,784252,6715,779940,6.05,2.36,0.13515580736543908,0.86,99.45
2022-08-16,Kerala,381,2,377,5032,3964,1555,7.57,2,35.3,784633,6717,780317,11.23,4.41,0.14254957507082153,0.86,99.45
2022-08-17,Kerala,1372,4,1364,16987,1254,863,8.08,4,35.3,786005,6721,781681,3.55,2.44,0.48121813031161476,0.86,99.45
2022-08-18,Kerala,558,3,558,6948,295,239,8.03,0,35.3,786563,6724,782239,0.84,0.68,0.19682719546742208,0.85,99.45
2022-08-19,Kerala,1390,4,1381,17386,825,511,7.99,5,35.3,787953,6728,783620,2.34,1.45,0.49252124645892353,0.85,99.45
2022-08-20,Kerala,787,6,784,10234,2076,1106,7.69,0,35.3,788740,6734,784404,5.88,3.13,0.28991501416430593,0.85,99.45
2022-08-21,Kerala,53,0,49,682,795,737,7.77,4,35.3,788793,6734,784453,2.25,2.09,0.019320113314447593,0.85,99.45
2022-08-22,Kerala,243,3,235,2694,469,259,9.02,5,35.3,789036,6737,784688,1.33,0.73,0.0763172804532578,0.85,99.45
2022-08-23,Kerala,752,6,750,9440,4464,1717,7.97,0,35.3,789788,6743,785438,12.65,4.86,0.2674220963172805,0.85,99.45
2022-08-24,Kerala,691,4,688,7990,1699,17,8.65,0,35.3,790479,6747,786126,4.81,0.05,0.2263456090651558,0.85,99.45
2022-08-25,Kerala,1187,5,1180,14899,2434,1820,7.97,2,35.3,791666,6752,787306,6.9,5.16,0.4220679886685552,0.85,99.45
2022-08-26,Kerala,1477,15,1474,18587,1862,12,7.95,0,35.3,793143,6767,788780,5.27,0.03,0.526543909348442,0.85,99.45
2022-08-27,Kerala,1037,8,1033,12891,4010,653,8.04,0,35.3,794180,6775,789813,11.36,1.85,0.3651841359773371,0.85,99.45
2022-08-28,Kerala,1553,12,1549,19387,4725,3595,8.01,0,35.3,795733,6787,791362,13.39,10.18,0.5492067988668555,0.85,99.45
2022-08-29,Kerala,721,7,718,8656,4029,1490,8.33,0,35.3,796454,6794,792080,11.41,4.22,0.24521246458923512,0.85,99.45
2022-08-30,Kerala,689,7,682,8364,4330,2280,8.24,0,35.3,797143,6801,792762,12.27,6.46,0.23694050991501417,0.85,99.45
2022-08-31,Kerala,722,9,719,9100,1479,935,7.93,0,35.3,797865,6810,793481,4.19,2.65,0.2577903682719547,0.85,99.45
2022-09-01,Kerala,1019,4,1010,12623,562,322,8.07,5,35.3,798884,6814,794491,1.59,0.91,0.35759206798866855,0.85,99.45
2022-09-02,Kerala,1181,12,1174,15146,1927,548,7.8,0,35.3,800065,6826,795665,5.46,1.55,0.42906515580736543,0.85,99.45
2022-09-03,Kerala,883,7,881,11538,1403,163,7.65,0,35.3,800948,6833,796546,3.97,0.46,0.3268555240793201,0.85,99.45
2022-09-04,Kerala,1424,6,1421,17690,705,696,8.05,0,35.3,802372,6839,797967,2.0,1.97,0.5011331444759207,0.85,99.45
2022-09-05,Kerala,775,4,773,9928,3973,3024,7.81,0,35.3,803147,6843,798740,11.25,8.57,0.28124645892351274,0.85,99.45
2022-09-06,Kerala,720,9,716,8946,3689,1050,8.05,0,35.3,803867,6852,799456,10.45,2.97,0.25342776203966005,0.85,99.45
2022-09-07,Kerala,621,5,612,8218,2276,1836,7.56,4,35.3,804488,6857,800068,6.45,5.2,0.23280453257790368,0.85,99.45
2022-09-08,Kerala,279,2,277,3844,3770,1347,7.26,0,35.3,804767,6859,800345,10.68,3.82,0.10889518413597733,0.85,99.45
2022-09-09,Kerala,458,4,457,5156,2132,249,8.88,0,35.3,805225,6863,800802,6.04,0.71,0.14606232294617563,0.85,99.45
2022-09-10,Kerala,1337,9,1328,16487,2168,2107,8.11,0,35.3,806562,6872,802130,6.14,5.97,0.46705382436260623,0.85,99.45
2022-09-11,Kerala,1463,14,1458,18315,3431,601,7.99,0,35.3,808025,6886,803588,9.72,1.7,0.5188385269121814,0.85,99.45
2022-09-12,Kerala,290,2,285,3325,455,453,8.72,3,35.3,808315,6888,803873,1.29,1.28,0.09419263456090651,0.85,99.45
2022-09-13,Kerala,1136,13,1131,14034,3579,1801,8.09,0,35.3,809451,6901,805004,10.14,5.1,0.39756373937677053,0.85,99.45
2022-09-14,Kerala,967,11,965,12049,3556,345,8.03,0,35.3,810418,6912,805969,10.07,0.98,0.3413314447592068,0.85,99.45
2022-09-15,Kerala,1348,12,1345,16847,2184,757,8.0,0,35.3,811766,6924,807314,6.19,2.14,0.47725212464589234,0.85,99.45
2022-09-16,Kerala,1562,14,1555,19632,2358,203,7.96,0,35.3,813328,6938,808869,6.68,0.58,0.5561473087818697,0.85,99.45
2022-09-17,Kerala,852,2,850,10700,542,287,7.96,0,35.3,814180,6940,809719,1.54,0.81,0.3031161473087819,0.85,99.45
2022-09-18,Kerala,311,4,310,4167,447,373,7.46,0,35.3,814491,6944,810029,1.27,1.06,0.11804532577903683,0.85,99.45
2022-09-19,Kerala,149,1,148,1584,3455,751,9.41,0,35.3,814640,6945,810177,9.79,2.13,0.04487252124645892,0.85,99.45
2022-09-20,Kerala,1119,4,1111,14467,1694,385,7.73,4,35.3,815759,6949,811288,4.8,1.09,0.4098300283286119,0.85,99.45
2022-09-21,Kerala,1012,7,1009,12343,4237,2671,8.2,0,35.3,816771,6956,812297,12.0,7.57,0.3496600566572238,0.85,99.45
2022-09-22,Kerala,487,2,478,5923,3909,3461,8.22,7,35.3,817258,6958,812775,11.07,9.8,0.16779036827195468,0.85,99.45
2022-09-23,Kerala,860,8,859,10368,2319,1272,8.29,0,35.3,818118,6966,813634,6.57,3.6,0.29371104815864024,0.85,99.45
2022-09-24,Kerala,115,1,108,1202,4653,2796,9.57,6,35.3,818233,6967,813742,13.18,7.92,0.03405099150141643,0.85,99.45
2022-09-25,Kerala,786,6,779,9428,816,425,8.34,1,35.3,819019,6973,814521,2.31,1.2,0.26708215297450427,0.85,99.45
2022-09-26,Kerala,1211,12,1205,15314,4302,101,7.91,0,35.3,820230,6985,815726,12.19,0.29,0.4338243626062323,0.85,99.45
2022-09-27,Kerala,120,1,118,1478,2615,455,8.12,1,35.3,820350,6986,815844,7.41,1.29,0.041869688385269124,0.85,99.45
2022-09-28,Kerala,567,1,558,7004,2344,1843,8.1,8,35.3,820917,6987,816402,6.64,5.22,0.19841359773371106,0.85,99.45
2022-09-29,Kerala,396,1,395,5314,4683,3927,7.45,0,35.3,821313,6988,816797,13.27,11.12,0.15053824362606233,0.85,99.45
2022-09-30,Kerala,210,1,204,2233,4318,1660,9.4,5,35.3,821523,6989,817001,12.23,4.7,0.06325779036827195,0.85,99.45
2022-10-01,Kerala,656,6,655,8656,1182,479,7.58,0,35.3,822179,6995,817656,3.35,1.36,0.24521246458923512,0.85,99.45
2022-10-02,Kerala,569,5,566,7076,770,243,8.04,0,35.3,822748,7000,818222,2.18,0.69,0.20045325779036827,0.85,99.45
2022-10-03,Kerala,1265,18,1261,16061,4732,2445,7.88,0,35.3,824013,7018,819483,13.41,6.93,0.454985835694051,0.85,99.45
2022-10-04,Kerala,635,5,633,7840,3667,2171,8.1,0,35.3,824648,7023,820116,10.39,6.15,0.22209631728045326,0.85,99.45
2022-10-05,Kerala,312,3,310,3774,2946,1341,8.27,0,35.3,824960,7026,820426,8.35,3.8,0.10691218130311615,0.85,99.45
2022-10-06,Kerala,1260,10,1260,15773,2045,1129,7.99,0,35.3,826220,7036,821686,5.79,3.2,0.4468271954674221,0.85,99.45
2022-10-07,Kerala,166,1,162,2428,266,168,6.84,3,35.3,826386,7037,821848,0.75,0.48,0.06878186968838527,0.85,99.45
2022-10-08,Kerala,648,5,640,8090,4263,2065,8.01,3,35.3,827034,7042,822488,12.08,5.85,0.2291784702549575,0.85,99.45
2022-10-09,Kerala,169,2,162,2129,690,68,7.94,5,35.3,827203,7044,822650,1.95,0.19,0.060311614730878184,0.85,99.45
2022-10-10,Kerala,773,7,773,9050,4492,468,8.54,0,35.3,827976,7051,823423,12.73,1.33,0.2563739376770538,0.85,99.45
2022-10-11,Kerala,363,4,359,4403,3365,2018,8.24,0,35.3,828339,7055,823782,9.53,5.72,0.12473087818696883,0.85,99.45
2022-10-12,Kerala,332,2,329,3940,2688,2217,8.43,1,35.3,828671,7057,824111,7.61,6.28,0.11161473087818696,0.85,99.45
2022-10-13,Kerala,531,3,524,6684,951,939,7.94,4,35.3,829202,7060,824635,2.69,2.66,0.18934844192634562,0.85,99.45
2022-10-14,Kerala,1425,17,1421,17721,122,105,8.04,0,35.3,830627,7077,826056,0.35,0.3,0.5020113314447592,0.85,99.45
2022-10-15,Kerala,1358,14,1351,16992,4695,4212,7.99,0,35.3,831985,7091,827407,13.3,11.93,0.4813597733711048,0.85,99.45
2022-10-16,Kerala,143,0,142,1698,4034,212,8.42,1,35.3,832128,7091,827549,11.43,0.6,0.04810198300283286,0.85,99.45
2022-10-17,Kerala,1555,5,1554,19475,2782,1459,7.98,0,35.3,833683,7096,829103,7.88,4.13,0.5516997167138811,0.85,99.45
2022-10-18,Kerala,196,2,189,2585,3952,740,7.58,5,35.3,833879,7098,829292,11.2,2.1,0.07322946175637393,0.85,99.45
2022-10-19,Kerala,271,1,265,3587,3073,1785,7.56,5,35.3,834150,7099,829557,8.71,5.06,0.10161473087818697,0.85,99.45
2022-10-20,Kerala,180,1,177,2207,770,492,8.16,2,35.3,834330,7100,829734,2.18,1.39,0.06252124645892351,0.85,99.45
2022-10-21,Kerala,60,0,60,655,4744,1792,9.16,0,35.3,834390,7100,829794,13.44,5.08,0.018555240793201134,0.85,99.45
2022-10-22,Kerala,922,5,920,11290,1133,1056,8.17,0,35.3,835312,7105,830714,3.21,2.99,0.3198300283286119,0.85,99.45
2022-10-23,Kerala,1360,9,1355,17322,937,62,7.85,0,35.3,836672,7114,832069,2.65,0.18,0.4907082152974504,0.85,99.45
2022-10-24,Kerala,701,5,697,9350,4894,1071,7.5,0,35.3,837373,7119,832766,13.86,3.03,0.26487252124645894,0.85,99.45
2022-10-25,Kerala,1576,15,1567,19827,1737,1530,7.95,0,35.3,838949,7134,834333,4.92,4.33,0.561671388101983,0.85,99.45
2022-10-26,Kerala,274,2,272,3434,3706,922,7.98,0,35.3,839223,7136,834605,10.5,2.61,0.09728045325779036,0.85,99.45
2022-10-27,Kerala,1208,8,1203,15263,1130,773,7.91,0,35.3,840431,7144,835808,3.2,2.19,0.43237960339943343,0.85,99.45
2022-10-28,Kerala,860,9,852,11136,673,164,7.72,0,35.3,841291,7153,836660,1.91,0.46,0.3154674220963173,0.85,99.45
2022-10-29,Kerala,1551,21,1542,19457,2993,2381,7.97,0,35.3,842842,7174,838202,8.48,6.75,0.5511898016997168,0.85,99.45
2022-10-30,Kerala,1400,9,1394,17472,1776,478,8.01,0,35.3,844242,7183,839596,5.03,1.35,0.49495750708215297,0.85,99.45
2022-10-31,Kerala,1254,16,1249,15632,1631,1350,8.02,0,35.3,845496,7199,840845,4.62,3.82,0.4428328611898017,0.85,99.45
2022-11-01,Kerala,552,4,550,7170,3521,367,7.7,0,35.3,846048,7203,841395,9.97,1.04,0.20311614730878186,0.85,99.45
2022-11-02,Kerala,1453,17,1445,18159,2135,1801,8.0,0,35.3,847501,7220,842840,6.05,5.1,0.5144192634560907,0.85,99.45
2022-11-03,Kerala,364,5,361,4565,1606,883,7.97,0,35.3,847865,7225,843201,4.55,2.5,0.1293201133144476,0.85,99.45
2022-11-04,Kerala,69,0,66,560,3079,354,12.32,3,35.3,847934,7225,843267,8.72,1.0,0.01586402266288952,0.85,99.45
2022-11-05,Kerala,448,4,448,5787,3167,3166,7.74,0,35.3,848382,7229,843715,8.97,8.97,0.16393767705382437,0.85,99.45
2022-11-06,Kerala,145,1,141,1994,4616,1002,7.27,3,35.3,848527,7230,843856,13.08,2.84,0.05648725212464589,0.85,99.45
2022-11-07,Kerala,948,9,941,11696,4904,4668,8.11,0,35.3,849475,7239,844797,13.89,13.22,0.3313314447592068,0.85,99.45
2022-11-08,Kerala,779,6,775,9697,3388,967,8.03,0,35.3,850254,7245,845572,9.6,2.74,0.27470254957507084,0.85,99.45
2022-11-09,Kerala,977,8,973,12169,1663,1163,8.03,0,35.3,851231,7253,846545,4.71,3.29,0.34473087818696885,0.85,99.45
2022-11-10,Kerala,1160,5,1159,14429,2642,1419,8.04,0,35.3,852391,7258,847704,7.48,4.02,0.40875354107648726,0.85,99.45
2022-11-11,Kerala,1496,14,1489,18538,4014,335,8.07,0,35.3,853887,7272,849193,11.37,0.95,0.5251558073654391,0.85,99.45
2022-11-12,Kerala,1329,10,1328,16669,4356,3624,7.97,0,35.3,855216,7282,850521,12.34,10.27,0.4722096317280453,0.85,99.45
2022-11-13,Kerala,1408,17,1406,17731,2514,2143,7.94,0,35.3,856624,7299,851927,7.12,6.07,0.5022946175637394,0.85,99.45
2022-11-14,Kerala,356,1,354,4554,2003,1396,7.82,1,35.3,856980,7300,852281,5.67,3.95,0.12900849858356941,0.85,99.45
2022-11-15,Kerala,598,7,595,7323,2564,595,8.17,0,35.3,857578,7307,852876,7.26,1.69,0.20745042492917848,0.85,99.45
2022-11-16,Kerala,325,2,323,4275,1961,938,7.6,0,35.3,857903,7309,853199,5.56,2.66,0.12110481586402266,0.85,99.45
2022-11-17,Kerala,1506,20,1504,19073,2136,536,7.9,0,35.3,859409,7329,854703,6.05,1.52,0.5403116147308782,0.85,99.45
2022-11-18,Kerala,18,0,11,538,1484,549,3.35,7,35.3,859427,7329,854714,4.2,1.56,0.015240793201133144,0.85,99.45
2022-11-19,Kerala,625,4,619,8284,535,225,7.54,2,35.3,860052,7333,855333,1.52,0.64,0.2346742209631728,0.85,99.45
2022-11-20,Kerala,859,11,853,10688,1016,106,8.04,0,35.3,860911,7344,856186,2.88,0.3,0.3027762039660057,0.85,99.45
2022-11-21,Kerala,1121,11,1115,13991,4818,2901,8.01,0,35.3,862032,7355,857301,13.65,8.22,0.3963456090651558,0.85,99.45
2022-11-22,Kerala,717,8,709,9286,3115,398,7.72,0,35.3,862749,7363,858010,8.82,1.13,0.26305949008498586,0.85,99.45
2022-11-23,Kerala,578,3,571,7413,4696,4379,7.8,4,35.3,863327,7366,858581,13.3,12.41,0.21,0.85,99.45
2022-11-24,Kerala,271,3,267,3707,3056,1193,7.31,1,35.3,863598,7369,858848,8.66,3.38,0.10501416430594901,0.85,99.45
2022-11-25,Kerala,44,0,43,828,2337,1434,5.31,1,35.3,863642,7369,858891,6.62,4.06,0.023456090651558074,0.85,99.45
2022-11-26,Kerala,327,3,318,4164,3899,2180,7.85,6,35.3,863969,7372,859209,11.05,6.18,0.11796033994334278,0.85,99.45
2022-11-27,Kerala,1557,17,1548,19430,3438,430,8.01,0,35.3,865526,7389,860757,9.74,1.22,0.5504249291784703,0.85,99.45
2022-11-28,Kerala,1032,8,1028,12913,3082,294,7.99,0,35.3,866558,7397,861785,8.73,0.83,0.3658073654390935,0.85,99.45
2022-11-29,Kerala,1285,4,1283,15850,3461,2857,8.11,0,35.3,867843,7401,863068,9.8,8.09,0.4490084985835694,0.85,99.45
2022-11-30,Kerala,850,4,847,10603,3061,3061,8.02,0,35.3,868693,7405,863915,8.67,8.67,0.30036827195467425,0.85,99.45
2022-12-01,Kerala,805,6,799,10271,4013,3823,7.84,0,35.3,869498,7411,864714,11.37,10.83,0.2909631728045326,0.85,99.45
2022-12-02,Kerala,737,3,734,8558,3269,1825,8.61,0,35.3,870235,7414,865448,9.26,5.17,0.24243626062322945,0.85,99.45
2022-12-03,Kerala,611,7,608,7888,945,718,7.75,0,35.3,870846,7421,866056,2.68,2.03,0.22345609065155808,0.85,99.45
2022-12-04,Kerala,1285,10,1276,15739,1823,1282,8.16,0,35.3,872131,7431,867332,5.16,3.63,0.4458640226628895,0.85,99.45
2022-12-05,Kerala,1324,15,1316,16495,4937,4303,8.03,0,35.3,873455,7446,868648,13.99,12.19,0.4672804532577904,0.85,99.45
2022-12-06,Kerala,954,5,954,12179,508,464,7.83,0,35.3,874409,7451,869602,1.44,1.31,0.345014164305949,0.85,99.45
2022-12-07,Kerala,834,5,829,10435,417,239,7.99,0,35.3,875243,7456,870431,1.18,0.68,0.29560906515580737,0.85,99.45
2022-12-08,Kerala,67,0,60,1275,386,27,5.25,7,35.3,875310,7456,870491,1.09,0.08,0.03611898016997167,0.85,99.45
2022-12-09,Kerala,1220,5,1214,15340,4426,1172,7.95,1,35.3,876530,7461,871705,12.54,3.32,0.4345609065155807,0.85,99.45
2022-12-10,Kerala,298,1,298,3704,393,37,8.05,0,35.3,876828,7462,872003,1.11,0.1,0.10492917847025496,0.85,99.45
2022-12-11,Kerala,1157,4,1151,14465,2698,910,8.0,2,35.3,877985,7466,873154,7.64,2.58,0.4097733711048159,0.85,99.45
2022-12-12,Kerala,1036,14,1029,12931,3190,1131,8.01,0,35.3,879021,7480,874183,9.04,3.2,0.3663172804532578,0.85,99.45
2022-12-13,Kerala,1535,5,1533,18762,4209,3976,8.18,0,35.3,880556,7485,875716,11.92,11.26,0.5315014164305949,0.85,99.45
2022-12-14,Kerala,80,0,73,1021,3756,3444,7.84,7,35.3,880636,7485,875789,10.64,9.76,0.028923512747875354,0.85,99.45
2022-12-15,Kerala,351,1,350,4326,1411,343,8.11,0,35.3,880987,7486,876139,4.0,0.97,0.12254957507082152,0.85,99.45
2022-12-16,Kerala,300,2,291,3853,1624,461,7.79,7,35.3,881287,7488,876430,4.6,1.31,0.10915014164305949,0.85,99.45
2022-12-17,Kerala,240,1,235,3156,2429,320,7.6,4,35.3,881527,7489,876665,6.88,0.91,0.08940509915014164,0.85,99.45
2022-12-18,Kerala,609,5,609,8250,165,130,7.38,0,35.3,882136,7494,877274,0.47,0.37,0.23371104815864022,0.85,99.45
2022-12-19,Kerala,841,10,839,10705,4093,3144,7.86,0,35.3,882977,7504,878113,11.59,8.91,0.30325779036827194,0.85,99.45
2022-12-20,Kerala,60,0,57,844,846,255,7.11,3,35.3,883037,7504,878170,2.4,0.72,0.023909348441926347,0.85,99.45
2022-12-21,Kerala,1237,13,1232,15414,1510,581,8.03,0,35.3,884274,7517,879402,4.28,1.65,0.436657223796034,0.85,99.45
2022-12-22,Kerala,830,3,824,10087,878,473,8.23,3,35.3,885104,7520,880226,2.49,1.34,0.28575070821529747,0.85,99.45
2022-12-23,Kerala,1161,8,1159,14518,523,69,8.0,0,35.3,886265,7528,881385,1.48,0.2,0.41127478753541075,0.85,99.45
2022-12-24,Kerala,1315,12,1315,16180,4857,412,8.13,0,35.3,887580,7540,882700,13.76,1.17,0.458356940509915,0.85,99.45
2022-12-25,Kerala,787,9,781,9817,1983,538,8.02,0,35.3,888367,7549,883481,5.62,1.52,0.27810198300283284,0.85,99.45
2022-12-26,Kerala,1200,9,1198,14682,3077,2723,8.17,0,35.3,889567,7558,884679,8.72,7.71,0.4159206798866856,0.85,99.45
2022-12-27,Kerala,1444,17,1444,18253,415,346,7.91,0,35.3,891011,7575,886123,1.18,0.98,0.5170821529745042,0.85,99.45
2022-12-28,Kerala,115,1,113,1006,1783,798,11.43,1,35.3,891126,7576,886236,5.05,2.26,0.0284985835694051,0.85,99.45
2022-12-29,Kerala,882,8,874,11014,4561,2878,8.01,0,35.3,892008,7584,887110,12.92,8.15,0.31201133144475923,0.85,99.45
2022-12-30,Kerala,267,3,266,3399,3328,1507,7.86,0,35.3,892275,7587,887376,9.43,4.27,0.09628895184135977,0.85,99.45
2022-12-31,Kerala,1116,10,1115,14061,774,739,7.94,0,35.3,893391,7597,888491,2.19,2.09,0.398328611898017,0.85,99.45
2020-01-01,Madhya Pradesh,290,1,288,3792,3268,1219,7.65,1,87.0,290,1,288,3.76,1.4,0.043586206896551724,0.34,99.31
2020-01-02,Madhya Pradesh,809,9,805,10146,2677,687,7.97,0,87.0,1099,10,1093,3.08,0.79,0.11662068965517242,0.91,99.45
2020-01-03,Madhya Pradesh,1476,9,1472,18096,4356,815,8.16,0,87.0,2575,19,2565,5.01,0.94,0.208,0.74,99.61
2020-01-04,Madhya Pradesh,1118,8,1111,13538,4774,1228,8.26,0,87.0,3693,27,3676,5.49,1.41,0.15560919540229884,0.73,99.54
2020-01-05,Madhya Pradesh,1594,18,1593,19715,132,67,8.09,0,87.0,5287,45,5269,0.15,0.08,0.22660919540229885,0.85,99.66
2020-01-06,Madhya Pradesh,1336,8,1330,16612,2223,680,8.04,0,87.0,6623,53,6599,2.56,0.78,0.1909425287356322,0.8,99.64
2020-01-07,Madhya Pradesh,1031,14,1024,12655,4499,430,8.15,0,87.0,7654,67,7623,5.17,0.49,0.14545977011494252,0.88,99.59
2020-01-08,Madhya Pradesh,415,3,413,5336,775,230,7.78,0,87.0,8069,70,8036,0.89,0.26,0.06133333333333333,0.87,99.59
2020-01-09,Madhya Pradesh,1314,14,1314,16448,309,154,7.99,0,87.0,9383,84,9350,0.36,0.18,0.1890574712643678,0.9,99.65
2020-01-10,Madhya Pradesh,1260,13,1260,15822,641,149,7.96,0,87.0,10643,97,10610,0.74,0.17,0.18186206896551724,0.91,99.69
2020-01-11,Madhya Pradesh,1478,15,1471,18403,4212,3369,8.03,0,87.0,12121,112,12081,4.84,3.87,0.2115287356321839,0.92,99.67
2020-01-12,Madhya Pradesh,739,7,733,9293,3521,956,7.95,0,87.0,12860,119,12814,4.05,1.1,0.10681609195402299,0.93,99.64
2020-01-13,Madhya Pradesh,253,0,244,3162,1514,688,8.0,9,87.0,13113,119,13058,1.74,0.79,0.0363448275862069,0.91,99.58
2020-01-14,Madhya Pradesh,670,3,666,8101,3175,103,8.27,1,87.0,13783,122,13724,3.65,0.12,0.09311494252873563,0.89,99.57
2020-01-15,Madhya Pradesh,702,8,701,8705,3654,3282,8.06,0,87.0,14485,130,14425,4.2,3.77,0.10005747126436781,0.9,99.59
2020-01-16,Madhya Pradesh,1563,13,1554,18981,4202,1469,8.23,0,87.0,16048,143,15979,4.83,1.69,0.21817241379310345,0.89,99.57
2020-01-17,Madhya Pradesh,574,4,565,6917,1526,739,8.3,5,87.0,16622,147,16544,1.75,0.85,0.07950574712643678,0.88,99.53
2020-01-18,Madhya Pradesh,292,3,285,3524,1459,826,8.29,4,87.0,16914,150,16829,1.68,0.95,0.04050574712643678,0.89,99.5
2020-01-19,Madhya Pradesh,997,7,996,12352,3770,1203,8.07,0,87.0,17911,157,17825,4.33,1.38,0.14197701149425287,0.88,99.52
2020-01-20,Madhya Pradesh,108,1,107,1428,3927,173,7.56,0,87.0,18019,158,17932,4.51,0.2,0.016413793103448277,0.88,99.52
2020-01-21,Madhya Pradesh,127,1,125,1199,4046,3308,10.59,1,87.0,18146,159,18057,4.65,3.8,0.013781609195402299,0.88,99.51
2020-01-22,Madhya Pradesh,407,1,402,4777,1216,680,8.52,4,87.0,18553,160,18459,1.4,0.78,0.054908045977011495,0.86,99.49
2020-01-23,Madhya Pradesh,831,3,829,10170,1360,129,8.17,0,87.0,19384,163,19288,1.56,0.15,0.11689655172413793,0.84,99.5
2020-01-24,Madhya Pradesh,144,1,137,2198,143,94,6.55,6,87.0,19528,164,19425,0.16,0.11,0.025264367816091954,0.84,99.47
2020-01-25,Madhya Pradesh,1330,12,1327,16696,2841,42,7.97,0,87.0,20858,176,20752,3.27,0.05,0.1919080459770115,0.84,99.49
2020-01-26,Madhya Pradesh,538,7,536,6537,1661,526,8.23,0,87.0,21396,183,21288,1.91,0.6,0.07513793103448276,0.86,99.5
2020-01-27,Madhya Pradesh,362,1,355,4746,1152,450,7.63,6,87.0,21758,184,21643,1.32,0.52,0.05455172413793104,0.85,99.47
2020-01-28,Madhya Pradesh,1319,13,1317,16832,3851,2719,7.84,0,87.0,23077,197,22960,4.43,3.13,0.1934712643678161,0.85,99.49
2020-01-29,Madhya Pradesh,1543,20,1541,19583,3231,1219,7.88,0,87.0,24620,217,24501,3.71,1.4,0.2250919540229885,0.88,99.52
2020-01-30,Madhya Pradesh,180,1,176,2440,1840,1810,7.38,3,87.0,24800,218,24677,2.11,2.08,0.028045977011494253,0.88,99.5
2020-01-31,Madhya Pradesh,1052,15,1047,12961,4126,3754,8.12,0,87.0,25852,233,25724,4.74,4.31,0.14897701149425288,0.9,99.5
2020-02-01,Madhya Pradesh,1089,10,1085,13411,832,334,8.12,0,87.0,26941,243,26809,0.96,0.38,0.1541494252873563,0.9,99.51
2020-02-02,Madhya Pradesh,502,1,502,5793,899,96,8.67,0,87.0,27443,244,27311,1.03,0.11,0.06658620689655173,0.89,99.52
2020-02-03,Madhya Pradesh,1345,11,1339,17169,116,41,7.83,0,87.0,28788,255,28650,0.13,0.05,0.1973448275862069,0.89,99.52
2020-02-04,Madhya Pradesh,319,3,312,3704,1971,1635,8.61,4,87.0,29107,258,28962,2.27,1.88,0.04257471264367816,0.89,99.5
2020-02-05,Madhya Pradesh,773,8,764,9816,468,121,7.87,1,87.0,29880,266,29726,0.54,0.14,0.11282758620689655,0.89,99.48
2020-02-06,Madhya Pradesh,274,3,269,3507,2016,124,7.81,2,87.0,30154,269,29995,2.32,0.14,0.040310344827586206,0.89,99.47
2020-02-07,Madhya Pradesh,1157,3,1151,14189,4303,3748,8.15,3,87.0,31311,272,31146,4.95,4.31,0.1630919540229885,0.87,99.47
2020-02-08,Madhya Pradesh,1217,12,1208,15089,84,72,8.07,0,87.0,32528,284,32354,0.1,0.08,0.1734367816091954,0.87,99.47
2020-02-09,Madhya Pradesh,819,4,811,10092,3145,2933,8.12,4,87.0,33347,288,33165,3.61,3.37,0.116,0.86,99.45
2020-02-10,Madhya Pradesh,56,0,48,591,1227,681,9.48,8,87.0,33403,288,33213,1.41,0.78,0.006793103448275862,0.86,99.43
2020-02-11,Madhya Pradesh,1182,9,1178,14573,407,209,8.11,0,87.0,34585,297,34391,0.47,0.24,0.1675057471264368,0.86,99.44
2020-02-12,Madhya Pradesh,1227,12,1224,15070,4001,3531,8.14,0,87.0,35812,309,35615,4.6,4.06,0.1732183908045977,0.86,99.45
2020-02-13,Madhya Pradesh,315,1,314,4157,984,176,7.58,0,87.0,36127,310,35929,1.13,0.2,0.0477816091954023,0.86,99.45
2020-02-14,Madhya Pradesh,1159,5,1158,14617,1821,1120,7.93,0,87.0,37286,315,37087,2.09,1.29,0.16801149425287357,0.84,99.47
2020-02-15,Madhya Pradesh,1010,12,1010,12676,114,16,7.97,0,87.0,38296,327,38097,0.13,0.02,0.14570114942528736,0.85,99.48
2020-02-16,Madhya Pradesh,1461,21,1460,18491,2694,2051,7.9,0,87.0,39757,348,39557,3.1,2.36,0.21254022988505747,0.88,99.5
2020-02-17,Madhya Pradesh,356,3,348,4454,4301,111,7.99,5,87.0,40113,351,39905,4.94,0.13,0.05119540229885058,0.88,99.48
2020-02-18,Madhya Pradesh,1523,16,1516,18958,3113,2052,8.03,0,87.0,41636,367,41421,3.58,2.36,0.2179080459770115,0.88,99.48
2020-02-19,Madhya Pradesh,912,3,908,11232,3701,842,8.12,1,87.0,42548,370,42329,4.25,0.97,0.12910344827586206,0.87,99.49
2020-02-20,Madhya Pradesh,1136,9,1130,14642,2362,144,7.76,0,87.0,43684,379,43459,2.71,0.17,0.16829885057471264,0.87,99.48
2020-02-21,Madhya Pradesh,255,3,251,2773,3721,1201,9.2,1,87.0,43939,382,43710,4.28,1.38,0.031873563218390806,0.87,99.48
2020-02-22,Madhya Pradesh,1196,9,1192,15369,2905,2771,7.78,0,87.0,45135,391,44902,3.34,3.19,0.1766551724137931,0.87,99.48
2020-02-23,Madhya Pradesh,969,14,968,11990,2738,1326,8.08,0,87.0,46104,405,45870,3.15,1.52,0.137816091954023,0.88,99.49
2020-02-24,Madhya Pradesh,220,2,220,2626,1731,653,8.38,0,87.0,46324,407,46090,1.99,0.75,0.030183908045977013,0.88,99.49
2020-02-25,Madhya Pradesh,482,6,477,6235,504,40,7.73,0,87.0,46806,413,46567,0.58,0.05,0.07166666666666667,0.88,99.49
2020-02-26,Madhya Pradesh,1458,7,1457,18528,1647,1637,7.87,0,87.0,48264,420,48024,1.89,1.88,0.2129655172413793,0.87,99.5
2020-02-27,Madhya Pradesh,986,5,982,12355,3803,779,7.98,0,87.0,49250,425,49006,4.37,0.9,0.14201149425287357,0.86,99.5
2020-02-28,Madhya Pradesh,492,3,491,6286,2578,2434,7.83,0,87.0,49742,428,49497,2.96,2.8,0.0722528735632184,0.86,99.51
2020-02-29,Madhya Pradesh,344,3,337,4241,3457,1235,8.11,4,87.0,50086,431,49834,3.97,1.42,0.04874712643678161,0.86,99.5
2020-03-01,Madhya Pradesh,836,9,835,10756,1613,378,7.77,0,87.0,50922,440,50669,1.85,0.43,0.12363218390804598,0.86,99.5
2020-03-02,Madhya Pradesh,249,3,248,2813,4053,751,8.85,0,87.0,51171,443,50917,4.66,0.86,0.03233333333333333,0.87,99.5
2020-03-03,Madhya Pradesh,1307,13,1299,16637,1450,813,7.86,0,87.0,52478,456,52216,1.67,0.93,0.19122988505747127,0.87,99.5
2020-03-04,Madhya Pradesh,1179,7,1175,14362,3402,2526,8.21,0,87.0,53657,463,53391,3.91,2.9,0.16508045977011493,0.86,99.5
2020-03-05,Madhya Pradesh,1597,22,1596,19808,2013,1615,8.06,0,87.0,55254,485,54987,2.31,1.86,0.22767816091954024,0.88,99.52
2020-03-06,Madhya Pradesh,990,14,982,12564,4834,4328,7.88,0,87.0,56244,499,55969,5.56,4.97,0.14441379310344826,0.89,99.51
2020-03-07,Madhya Pradesh,289,1,281,3339,2050,1714,8.66,7,87.0,56533,500,56250,2.36,1.97,0.03837931034482758,0.88,99.5
2020-03-08,Madhya Pradesh,1478,21,1476,18319,1811,286,8.07,0,87.0,58011,521,57726,2.08,0.33,0.2105632183908046,0.9,99.51
2020-03-09,Madhya Pradesh,347,4,338,4571,3658,1911,7.59,5,87.0,58358,525,58064,4.2,2.2,0.05254022988505747,0.9,99.5
2020-03-10,Madhya Pradesh,304,2,303,3628,248,192,8.38,0,87.0,58662,527,58367,0.29,0.22,0.041701149425287354,0.9,99.5
2020-03-11,Madhya Pradesh,730,3,721,9496,113,57,7.69,6,87.0,59392,530,59088,0.13,0.07,0.10914942528735633,0.89,99.49
2020-03-12,Madhya Pradesh,778,4,774,9680,2965,1932,8.04,0,87.0,60170,534,59862,3.41,2.22,0.11126436781609196,0.89,99.49
2020-03-13,Madhya Pradesh,920,6,915,11237,3246,448,8.19,0,87.0,61090,540,60777,3.73,0.51,0.12916091954022987,0.88,99.49
2020-03-14,Madhya Pradesh,1018,8,1015,12967,4418,2240,7.85,0,87.0,62108,548,61792,5.08,2.57,0.14904597701149425,0.88,99.49
2020-03-15,Madhya Pradesh,454,3,453,5810,1148,161,7.81,0,87.0,62562,551,62245,1.32,0.19,0.0667816091954023,0.88,99.49
2020-03-16,Madhya Pradesh,625,4,623,7787,1267,550,8.03,0,87.0,63187,555,62868,1.46,0.63,0.08950574712643679,0.88,99.5
2020-03-17,Madhya Pradesh,1440,15,1437,17915,507,365,8.04,0,87.0,64627,570,64305,0.58,0.42,0.20591954022988507,0.88,99.5
2020-03-18,Madhya Pradesh,139,1,133,1860,3221,999,7.47,5,87.0,64766,571,64438,3.7,1.15,0.021379310344827585,0.88,99.49
2020-03-19,Madhya Pradesh,267,3,260,3105,1954,1588,8.6,4,87.0,65033,574,64698,2.25,1.83,0.03568965517241379,0.88,99.48
2020-03-20,Madhya Pradesh,1325,6,1320,16685,3955,2787,7.94,0,87.0,66358,580,66018,4.55,3.2,0.1917816091954023,0.87,99.49
2020-03-21,Madhya Pradesh,1423,10,1423,17662,1963,18,8.06,0,87.0,67781,590,67441,2.26,0.02,0.20301149425287357,0.87,99.5
2020-03-22,Madhya Pradesh,1238,12,1232,15326,2516,2501,8.08,0,87.0,69019,602,68673,2.89,2.87,0.1761609195402299,0.87,99.5
2020-03-23,Madhya Pradesh,1505,10,1498,19006,203,35,7.92,0,87.0,70524,612,70171,0.23,0.04,0.21845977011494253,0.87,99.5
2020-03-24,Madhya Pradesh,1292,17,1291,16266,4484,49,7.94,0,87.0,71816,629,71462,5.15,0.06,0.1869655172413793,0.88,99.51
2020-03-25,Madhya Pradesh,148,0,147,1982,2460,796,7.47,1,87.0,71964,629,71609,2.83,0.91,0.0227816091954023,0.87,99.51
2020-03-26,Madhya Pradesh,947,7,940,12166,1212,358,7.78,0,87.0,72911,636,72549,1.39,0.41,0.13983908045977012,0.87,99.5
2020-03-27,Madhya Pradesh,1275,6,1268,15684,2986,747,8.13,1,87.0,74186,642,73817,3.43,0.86,0.1802758620689655,0.87,99.5
2020-03-28,Madhya Pradesh,320,2,319,4429,4239,263,7.23,0,87.0,74506,644,74136,4.87,0.3,0.05090804597701149,0.86,99.5
2020-03-29,Madhya Pradesh,598,4,592,7187,2028,869,8.32,2,87.0,75104,648,74728,2.33,1.0,0.08260919540229886,0.86,99.5
2020-03-30,Madhya Pradesh,761,11,757,9935,2592,583,7.66,0,87.0,75865,659,75485,2.98,0.67,0.11419540229885057,0.87,99.5
2020-03-31,Madhya Pradesh,116,1,109,1589,1895,431,7.3,6,87.0,75981,660,75594,2.18,0.5,0.018264367816091955,0.87,99.49
2020-04-01,Madhya Pradesh,650,8,642,8052,2657,1731,8.07,0,87.0,76631,668,76236,3.05,1.99,0.09255172413793103,0.87,99.48
2020-04-02,Madhya Pradesh,1015,7,1012,12761,3248,3187,7.95,0,87.0,77646,675,77248,3.73,3.66,0.14667816091954022,0.87,99.49
2020-04-03,Madhya Pradesh,268,3,265,3484,4110,1410,7.69,0,87.0,77914,678,77513,4.72,1.62,0.04004597701149425,0.87,99.49
2020-04-04,Madhya Pradesh,1168,8,1161,14469,1888,1382,8.07,0,87.0,79082,686,78674,2.17,1.59,0.16631034482758622,0.87,99.48
2020-04-05,Madhya Pradesh,351,1,351,4308,4875,2767,8.15,0,87.0,79433,687,79025,5.6,3.18,0.049517241379310344,0.86,99.49
2020-04-06,Madhya Pradesh,538,3,529,6798,1215,1169,7.91,6,87.0,79971,690,79554,1.4,1.34,0.07813793103448276,0.86,99.48
2020-04-07,Madhya Pradesh,60,0,52,572,4074,2905,10.49,8,87.0,80031,690,79606,4.68,3.34,0.006574712643678161,0.86,99.47
2020-04-08,Madhya Pradesh,741,10,733,9280,3023,1181,7.98,0,87.0,80772,700,80339,3.47,1.36,0.10666666666666667,0.87,99.46
2020-04-09,Madhya Pradesh,1453,18,1445,18254,1580,132,7.96,0,87.0,82225,718,81784,1.82,0.15,0.20981609195402298,0.87,99.46
2020-04-10,Madhya Pradesh,420,5,418,5372,4119,917,7.82,0,87.0,82645,723,82202,4.73,1.05,0.06174712643678161,0.87,99.46
2020-04-11,Madhya Pradesh,1539,19,1533,19593,3371,2116,7.85,0,87.0,84184,742,83735,3.87,2.43,0.22520689655172413,0.88,99.47
2020-04-12,Madhya Pradesh,150,2,141,1932,689,269,7.76,7,87.0,84334,744,83876,0.79,0.31,0.02220689655172414,0.88,99.46
2020-04-13,Madhya Pradesh,1400,15,1396,17713,191,56,7.9,0,87.0,85734,759,85272,0.22,0.06,0.2035977011494253,0.89,99.46
2020-04-14,Madhya Pradesh,1295,8,1291,15899,4671,3405,8.15,0,87.0,87029,767,86563,5.37,3.91,0.18274712643678162,0.88,99.46
2020-04-15,Madhya Pradesh,1563,7,1559,19975,2789,2266,7.82,0,87.0,88592,774,88122,3.21,2.6,0.2295977011494253,0.87,99.47
2020-04-16,Madhya Pradesh,430,3,424,5212,4135,3720,8.25,3,87.0,89022,777,88546,4.75,4.28,0.05990804597701149,0.87,99.47
2020-04-17,Madhya Pradesh,222,2,217,2709,558,283,8.19,3,87.0,89244,779,88763,0.64,0.33,0.031137931034482758,0.87,99.46
2020-04-18,Madhya Pradesh,1557,16,1553,19963,4369,3560,7.8,0,87.0,90801,795,90316,5.02,4.09,0.22945977011494254,0.88,99.47
2020-04-19,Madhya Pradesh,919,6,919,11158,457,326,8.24,0,87.0,91720,801,91235,0.53,0.37,0.12825287356321838,0.87,99.47
2020-04-20,Madhya Pradesh,301,2,298,3584,478,4,8.4,1,87.0,92021,803,91533,0.55,0.0,0.041195402298850575,0.87,99.47
2020-04-21,Madhya Pradesh,1112,14,1108,13707,484,422,8.11,0,87.0,93133,817,92641,0.56,0.49,0.15755172413793103,0.88,99.47
2020-04-22,Madhya Pradesh,977,14,974,12222,3440,3085,7.99,0,87.0,94110,831,93615,3.95,3.55,0.14048275862068965,0.88,99.47
2020-04-23,Madhya Pradesh,1218,15,1210,14891,3626,983,8.18,0,87.0,95328,846,94825,4.17,1.13,0.17116091954022988,0.89,99.47
2020-04-24,Madhya Pradesh,1005,10,1002,12800,3332,1429,7.85,0,87.0,96333,856,95827,3.83,1.64,0.1471264367816092,0.89,99.47
2020-04-25,Madhya Pradesh,812,3,810,10006,159,80,8.12,0,87.0,97145,859,96637,0.18,0.09,0.11501149425287356,0.88,99.48
2020-04-26,Madhya Pradesh,79,0,72,1392,4042,3545,5.68,7,87.0,97224,859,96709,4.65,4.07,0.016,0.88,99.47
2020-04-27,Madhya Pradesh,263,1,255,3208,1630,1249,8.2,7,87.0,97487,860,96964,1.87,1.44,0.036873563218390804,0.88,99.46
2020-04-28,Madhya Pradesh,862,2,854,10894,3485,1840,7.91,6,87.0,98349,862,97818,4.01,2.11,0.1252183908045977,0.88,99.46
2020-04-29,Madhya Pradesh,741,5,737,9315,1407,182,7.95,0,87.0,99090,867,98555,1.62,0.21,0.10706896551724138,0.87,99.46
2020-04-30,Madhya Pradesh,328,1,328,3804,4635,118,8.62,0,87.0,99418,868,98883,5.33,0.14,0.04372413793103448,0.87,99.46
2020-05-01,Madhya Pradesh,1401,7,1396,17645,2598,542,7.94,0,87.0,100819,875,100279,2.99,0.62,0.20281609195402298,0.87,99.46
2020-05-02,Madhya Pradesh,1111,6,1105,13894,125,64,8.0,0,87.0,101930,881,101384,0.14,0.07,0.15970114942528735,0.86,99.46
2020-05-03,Madhya Pradesh,1365,14,1363,16713,2310,1674,8.17,0,87.0,103295,895,102747,2.66,1.92,0.19210344827586207,0.87,99.47
2020-05-04,Madhya Pradesh,1330,12,1324,16762,1818,1209,7.93,0,87.0,104625,907,104071,2.09,1.39,0.19266666666666668,0.87,99.47
2020-05-05,Madhya Pradesh,377,3,369,4772,2513,1932,7.9,5,87.0,105002,910,104440,2.89,2.22,0.05485057471264368,0.87,99.46
2020-05-06,Madhya Pradesh,1384,6,1382,16827,799,309,8.22,0,87.0,106386,916,105822,0.92,0.36,0.19341379310344828,0.86,99.47
2020-05-07,Madhya Pradesh,1123,15,1123,13966,2496,1225,8.04,0,87.0,107509,931,106945,2.87,1.41,0.1605287356321839,0.87,99.48
2020-05-08,Madhya Pradesh,842,10,840,10514,2558,1446,8.01,0,87.0,108351,941,107785,2.94,1.66,0.12085057471264368,0.87,99.48
2020-05-09,Madhya Pradesh,76,1,73,1298,2364,2132,5.86,2,87.0,108427,942,107858,2.72,2.45,0.014919540229885057,0.87,99.48
2020-05-10,Madhya Pradesh,258,2,254,2978,2508,1515,8.66,2,87.0,108685,944,108112,2.88,1.74,0.034229885057471265,0.87,99.47
2020-05-11,Madhya Pradesh,993,8,989,12561,697,387,7.91,0,87.0,109678,952,109101,0.8,0.44,0.1443793103448276,0.87,99.47
2020-05-12,Madhya Pradesh,167,1,158,2571,3921,1893,6.5,8,87.0,109845,953,109259,4.51,2.18,0.029551724137931036,0.87,99.47
2020-05-13,Madhya Pradesh,785,9,781,9810,4155,111,8.0,0,87.0,110630,962,110040,4.78,0.13,0.11275862068965517,0.87,99.47
2020-05-14,Madhya Pradesh,350,2,346,4659,3743,1377,7.51,2,87.0,110980,964,110386,4.3,1.58,0.05355172413793104,0.87,99.46
2020-05-15,Madhya Pradesh,1559,19,1554,19710,751,55,7.91,0,87.0,112539,983,111940,0.86,0.06,0.22655172413793104,0.87,99.47
2020-05-16,Madhya Pradesh,994,4,989,12508,4019,500,7.95,1,87.0,113533,987,112929,4.62,0.57,0.14377011494252873,0.87,99.47
2020-05-17,Madhya Pradesh,396,1,391,4804,3652,2588,8.24,4,87.0,113929,988,113320,4.2,2.97,0.0552183908045977,0.87,99.47
2020-05-18,Madhya Pradesh,702,7,694,8616,1454,288,8.15,1,87.0,114631,995,114014,1.67,0.33,0.09903448275862069,0.87,99.46
2020-05-19,Madhya Pradesh,1168,9,1166,14747,4212,1500,7.92,0,87.0,115799,1004,115180,4.84,1.72,0.1695057471264368,0.87,99.47
2020-05-20,Madhya Pradesh,741,10,733,9449,102,63,7.84,0,87.0,116540,1014,115913,0.12,0.07,0.10860919540229885,0.87,99.46
2020-05-21,Madhya Pradesh,1135,8,1127,14869,1380,177,7.63,0,87.0,117675,1022,117040,1.59,0.2,0.1709080459770115,0.87,99.46
2020-05-22,Madhya Pradesh,954,8,945,12119,2642,768,7.87,1,87.0,118629,1030,117985,3.04,0.88,0.13929885057471264,0.87,99.46
2020-05-23,Madhya Pradesh,529,1,525,6804,1124,849,7.77,3,87.0,119158,1031,118510,1.29,0.98,0.07820689655172414,0.87,99.46
2020-05-24,Madhya Pradesh,359,3,358,4089,3055,1052,8.78,0,87.0,119517,1034,118868,3.51,1.21,0.047,0.87,99.46
2020-05-25,Madhya Pradesh,1370,9,1365,17335,4006,2929,7.9,0,87.0,120887,1043,120233,4.6,3.37,0.19925287356321839,0.86,99.46
2020-05-26,Madhya Pradesh,1471,11,1469,18356,2572,1434,8.01,0,87.0,122358,1054,121702,2.96,1.65,0.21098850574712644,0.86,99.46
2020-05-27,Madhya Pradesh,552,7,545,6852,1951,1222,8.06,0,87.0,122910,1061,122247,2.24,1.4,0.07875862068965517,0.86,99.46
2020-05-28,Madhya Pradesh,768,10,762,9610,1814,1442,7.99,0,87.0,123678,1071,123009,2.09,1.66,0.11045977011494253,0.87,99.46
2020-05-29,Madhya Pradesh,1283,9,1277,16171,1500,1038,7.93,0,87.0,124961,1080,124286,1.72,1.19,0.1858735632183908,0.86,99.46
2020-05-30,Madhya Pradesh,699,4,693,8602,322,82,8.13,2,87.0,125660,1084,124979,0.37,0.09,0.0988735632183908,0.86,99.46
2020-05-31,Madhya Pradesh,648,3,646,8114,1878,1141,7.99,0,87.0,126308,1087,125625,2.16,1.31,0.09326436781609196,0.86,99.46
2020-06-01,Madhya Pradesh,1513,7,1506,19217,3142,2130,7.87,0,87.0,127821,1094,127131,3.61,2.45,0.22088505747126436,0.86,99.46
2020-06-02,Madhya Pradesh,547,7,546,6978,4012,3342,7.84,0,87.0,128368,1101,127677,4.61,3.84,0.08020689655172414,0.86,99.46
2020-06-03,Madhya Pradesh,1453,20,1445,18318,3706,1826,7.93,0,87.0,129821,1121,129122,4.26,2.1,0.21055172413793102,0.86,99.46
2020-06-04,Madhya Pradesh,189,0,189,2162,4135,3907,8.74,0,87.0,130010,1121,129311,4.75,4.49,0.024850574712643677,0.86,99.46
2020-06-05,Madhya Pradesh,103,0,98,1047,66,14,9.84,5,87.0,130113,1121,129409,0.08,0.02,0.01203448275862069,0.86,99.46
2020-06-06,Madhya Pradesh,398,5,397,5282,2223,1054,7.54,0,87.0,130511,1126,129806,2.56,1.21,0.06071264367816092,0.86,99.46
2020-06-07,Madhya Pradesh,799,10,794,10167,575,11,7.86,0,87.0,131310,1136,130600,0.66,0.01,0.11686206896551724,0.87,99.46
2020-06-08,Madhya Pradesh,117,0,117,1808,2852,167,6.47,0,87.0,131427,1136,130717,3.28,0.19,0.020781609195402298,0.86,99.46
2020-06-09,Madhya Pradesh,1490,11,1488,18552,3638,205,8.03,0,87.0,132917,1147,132205,4.18,0.24,0.21324137931034481,0.86,99.46
2020-06-10,Madhya Pradesh,1008,3,1006,12959,1951,475,7.78,0,87.0,133925,1150,133211,2.24,0.55,0.14895402298850574,0.86,99.47
2020-06-11,Madhya Pradesh,815,4,809,10550,1527,835,7.73,2,87.0,134740,1154,134020,1.76,0.96,0.12126436781609196,0.86,99.47
2020-06-12,Madhya Pradesh,1102,14,1098,13829,1003,822,7.97,0,87.0,135842,1168,135118,1.15,0.94,0.15895402298850575,0.86,99.47
2020-06-13,Madhya Pradesh,87,0,86,1096,542,502,7.94,1,87.0,135929,1168,135204,0.62,0.58,0.012597701149425287,0.86,99.47
2020-06-14,Madhya Pradesh,1601,8,1601,19661,2802,1891,8.14,0,87.0,137530,1176,136805,3.22,2.17,0.22598850574712645,0.86,99.47
2020-06-15,Madhya Pradesh,660,9,657,7947,3632,3246,8.31,0,87.0,138190,1185,137462,4.17,3.73,0.09134482758620689,0.86,99.47
2020-06-16,Madhya Pradesh,1241,17,1241,15368,3803,2345,8.08,0,87.0,139431,1202,138703,4.37,2.7,0.17664367816091955,0.86,99.48
2020-06-17,Madhya Pradesh,1333,19,1332,16975,4577,2176,7.85,0,87.0,140764,1221,140035,5.26,2.5,0.19511494252873562,0.87,99.48
2020-06-18,Madhya Pradesh,1273,13,1267,16127,2254,721,7.89,0,87.0,142037,1234,141302,2.59,0.83,0.18536781609195402,0.87,99.48
2020-06-19,Madhya Pradesh,808,8,800,10062,2108,1168,8.03,0,87.0,142845,1242,142102,2.42,1.34,0.1156551724137931,0.87,99.48
2020-06-20,Madhya Pradesh,521,3,512,6553,2790,371,7.95,6,87.0,143366,1245,142614,3.21,0.43,0.07532183908045977,0.87,99.48
2020-06-21,Madhya Pradesh,654,9,649,8079,3286,2247,8.1,0,87.0,144020,1254,143263,3.78,2.58,0.09286206896551724,0.87,99.47
2020-06-22,Madhya Pradesh,720,6,715,9183,2289,489,7.84,0,87.0,144740,1260,143978,2.63,0.56,0.10555172413793104,0.87,99.47
2020-06-23,Madhya Pradesh,1560,8,1552,19207,2008,223,8.12,0,87.0,146300,1268,145530,2.31,0.26,0.22077011494252874,0.87,99.47
2020-06-24,Madhya Pradesh,545,2,545,6042,2161,1232,9.02,0,87.0,146845,1270,146075,2.48,1.42,0.06944827586206896,0.86,99.48
2020-06-25,Madhya Pradesh,818,4,809,10276,2358,2273,7.96,5,87.0,147663,1274,146884,2.71,2.61,0.11811494252873563,0.86,99.47
2020-06-26,Madhya Pradesh,154,2,151,2146,552,316,7.18,1,87.0,147817,1276,147035,0.63,0.36,0.024666666666666667,0.86,99.47
2020-06-27,Madhya Pradesh,1269,7,1264,16033,4579,2400,7.91,0,87.0,149086,1283,148299,5.26,2.76,0.18428735632183907,0.86,99.47
2020-06-28,Madhya Pradesh,68,0,67,792,2972,1117,8.59,1,87.0,149154,1283,148366,3.42,1.28,0.00910344827586207,0.86,99.47
2020-06-29,Madhya Pradesh,747,2,747,9127,1308,970,8.18,0,87.0,149901,1285,149113,1.5,1.11,0.10490804597701149,0.86,99.47
2020-06-30,Madhya Pradesh,189,1,181,2624,1376,371,7.2,7,87.0,150090,1286,149294,1.58,0.43,0.030160919540229886,0.86,99.47
2020-07-01,Madhya Pradesh,480,3,475,5808,4545,4462,8.26,2,87.0,150570,1289,149769,5.22,5.13,0.06675862068965517,0.86,99.47
2020-07-02,Madhya Pradesh,69,0,67,637,139,30,10.83,2,87.0,150639,1289,149836,0.16,0.03,0.00732183908045977,0.86,99.47
2020-07-03,Madhya Pradesh,161,1,154,2274,1437,515,7.08,6,87.0,150800,1290,149990,1.65,0.59,0.02613793103448276,0.86,99.46
2020-07-04,Madhya Pradesh,1415,10,1406,17519,3186,2603,8.08,0,87.0,152215,1300,151396,3.66,2.99,0.20136781609195403,0.85,99.46
2020-07-05,Madhya Pradesh,405,3,400,4994,212,91,8.11,2,87.0,152620,1303,151796,0.24,0.1,0.05740229885057471,0.85,99.46
2020-07-06,Madhya Pradesh,167,2,162,2415,2877,2447,6.92,3,87.0,152787,1305,151958,3.31,2.81,0.02775862068965517,0.85,99.46
2020-07-07,Madhya Pradesh,1525,20,1524,19339,1560,1551,7.89,0,87.0,154312,1325,153482,1.79,1.78,0.22228735632183907,0.86,99.46
2020-07-08,Madhya Pradesh,326,4,323,3946,211,17,8.26,0,87.0,154638,1329,153805,0.24,0.02,0.04535632183908046,0.86,99.46
2020-07-09,Madhya Pradesh,1159,14,1152,14302,1031,632,8.1,0,87.0,155797,1343,154957,1.19,0.73,0.16439080459770114,0.86,99.46
2020-07-10,Madhya Pradesh,1339,11,1331,16757,2663,1489,7.99,0,87.0,157136,1354,156288,3.06,1.71,0.19260919540229884,0.86,99.46
2020-07-11,Madhya Pradesh,1192,8,1188,15090,4562,1220,7.9,0,87.0,158328,1362,157476,5.24,1.4,0.17344827586206896,0.86,99.46
2020-07-12,Madhya Pradesh,537,3,532,6584,1401,439,8.16,2,87.0,158865,1365,158008,1.61,0.5,0.07567816091954023,0.86,99.46
2020-07-13,Madhya Pradesh,1349,16,1347,16703,900,704,8.08,0,87.0,160214,1381,159355,1.03,0.81,0.19198850574712645,0.86,99.46
2020-07-14,Madhya Pradesh,504,1,502,5894,2976,1269,8.55,1,87.0,160718,1382,159857,3.42,1.46,0.06774712643678162,0.86,99.46
2020-07-15,Madhya Pradesh,320,2,311,4082,864,609,7.84,7,87.0,161038,1384,160168,0.99,0.7,0.04691954022988506,0.86,99.46
2020-07-16,Madhya Pradesh,733,9,728,9407,4855,61,7.79,0,87.0,161771,1393,160896,5.58,0.07,0.1081264367816092,0.86,99.46
2020-07-17,Madhya Pradesh,796,5,795,9835,2757,1618,8.09,0,87.0,162567,1398,161691,3.17,1.86,0.11304597701149426,0.86,99.46
2020-07-18,Madhya Pradesh,237,1,229,2895,746,475,8.19,7,87.0,162804,1399,161920,0.86,0.55,0.03327586206896552,0.86,99.46
2020-07-19,Madhya Pradesh,1245,4,1242,15386,1002,703,8.09,0,87.0,164049,1403,163162,1.15,0.81,0.17685057471264368,0.86,99.46
2020-07-20,Madhya Pradesh,1026,15,1019,13163,3062,2101,7.79,0,87.0,165075,1418,164181,3.52,2.41,0.15129885057471265,0.86,99.46
2020-07-21,Madhya Pradesh,84,1,83,960,4933,1390,8.75,0,87.0,165159,1419,164264,5.67,1.6,0.011034482758620689,0.86,99.46
2020-07-22,Madhya Pradesh,427,3,423,4915,1356,144,8.69,1,87.0,165586,1422,164687,1.56,0.17,0.05649425287356322,0.86,99.46
2020-07-23,Madhya Pradesh,602,2,598,7576,2613,411,7.95,2,87.0,166188,1424,165285,3.0,0.47,0.08708045977011494,0.86,99.46
2020-07-24,Madhya Pradesh,926,11,923,11657,565,355,7.94,0,87.0,167114,1435,166208,0.65,0.41,0.13398850574712642,0.86,99.46
2020-07-25,Madhya Pradesh,119,1,116,1872,368,368,6.36,2,87.0,167233,1436,166324,0.42,0.42,0.021517241379310346,0.86,99.46
2020-07-26,Madhya Pradesh,415,5,407,4976,3493,339,8.34,3,87.0,167648,1441,166731,4.01,0.39,0.057195402298850576,0.86,99.45
2020-07-27,Madhya Pradesh,1315,13,1309,16721,2598,715,7.86,0,87.0,168963,1454,168040,2.99,0.82,0.19219540229885057,0.86,99.45
2020-07-28,Madhya Pradesh,832,9,827,10294,4260,1833,8.08,0,87.0,169795,1463,168867,4.9,2.11,0.11832183908045978,0.86,99.45
2020-07-29,Madhya Pradesh,1353,15,1348,17269,1298,1193,7.83,0,87.0,171148,1478,170215,1.49,1.37,0.19849425287356323,0.86,99.45
2020-07-30,Madhya Pradesh,767,8,764,9559,2863,2609,8.02,0,87.0,171915,1486,170979,3.29,3.0,0.1098735632183908,0.86,99.46
2020-07-31,Madhya Pradesh,1364,19,1363,16952,2479,1419,8.05,0,87.0,173279,1505,172342,2.85,1.63,0.19485057471264366,0.87,99.46
2020-08-01,Madhya Pradesh,1576,8,1567,19652,3664,2347,8.02,1,87.0,174855,1513,173909,4.21,2.7,0.22588505747126436,0.87,99.46
2020-08-02,Madhya Pradesh,986,13,978,12028,1424,318,8.2,0,87.0,175841,1526,174887,1.64,0.37,0.1382528735632184,0.87,99.46
2020-08-03,Madhya Pradesh,209,1,203,2486,2656,796,8.41,5,87.0,176050,1527,175090,3.05,0.91,0.02857471264367816,0.87,99.45
2020-08-04,Madhya Pradesh,473,6,473,5534,3915,3786,8.55,0,87.0,176523,1533,175563,4.5,4.35,0.06360919540229885,0.87,99.46
2020-08-05,Madhya Pradesh,587,6,581,7998,1416,1352,7.34,0,87.0,177110,1539,176144,1.63,1.55,0.09193103448275862,0.87,99.45
2020-08-06,Madhya Pradesh,608,3,606,7479,2573,530,8.13,0,87.0,177718,1542,176750,2.96,0.61,0.08596551724137931,0.87,99.46
2020-08-07,Madhya Pradesh,576,6,574,7088,3508,38,8.13,0,87.0,178294,1548,177324,4.03,0.04,0.0814712643678161,0.87,99.46
2020-08-08,Madhya Pradesh,237,1,234,3041,690,333,7.79,2,87.0,178531,1549,177558,0.79,0.38,0.034954022988505744,0.87,99.45
2020-08-09,Madhya Pradesh,1071,12,1064,13272,26,18,8.07,0,87.0,179602,1561,178622,0.03,0.02,0.15255172413793103,0.87,99.45
2020-08-10,Madhya Pradesh,1315,12,1312,16526,4286,4105,7.96,0,87.0,180917,1573,179934,4.93,4.72,0.18995402298850575,0.87,99.46
2020-08-11,Madhya Pradesh,606,3,604,7541,4422,3256,8.04,0,87.0,181523,1576,180538,5.08,3.74,0.08667816091954023,0.87,99.46
2020-08-12,Madhya Pradesh,1468,21,1466,18591,2596,777,7.9,0,87.0,182991,1597,182004,2.98,0.89,0.21368965517241378,0.87,99.46
2020-08-13,Madhya Pradesh,1086,15,1080,13800,885,64,7.87,0,87.0,184077,1612,183084,1.02,0.07,0.15862068965517243,0.88,99.46
2020-08-14,Madhya Pradesh,1485,8,1483,18628,3381,446,7.97,0,87.0,185562,1620,184567,3.89,0.51,0.21411494252873564,0.87,99.46
2020-08-15,Madhya Pradesh,946,12,944,11742,3190,2198,8.06,0,87.0,186508,1632,185511,3.67,2.53,0.1349655172413793,0.88,99.47
2020-08-16,Madhya Pradesh,1284,5,1284,15985,2427,56,8.03,0,87.0,187792,1637,186795,2.79,0.06,0.18373563218390804,0.87,99.47
2020-08-17,Madhya Pradesh,796,7,795,10024,1658,838,7.94,0,87.0,188588,1644,187590,1.91,0.96,0.1152183908045977,0.87,99.47
2020-08-18,Madhya Pradesh,1231,11,1222,15026,4762,3999,8.19,0,87.0,189819,1655,188812,5.47,4.6,0.17271264367816092,0.87,99.47
2020-08-19,Madhya Pradesh,697,3,690,9159,2732,564,7.61,4,87.0,190516,1658,189502,3.14,0.65,0.10527586206896551,0.87,99.47
2020-08-20,Madhya Pradesh,636,8,634,7699,3990,1966,8.26,0,87.0,191152,1666,190136,4.59,2.26,0.08849425287356322,0.87,99.47
2020-08-21,Madhya Pradesh,1058,13,1054,13161,720,553,8.04,0,87.0,192210,1679,191190,0.83,0.64,0.1512758620689655,0.87,99.47
2020-08-22,Madhya Pradesh,323,1,319,4130,1286,914,7.82,3,87.0,192533,1680,191509,1.48,1.05,0.04747126436781609,0.87,99.47
2020-08-23,Madhya Pradesh,1167,16,1165,14258,3446,1372,8.18,0,87.0,193700,1696,192674,3.96,1.58,0.16388505747126436,0.88,99.47
2020-08-24,Madhya Pradesh,1082,6,1073,14007,1005,164,7.72,3,87.0,194782,1702,193747,1.16,0.19,0.161,0.87,99.47
2020-08-25,Madhya Pradesh,292,1,290,3384,1962,645,8.63,1,87.0,195074,1703,194037,2.26,0.74,0.03889655172413793,0.87,99.47
2020-08-26,Madhya Pradesh,270,1,263,3454,2621,1646,7.82,6,87.0,195344,1704,194300,3.01,1.89,0.03970114942528736,0.87,99.47
2020-08-27,Madhya Pradesh,616,7,614,7641,2782,2537,8.06,0,87.0,195960,1711,194914,3.2,2.92,0.08782758620689655,0.87,99.47
2020-08-28,Madhya Pradesh,898,6,890,11500,1879,433,7.81,2,87.0,196858,1717,195804,2.16,0.5,0.13218390804597702,0.87,99.46
2020-08-29,Madhya Pradesh,715,4,713,8884,4309,2404,8.05,0,87.0,197573,1721,196517,4.95,2.76,0.10211494252873564,0.87,99.47
2020-08-30,Madhya Pradesh,112,1,109,1343,2468,908,8.34,2,87.0,197685,1722,196626,2.84,1.04,0.015436781609195403,0.87,99.46
2020-08-31,Madhya Pradesh,1294,15,1289,16418,1085,777,7.88,0,87.0,198979,1737,197915,1.25,0.89,0.18871264367816093,0.87,99.47
2020-09-01,Madhya Pradesh,1120,9,1115,14165,1889,1385,7.91,0,87.0,200099,1746,199030,2.17,1.59,0.162816091954023,0.87,99.47
2020-09-02,Madhya Pradesh,588,2,581,7224,1048,435,8.14,5,87.0,200687,1748,199611,1.2,0.5,0.08303448275862069,0.87,99.46
2020-09-03,Madhya Pradesh,1289,9,1285,16027,4132,1293,8.04,0,87.0,201976,1757,200896,4.75,1.49,0.1842183908045977,0.87,99.47
2020-09-04,Madhya Pradesh,811,2,802,10227,3158,2030,7.93,7,87.0,202787,1759,201698,3.63,2.33,0.11755172413793104,0.87,99.46
2020-09-05,Madhya Pradesh,1191,5,1184,14866,677,594,8.01,2,87.0,203978,1764,202882,0.78,0.68,0.1708735632183908,0.86,99.46
2020-09-06,Madhya Pradesh,929,13,923,11296,3787,991,8.22,0,87.0,204907,1777,203805,4.35,1.14,0.1298390804597701,0.87,99.46
2020-09-07,Madhya Pradesh,211,1,208,2694,2710,316,7.83,2,87.0,205118,1778,204013,3.11,0.36,0.03096551724137931,0.87,99.46
2020-09-08,Madhya Pradesh,117,0,109,1776,1063,956,6.59,8,87.0,205235,1778,204122,1.22,1.1,0.020413793103448277,0.87,99.46
2020-09-09,Madhya Pradesh,773,8,770,9626,4968,3550,8.03,0,87.0,206008,1786,204892,5.71,4.08,0.11064367816091954,0.87,99.46
2020-09-10,Madhya Pradesh,433,4,432,5485,598,94,7.89,0,87.0,206441,1790,205324,0.69,0.11,0.06304597701149425,0.87,99.46
2020-09-11,Madhya Pradesh,1147,8,1145,14042,4165,2552,8.17,0,87.0,207588,1798,206469,4.79,2.93,0.16140229885057472,0.87,99.46
2020-09-12,Madhya Pradesh,197,2,193,2571,1254,885,7.66,2,87.0,207785,1800,206662,1.44,1.02,0.029551724137931036,0.87,99.46
2020-09-13,Madhya Pradesh,235,1,226,2884,3060,805,8.15,8,87.0,208020,1801,206888,3.52,0.93,0.03314942528735632,0.87,99.46
2020-09-14,Madhya Pradesh,468,5,459,6145,4079,3560,7.62,4,87.0,208488,1806,207347,4.69,4.09,0.07063218390804597,0.87,99.45
2020-09-15,Madhya Pradesh,1183,16,1180,15377,1966,832,7.69,0,87.0,209671,1822,208527,2.26,0.96,0.17674712643678162,0.87,99.45
2020-09-16,Madhya Pradesh,683,3,674,8588,3105,2355,7.95,6,87.0,210354,1825,209201,3.57,2.71,0.09871264367816092,0.87,99.45
2020-09-17,Madhya Pradesh,1431,19,1430,17798,1902,1541,8.04,0,87.0,211785,1844,210631,2.19,1.77,0.20457471264367816,0.87,99.46
2020-09-18,Madhya Pradesh,1438,14,1437,17855,287,237,8.05,0,87.0,213223,1858,212068,0.33,0.27,0.20522988505747125,0.87,99.46
2020-09-19,Madhya Pradesh,363,3,360,5140,1197,682,7.06,0,87.0,213586,1861,212428,1.38,0.78,0.059080459770114946,0.87,99.46
2020-09-20,Madhya Pradesh,886,7,885,11132,967,726,7.96,0,87.0,214472,1868,213313,1.11,0.83,0.12795402298850575,0.87,99.46
2020-09-21,Madhya Pradesh,60,0,60,678,2730,1221,8.85,0,87.0,214532,1868,213373,3.14,1.4,0.007793103448275862,0.87,99.46
2020-09-22,Madhya Pradesh,694,8,687,8291,353,193,8.37,0,87.0,215226,1876,214060,0.41,0.22,0.09529885057471264,0.87,99.46
2020-09-23,Madhya Pradesh,353,4,344,4374,856,389,8.07,5,87.0,215579,1880,214404,0.98,0.45,0.05027586206896552,0.87,99.45
2020-09-24,Madhya Pradesh,694,3,688,9244,369,263,7.51,3,87.0,216273,1883,215092,0.42,0.3,0.10625287356321839,0.87,99.45
2020-09-25,Madhya Pradesh,1318,5,1315,16532,2710,748,7.97,0,87.0,217591,1888,216407,3.11,0.86,0.19002298850574711,0.87,99.46
2020-09-26,Madhya Pradesh,580,5,572,7271,26,8,7.98,3,87.0,218171,1893,216979,0.03,0.01,0.08357471264367816,0.87,99.45
2020-09-27,Madhya Pradesh,1080,7,1078,13329,4085,2048,8.1,0,87.0,219251,1900,218057,4.7,2.35,0.15320689655172415,0.87,99.46
2020-09-28,Madhya Pradesh,732,9,729,9415,1936,1282,7.77,0,87.0,219983,1909,218786,2.23,1.47,0.1082183908045977,0.87,99.46
2020-09-29,Madhya Pradesh,727,6,719,9493,706,595,7.66,2,87.0,220710,1915,219505,0.81,0.68,0.10911494252873563,0.87,99.45
2020-09-30,Madhya Pradesh,1399,6,1390,17488,4291,4105,8.0,3,87.0,222109,1921,220895,4.93,4.72,0.20101149425287357,0.86,99.45
2020-10-01,Madhya Pradesh,992,10,990,12093,338,218,8.2,0,87.0,223101,1931,221885,0.39,0.25,0.139,0.87,99.45
2020-10-02,Madhya Pradesh,857,12,849,10951,1297,746,7.83,0,87.0,223958,1943,222734,1.49,0.86,0.1258735632183908,0.87,99.45
2020-10-03,Madhya Pradesh,1309,17,1303,16190,1734,1448,8.09,0,87.0,225267,1960,224037,1.99,1.66,0.1860919540229885,0.87,99.45
2020-10-04,Madhya Pradesh,982,5,977,12151,2351,2097,8.08,0,87.0,226249,1965,225014,2.7,2.41,0.13966666666666666,0.87,99.45
2020-10-05,Madhya Pradesh,626,4,617,7504,2402,681,8.34,5,87.0,226875,1969,225631,2.76,0.78,0.0862528735632184,0.87,99.45
2020-10-06,Madhya Pradesh,693,2,693,8360,4901,2460,8.29,0,87.0,227568,1971,226324,5.63,2.83,0.09609195402298851,0.87,99.45
2020-10-07,Madhya Pradesh,487,5,484,5616,767,112,8.67,0,87.0,228055,1976,226808,0.88,0.13,0.06455172413793103,0.87,99.45
2020-10-08,Madhya Pradesh,1308,14,1306,16762,1512,144,7.8,0,87.0,229363,1990,228114,1.74,0.17,0.19266666666666668,0.87,99.46
2020-10-09,Madhya Pradesh,1454,14,1452,17637,1009,434,8.24,0,87.0,230817,2004,229566,1.16,0.5,0.20272413793103447,0.87,99.46
2020-10-10,Madhya Pradesh,591,6,584,7610,653,404,7.77,1,87.0,231408,2010,230150,0.75,0.46,0.08747126436781609,0.87,99.46
2020-10-11,Madhya Pradesh,117,1,108,1383,454,308,8.46,8,87.0,231525,2011,230258,0.52,0.35,0.015896551724137932,0.87,99.45
2020-10-12,Madhya Pradesh,341,4,340,4337,4093,989,7.86,0,87.0,231866,2015,230598,4.7,1.14,0.049850574712643675,0.87,99.45
2020-10-13,Madhya Pradesh,459,2,451,5714,983,716,8.03,6,87.0,232325,2017,231049,1.13,0.82,0.06567816091954023,0.87,99.45
2020-10-14,Madhya Pradesh,135,1,133,1526,2752,1867,8.85,1,87.0,232460,2018,231182,3.16,2.15,0.017540229885057473,0.87,99.45
2020-10-15,Madhya Pradesh,78,0,77,1221,1207,1054,6.39,1,87.0,232538,2018,231259,1.39,1.21,0.01403448275862069,0.87,99.45
2020-10-16,Madhya Pradesh,887,11,878,11134,2996,2180,7.97,0,87.0,233425,2029,232137,3.44,2.51,0.12797701149425286,0.87,99.45
2020-10-17,Madhya Pradesh,151,0,144,1821,491,460,8.29,7,87.0,233576,2029,232281,0.56,0.53,0.020931034482758622,0.87,99.45
2020-10-18,Madhya Pradesh,771,2,769,9983,3176,1611,7.72,0,87.0,234347,2031,233050,3.65,1.85,0.11474712643678162,0.87,99.45
2020-10-19,Madhya Pradesh,143,0,136,1646,52,38,8.69,7,87.0,234490,2031,233186,0.06,0.04,0.018919540229885057,0.87,99.44
2020-10-20,Madhya Pradesh,1420,6,1415,17641,1941,1267,8.05,0,87.0,235910,2037,234601,2.23,1.46,0.20277011494252872,0.86,99.45
2020-10-21,Madhya Pradesh,692,6,690,8664,3959,3371,7.99,0,87.0,236602,2043,235291,4.55,3.87,0.09958620689655172,0.86,99.45
2020-10-22,Madhya Pradesh,164,1,162,1959,2627,51,8.37,1,87.0,236766,2044,235453,3.02,0.06,0.022517241379310344,0.86,99.45
2020-10-23,Madhya Pradesh,1622,10,1618,19968,1071,35,8.12,0,87.0,238388,2054,237071,1.23,0.04,0.22951724137931034,0.86,99.45
2020-10-24,Madhya Pradesh,1331,15,1325,16930,404,261,7.86,0,87.0,239719,2069,238396,0.46,0.3,0.1945977011494253,0.86,99.45
2020-10-25,Madhya Pradesh,1542,13,1533,19229,1673,1309,8.02,0,87.0,241261,2082,239929,1.92,1.5,0.22102298850574711,0.86,99.45
2020-10-26,Madhya Pradesh,1012,10,1011,12678,4521,2974,7.98,0,87.0,242273,2092,240940,5.2,3.42,0.14572413793103448,0.86,99.45
2020-10-27,Madhya Pradesh,585,2,583,7257,99,75,8.06,0,87.0,242858,2094,241523,0.11,0.09,0.08341379310344828,0.86,99.45
2020-10-28,Madhya Pradesh,109,1,103,1467,2192,1073,7.43,5,87.0,242967,2095,241626,2.52,1.23,0.01686206896551724,0.86,99.45
2020-10-29,Madhya Pradesh,469,3,465,5797,498,222,8.09,1,87.0,243436,2098,242091,0.57,0.26,0.06663218390804598,0.86,99.45
2020-10-30,Madhya Pradesh,598,3,597,7417,3004,1591,8.06,0,87.0,244034,2101,242688,3.45,1.83,0.0852528735632184,0.86,99.45
2020-10-31,Madhya Pradesh,1065,10,1065,13097,716,662,8.13,0,87.0,245099,2111,243753,0.82,0.76,0.15054022988505747,0.86,99.45
2020-11-01,Madhya Pradesh,1247,18,1238,15343,4006,1659,8.13,0,87.0,246346,2129,244991,4.6,1.91,0.17635632183908045,0.86,99.45
2020-11-02,Madhya Pradesh,247,1,238,3072,4954,4666,8.04,8,87.0,246593,2130,245229,5.69,5.36,0.03531034482758621,0.86,99.45
2020-11-03,Madhya Pradesh,977,4,971,12017,96,58,8.13,2,87.0,247570,2134,246200,0.11,0.07,0.13812643678160919,0.86,99.45
2020-11-04,Madhya Pradesh,1063,13,1058,13109,2598,653,8.11,0,87.0,248633,2147,247258,2.99,0.75,0.15067816091954023,0.86,99.45
2020-11-05,Madhya Pradesh,843,6,835,10337,544,174,8.16,2,87.0,249476,2153,248093,0.63,0.2,0.11881609195402298,0.86,99.45
2020-11-06,Madhya Pradesh,1449,5,1447,17784,2152,584,8.15,0,87.0,250925,2158,249540,2.47,0.67,0.2044137931034483,0.86,99.45
2020-11-07,Madhya Pradesh,464,1,464,5809,1420,84,7.99,0,87.0,251389,2159,250004,1.63,0.1,0.06677011494252874,0.86,99.45
2020-11-08,Madhya Pradesh,981,7,973,12260,3536,3122,8.0,1,87.0,252370,2166,250977,4.06,3.59,0.14091954022988507,0.86,99.45
2020-11-09,Madhya Pradesh,1008,13,1006,12261,4454,545,8.22,0,87.0,253378,2179,251983,5.12,0.63,0.14093103448275862,0.86,99.45
2020-11-10,Madhya Pradesh,535,6,534,6936,878,288,7.71,0,87.0,253913,2185,252517,1.01,0.33,0.07972413793103449,0.86,99.45
2020-11-11,Madhya Pradesh,1384,19,1376,17417,469,159,7.95,0,87.0,255297,2204,253893,0.54,0.18,0.20019540229885058,0.86,99.45
2020-11-12,Madhya Pradesh,224,2,221,2672,4177,2099,8.38,1,87.0,255521,2206,254114,4.8,2.41,0.03071264367816092,0.86,99.45
2020-11-13,Madhya Pradesh,725,2,721,9049,2295,1500,8.01,2,87.0,256246,2208,254835,2.64,1.72,0.10401149425287357,0.86,99.45
2020-11-14,Madhya Pradesh,725,6,720,8897,1050,346,8.15,0,87.0,256971,2214,255555,1.21,0.4,0.10226436781609195,0.86,99.45
2020-11-15,Madhya Pradesh,1380,12,1379,16829,3797,2440,8.2,0,87.0,258351,2226,256934,4.36,2.8,0.1934367816091954,0.86,99.45
2020-11-16,Madhya Pradesh,869,5,866,10903,518,8,7.97,0,87.0,259220,2231,257800,0.6,0.01,0.12532183908045977,0.86,99.45
2020-11-17,Madhya Pradesh,1310,8,1303,16284,1355,858,8.04,0,87.0,260530,2239,259103,1.56,0.99,0.18717241379310345,0.86,99.45
2020-11-18,Madhya Pradesh,1438,19,1430,17745,4558,3859,8.1,0,87.0,261968,2258,260533,5.24,4.44,0.20396551724137932,0.86,99.45
2020-11-19,Madhya Pradesh,174,2,167,2209,2223,874,7.88,5,87.0,262142,2260,260700,2.56,1.0,0.02539080459770115,0.86,99.45
2020-11-20,Madhya Pradesh,1105,14,1096,13706,3354,2194,8.06,0,87.0,263247,2274,261796,3.86,2.52,0.15754022988505748,0.86,99.45
2020-11-21,Madhya Pradesh,584,3,575,7173,2835,2504,8.14,6,87.0,263831,2277,262371,3.26,2.88,0.08244827586206896,0.86,99.45
2020-11-22,Madhya Pradesh,163,2,160,1831,2508,798,8.9,1,87.0,263994,2279,262531,2.88,0.92,0.021045977011494254,0.86,99.45
2020-11-23,Madhya Pradesh,9,0,5,573,1277,318,1.57,4,87.0,264003,2279,262536,1.47,0.37,0.006586206896551724,0.86,99.44
2020-11-24,Madhya Pradesh,319,4,310,4165,1331,400,7.66,5,87.0,264322,2283,262846,1.53,0.46,0.047873563218390806,0.86,99.44
2020-11-25,Madhya Pradesh,1190,11,1184,15177,1577,525,7.84,0,87.0,265512,2294,264030,1.81,0.6,0.17444827586206896,0.86,99.44
2020-11-26,Madhya Pradesh,1077,12,1071,13288,3999,2218,8.11,0,87.0,266589,2306,265101,4.6,2.55,0.15273563218390804,0.87,99.44
2020-11-27,Madhya Pradesh,452,1,451,5709,3496,716,7.92,0,87.0,267041,2307,265552,4.02,0.82,0.06562068965517241,0.86,99.44
2020-11-28,Madhya Pradesh,25,0,23,539,2431,799,4.64,2,87.0,267066,2307,265575,2.79,0.92,0.0061954022988505745,0.86,99.44
2020-11-29,Madhya Pradesh,1451,12,1447,17801,4646,2378,8.15,0,87.0,268517,2319,267022,5.34,2.73,0.20460919540229885,0.86,99.44
2020-11-30,Madhya Pradesh,492,4,486,5991,4925,977,8.21,2,87.0,269009,2323,267508,5.66,1.12,0.06886206896551725,0.86,99.44
2020-12-01,Madhya Pradesh,633,4,631,7716,4596,517,8.2,0,87.0,269642,2327,268139,5.28,0.59,0.0886896551724138,0.86,99.44
2020-12-02,Madhya Pradesh,332,1,332,4521,3232,2120,7.34,0,87.0,269974,2328,268471,3.71,2.44,0.05196551724137931,0.86,99.44
2020-12-03,Madhya Pradesh,1245,18,1245,15685,4702,3683,7.94,0,87.0,271219,2346,269716,5.4,4.23,0.1802873563218391,0.86,99.45
2020-12-04,Madhya Pradesh,1448,9,1443,17997,2545,233,8.05,0,87.0,272667,2355,271159,2.93,0.27,0.20686206896551723,0.86,99.45
2020-12-05,Madhya Pradesh,1495,13,1492,18442,2094,729,8.11,0,87.0,274162,2368,272651,2.41,0.84,0.21197701149425288,0.86,99.45
2020-12-06,Madhya Pradesh,502,2,493,6255,4217,760,8.03,7,87.0,274664,2370,273144,4.85,0.87,0.07189655172413793,0.86,99.45
2020-12-07,Madhya Pradesh,1456,13,1455,18193,366,214,8.0,0,87.0,276120,2383,274599,0.42,0.25,0.20911494252873564,0.86,99.45
2020-12-08,Madhya Pradesh,1164,11,1163,14549,1583,957,8.0,0,87.0,277284,2394,275762,1.82,1.1,0.16722988505747127,0.86,99.45
2020-12-09,Madhya Pradesh,457,4,450,5619,4442,308,8.13,3,87.0,277741,2398,276212,5.11,0.35,0.06458620689655173,0.86,99.45
2020-12-10,Madhya Pradesh,1357,13,1356,16394,2039,103,8.28,0,87.0,279098,2411,277568,2.34,0.12,0.18843678160919541,0.86,99.45
2020-12-11,Madhya Pradesh,1158,12,1153,14381,4932,4289,8.05,0,87.0,280256,2423,278721,5.67,4.93,0.16529885057471264,0.86,99.45
2020-12-12,Madhya Pradesh,564,8,561,6844,3627,1416,8.24,0,87.0,280820,2431,279282,4.17,1.63,0.07866666666666666,0.87,99.45
2020-12-13,Madhya Pradesh,322,2,320,3947,4389,3019,8.16,0,87.0,281142,2433,279602,5.04,3.47,0.045367816091954026,0.87,99.45
2020-12-14,Madhya Pradesh,264,2,255,3757,2021,1005,7.03,7,87.0,281406,2435,279857,2.32,1.16,0.043183908045977014,0.87,99.45
2020-12-15,Madhya Pradesh,826,8,822,9891,1290,207,8.35,0,87.0,282232,2443,280679,1.48,0.24,0.11368965517241379,0.87,99.45
2020-12-16,Madhya Pradesh,79,0,77,827,4299,2495,9.55,2,87.0,282311,2443,280756,4.94,2.87,0.009505747126436781,0.87,99.45
2020-12-17,Madhya Pradesh,630,8,629,8013,4446,2827,7.86,0,87.0,282941,2451,281385,5.11,3.25,0.09210344827586207,0.87,99.45
2020-12-18,Madhya Pradesh,947,3,944,11781,3939,3565,8.04,0,87.0,283888,2454,282329,4.53,4.1,0.13541379310344828,0.86,99.45
2020-12-19,Madhya Pradesh,329,1,322,3836,4534,2301,8.58,6,87.0,284217,2455,282651,5.21,2.64,0.0440919540229885,0.86,99.45
2020-12-20,Madhya Pradesh,1213,15,1210,14996,3767,3431,8.09,0,87.0,285430,2470,283861,4.33,3.94,0.17236781609195403,0.87,99.45
2020-12-21,Madhya Pradesh,917,10,909,11356,1397,799,8.08,0,87.0,286347,2480,284770,1.61,0.92,0.1305287356321839,0.87,99.45
2020-12-22,Madhya Pradesh,1578,15,1578,19739,2614,563,7.99,0,87.0,287925,2495,286348,3.0,0.65,0.22688505747126436,0.87,99.45
2020-12-23,Madhya Pradesh,994,12,985,12465,2355,1914,7.97,0,87.0,288919,2507,287333,2.71,2.2,0.1432758620689655,0.87,99.45
2020-12-24,Madhya Pradesh,658,2,649,8320,4414,3423,7.91,7,87.0,289577,2509,287982,5.07,3.93,0.09563218390804598,0.87,99.45
2020-12-25,Madhya Pradesh,339,3,335,4373,930,340,7.75,1,87.0,289916,2512,288317,1.07,0.39,0.050264367816091955,0.87,99.45
2020-12-26,Madhya Pradesh,44,0,35,698,840,199,6.3,9,87.0,289960,2512,288352,0.97,0.23,0.008022988505747126,0.87,99.45
2020-12-27,Madhya Pradesh,801,7,800,10141,1231,1083,7.9,0,87.0,290761,2519,289152,1.41,1.24,0.1165632183908046,0.87,99.45
2020-12-28,Madhya Pradesh,502,4,499,5905,733,595,8.5,0,87.0,291263,2523,289651,0.84,0.68,0.0678735632183908,0.87,99.45
2020-12-29,Madhya Pradesh,251,2,243,2618,3620,3548,9.59,6,87.0,291514,2525,289894,4.16,4.08,0.030091954022988504,0.87,99.44
2020-12-30,Madhya Pradesh,877,12,872,10931,2070,263,8.02,0,87.0,292391,2537,290766,2.38,0.3,0.12564367816091954,0.87,99.44
2020-12-31,Madhya Pradesh,1388,12,1386,17393,2473,1445,7.98,0,87.0,293779,2549,292152,2.84,1.66,0.19991954022988506,0.87,99.45
2021-01-01,Madhya Pradesh,364,1,357,4270,2334,894,8.52,6,87.0,294143,2550,292509,2.68,1.03,0.049080459770114944,0.87,99.44
2021-01-02,Madhya Pradesh,433,2,431,5682,806,381,7.62,0,87.0,294576,2552,292940,0.93,0.44,0.0653103448275862,0.87,99.44
2021-01-03,Madhya Pradesh,969,3,961,12405,2623,2574,7.81,5,87.0,295545,2555,293901,3.01,2.96,0.14258620689655171,0.86,99.44
2021-01-04,Madhya Pradesh,906,3,906,11130,4970,4200,8.14,0,87.0,296451,2558,294807,5.71,4.83,0.1279310344827586,0.86,99.45
2021-01-05,Madhya Pradesh,777,7,777,9884,4385,3806,7.86,0,87.0,297228,2565,295584,5.04,4.37,0.11360919540229886,0.86,99.45
2021-01-06,Madhya Pradesh,793,4,786,10055,1287,338,7.89,3,87.0,298021,2569,296370,1.48,0.39,0.11557471264367816,0.86,99.45
2021-01-07,Madhya Pradesh,1219,7,1213,15332,1775,1337,7.95,0,87.0,299240,2576,297583,2.04,1.54,0.17622988505747125,0.86,99.45
2021-01-08,Madhya Pradesh,681,5,673,8367,3404,2680,8.14,3,87.0,299921,2581,298256,3.91,3.08,0.09617241379310344,0.86,99.44
2021-01-09,Madhya Pradesh,1544,20,1539,19253,72,67,8.02,0,87.0,301465,2601,299795,0.08,0.08,0.22129885057471263,0.86,99.45
2021-01-10,Madhya Pradesh,174,2,168,2321,2414,1485,7.5,4,87.0,301639,2603,299963,2.77,1.71,0.02667816091954023,0.86,99.44
2021-01-11,Madhya Pradesh,60,0,53,875,3551,2041,6.86,7,87.0,301699,2603,300016,4.08,2.35,0.010057471264367816,0.86,99.44
2021-01-12,Madhya Pradesh,1273,14,1271,16346,3433,1750,7.79,0,87.0,302972,2617,301287,3.95,2.01,0.18788505747126436,0.86,99.44
2021-01-13,Madhya Pradesh,1594,23,1590,19589,1372,242,8.14,0,87.0,304566,2640,302877,1.58,0.28,0.22516091954022988,0.87,99.45
2021-01-14,Madhya Pradesh,1197,16,1191,14886,3515,1883,8.04,0,87.0,305763,2656,304068,4.04,2.16,0.17110344827586207,0.87,99.45
2021-01-15,Madhya Pradesh,544,6,540,7083,321,294,7.68,0,87.0,306307,2662,304608,0.37,0.34,0.08141379310344828,0.87,99.45
2021-01-16,Madhya Pradesh,481,3,479,5934,4285,3037,8.11,0,87.0,306788,2665,305087,4.93,3.49,0.06820689655172414,0.87,99.45
2021-01-17,Madhya Pradesh,1019,8,1017,12749,2442,1417,7.99,0,87.0,307807,2673,306104,2.81,1.63,0.14654022988505747,0.87,99.45
2021-01-18,Madhya Pradesh,406,4,406,5445,2007,1493,7.46,0,87.0,308213,2677,306510,2.31,1.72,0.06258620689655173,0.87,99.45
2021-01-19,Madhya Pradesh,1349,4,1347,16744,1532,347,8.06,0,87.0,309562,2681,307857,1.76,0.4,0.19245977011494253,0.87,99.45
2021-01-20,Madhya Pradesh,1370,4,1369,17412,1608,1011,7.87,0,87.0,310932,2685,309226,1.85,1.16,0.20013793103448277,0.86,99.45
2021-01-21,Madhya Pradesh,353,1,344,4619,175,174,7.64,8,87.0,311285,2686,309570,0.2,0.2,0.053091954022988504,0.86,99.45
2021-01-22,Madhya Pradesh,1053,12,1045,13365,1113,946,7.88,0,87.0,312338,2698,310615,1.28,1.09,0.15362068965517242,0.86,99.45
2021-01-23,Madhya Pradesh,198,1,190,2273,2027,372,8.71,7,87.0,312536,2699,310805,2.33,0.43,0.026126436781609197,0.86,99.45
2021-01-24,Madhya Pradesh,339,1,332,4319,345,29,7.85,6,87.0,312875,2700,311137,0.4,0.03,0.04964367816091954,0.86,99.44
2021-01-25,Madhya Pradesh,706,4,702,8942,2408,1065,7.9,0,87.0,313581,2704,311839,2.77,1.22,0.1027816091954023,0.86,99.44
2021-01-26,Madhya Pradesh,336,4,333,4066,2007,52,8.26,0,87.0,313917,2708,312172,2.31,0.06,0.04673563218390805,0.86,99.44
2021-01-27,Madhya Pradesh,1019,10,1010,12905,1060,875,7.9,0,87.0,314936,2718,313182,1.22,1.01,0.14833333333333334,0.86,99.44
2021-01-28,Madhya Pradesh,1187,4,1178,14431,2695,2202,8.23,5,87.0,316123,2722,314360,3.1,2.53,0.1658735632183908,0.86,99.44
2021-01-29,Madhya Pradesh,278,2,271,3687,1047,716,7.54,5,87.0,316401,2724,314631,1.2,0.82,0.042379310344827587,0.86,99.44
2021-01-30,Madhya Pradesh,450,5,446,5512,3730,925,8.16,0,87.0,316851,2729,315077,4.29,1.06,0.06335632183908046,0.86,99.44
2021-01-31,Madhya Pradesh,170,1,166,1942,4674,1071,8.75,3,87.0,317021,2730,315243,5.37,1.23,0.02232183908045977,0.86,99.44
2021-02-01,Madhya Pradesh,1043,11,1038,13408,1126,425,7.78,0,87.0,318064,2741,316281,1.29,0.49,0.15411494252873564,0.86,99.44
2021-02-02,Madhya Pradesh,1564,13,1556,19425,3837,3386,8.05,0,87.0,319628,2754,317837,4.41,3.89,0.22327586206896552,0.86,99.44
2021-02-03,Madhya Pradesh,899,4,898,10966,1561,277,8.2,0,87.0,320527,2758,318735,1.79,0.32,0.12604597701149425,0.86,99.44
2021-02-04,Madhya Pradesh,1560,10,1560,19371,2677,2556,8.05,0,87.0,322087,2768,320295,3.08,2.94,0.2226551724137931,0.86,99.44
2021-02-05,Madhya Pradesh,954,3,954,12232,638,511,7.8,0,87.0,323041,2771,321249,0.73,0.59,0.1405977011494253,0.86,99.45
2021-02-06,Madhya Pradesh,1040,9,1033,12736,277,249,8.17,0,87.0,324081,2780,322282,0.32,0.29,0.14639080459770115,0.86,99.44
2021-02-07,Madhya Pradesh,639,3,631,8227,4220,3236,7.77,5,87.0,324720,2783,322913,4.85,3.72,0.0945632183908046,0.86,99.44
2021-02-08,Madhya Pradesh,1052,6,1050,13639,3263,2265,7.71,0,87.0,325772,2789,323963,3.75,2.6,0.15677011494252874,0.86,99.44
2021-02-09,Madhya Pradesh,830,7,830,10378,231,63,8.0,0,87.0,326602,2796,324793,0.27,0.07,0.11928735632183908,0.86,99.45
2021-02-10,Madhya Pradesh,467,5,460,5796,893,841,8.06,2,87.0,327069,2801,325253,1.03,0.97,0.06662068965517241,0.86,99.44
2021-02-11,Madhya Pradesh,1086,13,1080,13637,3327,209,7.96,0,87.0,328155,2814,326333,3.82,0.24,0.1567471264367816,0.86,99.44
2021-02-12,Madhya Pradesh,620,2,617,7619,1085,614,8.14,1,87.0,328775,2816,326950,1.25,0.71,0.08757471264367817,0.86,99.44
2021-02-13,Madhya Pradesh,1111,4,1109,13632,253,24,8.15,0,87.0,329886,2820,328059,0.29,0.03,0.1566896551724138,0.85,99.45
2021-02-14,Madhya Pradesh,701,7,692,8525,1292,744,8.22,2,87.0,330587,2827,328751,1.49,0.86,0.09798850574712643,0.86,99.44
2021-02-15,Madhya Pradesh,1359,5,1359,16699,3728,2732,8.14,0,87.0,331946,2832,330110,4.29,3.14,0.1919425287356322,0.85,99.45
2021-02-16,Madhya Pradesh,1511,14,1508,18966,2303,1,7.97,0,87.0,333457,2846,331618,2.65,0.0,0.218,0.85,99.45
2021-02-17,Madhya Pradesh,1384,8,1384,17341,952,2,7.98,0,87.0,334841,2854,333002,1.09,0.0,0.19932183908045978,0.85,99.45
2021-02-18,Madhya Pradesh,718,5,711,8804,267,64,8.16,2,87.0,335559,2859,333713,0.31,0.07,0.10119540229885057,0.85,99.45
2021-02-19,Madhya Pradesh,1215,15,1209,15104,1147,250,8.04,0,87.0,336774,2874,334922,1.32,0.29,0.17360919540229885,0.85,99.45
2021-02-20,Madhya Pradesh,513,7,509,6442,1603,952,7.96,0,87.0,337287,2881,335431,1.84,1.09,0.07404597701149425,0.85,99.45
2021-02-21,Madhya Pradesh,907,3,903,11506,3902,1684,7.88,1,87.0,338194,2884,336334,4.49,1.94,0.13225287356321838,0.85,99.45
2021-02-22,Madhya Pradesh,848,3,847,10567,1514,544,8.02,0,87.0,339042,2887,337181,1.74,0.63,0.12145977011494252,0.85,99.45
2021-02-23,Madhya Pradesh,1577,14,1569,19451,4827,165,8.11,0,87.0,340619,2901,338750,5.55,0.19,0.22357471264367815,0.85,99.45
2021-02-24,Madhya Pradesh,1008,4,1000,12281,250,233,8.21,4,87.0,341627,2905,339750,0.29,0.27,0.14116091954022988,0.85,99.45
2021-02-25,Madhya Pradesh,843,3,841,10351,2262,2045,8.14,0,87.0,342470,2908,340591,2.6,2.35,0.11897701149425287,0.85,99.45
2021-02-26,Madhya Pradesh,1300,13,1298,15878,60,50,8.19,0,87.0,343770,2921,341889,0.07,0.06,0.18250574712643677,0.85,99.45
2021-02-27,Madhya Pradesh,1051,8,1042,13497,4050,891,7.79,1,87.0,344821,2929,342931,4.66,1.02,0.15513793103448276,0.85,99.45
2021-02-28,Madhya Pradesh,252,2,246,3189,2530,1100,7.9,4,87.0,345073,2931,343177,2.91,1.26,0.036655172413793104,0.85,99.45
2021-03-01,Madhya Pradesh,92,1,83,1021,4779,1992,9.01,8,87.0,345165,2932,343260,5.49,2.29,0.011735632183908046,0.85,99.45
2021-03-02,Madhya Pradesh,1065,15,1060,13340,434,337,7.98,0,87.0,346230,2947,344320,0.5,0.39,0.15333333333333332,0.85,99.45
2021-03-03,Madhya Pradesh,1190,15,1187,14431,3599,162,8.25,0,87.0,347420,2962,345507,4.14,0.19,0.1658735632183908,0.85,99.45
2021-03-04,Madhya Pradesh,1392,5,1388,17523,3503,987,7.94,0,87.0,348812,2967,346895,4.03,1.13,0.20141379310344829,0.85,99.45
2021-03-05,Madhya Pradesh,626,5,625,7924,4418,4066,7.9,0,87.0,349438,2972,347520,5.08,4.67,0.09108045977011495,0.85,99.45
2021-03-06,Madhya Pradesh,271,2,265,3619,1902,1746,7.49,4,87.0,349709,2974,347785,2.19,2.01,0.041597701149425285,0.85,99.45
2021-03-07,Madhya Pradesh,294,4,289,3341,2350,1802,8.8,1,87.0,350003,2978,348074,2.7,2.07,0.03840229885057471,0.85,99.45
2021-03-08,Madhya Pradesh,1500,19,1499,18821,3633,902,7.97,0,87.0,351503,2997,349573,4.18,1.04,0.21633333333333332,0.85,99.45
2021-03-09,Madhya Pradesh,640,7,633,7673,2926,277,8.34,0,87.0,352143,3004,350206,3.36,0.32,0.08819540229885058,0.85,99.45
2021-03-10,Madhya Pradesh,1488,11,1480,18519,2237,642,8.03,0,87.0,353631,3015,351686,2.57,0.74,0.21286206896551724,0.85,99.45
2021-03-11,Madhya Pradesh,832,9,823,10545,4024,1422,7.89,0,87.0,354463,3024,352509,4.63,1.63,0.12120689655172413,0.85,99.45
2021-03-12,Madhya Pradesh,12,0,6,573,3389,2954,2.09,6,87.0,354475,3024,352515,3.9,3.4,0.006586206896551724,0.85,99.45
2021-03-13,Madhya Pradesh,269,3,263,3541,3840,1822,7.6,3,87.0,354744,3027,352778,4.41,2.09,0.04070114942528735,0.85,99.45
2021-03-14,Madhya Pradesh,176,2,169,2256,3247,599,7.8,5,87.0,354920,3029,352947,3.73,0.69,0.02593103448275862,0.85,99.44
2021-03-15,Madhya Pradesh,536,4,531,7297,3323,1811,7.35,1,87.0,355456,3033,353478,3.82,2.08,0.0838735632183908,0.85,99.44
2021-03-16,Madhya Pradesh,22,0,18,628,4450,620,3.5,4,87.0,355478,3033,353496,5.11,0.71,0.007218390804597701,0.85,99.44
2021-03-17,Madhya Pradesh,216,0,212,2633,1599,1230,8.2,4,87.0,355694,3033,353708,1.84,1.41,0.030264367816091955,0.85,99.44
2021-03-18,Madhya Pradesh,593,4,584,7393,2014,922,8.02,5,87.0,356287,3037,354292,2.31,1.06,0.08497701149425288,0.85,99.44
2021-03-19,Madhya Pradesh,937,9,934,11830,4460,1988,7.92,0,87.0,357224,3046,355226,5.13,2.29,0.13597701149425287,0.85,99.44
2021-03-20,Madhya Pradesh,775,4,770,9464,2675,937,8.19,1,87.0,357999,3050,355996,3.07,1.08,0.10878160919540229,0.85,99.44
2021-03-21,Madhya Pradesh,1574,15,1567,19927,461,204,7.9,0,87.0,359573,3065,357563,0.53,0.23,0.22904597701149426,0.85,99.44
2021-03-22,Madhya Pradesh,1427,14,1427,18149,229,147,7.86,0,87.0,361000,3079,358990,0.26,0.17,0.20860919540229886,0.85,99.44
2021-03-23,Madhya Pradesh,1545,16,1544,19202,4655,1829,8.05,0,87.0,362545,3095,360534,5.35,2.1,0.22071264367816093,0.85,99.45
2021-03-24,Madhya Pradesh,1347,20,1345,16595,4621,2866,8.12,0,87.0,363892,3115,361879,5.31,3.29,0.1907471264367816,0.86,99.45
2021-03-25,Madhya Pradesh,179,1,173,2269,3331,2546,7.89,5,87.0,364071,3116,362052,3.83,2.93,0.02608045977011494,0.86,99.45
2021-03-26,Madhya Pradesh,490,4,486,6552,1473,777,7.48,0,87.0,364561,3120,362538,1.69,0.89,0.07531034482758621,0.86,99.45
2021-03-27,Madhya Pradesh,1346,11,1343,16837,3641,3379,7.99,0,87.0,365907,3131,363881,4.19,3.88,0.1935287356321839,0.86,99.45
2021-03-28,Madhya Pradesh,478,2,475,6377,401,354,7.5,1,87.0,366385,3133,364356,0.46,0.41,0.07329885057471264,0.86,99.45
2021-03-29,Madhya Pradesh,1047,7,1044,13478,3114,535,7.77,0,87.0,367432,3140,365400,3.58,0.61,0.15491954022988505,0.85,99.45
2021-03-30,Madhya Pradesh,1510,11,1507,18700,4939,4384,8.07,0,87.0,368942,3151,366907,5.68,5.04,0.2149425287356322,0.85,99.45
2021-03-31,Madhya Pradesh,331,1,323,4363,4657,3962,7.59,7,87.0,369273,3152,367230,5.35,4.55,0.050149425287356324,0.85,99.45
2021-04-01,Madhya Pradesh,738,7,734,9096,1340,526,8.11,0,87.0,370011,3159,367964,1.54,0.6,0.10455172413793104,0.85,99.45
2021-04-02,Madhya Pradesh,512,4,503,6345,451,284,8.07,5,87.0,370523,3163,368467,0.52,0.33,0.07293103448275862,0.85,99.45
2021-04-03,Madhya Pradesh,1363,19,1356,16965,22,1,8.03,0,87.0,371886,3182,369823,0.03,0.0,0.195,0.86,99.45
2021-04-04,Madhya Pradesh,707,6,699,8709,4987,3716,8.12,2,87.0,372593,3188,370522,5.73,4.27,0.10010344827586207,0.86,99.44
2021-04-05,Madhya Pradesh,96,0,91,1342,924,833,7.15,5,87.0,372689,3188,370613,1.06,0.96,0.01542528735632184,0.86,99.44
2021-04-06,Madhya Pradesh,1394,5,1389,17318,1303,831,8.05,0,87.0,374083,3193,372002,1.5,0.96,0.19905747126436782,0.85,99.44
2021-04-07,Madhya Pradesh,123,0,116,1602,2037,1410,7.68,7,87.0,374206,3193,372118,2.34,1.62,0.018413793103448275,0.85,99.44
2021-04-08,Madhya Pradesh,1400,9,1393,17275,305,8,8.1,0,87.0,375606,3202,373511,0.35,0.01,0.1985632183908046,0.85,99.44
2021-04-09,Madhya Pradesh,1571,15,1566,19485,1733,939,8.06,0,87.0,377177,3217,375077,1.99,1.08,0.2239655172413793,0.85,99.44
2021-04-10,Madhya Pradesh,1541,13,1534,19569,1871,1489,7.87,0,87.0,378718,3230,376611,2.15,1.71,0.2249310344827586,0.85,99.44
2021-04-11,Madhya Pradesh,952,8,949,12336,4774,3276,7.72,0,87.0,379670,3238,377560,5.49,3.77,0.14179310344827586,0.85,99.44
2021-04-12,Madhya Pradesh,1153,4,1148,14754,2120,1529,7.81,1,87.0,380823,3242,378708,2.44,1.76,0.1695862068965517,0.85,99.44
2021-04-13,Madhya Pradesh,971,12,963,12171,3714,1888,7.98,0,87.0,381794,3254,379671,4.27,2.17,0.13989655172413792,0.85,99.44
2021-04-14,Madhya Pradesh,1238,5,1234,15879,3304,881,7.8,0,87.0,383032,3259,380905,3.8,1.01,0.18251724137931036,0.85,99.44
2021-04-15,Madhya Pradesh,591,8,589,7530,4974,2557,7.85,0,87.0,383623,3267,381494,5.72,2.94,0.08655172413793104,0.85,99.45
2021-04-16,Madhya Pradesh,496,1,496,5854,2480,2018,8.47,0,87.0,384119,3268,381990,2.85,2.32,0.06728735632183908,0.85,99.45
2021-04-17,Madhya Pradesh,1259,5,1253,16034,1159,137,7.85,1,87.0,385378,3273,383243,1.33,0.16,0.18429885057471265,0.85,99.45
2021-04-18,Madhya Pradesh,984,11,975,12691,985,283,7.75,0,87.0,386362,3284,384218,1.13,0.33,0.14587356321839082,0.85,99.45
2021-04-19,Madhya Pradesh,500,4,498,5920,4850,2948,8.45,0,87.0,386862,3288,384716,5.57,3.39,0.06804597701149426,0.85,99.45
2021-04-20,Madhya Pradesh,1076,14,1072,13346,4995,2969,8.06,0,87.0,387938,3302,385788,5.74,3.41,0.15340229885057471,0.85,99.45
2021-04-21,Madhya Pradesh,1495,9,1495,18603,473,462,8.04,0,87.0,389433,3311,387283,0.54,0.53,0.21382758620689654,0.85,99.45
2021-04-22,Madhya Pradesh,1284,7,1281,16005,1133,1088,8.02,0,87.0,390717,3318,388564,1.3,1.25,0.1839655172413793,0.85,99.45
2021-04-23,Madhya Pradesh,325,1,318,3887,0,0,8.36,6,87.0,391042,3319,388882,0.0,0.0,0.04467816091954023,0.85,99.45
2021-04-24,Madhya Pradesh,78,0,74,1080,4798,3237,7.22,4,87.0,391120,3319,388956,5.51,3.72,0.012413793103448275,0.85,99.45
2021-04-25,Madhya Pradesh,801,10,795,10154,4881,522,7.89,0,87.0,391921,3329,389751,5.61,0.6,0.11671264367816092,0.85,99.45
2021-04-26,Madhya Pradesh,1282,14,1275,15767,332,15,8.13,0,87.0,393203,3343,391026,0.38,0.02,0.18122988505747126,0.85,99.45
2021-04-27,Madhya Pradesh,198,1,189,2539,1422,588,7.8,8,87.0,393401,3344,391215,1.63,0.68,0.029183908045977012,0.85,99.44
2021-04-28,Madhya Pradesh,1170,10,1168,14987,127,2,7.81,0,87.0,394571,3354,392383,0.15,0.0,0.17226436781609195,0.85,99.45
2021-04-29,Madhya Pradesh,1234,10,1228,15256,4045,3448,8.09,0,87.0,395805,3364,393611,4.65,3.96,0.17535632183908045,0.85,99.45
2021-04-30,Madhya Pradesh,1449,18,1443,17986,2020,1528,8.06,0,87.0,397254,3382,395054,2.32,1.76,0.20673563218390806,0.85,99.45
2021-05-01,Madhya Pradesh,839,11,835,10637,4960,4071,7.89,0,87.0,398093,3393,395889,5.7,4.68,0.12226436781609196,0.85,99.45
2021-05-02,Madhya Pradesh,875,8,868,10584,3350,1375,8.27,0,87.0,398968,3401,396757,3.85,1.58,0.1216551724137931,0.85,99.45
2021-05-03,Madhya Pradesh,1014,5,1008,12918,4598,4213,7.85,1,87.0,399982,3406,397765,5.29,4.84,0.14848275862068966,0.85,99.45
2021-05-04,Madhya Pradesh,775,2,770,9774,2140,1499,7.93,3,87.0,400757,3408,398535,2.46,1.72,0.1123448275862069,0.85,99.45
2021-05-05,Madhya Pradesh,996,6,988,12494,4274,2052,7.97,2,87.0,401753,3414,399523,4.91,2.36,0.14360919540229886,0.85,99.44
2021-05-06,Madhya Pradesh,513,3,504,6091,3240,2883,8.42,6,87.0,402266,3417,400027,3.72,3.31,0.07001149425287356,0.85,99.44
2021-05-07,Madhya Pradesh,100,0,91,1471,650,637,6.8,9,87.0,402366,3417,400118,0.75,0.73,0.016908045977011493,0.85,99.44
2021-05-08,Madhya Pradesh,1092,8,1088,13312,4409,299,8.2,0,87.0,403458,3425,401206,5.07,0.34,0.15301149425287355,0.85,99.44
2021-05-09,Madhya Pradesh,678,3,674,8311,2475,1791,8.16,1,87.0,404136,3428,401880,2.84,2.06,0.0955287356321839,0.85,99.44
2021-05-10,Madhya Pradesh,981,6,973,11710,2215,711,8.38,2,87.0,405117,3434,402853,2.55,0.82,0.1345977011494253,0.85,99.44
2021-05-11,Madhya Pradesh,241,1,232,2956,1494,748,8.15,8,87.0,405358,3435,403085,1.72,0.86,0.033977011494252876,0.85,99.44
2021-05-12,Madhya Pradesh,572,7,567,6942,3147,2084,8.24,0,87.0,405930,3442,403652,3.62,2.4,0.07979310344827586,0.85,99.44
2021-05-13,Madhya Pradesh,72,0,71,904,1504,4,7.96,1,87.0,406002,3442,403723,1.73,0.0,0.010390804597701149,0.85,99.44
2021-05-14,Madhya Pradesh,627,7,623,7551,827,224,8.3,0,87.0,406629,3449,404346,0.95,0.26,0.08679310344827586,0.85,99.44
2021-05-15,Madhya Pradesh,1230,13,1226,15754,1571,1069,7.81,0,87.0,407859,3462,405572,1.81,1.23,0.18108045977011494,0.85,99.44
2021-05-16,Madhya Pradesh,434,3,427,5589,3745,1506,7.77,4,87.0,408293,3465,405999,4.3,1.73,0.06424137931034483,0.85,99.44
2021-05-17,Madhya Pradesh,975,2,972,12377,4584,3359,7.88,1,87.0,409268,3467,406971,5.27,3.86,0.14226436781609195,0.85,99.44
2021-05-18,Madhya Pradesh,763,8,761,9728,3475,1287,7.84,0,87.0,410031,3475,407732,3.99,1.48,0.11181609195402299,0.85,99.44
2021-05-19,Madhya Pradesh,731,3,723,9080,3078,2816,8.05,5,87.0,410762,3478,408455,3.54,3.24,0.10436781609195403,0.85,99.44
2021-05-20,Madhya Pradesh,840,8,833,10522,4393,1484,7.98,0,87.0,411602,3486,409288,5.05,1.71,0.12094252873563219,0.85,99.44
2021-05-21,Madhya Pradesh,607,7,602,7664,4613,1311,7.92,0,87.0,412209,3493,409890,5.3,1.51,0.0880919540229885,0.85,99.44
2021-05-22,Madhya Pradesh,586,5,583,7417,4920,4905,7.9,0,87.0,412795,3498,410473,5.66,5.64,0.0852528735632184,0.85,99.44
2021-05-23,Madhya Pradesh,88,0,85,776,3716,1095,11.34,3,87.0,412883,3498,410558,4.27,1.26,0.008919540229885057,0.85,99.44
2021-05-24,Madhya Pradesh,222,1,219,2763,3268,192,8.03,2,87.0,413105,3499,410777,3.76,0.22,0.031758620689655175,0.85,99.44
2021-05-25,Madhya Pradesh,366,3,362,4380,1718,471,8.36,1,87.0,413471,3502,411139,1.97,0.54,0.0503448275862069,0.85,99.44
2021-05-26,Madhya Pradesh,1435,7,1431,18251,1274,504,7.86,0,87.0,414906,3509,412570,1.46,0.58,0.20978160919540229,0.85,99.44
2021-05-27,Madhya Pradesh,1245,17,1243,15441,1783,635,8.06,0,87.0,416151,3526,413813,2.05,0.73,0.17748275862068966,0.85,99.44
2021-05-28,Madhya Pradesh,1309,8,1305,16178,679,419,8.09,0,87.0,417460,3534,415118,0.78,0.48,0.18595402298850575,0.85,99.44
2021-05-29,Madhya Pradesh,769,10,766,9686,3895,2846,7.94,0,87.0,418229,3544,415884,4.48,3.27,0.11133333333333334,0.85,99.44
2021-05-30,Madhya Pradesh,958,10,956,12096,1457,308,7.92,0,87.0,419187,3554,416840,1.67,0.35,0.13903448275862068,0.85,99.44
2021-05-31,Madhya Pradesh,1336,19,1331,16981,2306,1065,7.87,0,87.0,420523,3573,418171,2.65,1.22,0.19518390804597702,0.85,99.44
2021-06-01,Madhya Pradesh,452,2,446,5551,429,403,8.14,4,87.0,420975,3575,418617,0.49,0.46,0.06380459770114942,0.85,99.44
2021-06-02,Madhya Pradesh,375,3,367,4538,3110,1954,8.26,5,87.0,421350,3578,418984,3.57,2.25,0.05216091954022988,0.85,99.44
2021-06-03,Madhya Pradesh,91,1,84,1159,1905,1282,7.85,6,87.0,421441,3579,419068,2.19,1.47,0.01332183908045977,0.85,99.44
2021-06-04,Madhya Pradesh,1526,11,1523,19188,3052,1472,7.95,0,87.0,422967,3590,420591,3.51,1.69,0.22055172413793103,0.85,99.44
2021-06-05,Madhya Pradesh,507,3,503,6464,235,208,7.84,1,87.0,423474,3593,421094,0.27,0.24,0.07429885057471264,0.85,99.44
2021-06-06,Madhya Pradesh,899,10,896,11452,1949,812,7.85,0,87.0,424373,3603,421990,2.24,0.93,0.13163218390804599,0.85,99.44
2021-06-07,Madhya Pradesh,432,1,431,4801,1573,1319,9.0,0,87.0,424805,3604,422421,1.81,1.52,0.05518390804597701,0.85,99.44
2021-06-08,Madhya Pradesh,1559,11,1551,19451,1518,236,8.02,0,87.0,426364,3615,423972,1.74,0.27,0.22357471264367815,0.85,99.44
2021-06-09,Madhya Pradesh,1379,4,1375,17547,1788,1113,7.86,0,87.0,427743,3619,425347,2.06,1.28,0.2016896551724138,0.85,99.44
2021-06-10,Madhya Pradesh,1149,12,1147,14584,4974,2572,7.88,0,87.0,428892,3631,426494,5.72,2.96,0.167632183908046,0.85,99.44
2021-06-11,Madhya Pradesh,1362,10,1355,17109,605,296,7.96,0,87.0,430254,3641,427849,0.7,0.34,0.1966551724137931,0.85,99.44
2021-06-12,Madhya Pradesh,1563,15,1558,19546,4311,1265,8.0,0,87.0,431817,3656,429407,4.96,1.45,0.22466666666666665,0.85,99.44
2021-06-13,Madhya Pradesh,805,5,799,9920,1884,941,8.11,1,87.0,432622,3661,430206,2.17,1.08,0.11402298850574713,0.85,99.44
2021-06-14,Madhya Pradesh,1475,8,1469,17906,453,257,8.24,0,87.0,434097,3669,431675,0.52,0.3,0.20581609195402298,0.85,99.44
2021-06-15,Madhya Pradesh,348,2,342,4297,1369,696,8.1,4,87.0,434445,3671,432017,1.57,0.8,0.04939080459770115,0.84,99.44
2021-06-16,Madhya Pradesh,274,0,266,3408,543,112,8.04,8,87.0,434719,3671,432283,0.62,0.13,0.03917241379310345,0.84,99.44
2021-06-17,Madhya Pradesh,1455,9,1448,18424,3623,570,7.9,0,87.0,436174,3680,433731,4.16,0.66,0.21177011494252873,0.84,99.44
2021-06-18,Madhya Pradesh,288,3,283,3336,2360,1003,8.63,2,87.0,436462,3683,434014,2.71,1.15,0.038344827586206894,0.84,99.44
2021-06-19,Madhya Pradesh,1428,9,1422,17770,1102,954,8.04,0,87.0,437890,3692,435436,1.27,1.1,0.2042528735632184,0.84,99.44
2021-06-20,Madhya Pradesh,961,14,957,12050,2697,2539,7.98,0,87.0,438851,3706,436393,3.1,2.92,0.1385057471264368,0.84,99.44
2021-06-21,Madhya Pradesh,356,4,351,4758,117,46,7.48,1,87.0,439207,3710,436744,0.13,0.05,0.054689655172413795,0.84,99.44
2021-06-22,Madhya Pradesh,1266,11,1261,15764,3611,625,8.03,0,87.0,440473,3721,438005,4.15,0.72,0.1811954022988506,0.84,99.44
2021-06-23,Madhya Pradesh,1551,22,1542,19541,1586,177,7.94,0,87.0,442024,3743,439547,1.82,0.2,0.22460919540229884,0.85,99.44
2021-06-24,Madhya Pradesh,435,4,428,5357,2951,409,8.12,3,87.0,442459,3747,439975,3.39,0.47,0.06157471264367816,0.85,99.44
2021-06-25,Madhya Pradesh,488,5,479,6233,3794,13,7.83,4,87.0,442947,3752,440454,4.36,0.01,0.07164367816091954,0.85,99.44
2021-06-26,Madhya Pradesh,759,3,755,9572,3577,3520,7.93,1,87.0,443706,3755,441209,4.11,4.05,0.11002298850574713,0.85,99.44
2021-06-27,Madhya Pradesh,319,2,313,3993,4057,3868,7.99,4,87.0,444025,3757,441522,4.66,4.45,0.04589655172413793,0.85,99.44
2021-06-28,Madhya Pradesh,322,2,313,4058,389,316,7.93,7,87.0,444347,3759,441835,0.45,0.36,0.04664367816091954,0.85,99.43
2021-06-29,Madhya Pradesh,402,3,395,5067,2967,1193,7.93,4,87.0,444749,3762,442230,3.41,1.37,0.05824137931034483,0.85,99.43
2021-06-30,Madhya Pradesh,538,2,533,6949,545,206,7.74,3,87.0,445287,3764,442763,0.63,0.24,0.0798735632183908,0.85,99.43
2021-07-01,Madhya Pradesh,815,10,810,10322,2908,2821,7.9,0,87.0,446102,3774,443573,3.34,3.24,0.11864367816091954,0.85,99.43
2021-07-02,Madhya Pradesh,73,0,64,1321,63,60,5.53,9,87.0,446175,3774,443637,0.07,0.07,0.015183908045977012,0.85,99.43
2021-07-03,Madhya Pradesh,280,2,272,3723,1270,1262,7.52,6,87.0,446455,3776,443909,1.46,1.45,0.04279310344827586,0.85,99.43
2021-07-04,Madhya Pradesh,1447,18,1444,17937,3342,2289,8.07,0,87.0,447902,3794,445353,3.84,2.63,0.20617241379310344,0.85,99.43
2021-07-05,Madhya Pradesh,1106,14,1099,13949,3502,3467,7.93,0,87.0,449008,3808,446452,4.03,3.99,0.16033333333333333,0.85,99.43
2021-07-06,Madhya Pradesh,496,7,496,5960,3014,204,8.32,0,87.0,449504,3815,446948,3.46,0.23,0.06850574712643678,0.85,99.43
2021-07-07,Madhya Pradesh,701,10,694,8271,1742,256,8.48,0,87.0,450205,3825,447642,2.0,0.29,0.09506896551724138,0.85,99.43
2021-07-08,Madhya Pradesh,61,0,55,1017,937,849,6.0,6,87.0,450266,3825,447697,1.08,0.98,0.011689655172413793,0.85,99.43
2021-07-09,Madhya Pradesh,1474,15,1473,18607,1372,1157,7.92,0,87.0,451740,3840,449170,1.58,1.33,0.2138735632183908,0.85,99.43
2021-07-10,Madhya Pradesh,1506,15,1502,18452,1173,438,8.16,0,87.0,453246,3855,450672,1.35,0.5,0.2120919540229885,0.85,99.43
2021-07-11,Madhya Pradesh,237,2,228,2364,3218,251,10.03,7,87.0,453483,3857,450900,3.7,0.29,0.027172413793103447,0.85,99.43
2021-07-12,Madhya Pradesh,744,9,744,9687,3199,2088,7.68,0,87.0,454227,3866,451644,3.68,2.4,0.1113448275862069,0.85,99.43
2021-07-13,Madhya Pradesh,189,1,189,2369,4272,1819,7.98,0,87.0,454416,3867,451833,4.91,2.09,0.027229885057471263,0.85,99.43
2021-07-14,Madhya Pradesh,1216,7,1209,15071,2624,157,8.07,0,87.0,455632,3874,453042,3.02,0.18,0.17322988505747128,0.85,99.43
2021-07-15,Madhya Pradesh,754,2,745,9541,4705,1278,7.9,7,87.0,456386,3876,453787,5.41,1.47,0.10966666666666666,0.85,99.43
2021-07-16,Madhya Pradesh,1225,12,1217,15627,2844,2771,7.84,0,87.0,457611,3888,455004,3.27,3.19,0.17962068965517242,0.85,99.43
2021-07-17,Madhya Pradesh,482,3,474,5620,53,34,8.58,5,87.0,458093,3891,455478,0.06,0.04,0.06459770114942529,0.85,99.43
2021-07-18,Madhya Pradesh,869,12,869,10718,4698,3982,8.11,0,87.0,458962,3903,456347,5.4,4.58,0.12319540229885058,0.85,99.43
2021-07-19,Madhya Pradesh,256,3,256,3598,3156,238,7.12,0,87.0,459218,3906,456603,3.63,0.27,0.04135632183908046,0.85,99.43
2021-07-20,Madhya Pradesh,485,1,485,6014,4525,842,8.06,0,87.0,459703,3907,457088,5.2,0.97,0.0691264367816092,0.85,99.43
2021-07-21,Madhya Pradesh,1135,14,1129,14352,22,14,7.91,0,87.0,460838,3921,458217,0.03,0.02,0.1649655172413793,0.85,99.43
2021-07-22,Madhya Pradesh,1200,3,1196,15126,2428,800,7.93,1,87.0,462038,3924,459413,2.79,0.92,0.17386206896551723,0.85,99.43
2021-07-23,Madhya Pradesh,952,10,951,11761,228,150,8.09,0,87.0,462990,3934,460364,0.26,0.17,0.13518390804597702,0.85,99.43
2021-07-24,Madhya Pradesh,71,0,64,1129,1626,481,6.29,7,87.0,463061,3934,460428,1.87,0.55,0.012977011494252873,0.85,99.43
2021-07-25,Madhya Pradesh,289,3,283,3761,4363,1294,7.68,3,87.0,463350,3937,460711,5.01,1.49,0.043229885057471266,0.85,99.43
2021-07-26,Madhya Pradesh,717,9,715,8767,1702,1628,8.18,0,87.0,464067,3946,461426,1.96,1.87,0.10077011494252873,0.85,99.43
2021-07-27,Madhya Pradesh,1186,15,1182,14247,3007,602,8.32,0,87.0,465253,3961,462608,3.46,0.69,0.16375862068965516,0.85,99.43
2021-07-28,Madhya Pradesh,994,12,992,12115,149,49,8.2,0,87.0,466247,3973,463600,0.17,0.06,0.1392528735632184,0.85,99.43
2021-07-29,Madhya Pradesh,210,1,203,2604,1656,568,8.06,6,87.0,466457,3974,463803,1.9,0.65,0.02993103448275862,0.85,99.43
2021-07-30,Madhya Pradesh,577,8,577,6959,658,95,8.29,0,87.0,467034,3982,464380,0.76,0.11,0.07998850574712643,0.85,99.43
2021-07-31,Madhya Pradesh,362,1,355,4615,875,355,7.84,6,87.0,467396,3983,464735,1.01,0.41,0.05304597701149425,0.85,99.43
2021-08-01,Madhya Pradesh,243,1,236,3350,4470,4177,7.25,6,87.0,467639,3984,464971,5.14,4.8,0.038505747126436785,0.85,99.43
2021-08-02,Madhya Pradesh,1400,10,1397,17895,1889,1025,7.82,0,87.0,469039,3994,466368,2.17,1.18,0.2056896551724138,0.85,99.43
2021-08-03,Madhya Pradesh,329,1,324,4260,2375,2000,7.72,4,87.0,469368,3995,466692,2.73,2.3,0.04896551724137931,0.85,99.43
2021-08-04,Madhya Pradesh,1436,14,1432,17739,1286,521,8.1,0,87.0,470804,4009,468124,1.48,0.6,0.20389655172413793,0.85,99.43
2021-08-05,Madhya Pradesh,301,3,293,3825,3097,91,7.87,5,87.0,471105,4012,468417,3.56,0.1,0.04396551724137931,0.85,99.43
2021-08-06,Madhya Pradesh,1097,13,1091,13467,1878,1338,8.15,0,87.0,472202,4025,469508,2.16,1.54,0.15479310344827585,0.85,99.43
2021-08-07,Madhya Pradesh,350,4,347,4150,302,122,8.43,0,87.0,472552,4029,469855,0.35,0.14,0.04770114942528736,0.85,99.43
2021-08-08,Madhya Pradesh,1535,20,1527,19154,1671,247,8.01,0,87.0,474087,4049,471382,1.92,0.28,0.22016091954022987,0.85,99.43
2021-08-09,Madhya Pradesh,1108,9,1105,14130,646,616,7.84,0,87.0,475195,4058,472487,0.74,0.71,0.16241379310344828,0.85,99.43
2021-08-10,Madhya Pradesh,731,3,726,9474,809,52,7.72,2,87.0,475926,4061,473213,0.93,0.06,0.10889655172413792,0.85,99.43
2021-08-11,Madhya Pradesh,1117,12,1117,13895,390,243,8.04,0,87.0,477043,4073,474330,0.45,0.28,0.15971264367816093,0.85,99.43
2021-08-12,Madhya Pradesh,249,1,242,3555,2340,1535,7.0,6,87.0,477292,4074,474572,2.69,1.76,0.040862068965517244,0.85,99.43
2021-08-13,Madhya Pradesh,788,6,786,9839,718,149,8.01,0,87.0,478080,4080,475358,0.83,0.17,0.11309195402298851,0.85,99.43
2021-08-14,Madhya Pradesh,487,1,484,6003,4939,3905,8.11,2,87.0,478567,4081,475842,5.68,4.49,0.069,0.85,99.43
2021-08-15,Madhya Pradesh,1575,23,1573,19916,4732,863,7.91,0,87.0,480142,4104,477415,5.44,0.99,0.22891954022988506,0.85,99.43
2021-08-16,Madhya Pradesh,1140,15,1136,14051,3254,1109,8.11,0,87.0,481282,4119,478551,3.74,1.27,0.16150574712643678,0.86,99.43
2021-08-17,Madhya Pradesh,683,4,674,8695,520,400,7.86,5,87.0,481965,4123,479225,0.6,0.46,0.09994252873563218,0.86,99.43
2021-08-18,Madhya Pradesh,478,1,471,5954,3523,2381,8.03,6,87.0,482443,4124,479696,4.05,2.74,0.0684367816091954,0.85,99.43
2021-08-19,Madhya Pradesh,1584,21,1575,19506,3544,422,8.12,0,87.0,484027,4145,481271,4.07,0.49,0.22420689655172413,0.86,99.43
2021-08-20,Madhya Pradesh,570,2,569,7062,3249,718,8.07,0,87.0,484597,4147,481840,3.73,0.83,0.08117241379310344,0.86,99.43
2021-08-21,Madhya Pradesh,1570,22,1566,19750,4543,736,7.95,0,87.0,486167,4169,483406,5.22,0.85,0.22701149425287356,0.86,99.43
2021-08-22,Madhya Pradesh,72,1,65,782,852,414,9.21,6,87.0,486239,4170,483471,0.98,0.48,0.008988505747126436,0.86,99.43
2021-08-23,Madhya Pradesh,1162,14,1159,13940,2820,867,8.34,0,87.0,487401,4184,484630,3.24,1.0,0.16022988505747127,0.86,99.43
2021-08-24,Madhya Pradesh,1129,3,1125,14138,3857,1484,7.99,1,87.0,488530,4187,485755,4.43,1.71,0.16250574712643678,0.86,99.43
2021-08-25,Madhya Pradesh,811,7,803,10229,1493,802,7.93,1,87.0,489341,4194,486558,1.72,0.92,0.11757471264367816,0.86,99.43
2021-08-26,Madhya Pradesh,88,0,82,986,2283,2236,8.92,6,87.0,489429,4194,486640,2.62,2.57,0.011333333333333334,0.86,99.43
2021-08-27,Madhya Pradesh,313,3,309,3940,60,22,7.94,1,87.0,489742,4197,486949,0.07,0.03,0.04528735632183908,0.86,99.43
2021-08-28,Madhya Pradesh,1218,4,1209,15271,3196,887,7.98,5,87.0,490960,4201,488158,3.67,1.02,0.1755287356321839,0.86,99.43
2021-08-29,Madhya Pradesh,599,4,594,6878,1185,1147,8.71,1,87.0,491559,4205,488752,1.36,1.32,0.07905747126436781,0.86,99.43
2021-08-30,Madhya Pradesh,104,1,95,1066,4707,747,9.76,8,87.0,491663,4206,488847,5.41,0.86,0.012252873563218391,0.86,99.43
2021-08-31,Madhya Pradesh,1317,5,1314,16918,960,728,7.78,0,87.0,492980,4211,490161,1.1,0.84,0.19445977011494253,0.85,99.43
2021-09-01,Madhya Pradesh,735,7,726,9269,547,531,7.93,2,87.0,493715,4218,490887,0.63,0.61,0.10654022988505747,0.85,99.43
2021-09-02,Madhya Pradesh,1033,10,1024,12685,716,683,8.14,0,87.0,494748,4228,491911,0.82,0.79,0.14580459770114942,0.85,99.43
2021-09-03,Madhya Pradesh,360,2,360,4572,3491,3235,7.87,0,87.0,495108,4230,492271,4.01,3.72,0.052551724137931036,0.85,99.43
2021-09-04,Madhya Pradesh,1209,4,1206,14971,2908,303,8.08,0,87.0,496317,4234,493477,3.34,0.35,0.17208045977011494,0.85,99.43
2021-09-05,Madhya Pradesh,660,8,655,8421,3925,1633,7.84,0,87.0,496977,4242,494132,4.51,1.88,0.09679310344827587,0.85,99.43
2021-09-06,Madhya Pradesh,1492,19,1492,18856,565,255,7.91,0,87.0,498469,4261,495624,0.65,0.29,0.21673563218390804,0.85,99.43
2021-09-07,Madhya Pradesh,886,9,877,11052,4833,1,8.02,0,87.0,499355,4270,496501,5.56,0.0,0.1270344827586207,0.86,99.43
2021-09-08,Madhya Pradesh,367,3,361,4825,9,8,7.61,3,87.0,499722,4273,496862,0.01,0.01,0.055459770114942526,0.86,99.43
2021-09-09,Madhya Pradesh,524,5,515,6661,4419,3332,7.87,4,87.0,500246,4278,497377,5.08,3.83,0.0765632183908046,0.86,99.43
2021-09-10,Madhya Pradesh,137,0,131,1887,2960,564,7.26,6,87.0,500383,4278,497508,3.4,0.65,0.021689655172413794,0.85,99.43
2021-09-11,Madhya Pradesh,737,8,729,8925,4409,3690,8.26,0,87.0,501120,4286,498237,5.07,4.24,0.10258620689655172,0.86,99.42
2021-09-12,Madhya Pradesh,1514,10,1507,18850,1323,479,8.03,0,87.0,502634,4296,499744,1.52,0.55,0.21666666666666667,0.85,99.43
2021-09-13,Madhya Pradesh,118,0,111,1806,1374,1331,6.53,7,87.0,502752,4296,499855,1.58,1.53,0.02075862068965517,0.85,99.42
2021-09-14,Madhya Pradesh,366,5,365,4562,4318,3993,8.02,0,87.0,503118,4301,500220,4.96,4.59,0.052436781609195404,0.85,99.42
2021-09-15,Madhya Pradesh,451,3,449,5434,1317,105,8.3,0,87.0,503569,4304,500669,1.51,0.12,0.062459770114942526,0.85,99.42
2021-09-16,Madhya Pradesh,134,1,125,2248,203,134,5.96,8,87.0,503703,4305,500794,0.23,0.15,0.025839080459770115,0.85,99.42
2021-09-17,Madhya Pradesh,409,4,405,4993,3866,913,8.19,0,87.0,504112,4309,501199,4.44,1.05,0.05739080459770115,0.85,99.42
2021-09-18,Madhya Pradesh,1127,15,1124,14474,3867,1243,7.79,0,87.0,505239,4324,502323,4.44,1.43,0.16636781609195403,0.86,99.42
2021-09-19,Madhya Pradesh,892,3,887,11438,3145,1904,7.8,2,87.0,506131,4327,503210,3.61,2.19,0.1314712643678161,0.85,99.42
2021-09-20,Madhya Pradesh,1253,15,1246,15466,93,20,8.1,0,87.0,507384,4342,504456,0.11,0.02,0.17777011494252873,0.86,99.42
2021-09-21,Madhya Pradesh,99,0,91,832,2008,1125,11.9,8,87.0,507483,4342,504547,2.31,1.29,0.009563218390804597,0.86,99.42
2021-09-22,Madhya Pradesh,1072,14,1063,13253,4609,1180,8.09,0,87.0,508555,4356,505610,5.3,1.36,0.15233333333333332,0.86,99.42
2021-09-23,Madhya Pradesh,443,2,435,5812,3929,1366,7.62,6,87.0,508998,4358,506045,4.52,1.57,0.06680459770114942,0.86,99.42
2021-09-24,Madhya Pradesh,268,1,265,3379,3549,923,7.93,2,87.0,509266,4359,506310,4.08,1.06,0.038839080459770116,0.86,99.42
2021-09-25,Madhya Pradesh,747,2,739,9379,1702,731,7.96,6,87.0,510013,4361,507049,1.96,0.84,0.10780459770114943,0.86,99.42
2021-09-26,Madhya Pradesh,361,2,357,4411,4676,4621,8.18,2,87.0,510374,4363,507406,5.37,5.31,0.050701149425287355,0.85,99.42
2021-09-27,Madhya Pradesh,1569,13,1565,19517,514,449,8.04,0,87.0,511943,4376,508971,0.59,0.52,0.22433333333333333,0.85,99.42
2021-09-28,Madhya Pradesh,1090,10,1084,13526,2422,125,8.06,0,87.0,513033,4386,510055,2.78,0.14,0.15547126436781608,0.85,99.42
2021-09-29,Madhya Pradesh,1039,10,1035,13014,3818,3733,7.98,0,87.0,514072,4396,511090,4.39,4.29,0.14958620689655172,0.86,99.42
2021-09-30,Madhya Pradesh,656,9,648,7888,4740,1634,8.32,0,87.0,514728,4405,511738,5.45,1.88,0.09066666666666667,0.86,99.42
2021-10-01,Madhya Pradesh,145,0,142,1769,2140,1129,8.2,3,87.0,514873,4405,511880,2.46,1.3,0.02033333333333333,0.86,99.42
2021-10-02,Madhya Pradesh,869,4,860,11026,636,201,7.88,5,87.0,515742,4409,512740,0.73,0.23,0.12673563218390804,0.85,99.42
2021-10-03,Madhya Pradesh,304,2,297,3429,3114,1492,8.87,5,87.0,516046,4411,513037,3.58,1.71,0.03941379310344827,0.85,99.42
2021-10-04,Madhya Pradesh,866,10,865,11518,3708,2343,7.52,0,87.0,516912,4421,513902,4.26,2.69,0.13239080459770114,0.86,99.42
2021-10-05,Madhya Pradesh,716,5,716,9440,4887,4064,7.58,0,87.0,517628,4426,514618,5.62,4.67,0.10850574712643678,0.86,99.42
2021-10-06,Madhya Pradesh,1315,11,1308,15896,2596,1575,8.27,0,87.0,518943,4437,515926,2.98,1.81,0.18271264367816092,0.86,99.42
2021-10-07,Madhya Pradesh,316,2,307,4091,201,128,7.72,7,87.0,519259,4439,516233,0.23,0.15,0.047022988505747126,0.85,99.42
2021-10-08,Madhya Pradesh,1563,8,1563,19174,3705,1068,8.15,0,87.0,520822,4447,517796,4.26,1.23,0.22039080459770116,0.85,99.42
2021-10-09,Madhya Pradesh,896,3,895,11509,2048,313,7.79,0,87.0,521718,4450,518691,2.35,0.36,0.13228735632183908,0.85,99.42
2021-10-10,Madhya Pradesh,1326,15,1319,16492,216,72,8.04,0,87.0,523044,4465,520010,0.25,0.08,0.1895632183908046,0.85,99.42
2021-10-11,Madhya Pradesh,704,5,696,8917,4140,3681,7.9,3,87.0,523748,4470,520706,4.76,4.23,0.10249425287356322,0.85,99.42
2021-10-12,Madhya Pradesh,250,1,250,2931,4399,513,8.53,0,87.0,523998,4471,520956,5.06,0.59,0.03368965517241379,0.85,99.42
2021-10-13,Madhya Pradesh,301,2,295,3910,2104,543,7.7,4,87.0,524299,4473,521251,2.42,0.62,0.04494252873563218,0.85,99.42
2021-10-14,Madhya Pradesh,709,2,704,8488,3675,2272,8.35,3,87.0,525008,4475,521955,4.22,2.61,0.0975632183908046,0.85,99.42
2021-10-15,Madhya Pradesh,1072,6,1072,13509,3373,1465,7.94,0,87.0,526080,4481,523027,3.88,1.68,0.15527586206896551,0.85,99.42
2021-10-16,Madhya Pradesh,1134,8,1125,14771,2485,2461,7.68,1,87.0,527214,4489,524152,2.86,2.83,0.1697816091954023,0.85,99.42
2021-10-17,Madhya Pradesh,429,5,428,5675,1943,451,7.56,0,87.0,527643,4494,524580,2.23,0.52,0.06522988505747127,0.85,99.42
2021-10-18,Madhya Pradesh,1438,13,1436,18142,57,18,7.93,0,87.0,529081,4507,526016,0.07,0.02,0.2085287356321839,0.85,99.42
2021-10-19,Madhya Pradesh,1516,7,1511,18941,1406,726,8.0,0,87.0,530597,4514,527527,1.62,0.83,0.21771264367816093,0.85,99.42
2021-10-20,Madhya Pradesh,707,4,701,8807,4052,2251,8.03,2,87.0,531304,4518,528228,4.66,2.59,0.10122988505747127,0.85,99.42
2021-10-21,Madhya Pradesh,1516,21,1516,19179,1918,1113,7.9,0,87.0,532820,4539,529744,2.2,1.28,0.22044827586206897,0.85,99.42
2021-10-22,Madhya Pradesh,1468,7,1467,18435,3076,884,7.96,0,87.0,534288,4546,531211,3.54,1.02,0.21189655172413793,0.85,99.42
2021-10-23,Madhya Pradesh,829,10,827,10494,308,295,7.9,0,87.0,535117,4556,532038,0.35,0.34,0.12062068965517242,0.85,99.42
2021-10-24,Madhya Pradesh,566,2,558,6840,4608,2343,8.27,6,87.0,535683,4558,532596,5.3,2.69,0.07862068965517241,0.85,99.42
2021-10-25,Madhya Pradesh,406,5,400,5237,439,229,7.75,1,87.0,536089,4563,532996,0.5,0.26,0.06019540229885057,0.85,99.42
2021-10-26,Madhya Pradesh,387,2,387,4892,1672,1613,7.91,0,87.0,536476,4565,533383,1.92,1.85,0.056229885057471264,0.85,99.42
2021-10-27,Madhya Pradesh,404,3,401,5141,1378,1121,7.86,0,87.0,536880,4568,533784,1.58,1.29,0.05909195402298851,0.85,99.42
2021-10-28,Madhya Pradesh,1208,10,1205,15132,1043,156,7.98,0,87.0,538088,4578,534989,1.2,0.18,0.17393103448275862,0.85,99.42
2021-10-29,Madhya Pradesh,1136,16,1127,14813,1206,352,7.67,0,87.0,539224,4594,536116,1.39,0.4,0.17026436781609194,0.85,99.42
2021-10-30,Madhya Pradesh,38,0,31,502,216,55,7.57,7,87.0,539262,4594,536147,0.25,0.06,0.005770114942528735,0.85,99.42
2021-10-31,Madhya Pradesh,128,1,121,1234,4873,1662,10.37,6,87.0,539390,4595,536268,5.6,1.91,0.01418390804597701,0.85,99.42
2021-11-01,Madhya Pradesh,844,6,839,10809,3298,834,7.81,0,87.0,540234,4601,537107,3.79,0.96,0.12424137931034483,0.85,99.42
2021-11-02,Madhya Pradesh,1176,14,1168,14670,877,742,8.02,0,87.0,541410,4615,538275,1.01,0.85,0.1686206896551724,0.85,99.42
2021-11-03,Madhya Pradesh,151,0,149,1566,1494,955,9.64,2,87.0,541561,4615,538424,1.72,1.1,0.018,0.85,99.42
2021-11-04,Madhya Pradesh,278,1,273,3647,2845,22,7.62,4,87.0,541839,4616,538697,3.27,0.03,0.04191954022988506,0.85,99.42
2021-11-05,Madhya Pradesh,880,6,878,10894,2070,308,8.08,0,87.0,542719,4622,539575,2.38,0.35,0.1252183908045977,0.85,99.42
2021-11-06,Madhya Pradesh,1111,16,1108,13780,739,64,8.06,0,87.0,543830,4638,540683,0.85,0.07,0.15839080459770116,0.85,99.42
2021-11-07,Madhya Pradesh,71,1,69,1321,3252,2726,5.37,1,87.0,543901,4639,540752,3.74,3.13,0.015183908045977012,0.85,99.42
2021-11-08,Madhya Pradesh,163,0,158,2148,2662,1905,7.59,5,87.0,544064,4639,540910,3.06,2.19,0.024689655172413793,0.85,99.42
2021-11-09,Madhya Pradesh,1080,15,1080,13486,3193,1121,8.01,0,87.0,545144,4654,541990,3.67,1.29,0.15501149425287356,0.85,99.42
2021-11-10,Madhya Pradesh,839,4,839,10648,3691,494,7.88,0,87.0,545983,4658,542829,4.24,0.57,0.12239080459770114,0.85,99.42
2021-11-11,Madhya Pradesh,755,8,753,9507,3,3,7.94,0,87.0,546738,4666,543582,0.0,0.0,0.10927586206896552,0.85,99.42
2021-11-12,Madhya Pradesh,1080,7,1079,13588,2186,302,7.95,0,87.0,547818,4673,544661,2.51,0.35,0.156183908045977,0.85,99.42
2021-11-13,Madhya Pradesh,1518,8,1510,19383,4930,4759,7.83,0,87.0,549336,4681,546171,5.67,5.47,0.22279310344827585,0.85,99.42
2021-11-14,Madhya Pradesh,533,2,524,5980,437,393,8.91,7,87.0,549869,4683,546695,0.5,0.45,0.06873563218390805,0.85,99.42
2021-11-15,Madhya Pradesh,261,2,255,3319,3346,1040,7.86,4,87.0,550130,4685,546950,3.85,1.2,0.03814942528735632,0.85,99.42
2021-11-16,Madhya Pradesh,496,1,495,6425,920,319,7.72,0,87.0,550626,4686,547445,1.06,0.37,0.07385057471264368,0.85,99.42
2021-11-17,Madhya Pradesh,626,8,625,7808,3799,1506,8.02,0,87.0,551252,4694,548070,4.37,1.73,0.08974712643678161,0.85,99.42
2021-11-18,Madhya Pradesh,732,6,724,8979,51,33,8.15,2,87.0,551984,4700,548794,0.06,0.04,0.10320689655172413,0.85,99.42
2021-11-19,Madhya Pradesh,706,2,706,8548,2822,891,8.26,0,87.0,552690,4702,549500,3.24,1.02,0.09825287356321839,0.85,99.42
2021-11-20,Madhya Pradesh,101,1,94,1552,2675,2338,6.51,6,87.0,552791,4703,549594,3.07,2.69,0.017839080459770115,0.85,99.42
2021-11-21,Madhya Pradesh,349,3,342,4854,1063,941,7.19,4,87.0,553140,4706,549936,1.22,1.08,0.055793103448275864,0.85,99.42
2021-11-22,Madhya Pradesh,1169,15,1168,14294,2340,2151,8.18,0,87.0,554309,4721,551104,2.69,2.47,0.16429885057471263,0.85,99.42
2021-11-23,Madhya Pradesh,507,3,499,6316,4742,3319,8.03,5,87.0,554816,4724,551603,5.45,3.81,0.07259770114942529,0.85,99.42
2021-11-24,Madhya Pradesh,384,2,382,4825,3815,2432,7.96,0,87.0,555200,4726,551985,4.39,2.8,0.055459770114942526,0.85,99.42
2021-11-25,Madhya Pradesh,1000,6,991,12735,1093,1013,7.85,3,87.0,556200,4732,552976,1.26,1.16,0.1463793103448276,0.85,99.42
2021-11-26,Madhya Pradesh,664,8,660,7956,4451,2814,8.35,0,87.0,556864,4740,553636,5.12,3.23,0.09144827586206897,0.85,99.42
2021-11-27,Madhya Pradesh,1405,10,1399,17346,4468,2195,8.1,0,87.0,558269,4750,555035,5.14,2.52,0.1993793103448276,0.85,99.42
2021-11-28,Madhya Pradesh,674,9,671,8144,3005,1085,8.28,0,87.0,558943,4759,555706,3.45,1.25,0.09360919540229885,0.85,99.42
2021-11-29,Madhya Pradesh,812,10,804,9866,3692,3081,8.23,0,87.0,559755,4769,556510,4.24,3.54,0.1134022988505747,0.85,99.42
2021-11-30,Madhya Pradesh,890,3,884,11241,488,41,7.92,3,87.0,560645,4772,557394,0.56,0.05,0.12920689655172413,0.85,99.42
2021-12-01,Madhya Pradesh,220,2,220,2790,1513,1237,7.89,0,87.0,560865,4774,557614,1.74,1.42,0.03206896551724138,0.85,99.42
2021-12-02,Madhya Pradesh,1402,12,1395,17267,1101,686,8.12,0,87.0,562267,4786,559009,1.27,0.79,0.1984712643678161,0.85,99.42
2021-12-03,Madhya Pradesh,1072,13,1070,13568,478,301,7.9,0,87.0,563339,4799,560079,0.55,0.35,0.15595402298850575,0.85,99.42
2021-12-04,Madhya Pradesh,1291,18,1283,15918,3099,1563,8.11,0,87.0,564630,4817,561362,3.56,1.8,0.1829655172413793,0.85,99.42
2021-12-05,Madhya Pradesh,988,6,988,12257,1673,430,8.06,0,87.0,565618,4823,562350,1.92,0.49,0.14088505747126437,0.85,99.42
2021-12-06,Madhya Pradesh,111,1,102,1495,3850,3122,7.42,8,87.0,565729,4824,562452,4.43,3.59,0.01718390804597701,0.85,99.42
2021-12-07,Madhya Pradesh,1300,11,1300,16317,868,755,7.97,0,87.0,567029,4835,563752,1.0,0.87,0.18755172413793103,0.85,99.42
2021-12-08,Madhya Pradesh,378,5,375,4791,2323,1363,7.89,0,87.0,567407,4840,564127,2.67,1.57,0.05506896551724138,0.85,99.42
2021-12-09,Madhya Pradesh,244,0,237,3238,3360,214,7.54,7,87.0,567651,4840,564364,3.86,0.25,0.0372183908045977,0.85,99.42
2021-12-10,Madhya Pradesh,136,0,133,1799,3458,131,7.56,3,87.0,567787,4840,564497,3.97,0.15,0.02067816091954023,0.85,99.42
2021-12-11,Madhya Pradesh,539,3,532,7432,474,431,7.25,4,87.0,568326,4843,565029,0.54,0.5,0.08542528735632184,0.85,99.42
2021-12-12,Madhya Pradesh,1274,10,1269,15618,3215,957,8.16,0,87.0,569600,4853,566298,3.7,1.1,0.17951724137931035,0.85,99.42
2021-12-13,Madhya Pradesh,748,4,747,9056,4848,4810,8.26,0,87.0,570348,4857,567045,5.57,5.53,0.1040919540229885,0.85,99.42
2021-12-14,Madhya Pradesh,462,4,461,6363,631,159,7.26,0,87.0,570810,4861,567506,0.73,0.18,0.07313793103448275,0.85,99.42
2021-12-15,Madhya Pradesh,823,11,822,10787,956,780,7.63,0,87.0,571633,4872,568328,1.1,0.9,0.12398850574712644,0.85,99.42
2021-12-16,Madhya Pradesh,598,6,594,7322,2823,2768,8.17,0,87.0,572231,4878,568922,3.24,3.18,0.08416091954022989,0.85,99.42
2021-12-17,Madhya Pradesh,1511,17,1505,18634,2238,278,8.11,0,87.0,573742,4895,570427,2.57,0.32,0.214183908045977,0.85,99.42
2021-12-18,Madhya Pradesh,252,3,245,3457,2679,334,7.29,4,87.0,573994,4898,570672,3.08,0.38,0.03973563218390805,0.85,99.42
2021-12-19,Madhya Pradesh,993,6,991,12613,3330,2173,7.87,0,87.0,574987,4904,571663,3.83,2.5,0.14497701149425288,0.85,99.42
2021-12-20,Madhya Pradesh,141,1,134,1593,3864,2505,8.85,6,87.0,575128,4905,571797,4.44,2.88,0.018310344827586207,0.85,99.42
2021-12-21,Madhya Pradesh,586,5,578,7141,2723,696,8.21,3,87.0,575714,4910,572375,3.13,0.8,0.08208045977011494,0.85,99.42
2021-12-22,Madhya Pradesh,1356,7,1349,16871,587,229,8.04,0,87.0,577070,4917,573724,0.67,0.26,0.19391954022988506,0.85,99.42
2021-12-23,Madhya Pradesh,1023,3,1017,12829,3957,583,7.97,3,87.0,578093,4920,574741,4.55,0.67,0.14745977011494252,0.85,99.42
2021-12-24,Madhya Pradesh,355,5,348,4864,2428,361,7.3,2,87.0,578448,4925,575089,2.79,0.41,0.055908045977011496,0.85,99.42
2021-12-25,Madhya Pradesh,1449,7,1449,18057,2153,377,8.02,0,87.0,579897,4932,576538,2.47,0.43,0.20755172413793102,0.85,99.42
2021-12-26,Madhya Pradesh,1192,12,1192,14397,1368,1116,8.28,0,87.0,581089,4944,577730,1.57,1.28,0.16548275862068965,0.85,99.42
2021-12-27,Madhya Pradesh,663,8,659,8026,765,157,8.26,0,87.0,581752,4952,578389,0.88,0.18,0.09225287356321839,0.85,99.42
2021-12-28,Madhya Pradesh,487,3,480,6154,916,21,7.91,4,87.0,582239,4955,578869,1.05,0.02,0.07073563218390805,0.85,99.42
2021-12-29,Madhya Pradesh,1331,8,1324,17015,2547,1740,7.82,0,87.0,583570,4963,580193,2.93,2.0,0.19557471264367815,0.85,99.42
2021-12-30,Madhya Pradesh,809,8,803,10080,1985,1010,8.03,0,87.0,584379,4971,580996,2.28,1.16,0.11586206896551725,0.85,99.42
2021-12-31,Madhya Pradesh,1297,4,1297,16781,3619,2372,7.73,0,87.0,585676,4975,582293,4.16,2.73,0.19288505747126436,0.85,99.42
2022-01-01,Madhya Pradesh,191,1,185,2070,4984,3271,9.23,5,87.0,585867,4976,582478,5.73,3.76,0.02379310344827586,0.85,99.42
2022-01-02,Madhya Pradesh,1576,23,1574,19606,34,27,8.04,0,87.0,587443,4999,584052,0.04,0.03,0.22535632183908047,0.85,99.42
2022-01-03,Madhya Pradesh,706,4,704,9197,3935,2346,7.68,0,87.0,588149,5003,584756,4.52,2.7,0.10571264367816093,0.85,99.42
2022-01-04,Madhya Pradesh,1079,11,1078,13582,1260,355,7.94,0,87.0,589228,5014,585834,1.45,0.41,0.15611494252873565,0.85,99.42
2022-01-05,Madhya Pradesh,909,7,908,11364,3124,2858,8.0,0,87.0,590137,5021,586742,3.59,3.29,0.1306206896551724,0.85,99.42
2022-01-06,Madhya Pradesh,58,0,53,840,3644,1472,6.9,5,87.0,590195,5021,586795,4.19,1.69,0.009655172413793104,0.85,99.42
2022-01-07,Madhya Pradesh,415,5,412,5425,320,182,7.65,0,87.0,590610,5026,587207,0.37,0.21,0.06235632183908046,0.85,99.42
2022-01-08,Madhya Pradesh,1249,16,1248,16081,532,463,7.77,0,87.0,591859,5042,588455,0.61,0.53,0.18483908045977013,0.85,99.42
2022-01-09,Madhya Pradesh,306,4,301,3438,508,203,8.9,1,87.0,592165,5046,588756,0.58,0.23,0.03951724137931034,0.85,99.42
2022-01-10,Madhya Pradesh,821,9,812,10203,2648,1676,8.05,0,87.0,592986,5055,589568,3.04,1.93,0.11727586206896552,0.85,99.42
2022-01-11,Madhya Pradesh,474,2,474,5996,3126,1483,7.91,0,87.0,593460,5057,590042,3.59,1.7,0.06891954022988506,0.85,99.42
2022-01-12,Madhya Pradesh,816,7,814,10408,4467,547,7.84,0,87.0,594276,5064,590856,5.13,0.63,0.11963218390804597,0.85,99.42
2022-01-13,Madhya Pradesh,548,4,539,6589,3771,2298,8.32,5,87.0,594824,5068,591395,4.33,2.64,0.07573563218390805,0.85,99.42
2022-01-14,Madhya Pradesh,399,3,393,5017,1871,408,7.95,3,87.0,595223,5071,591788,2.15,0.47,0.057666666666666665,0.85,99.42
2022-01-15,Madhya Pradesh,1350,5,1349,17127,878,309,7.88,0,87.0,596573,5076,593137,1.01,0.36,0.19686206896551725,0.85,99.42
2022-01-16,Madhya Pradesh,558,7,549,7239,2258,1336,7.71,2,87.0,597131,5083,593686,2.6,1.54,0.08320689655172414,0.85,99.42
2022-01-17,Madhya Pradesh,70,0,70,784,2654,670,8.93,0,87.0,597201,5083,593756,3.05,0.77,0.009011494252873562,0.85,99.42
2022-01-18,Madhya Pradesh,1413,4,1407,17915,1327,353,7.89,2,87.0,598614,5087,595163,1.53,0.41,0.20591954022988507,0.85,99.42
2022-01-19,Madhya Pradesh,1138,5,1130,14409,3370,2530,7.9,3,87.0,599752,5092,596293,3.87,2.91,0.1656206896551724,0.85,99.42
2022-01-20,Madhya Pradesh,1263,3,1258,15717,2607,1604,8.04,2,87.0,601015,5095,597551,3.0,1.84,0.1806551724137931,0.85,99.42
2022-01-21,Madhya Pradesh,354,1,354,4846,4968,2923,7.3,0,87.0,601369,5096,597905,5.71,3.36,0.05570114942528736,0.85,99.42
2022-01-22,Madhya Pradesh,132,1,125,1715,24,8,7.7,6,87.0,601501,5097,598030,0.03,0.01,0.019712643678160918,0.85,99.42
2022-01-23,Madhya Pradesh,465,6,464,5413,3259,3185,8.59,0,87.0,601966,5103,598494,3.75,3.66,0.0622183908045977,0.85,99.42
2022-01-24,Madhya Pradesh,1007,8,1000,11916,2842,1490,8.45,0,87.0,602973,5111,599494,3.27,1.71,0.13696551724137931,0.85,99.42
2022-01-25,Madhya Pradesh,654,5,646,7944,2579,2401,8.23,3,87.0,603627,5116,600140,2.96,2.76,0.09131034482758621,0.85,99.42
2022-01-26,Madhya Pradesh,1054,6,1051,13388,2048,387,7.87,0,87.0,604681,5122,601191,2.35,0.44,0.15388505747126438,0.85,99.42
2022-01-27,Madhya Pradesh,1457,12,1454,18215,1950,1895,8.0,0,87.0,606138,5134,602645,2.24,2.18,0.209367816091954,0.85,99.42
2022-01-28,Madhya Pradesh,862,4,853,10614,4811,322,8.12,5,87.0,607000,5138,603498,5.53,0.37,0.122,0.85,99.42
2022-01-29,Madhya Pradesh,408,2,405,5190,1507,42,7.86,1,87.0,607408,5140,603903,1.73,0.05,0.0596551724137931,0.85,99.42
2022-01-30,Madhya Pradesh,1223,16,1216,15721,3691,2355,7.78,0,87.0,608631,5156,605119,4.24,2.71,0.18070114942528737,0.85,99.42
2022-01-31,Madhya Pradesh,1176,14,1168,15021,2997,379,7.83,0,87.0,609807,5170,606287,3.44,0.44,0.1726551724137931,0.85,99.42
2022-02-01,Madhya Pradesh,900,10,891,11115,4265,2336,8.1,0,87.0,610707,5180,607178,4.9,2.69,0.12775862068965518,0.85,99.42
2022-02-02,Madhya Pradesh,1566,12,1565,19497,625,271,8.03,0,87.0,612273,5192,608743,0.72,0.31,0.22410344827586207,0.85,99.42
2022-02-03,Madhya Pradesh,1034,10,1031,13366,1578,507,7.74,0,87.0,613307,5202,609774,1.81,0.58,0.15363218390804598,0.85,99.42
2022-02-04,Madhya Pradesh,463,6,459,6011,4989,2325,7.7,0,87.0,613770,5208,610233,5.73,2.67,0.06909195402298851,0.85,99.42
2022-02-05,Madhya Pradesh,1329,10,1325,16618,3585,2470,8.0,0,87.0,615099,5218,611558,4.12,2.84,0.19101149425287356,0.85,99.42
2022-02-06,Madhya Pradesh,573,8,567,6917,4206,11,8.28,0,87.0,615672,5226,612125,4.83,0.01,0.07950574712643678,0.85,99.42
2022-02-07,Madhya Pradesh,802,3,800,10136,4692,4390,7.91,0,87.0,616474,5229,612925,5.39,5.05,0.11650574712643678,0.85,99.42
2022-02-08,Madhya Pradesh,228,1,223,3136,2139,137,7.27,4,87.0,616702,5230,613148,2.46,0.16,0.03604597701149425,0.85,99.42
2022-02-09,Madhya Pradesh,1288,8,1282,15675,3297,2179,8.22,0,87.0,617990,5238,614430,3.79,2.5,0.18017241379310345,0.85,99.42
2022-02-10,Madhya Pradesh,974,4,973,12137,1090,253,8.03,0,87.0,618964,5242,615403,1.25,0.29,0.1395057471264368,0.85,99.42
2022-02-11,Madhya Pradesh,325,2,321,4267,1363,1053,7.62,2,87.0,619289,5244,615724,1.57,1.21,0.049045977011494254,0.85,99.42
2022-02-12,Madhya Pradesh,756,7,756,9726,1475,770,7.77,0,87.0,620045,5251,616480,1.7,0.89,0.11179310344827587,0.85,99.43
2022-02-13,Madhya Pradesh,41,0,37,760,1606,529,5.39,4,87.0,620086,5251,616517,1.85,0.61,0.008735632183908045,0.85,99.42
2022-02-14,Madhya Pradesh,1481,13,1473,18327,2202,2201,8.08,0,87.0,621567,5264,617990,2.53,2.53,0.2106551724137931,0.85,99.42
2022-02-15,Madhya Pradesh,277,1,270,3449,2921,1740,8.03,6,87.0,621844,5265,618260,3.36,2.0,0.03964367816091954,0.85,99.42
2022-02-16,Madhya Pradesh,999,10,992,12408,1199,955,8.05,0,87.0,622843,5275,619252,1.38,1.1,0.1426206896551724,0.85,99.42
2022-02-17,Madhya Pradesh,573,3,567,7175,240,42,7.99,3,87.0,623416,5278,619819,0.28,0.05,0.08247126436781609,0.85,99.42
2022-02-18,Madhya Pradesh,1228,14,1225,15253,2327,1636,8.05,0,87.0,624644,5292,621044,2.67,1.88,0.17532183908045976,0.85,99.42
2022-02-19,Madhya Pradesh,1333,4,1332,16617,70,13,8.02,0,87.0,625977,5296,622376,0.08,0.01,0.191,0.85,99.42
2022-02-20,Madhya Pradesh,574,3,569,6939,4584,2015,8.27,2,87.0,626551,5299,622945,5.27,2.32,0.07975862068965517,0.85,99.42
2022-02-21,Madhya Pradesh,1102,3,1093,13333,3729,2587,8.27,6,87.0,627653,5302,624038,4.29,2.97,0.1532528735632184,0.84,99.42
2022-02-22,Madhya Pradesh,1192,10,1183,15125,1637,937,7.88,0,87.0,628845,5312,625221,1.88,1.08,0.17385057471264367,0.84,99.42
2022-02-23,Madhya Pradesh,1378,20,1378,17443,4943,2918,7.9,0,87.0,630223,5332,626599,5.68,3.35,0.2004942528735632,0.85,99.42
2022-02-24,Madhya Pradesh,103,0,102,1366,4847,746,7.54,1,87.0,630326,5332,626701,5.57,0.86,0.015701149425287355,0.85,99.42
2022-02-25,Madhya Pradesh,387,4,386,4515,999,627,8.57,0,87.0,630713,5336,627087,1.15,0.72,0.05189655172413793,0.85,99.43
2022-02-26,Madhya Pradesh,369,1,363,4706,1209,576,7.84,5,87.0,631082,5337,627450,1.39,0.66,0.054091954022988505,0.85,99.42
2022-02-27,Madhya Pradesh,284,2,277,3427,4005,736,8.29,5,87.0,631366,5339,627727,4.6,0.85,0.03939080459770115,0.85,99.42
2022-02-28,Madhya Pradesh,634,7,628,7784,3106,1468,8.14,0,87.0,632000,5346,628355,3.57,1.69,0.08947126436781609,0.85,99.42
2022-03-01,Madhya Pradesh,213,2,207,2303,1979,1333,9.25,4,87.0,632213,5348,628562,2.27,1.53,0.02647126436781609,0.85,99.42
2022-03-02,Madhya Pradesh,1615,20,1615,19913,1487,83,8.11,0,87.0,633828,5368,630177,1.71,0.1,0.22888505747126436,0.85,99.42
2022-03-03,Madhya Pradesh,855,8,847,10564,2471,1249,8.09,0,87.0,634683,5376,631024,2.84,1.44,0.12142528735632184,0.85,99.42
2022-03-04,Madhya Pradesh,481,5,477,5989,727,518,8.03,0,87.0,635164,5381,631501,0.84,0.6,0.06883908045977012,0.85,99.42
2022-03-05,Madhya Pradesh,1413,16,1405,17700,2336,1254,7.98,0,87.0,636577,5397,632906,2.69,1.44,0.20344827586206896,0.85,99.42
2022-03-06,Madhya Pradesh,746,8,741,9450,37,21,7.89,0,87.0,637323,5405,633647,0.04,0.02,0.10862068965517241,0.85,99.42
2022-03-07,Madhya Pradesh,310,4,307,4193,139,83,7.39,0,87.0,637633,5409,633954,0.16,0.1,0.048195402298850575,0.85,99.42
2022-03-08,Madhya Pradesh,308,2,306,4046,2668,929,7.61,0,87.0,637941,5411,634260,3.07,1.07,0.046505747126436785,0.85,99.42
2022-03-09,Madhya Pradesh,630,8,622,7682,631,178,8.2,0,87.0,638571,5419,634882,0.73,0.2,0.08829885057471264,0.85,99.42
2022-03-10,Madhya Pradesh,1543,21,1539,19528,1470,171,7.9,0,87.0,640114,5440,636421,1.69,0.2,0.22445977011494253,0.85,99.42
2022-03-11,Madhya Pradesh,460,2,456,5902,3076,2069,7.79,2,87.0,640574,5442,636877,3.54,2.38,0.06783908045977012,0.85,99.42
2022-03-12,Madhya Pradesh,1419,5,1413,17723,1798,119,8.01,1,87.0,641993,5447,638290,2.07,0.14,0.20371264367816092,0.85,99.42
2022-03-13,Madhya Pradesh,1424,10,1421,17818,4298,4156,7.99,0,87.0,643417,5457,639711,4.94,4.78,0.20480459770114942,0.85,99.42
2022-03-14,Madhya Pradesh,143,1,139,1816,4730,1864,7.87,3,87.0,643560,5458,639850,5.44,2.14,0.020873563218390803,0.85,99.42
2022-03-15,Madhya Pradesh,336,1,336,4020,1672,930,8.36,0,87.0,643896,5459,640186,1.92,1.07,0.046206896551724136,0.85,99.42
2022-03-16,Madhya Pradesh,1402,18,1399,17330,3251,97,8.09,0,87.0,645298,5477,641585,3.74,0.11,0.19919540229885058,0.85,99.42
2022-03-17,Madhya Pradesh,772,2,766,9671,793,425,7.98,4,87.0,646070,5479,642351,0.91,0.49,0.11116091954022989,0.85,99.42
2022-03-18,Madhya Pradesh,504,5,503,6214,2184,317,8.11,0,87.0,646574,5484,642854,2.51,0.36,0.07142528735632184,0.85,99.42
2022-03-19,Madhya Pradesh,211,2,210,2587,37,12,8.16,0,87.0,646785,5486,643064,0.04,0.01,0.029735632183908046,0.85,99.42
2022-03-20,Madhya Pradesh,780,6,776,10152,2623,1258,7.68,0,87.0,647565,5492,643840,3.01,1.45,0.1166896551724138,0.85,99.42
2022-03-21,Madhya Pradesh,780,4,776,9491,4041,749,8.22,0,87.0,648345,5496,644616,4.64,0.86,0.1090919540229885,0.85,99.42
2022-03-22,Madhya Pradesh,1023,10,1017,12818,508,503,7.98,0,87.0,649368,5506,645633,0.58,0.58,0.14733333333333334,0.85,99.42
2022-03-23,Madhya Pradesh,336,1,333,4479,4581,3818,7.5,2,87.0,649704,5507,645966,5.27,4.39,0.051482758620689656,0.85,99.42
2022-03-24,Madhya Pradesh,1288,18,1280,15859,300,298,8.12,0,87.0,650992,5525,647246,0.34,0.34,0.18228735632183907,0.85,99.42
2022-03-25,Madhya Pradesh,13,0,4,515,3962,222,2.52,9,87.0,651005,5525,647250,4.55,0.26,0.005919540229885057,0.85,99.42
2022-03-26,Madhya Pradesh,83,0,79,516,4622,675,16.09,4,87.0,651088,5525,647329,5.31,0.78,0.00593103448275862,0.85,99.42
2022-03-27,Madhya Pradesh,145,2,136,1727,4848,3275,8.4,7,87.0,651233,5527,647465,5.57,3.76,0.01985057471264368,0.85,99.42
2022-03-28,Madhya Pradesh,1187,3,1185,14987,2570,1891,7.92,0,87.0,652420,5530,648650,2.95,2.17,0.17226436781609195,0.85,99.42
2022-03-29,Madhya Pradesh,1282,17,1281,16275,4565,635,7.88,0,87.0,653702,5547,649931,5.25,0.73,0.1870689655172414,0.85,99.42
2022-03-30,Madhya Pradesh,642,2,638,7953,2635,891,8.07,2,87.0,654344,5549,650569,3.03,1.02,0.09141379310344827,0.85,99.42
2022-03-31,Madhya Pradesh,1126,5,1126,13813,3024,1761,8.15,0,87.0,655470,5554,651695,3.48,2.02,0.15877011494252874,0.85,99.42
2022-04-01,Madhya Pradesh,1234,17,1226,15217,1146,636,8.11,0,87.0,656704,5571,652921,1.32,0.73,0.17490804597701148,0.85,99.42
2022-04-02,Madhya Pradesh,1374,10,1367,17426,789,398,7.88,0,87.0,658078,5581,654288,0.91,0.46,0.20029885057471264,0.85,99.42
2022-04-03,Madhya Pradesh,1406,11,1404,17698,3939,1374,7.94,0,87.0,659484,5592,655692,4.53,1.58,0.20342528735632184,0.85,99.43
2022-04-04,Madhya Pradesh,1268,6,1268,15565,3024,1467,8.15,0,87.0,660752,5598,656960,3.48,1.69,0.1789080459770115,0.85,99.43
2022-04-05,Madhya Pradesh,587,4,582,7550,4679,2921,7.77,1,87.0,661339,5602,657542,5.38,3.36,0.0867816091954023,0.85,99.43
2022-04-06,Madhya Pradesh,882,8,878,11349,397,326,7.77,0,87.0,662221,5610,658420,0.46,0.37,0.13044827586206897,0.85,99.43
2022-04-07,Madhya Pradesh,230,2,228,2652,2358,2335,8.67,0,87.0,662451,5612,658648,2.71,2.68,0.030482758620689655,0.85,99.43
2022-04-08,Madhya Pradesh,1406,15,1405,17300,2467,1474,8.13,0,87.0,663857,5627,660053,2.84,1.69,0.19885057471264367,0.85,99.43
2022-04-09,Madhya Pradesh,1373,4,1366,17062,1439,1229,8.05,3,87.0,665230,5631,661419,1.65,1.41,0.19611494252873563,0.85,99.43
2022-04-10,Madhya Pradesh,587,5,582,7910,407,249,7.42,0,87.0,665817,5636,662001,0.47,0.29,0.09091954022988506,0.85,99.43
2022-04-11,Madhya Pradesh,574,7,569,6884,2279,422,8.34,0,87.0,666391,5643,662570,2.62,0.49,0.07912643678160919,0.85,99.43
2022-04-12,Madhya Pradesh,294,3,293,3917,3528,2517,7.51,0,87.0,666685,5646,662863,4.06,2.89,0.045022988505747125,0.85,99.43
2022-04-13,Madhya Pradesh,839,5,837,10460,4620,3668,8.02,0,87.0,667524,5651,663700,5.31,4.22,0.12022988505747126,0.85,99.43
2022-04-14,Madhya Pradesh,1376,15,1369,17101,111,98,8.05,0,87.0,668900,5666,665069,0.13,0.11,0.1965632183908046,0.85,99.43
2022-04-15,Madhya Pradesh,769,9,765,9696,1603,660,7.93,0,87.0,669669,5675,665834,1.84,0.76,0.11144827586206897,0.85,99.43
2022-04-16,Madhya Pradesh,1292,6,1288,16283,2353,561,7.93,0,87.0,670961,5681,667122,2.7,0.64,0.1871609195402299,0.85,99.43
2022-04-17,Madhya Pradesh,745,4,742,9399,4738,2224,7.93,0,87.0,671706,5685,667864,5.45,2.56,0.1080344827586207,0.85,99.43
2022-04-18,Madhya Pradesh,795,2,787,9735,3194,2346,8.17,6,87.0,672501,5687,668651,3.67,2.7,0.11189655172413793,0.85,99.43
2022-04-19,Madhya Pradesh,1275,13,1269,16282,345,236,7.83,0,87.0,673776,5700,669920,0.4,0.27,0.1871494252873563,0.85,99.43
2022-04-20,Madhya Pradesh,1437,13,1432,18532,1712,230,7.75,0,87.0,675213,5713,671352,1.97,0.26,0.21301149425287355,0.85,99.43
2022-04-21,Madhya Pradesh,1326,9,1317,16333,4325,2077,8.12,0,87.0,676539,5722,672669,4.97,2.39,0.18773563218390804,0.85,99.43
2022-04-22,Madhya Pradesh,593,4,592,7454,3815,1598,7.96,0,87.0,677132,5726,673261,4.39,1.84,0.08567816091954022,0.85,99.43
2022-04-23,Madhya Pradesh,564,5,555,7050,1154,840,8.0,4,87.0,677696,5731,673816,1.33,0.97,0.08103448275862069,0.85,99.43
2022-04-24,Madhya Pradesh,1099,9,1098,14104,718,443,7.79,0,87.0,678795,5740,674914,0.83,0.51,0.16211494252873562,0.85,99.43
2022-04-25,Madhya Pradesh,985,9,976,12116,556,262,8.13,0,87.0,679780,5749,675890,0.64,0.3,0.13926436781609194,0.85,99.43
2022-04-26,Madhya Pradesh,501,2,495,6465,1480,681,7.75,4,87.0,680281,5751,676385,1.7,0.78,0.07431034482758621,0.85,99.43
2022-04-27,Madhya Pradesh,695,8,692,8854,2904,914,7.85,0,87.0,680976,5759,677077,3.34,1.05,0.10177011494252873,0.85,99.43
2022-04-28,Madhya Pradesh,672,7,663,8756,4223,1589,7.67,2,87.0,681648,5766,677740,4.85,1.83,0.10064367816091954,0.85,99.43
2022-04-29,Madhya Pradesh,1160,7,1152,14089,4974,3807,8.23,1,87.0,682808,5773,678892,5.72,4.38,0.1619425287356322,0.85,99.43
2022-04-30,Madhya Pradesh,1332,8,1329,16645,888,647,8.0,0,87.0,684140,5781,680221,1.02,0.74,0.19132183908045977,0.85,99.43
2022-05-01,Madhya Pradesh,551,2,547,7231,4177,3564,7.62,2,87.0,684691,5783,680768,4.8,4.1,0.08311494252873564,0.84,99.43
2022-05-02,Madhya Pradesh,998,6,995,12057,4594,237,8.28,0,87.0,685689,5789,681763,5.28,0.27,0.1385862068965517,0.84,99.43
2022-05-03,Madhya Pradesh,170,1,170,2652,982,773,6.41,0,87.0,685859,5790,681933,1.13,0.89,0.030482758620689655,0.84,99.43
2022-05-04,Madhya Pradesh,510,7,505,5873,3116,1279,8.68,0,87.0,686369,5797,682438,3.58,1.47,0.06750574712643678,0.84,99.43
2022-05-05,Madhya Pradesh,395,2,393,5102,4563,4050,7.74,0,87.0,686764,5799,682831,5.24,4.66,0.05864367816091954,0.84,99.43
2022-05-06,Madhya Pradesh,184,1,175,1705,4392,371,10.79,8,87.0,686948,5800,683006,5.05,0.43,0.019597701149425287,0.84,99.43
2022-05-07,Madhya Pradesh,1038,9,1030,13158,3659,1885,7.89,0,87.0,687986,5809,684036,4.21,2.17,0.15124137931034481,0.84,99.43
2022-05-08,Madhya Pradesh,1486,11,1479,18580,2781,1692,8.0,0,87.0,689472,5820,685515,3.2,1.94,0.2135632183908046,0.84,99.43
2022-05-09,Madhya Pradesh,1345,6,1342,16753,983,259,8.03,0,87.0,690817,5826,686857,1.13,0.3,0.1925632183908046,0.84,99.43
2022-05-10,Madhya Pradesh,1619,8,1611,19631,769,103,8.25,0,87.0,692436,5834,688468,0.88,0.12,0.22564367816091954,0.84,99.43
2022-05-11,Madhya Pradesh,331,2,326,4285,2809,344,7.72,3,87.0,692767,5836,688794,3.23,0.4,0.04925287356321839,0.84,99.43
2022-05-12,Madhya Pradesh,1211,13,1207,15785,2280,259,7.67,0,87.0,693978,5849,690001,2.62,0.3,0.1814367816091954,0.84,99.43
2022-05-13,Madhya Pradesh,141,0,140,1740,4454,4113,8.1,1,87.0,694119,5849,690141,5.12,4.73,0.02,0.84,99.43
2022-05-14,Madhya Pradesh,1433,5,1429,18495,669,593,7.75,0,87.0,695552,5854,691570,0.77,0.68,0.21258620689655172,0.84,99.43
2022-05-15,Madhya Pradesh,384,5,375,5077,196,3,7.56,4,87.0,695936,5859,691945,0.23,0.0,0.05835632183908046,0.84,99.43
2022-05-16,Madhya Pradesh,1083,12,1082,13306,904,488,8.14,0,87.0,697019,5871,693027,1.04,0.56,0.1529425287356322,0.84,99.43
2022-05-17,Madhya Pradesh,309,3,309,3891,4624,3205,7.94,0,87.0,697328,5874,693336,5.31,3.68,0.04472413793103448,0.84,99.43
2022-05-18,Madhya Pradesh,88,1,85,562,1662,1295,15.66,2,87.0,697416,5875,693421,1.91,1.49,0.006459770114942529,0.84,99.43
2022-05-19,Madhya Pradesh,797,5,793,10101,1366,3,7.89,0,87.0,698213,5880,694214,1.57,0.0,0.11610344827586207,0.84,99.43
2022-05-20,Madhya Pradesh,318,2,314,3910,2548,155,8.13,2,87.0,698531,5882,694528,2.93,0.18,0.04494252873563218,0.84,99.43
2022-05-21,Madhya Pradesh,8,0,6,562,578,320,1.42,2,87.0,698539,5882,694534,0.66,0.37,0.006459770114942529,0.84,99.43
2022-05-22,Madhya Pradesh,210,2,204,2221,2306,1730,9.46,4,87.0,698749,5884,694738,2.65,1.99,0.02552873563218391,0.84,99.43
2022-05-23,Madhya Pradesh,1471,18,1466,18306,3469,2842,8.04,0,87.0,700220,5902,696204,3.99,3.27,0.21041379310344827,0.84,99.43
2022-05-24,Madhya Pradesh,1168,7,1165,14404,2278,2096,8.11,0,87.0,701388,5909,697369,2.62,2.41,0.1655632183908046,0.84,99.43
2022-05-25,Madhya Pradesh,74,0,65,530,2714,187,13.96,9,87.0,701462,5909,697434,3.12,0.21,0.006091954022988505,0.84,99.43
2022-05-26,Madhya Pradesh,1338,6,1332,17202,3431,96,7.78,0,87.0,702800,5915,698766,3.94,0.11,0.1977241379310345,0.84,99.43
2022-05-27,Madhya Pradesh,247,1,239,2981,3989,89,8.29,7,87.0,703047,5916,699005,4.59,0.1,0.034264367816091955,0.84,99.43
2022-05-28,Madhya Pradesh,552,3,550,7043,1633,148,7.84,0,87.0,703599,5919,699555,1.88,0.17,0.08095402298850575,0.84,99.43
2022-05-29,Madhya Pradesh,1037,5,1031,12913,3504,977,8.03,1,87.0,704636,5924,700586,4.03,1.12,0.14842528735632185,0.84,99.43
2022-05-30,Madhya Pradesh,289,1,286,3537,997,744,8.17,2,87.0,704925,5925,700872,1.15,0.86,0.0406551724137931,0.84,99.43
2022-05-31,Madhya Pradesh,325,4,320,4417,1560,145,7.36,1,87.0,705250,5929,701192,1.79,0.17,0.050770114942528734,0.84,99.42
2022-06-01,Madhya Pradesh,181,1,180,2089,2838,2517,8.66,0,87.0,705431,5930,701372,3.26,2.89,0.024011494252873564,0.84,99.42
2022-06-02,Madhya Pradesh,1441,11,1438,18228,1485,1137,7.91,0,87.0,706872,5941,702810,1.71,1.31,0.20951724137931035,0.84,99.43
2022-06-03,Madhya Pradesh,985,10,984,12030,1173,452,8.19,0,87.0,707857,5951,703794,1.35,0.52,0.13827586206896553,0.84,99.43
2022-06-04,Madhya Pradesh,1153,7,1146,14317,3596,3453,8.05,0,87.0,709010,5958,704940,4.13,3.97,0.1645632183908046,0.84,99.43
2022-06-05,Madhya Pradesh,220,1,212,2817,162,112,7.81,7,87.0,709230,5959,705152,0.19,0.13,0.032379310344827585,0.84,99.43
2022-06-06,Madhya Pradesh,1454,9,1445,18107,3852,1675,8.03,0,87.0,710684,5968,706597,4.43,1.93,0.2081264367816092,0.84,99.42
2022-06-07,Madhya Pradesh,937,11,937,11388,4435,2080,8.23,0,87.0,711621,5979,707534,5.1,2.39,0.13089655172413794,0.84,99.43
2022-06-08,Madhya Pradesh,1497,14,1490,18994,2813,1522,7.88,0,87.0,713118,5993,709024,3.23,1.75,0.21832183908045977,0.84,99.43
2022-06-09,Madhya Pradesh,605,4,597,7696,2205,1277,7.86,4,87.0,713723,5997,709621,2.53,1.47,0.08845977011494253,0.84,99.43
2022-06-10,Madhya Pradesh,120,0,120,1416,2661,768,8.47,0,87.0,713843,5997,709741,3.06,0.88,0.016275862068965516,0.84,99.43
2022-06-11,Madhya Pradesh,1438,11,1432,17956,3661,13,8.01,0,87.0,715281,6008,711173,4.21,0.01,0.20639080459770115,0.84,99.43
2022-06-12,Madhya Pradesh,922,5,919,11767,1788,1698,7.84,0,87.0,716203,6013,712092,2.06,1.95,0.13525287356321838,0.84,99.43
2022-06-13,Madhya Pradesh,1185,8,1181,14991,4426,149,7.9,0,87.0,717388,6021,713273,5.09,0.17,0.1723103448275862,0.84,99.43
2022-06-14,Madhya Pradesh,1088,5,1085,13320,450,82,8.17,0,87.0,718476,6026,714358,0.52,0.09,0.15310344827586206,0.84,99.43
2022-06-15,Madhya Pradesh,437,4,428,5783,4792,3381,7.56,5,87.0,718913,6030,714786,5.51,3.89,0.06647126436781609,0.84,99.43
2022-06-16,Madhya Pradesh,1160,14,1152,14523,424,206,7.99,0,87.0,720073,6044,715938,0.49,0.24,0.16693103448275862,0.84,99.43
2022-06-17,Madhya Pradesh,671,7,669,8262,1718,1620,8.12,0,87.0,720744,6051,716607,1.97,1.86,0.0949655172413793,0.84,99.43
2022-06-18,Madhya Pradesh,479,4,474,5965,2877,1553,8.03,1,87.0,721223,6055,717081,3.31,1.79,0.06856321839080459,0.84,99.43
2022-06-19,Madhya Pradesh,765,3,758,9435,3874,303,8.11,4,87.0,721988,6058,717839,4.45,0.35,0.10844827586206897,0.84,99.43
2022-06-20,Madhya Pradesh,765,8,761,9541,2664,1814,8.02,0,87.0,722753,6066,718600,3.06,2.09,0.10966666666666666,0.84,99.43
2022-06-21,Madhya Pradesh,1287,6,1283,15685,2580,842,8.21,0,87.0,724040,6072,719883,2.97,0.97,0.1802873563218391,0.84,99.43
2022-06-22,Madhya Pradesh,455,5,453,5704,3123,26,7.98,0,87.0,724495,6077,720336,3.59,0.03,0.0655632183908046,0.84,99.43
2022-06-23,Madhya Pradesh,1166,8,1159,14552,4331,3735,8.01,0,87.0,725661,6085,721495,4.98,4.29,0.16726436781609194,0.84,99.43
2022-06-24,Madhya Pradesh,743,9,737,8995,2159,1125,8.26,0,87.0,726404,6094,722232,2.48,1.29,0.10339080459770116,0.84,99.43
2022-06-25,Madhya Pradesh,297,4,296,3823,1138,507,7.77,0,87.0,726701,6098,722528,1.31,0.58,0.04394252873563218,0.84,99.43
2022-06-26,Madhya Pradesh,959,9,955,11976,3583,1063,8.01,0,87.0,727660,6107,723483,4.12,1.22,0.1376551724137931,0.84,99.43
2022-06-27,Madhya Pradesh,1043,6,1043,13045,3499,2428,8.0,0,87.0,728703,6113,724526,4.02,2.79,0.14994252873563219,0.84,99.43
2022-06-28,Madhya Pradesh,962,11,958,11655,2176,282,8.25,0,87.0,729665,6124,725484,2.5,0.32,0.1339655172413793,0.84,99.43
2022-06-29,Madhya Pradesh,251,2,249,3132,2814,1045,8.01,0,87.0,729916,6126,725733,3.23,1.2,0.036,0.84,99.43
2022-06-30,Madhya Pradesh,1119,16,1115,13779,4027,3876,8.12,0,87.0,731035,6142,726848,4.63,4.46,0.15837931034482758,0.84,99.43
2022-07-01,Madhya Pradesh,566,8,562,7073,1018,638,8.0,0,87.0,731601,6150,727410,1.17,0.73,0.08129885057471264,0.84,99.43
2022-07-02,Madhya Pradesh,1120,9,1117,14189,4941,3234,7.89,0,87.0,732721,6159,728527,5.68,3.72,0.1630919540229885,0.84,99.43
2022-07-03,Madhya Pradesh,1315,10,1309,16600,3194,2237,7.92,0,87.0,734036,6169,729836,3.67,2.57,0.19080459770114944,0.84,99.43
2022-07-04,Madhya Pradesh,220,2,218,2592,3436,57,8.49,0,87.0,734256,6171,730054,3.95,0.07,0.029793103448275862,0.84,99.43
2022-07-05,Madhya Pradesh,1179,11,1173,14946,3832,2119,7.89,0,87.0,735435,6182,731227,4.4,2.44,0.17179310344827586,0.84,99.43
2022-07-06,Madhya Pradesh,1135,7,1133,13957,3087,224,8.13,0,87.0,736570,6189,732360,3.55,0.26,0.16042528735632183,0.84,99.43
2022-07-07,Madhya Pradesh,774,5,767,9804,3578,3024,7.89,2,87.0,737344,6194,733127,4.11,3.48,0.11268965517241379,0.84,99.43
2022-07-08,Madhya Pradesh,961,4,960,12113,4914,4410,7.93,0,87.0,738305,6198,734087,5.65,5.07,0.13922988505747128,0.84,99.43
2022-07-09,Madhya Pradesh,867,3,862,10764,3159,663,8.05,2,87.0,739172,6201,734949,3.63,0.76,0.12372413793103448,0.84,99.43
2022-07-10,Madhya Pradesh,1005,14,1001,12773,1713,519,7.87,0,87.0,740177,6215,735950,1.97,0.6,0.14681609195402298,0.84,99.43
2022-07-11,Madhya Pradesh,220,1,218,3097,4929,3553,7.1,1,87.0,740397,6216,736168,5.67,4.08,0.03559770114942529,0.84,99.43
2022-07-12,Madhya Pradesh,717,5,708,8715,1652,1554,8.23,4,87.0,741114,6221,736876,1.9,1.79,0.10017241379310345,0.84,99.43
2022-07-13,Madhya Pradesh,695,6,693,8739,306,155,7.95,0,87.0,741809,6227,737569,0.35,0.18,0.10044827586206896,0.84,99.43
2022-07-14,Madhya Pradesh,297,1,288,3539,536,501,8.39,8,87.0,742106,6228,737857,0.62,0.58,0.04067816091954023,0.84,99.43
2022-07-15,Madhya Pradesh,542,5,534,6733,1015,21,8.05,3,87.0,742648,6233,738391,1.17,0.02,0.07739080459770115,0.84,99.43
2022-07-16,Madhya Pradesh,1041,12,1041,13231,4461,2294,7.87,0,87.0,743689,6245,739432,5.13,2.64,0.15208045977011495,0.84,99.43
2022-07-17,Madhya Pradesh,868,10,867,10477,2376,2216,8.28,0,87.0,744557,6255,740299,2.73,2.55,0.12042528735632184,0.84,99.43
2022-07-18,Madhya Pradesh,728,9,722,8950,982,657,8.13,0,87.0,745285,6264,741021,1.13,0.76,0.1028735632183908,0.84,99.43
2022-07-19,Madhya Pradesh,1000,12,997,12635,88,71,7.91,0,87.0,746285,6276,742018,0.1,0.08,0.14522988505747125,0.84,99.43
2022-07-20,Madhya Pradesh,941,14,939,11360,47,39,8.28,0,87.0,747226,6290,742957,0.05,0.04,0.13057471264367815,0.84,99.43
2022-07-21,Madhya Pradesh,1273,18,1268,16162,2598,1597,7.88,0,87.0,748499,6308,744225,2.99,1.84,0.18577011494252874,0.84,99.43
2022-07-22,Madhya Pradesh,1045,15,1037,13118,2103,825,7.97,0,87.0,749544,6323,745262,2.42,0.95,0.1507816091954023,0.84,99.43
2022-07-23,Madhya Pradesh,1193,13,1191,14603,1829,1224,8.17,0,87.0,750737,6336,746453,2.1,1.41,0.16785057471264367,0.84,99.43
2022-07-24,Madhya Pradesh,853,9,848,10727,4456,3445,7.95,0,87.0,751590,6345,747301,5.12,3.96,0.12329885057471264,0.84,99.43
2022-07-25,Madhya Pradesh,539,5,534,6946,645,174,7.76,0,87.0,752129,6350,747835,0.74,0.2,0.07983908045977012,0.84,99.43
2022-07-26,Madhya Pradesh,771,7,771,9945,660,143,7.75,0,87.0,752900,6357,748606,0.76,0.16,0.1143103448275862,0.84,99.43
2022-07-27,Madhya Pradesh,151,0,149,1501,4667,4409,10.06,2,87.0,753051,6357,748755,5.36,5.07,0.01725287356321839,0.84,99.43
2022-07-28,Madhya Pradesh,266,2,263,3375,4267,2391,7.88,1,87.0,753317,6359,749018,4.9,2.75,0.03879310344827586,0.84,99.43
2022-07-29,Madhya Pradesh,357,1,357,4419,1323,1013,8.08,0,87.0,753674,6360,749375,1.52,1.16,0.05079310344827586,0.84,99.43
2022-07-30,Madhya Pradesh,1270,5,1270,16102,4664,156,7.89,0,87.0,754944,6365,750645,5.36,0.18,0.18508045977011495,0.84,99.43
2022-07-31,Madhya Pradesh,706,5,698,8750,2242,569,8.07,3,87.0,755650,6370,751343,2.58,0.65,0.10057471264367816,0.84,99.43
2022-08-01,Madhya Pradesh,1069,6,1060,13256,950,377,8.06,3,87.0,756719,6376,752403,1.09,0.43,0.15236781609195402,0.84,99.43
2022-08-02,Madhya Pradesh,563,5,557,7182,3311,2722,7.84,1,87.0,757282,6381,752960,3.81,3.13,0.08255172413793103,0.84,99.43
2022-08-03,Madhya Pradesh,1536,16,1527,19375,1515,159,7.93,0,87.0,758818,6397,754487,1.74,0.18,0.22270114942528735,0.84,99.43
2022-08-04,Madhya Pradesh,841,4,836,10362,2150,1633,8.12,1,87.0,759659,6401,755323,2.47,1.88,0.11910344827586207,0.84,99.43
2022-08-05,Madhya Pradesh,570,6,561,7530,4016,681,7.57,3,87.0,760229,6407,755884,4.62,0.78,0.08655172413793104,0.84,99.43
2022-08-06,Madhya Pradesh,655,5,646,7999,3022,1823,8.19,4,87.0,760884,6412,756530,3.47,2.1,0.09194252873563219,0.84,99.43
2022-08-07,Madhya Pradesh,1318,18,1309,16722,4407,3633,7.88,0,87.0,762202,6430,757839,5.07,4.18,0.19220689655172413,0.84,99.43
2022-08-08,Madhya Pradesh,1023,5,1023,13180,995,936,7.76,0,87.0,763225,6435,758862,1.14,1.08,0.15149425287356322,0.84,99.43
2022-08-09,Madhya Pradesh,788,6,785,10182,1517,1032,7.74,0,87.0,764013,6441,759647,1.74,1.19,0.11703448275862069,0.84,99.43
2022-08-10,Madhya Pradesh,637,6,631,7750,3521,2721,8.22,0,87.0,764650,6447,760278,4.05,3.13,0.08908045977011494,0.84,99.43
2022-08-11,Madhya Pradesh,1352,18,1344,16837,1699,1389,8.03,0,87.0,766002,6465,761622,1.95,1.6,0.1935287356321839,0.84,99.43
2022-08-12,Madhya Pradesh,615,3,611,7387,603,230,8.33,1,87.0,766617,6468,762233,0.69,0.26,0.0849080459770115,0.84,99.43
2022-08-13,Madhya Pradesh,299,1,296,3685,1561,1283,8.11,2,87.0,766916,6469,762529,1.79,1.47,0.04235632183908046,0.84,99.43
2022-08-14,Madhya Pradesh,14,0,5,580,2546,768,2.41,9,87.0,766930,6469,762534,2.93,0.88,0.006666666666666667,0.84,99.43
2022-08-15,Madhya Pradesh,1213,11,1213,15469,771,371,7.84,0,87.0,768143,6480,763747,0.89,0.43,0.17780459770114942,0.84,99.43
2022-08-16,Madhya Pradesh,513,4,508,6545,1746,1567,7.84,1,87.0,768656,6484,764255,2.01,1.8,0.07522988505747126,0.84,99.43
2022-08-17,Madhya Pradesh,1398,16,1390,17313,820,341,8.07,0,87.0,770054,6500,765645,0.94,0.39,0.199,0.84,99.43
2022-08-18,Madhya Pradesh,647,8,645,7858,4838,4172,8.23,0,87.0,770701,6508,766290,5.56,4.8,0.09032183908045976,0.84,99.43
2022-08-19,Madhya Pradesh,106,0,100,1353,1190,62,7.83,6,87.0,770807,6508,766390,1.37,0.07,0.015551724137931034,0.84,99.43
2022-08-20,Madhya Pradesh,1037,3,1030,12815,2204,1523,8.09,4,87.0,771844,6511,767420,2.53,1.75,0.14729885057471265,0.84,99.43
2022-08-21,Madhya Pradesh,1387,12,1380,17348,2064,520,8.0,0,87.0,773231,6523,768800,2.37,0.6,0.1994022988505747,0.84,99.43
2022-08-22,Madhya Pradesh,412,5,412,5204,2289,1910,7.92,0,87.0,773643,6528,769212,2.63,2.2,0.05981609195402299,0.84,99.43
2022-08-23,Madhya Pradesh,731,2,727,8817,382,121,8.29,2,87.0,774374,6530,769939,0.44,0.14,0.1013448275862069,0.84,99.43
2022-08-24,Madhya Pradesh,1364,7,1359,17003,2545,1737,8.02,0,87.0,775738,6537,771298,2.93,2.0,0.1954367816091954,0.84,99.43
2022-08-25,Madhya Pradesh,66,0,62,593,229,197,11.13,4,87.0,775804,6537,771360,0.26,0.23,0.006816091954022989,0.84,99.43
2022-08-26,Madhya Pradesh,117,0,110,1384,23,7,8.45,7,87.0,775921,6537,771470,0.03,0.01,0.015908045977011495,0.84,99.43
2022-08-27,Madhya Pradesh,319,1,317,4184,3464,741,7.62,1,87.0,776240,6538,771787,3.98,0.85,0.048091954022988506,0.84,99.43
2022-08-28,Madhya Pradesh,1629,9,1627,19985,1948,1053,8.15,0,87.0,777869,6547,773414,2.24,1.21,0.2297126436781609,0.84,99.43
2022-08-29,Madhya Pradesh,1309,11,1305,16439,2355,1963,7.96,0,87.0,779178,6558,774719,2.71,2.26,0.18895402298850575,0.84,99.43
2022-08-30,Madhya Pradesh,1361,13,1353,17265,2850,2489,7.88,0,87.0,780539,6571,776072,3.28,2.86,0.19844827586206898,0.84,99.43
2022-08-31,Madhya Pradesh,161,1,152,1519,2407,989,10.6,8,87.0,780700,6572,776224,2.77,1.14,0.017459770114942527,0.84,99.43
2022-09-01,Madhya Pradesh,589,5,581,7113,2553,839,8.28,3,87.0,781289,6577,776805,2.93,0.96,0.08175862068965517,0.84,99.43
2022-09-02,Madhya Pradesh,1053,9,1053,13150,864,154,8.01,0,87.0,782342,6586,777858,0.99,0.18,0.1511494252873563,0.84,99.43
2022-09-03,Madhya Pradesh,492,2,491,5856,145,25,8.4,0,87.0,782834,6588,778349,0.17,0.03,0.0673103448275862,0.84,99.43
2022-09-04,Madhya Pradesh,781,8,777,9532,2833,2741,8.19,0,87.0,783615,6596,779126,3.26,3.15,0.1095632183908046,0.84,99.43
2022-09-05,Madhya Pradesh,1196,5,1192,14898,879,722,8.03,0,87.0,784811,6601,780318,1.01,0.83,0.17124137931034483,0.84,99.43
2022-09-06,Madhya Pradesh,408,3,400,5790,692,367,7.05,5,87.0,785219,6604,780718,0.8,0.42,0.06655172413793103,0.84,99.43
2022-09-07,Madhya Pradesh,766,9,766,9530,4241,854,8.04,0,87.0,785985,6613,781484,4.87,0.98,0.10954022988505747,0.84,99.43
2022-09-08,Madhya Pradesh,1423,6,1414,17687,3965,1455,8.05,3,87.0,787408,6619,782898,4.56,1.67,0.20329885057471264,0.84,99.43
2022-09-09,Madhya Pradesh,864,12,862,11004,2143,482,7.85,0,87.0,788272,6631,783760,2.46,0.55,0.12648275862068967,0.84,99.43
2022-09-10,Madhya Pradesh,130,1,123,1370,863,127,9.49,6,87.0,788402,6632,783883,0.99,0.15,0.015747126436781608,0.84,99.43
2022-09-11,Madhya Pradesh,700,2,691,8828,2632,793,7.93,7,87.0,789102,6634,784574,3.03,0.91,0.10147126436781609,0.84,99.43
2022-09-12,Madhya Pradesh,1417,9,1411,18021,1789,141,7.86,0,87.0,790519,6643,785985,2.06,0.16,0.20713793103448275,0.84,99.43
2022-09-13,Madhya Pradesh,601,8,596,7403,1292,134,8.12,0,87.0,791120,6651,786581,1.49,0.15,0.08509195402298851,0.84,99.43
2022-09-14,Madhya Pradesh,1226,7,1224,14986,4649,4222,8.18,0,87.0,792346,6658,787805,5.34,4.85,0.1722528735632184,0.84,99.43
2022-09-15,Madhya Pradesh,1160,13,1151,14429,774,551,8.04,0,87.0,793506,6671,788956,0.89,0.63,0.16585057471264367,0.84,99.43
2022-09-16,Madhya Pradesh,635,7,626,8071,2754,1833,7.87,2,87.0,794141,6678,789582,3.17,2.11,0.09277011494252874,0.84,99.43
2022-09-17,Madhya Pradesh,627,3,619,8176,38,35,7.67,5,87.0,794768,6681,790201,0.04,0.04,0.09397701149425287,0.84,99.43
2022-09-18,Madhya Pradesh,556,7,552,6907,1621,613,8.05,0,87.0,795324,6688,790753,1.86,0.7,0.07939080459770115,0.84,99.43
2022-09-19,Madhya Pradesh,749,8,742,9502,471,90,7.88,0,87.0,796073,6696,791495,0.54,0.1,0.1092183908045977,0.84,99.42
2022-09-20,Madhya Pradesh,1107,13,1101,14142,605,519,7.83,0,87.0,797180,6709,792596,0.7,0.6,0.16255172413793104,0.84,99.42
2022-09-21,Madhya Pradesh,1356,14,1351,16527,4752,3016,8.2,0,87.0,798536,6723,793947,5.46,3.47,0.1899655172413793,0.84,99.43
2022-09-22,Madhya Pradesh,836,3,831,10421,3083,2198,8.02,2,87.0,799372,6726,794778,3.54,2.53,0.1197816091954023,0.84,99.43
2022-09-23,Madhya Pradesh,781,6,774,9728,281,80,8.03,1,87.0,800153,6732,795552,0.32,0.09,0.11181609195402299,0.84,99.42
2022-09-24,Madhya Pradesh,619,3,615,7884,4511,2196,7.85,1,87.0,800772,6735,796167,5.19,2.52,0.09062068965517242,0.84,99.42
2022-09-25,Madhya Pradesh,890,4,884,11253,43,40,7.91,2,87.0,801662,6739,797051,0.05,0.05,0.12934482758620688,0.84,99.42
2022-09-26,Madhya Pradesh,929,11,920,11664,1991,430,7.96,0,87.0,802591,6750,797971,2.29,0.49,0.13406896551724137,0.84,99.42
2022-09-27,Madhya Pradesh,741,2,734,9395,3123,648,7.89,5,87.0,803332,6752,798705,3.59,0.74,0.10798850574712644,0.84,99.42
2022-09-28,Madhya Pradesh,911,8,904,10833,247,74,8.41,0,87.0,804243,6760,799609,0.28,0.09,0.12451724137931035,0.84,99.42
2022-09-29,Madhya Pradesh,1305,10,1300,16079,927,535,8.12,0,87.0,805548,6770,800909,1.07,0.61,0.184816091954023,0.84,99.42
2022-09-30,Madhya Pradesh,1189,6,1181,14918,4347,245,7.97,2,87.0,806737,6776,802090,5.0,0.28,0.1714712643678161,0.84,99.42
2022-10-01,Madhya Pradesh,1223,11,1219,15172,2260,1501,8.06,0,87.0,807960,6787,803309,2.6,1.73,0.17439080459770115,0.84,99.42
2022-10-02,Madhya Pradesh,955,8,950,12013,640,171,7.95,0,87.0,808915,6795,804259,0.74,0.2,0.13808045977011493,0.84,99.42
2022-10-03,Madhya Pradesh,433,5,425,5225,4773,1448,8.29,3,87.0,809348,6800,804684,5.49,1.66,0.060057471264367814,0.84,99.42
2022-10-04,Madhya Pradesh,179,1,177,2432,2235,1237,7.36,1,87.0,809527,6801,804861,2.57,1.42,0.027954022988505748,0.84,99.42
2022-10-05,Madhya Pradesh,790,2,782,9254,4769,1467,8.54,6,87.0,810317,6803,805643,5.48,1.69,0.10636781609195402,0.84,99.42
2022-10-06,Madhya Pradesh,768,6,762,10124,1972,1250,7.59,0,87.0,811085,6809,806405,2.27,1.44,0.11636781609195403,0.84,99.42
2022-10-07,Madhya Pradesh,483,3,478,6100,4913,2365,7.92,2,87.0,811568,6812,806883,5.65,2.72,0.07011494252873564,0.84,99.42
2022-10-08,Madhya Pradesh,89,1,80,1300,1241,888,6.85,8,87.0,811657,6813,806963,1.43,1.02,0.014942528735632184,0.84,99.42
2022-10-09,Madhya Pradesh,1214,17,1211,15063,876,32,8.06,0,87.0,812871,6830,808174,1.01,0.04,0.17313793103448274,0.84,99.42
2022-10-10,Madhya Pradesh,131,0,131,1803,2403,1138,7.27,0,87.0,813002,6830,808305,2.76,1.31,0.020724137931034482,0.84,99.42
2022-10-11,Madhya Pradesh,257,2,256,3011,160,6,8.54,0,87.0,813259,6832,808561,0.18,0.01,0.03460919540229885,0.84,99.42
2022-10-12,Madhya Pradesh,1306,10,1298,16586,4091,2583,7.87,0,87.0,814565,6842,809859,4.7,2.97,0.19064367816091954,0.84,99.42
2022-10-13,Madhya Pradesh,660,9,651,7882,4349,1601,8.37,0,87.0,815225,6851,810510,5.0,1.84,0.0905977011494253,0.84,99.42
2022-10-14,Madhya Pradesh,1251,7,1243,15956,1184,641,7.84,1,87.0,816476,6858,811753,1.36,0.74,0.1834022988505747,0.84,99.42
2022-10-15,Madhya Pradesh,467,2,466,5621,4555,3708,8.31,0,87.0,816943,6860,812219,5.24,4.26,0.06460919540229886,0.84,99.42
2022-10-16,Madhya Pradesh,154,1,147,1961,4522,2302,7.85,6,87.0,817097,6861,812366,5.2,2.65,0.02254022988505747,0.84,99.42
2022-10-17,Madhya Pradesh,1130,15,1121,13909,2339,1782,8.12,0,87.0,818227,6876,813487,2.69,2.05,0.1598735632183908,0.84,99.42
2022-10-18,Madhya Pradesh,752,11,749,9535,2304,209,7.89,0,87.0,818979,6887,814236,2.65,0.24,0.10959770114942528,0.84,99.42
2022-10-19,Madhya Pradesh,434,1,425,5652,4415,3253,7.68,8,87.0,819413,6888,814661,5.07,3.74,0.0649655172413793,0.84,99.42
2022-10-20,Madhya Pradesh,1209,16,1205,15210,2463,1833,7.95,0,87.0,820622,6904,815866,2.83,2.11,0.17482758620689656,0.84,99.42
2022-10-21,Madhya Pradesh,392,3,388,5110,2619,810,7.67,1,87.0,821014,6907,816254,3.01,0.93,0.058735632183908044,0.84,99.42
2022-10-22,Madhya Pradesh,1003,10,996,12424,4978,1877,8.07,0,87.0,822017,6917,817250,5.72,2.16,0.14280459770114942,0.84,99.42
2022-10-23,Madhya Pradesh,420,3,420,5570,2754,2485,7.54,0,87.0,822437,6920,817670,3.17,2.86,0.06402298850574713,0.84,99.42
2022-10-24,Madhya Pradesh,230,3,226,2385,1477,201,9.64,1,87.0,822667,6923,817896,1.7,0.23,0.027413793103448277,0.84,99.42
2022-10-25,Madhya Pradesh,1179,17,1170,14797,3524,818,7.97,0,87.0,823846,6940,819066,4.05,0.94,0.17008045977011493,0.84,99.42
2022-10-26,Madhya Pradesh,630,1,624,7974,1334,4,7.9,5,87.0,824476,6941,819690,1.53,0.0,0.0916551724137931,0.84,99.42
2022-10-27,Madhya Pradesh,696,5,689,8807,4160,2398,7.9,2,87.0,825172,6946,820379,4.78,2.76,0.10122988505747127,0.84,99.42
2022-10-28,Madhya Pradesh,972,14,964,12453,1423,1070,7.81,0,87.0,826144,6960,821343,1.64,1.23,0.14313793103448275,0.84,99.42
2022-10-29,Madhya Pradesh,197,1,193,2411,4910,4543,8.17,3,87.0,826341,6961,821536,5.64,5.22,0.02771264367816092,0.84,99.42
2022-10-30,Madhya Pradesh,1151,17,1146,14593,2232,1347,7.89,0,87.0,827492,6978,822682,2.57,1.55,0.16773563218390805,0.84,99.42
2022-10-31,Madhya Pradesh,119,1,110,1317,1085,384,9.04,8,87.0,827611,6979,822792,1.25,0.44,0.015137931034482759,0.84,99.42
2022-11-01,Madhya Pradesh,1365,15,1364,16979,1498,1453,8.04,0,87.0,828976,6994,824156,1.72,1.67,0.19516091954022988,0.84,99.42
2022-11-02,Madhya Pradesh,1093,5,1093,13741,4250,2277,7.95,0,87.0,830069,6999,825249,4.89,2.62,0.1579425287356322,0.84,99.42
2022-11-03,Madhya Pradesh,619,3,618,7726,877,310,8.01,0,87.0,830688,7002,825867,1.01,0.36,0.08880459770114943,0.84,99.42
2022-11-04,Madhya Pradesh,153,1,149,2001,4318,3943,7.65,3,87.0,830841,7003,826016,4.96,4.53,0.023,0.84,99.42
2022-11-05,Madhya Pradesh,198,1,189,2134,2188,980,9.28,8,87.0,831039,7004,826205,2.51,1.13,0.02452873563218391,0.84,99.42
2022-11-06,Madhya Pradesh,1136,4,1127,13685,611,447,8.3,5,87.0,832175,7008,827332,0.7,0.51,0.15729885057471266,0.84,99.42
2022-11-07,Madhya Pradesh,1115,11,1113,13956,1866,1369,7.99,0,87.0,833290,7019,828445,2.14,1.57,0.16041379310344828,0.84,99.42
2022-11-08,Madhya Pradesh,1589,12,1589,19951,186,178,7.96,0,87.0,834879,7031,830034,0.21,0.2,0.22932183908045978,0.84,99.42
2022-11-09,Madhya Pradesh,626,3,622,7591,1260,17,8.25,1,87.0,835505,7034,830656,1.45,0.02,0.0872528735632184,0.84,99.42
2022-11-10,Madhya Pradesh,1097,9,1091,13490,2231,1758,8.13,0,87.0,836602,7043,831747,2.56,2.02,0.1550574712643678,0.84,99.42
2022-11-11,Madhya Pradesh,1306,8,1301,16123,1156,264,8.1,0,87.0,837908,7051,833048,1.33,0.3,0.18532183908045977,0.84,99.42
2022-11-12,Madhya Pradesh,1260,12,1260,15486,2489,359,8.14,0,87.0,839168,7063,834308,2.86,0.41,0.178,0.84,99.42
2022-11-13,Madhya Pradesh,721,9,715,9065,2489,2127,7.95,0,87.0,839889,7072,835023,2.86,2.44,0.10419540229885058,0.84,99.42
2022-11-14,Madhya Pradesh,102,0,93,1027,4781,2535,9.93,9,87.0,839991,7072,835116,5.5,2.91,0.011804597701149425,0.84,99.42
2022-11-15,Madhya Pradesh,1393,16,1388,17474,3901,1875,7.97,0,87.0,841384,7088,836504,4.48,2.16,0.20085057471264367,0.84,99.42
2022-11-16,Madhya Pradesh,1119,10,1118,13823,1065,9,8.1,0,87.0,842503,7098,837622,1.22,0.01,0.15888505747126436,0.84,99.42
2022-11-17,Madhya Pradesh,276,1,268,3317,3163,324,8.32,7,87.0,842779,7099,837890,3.64,0.37,0.038126436781609194,0.84,99.42
2022-11-18,Madhya Pradesh,143,0,134,2237,4125,1697,6.39,9,87.0,842922,7099,838024,4.74,1.95,0.02571264367816092,0.84,99.42
2022-11-19,Madhya Pradesh,969,5,960,12087,2112,1589,8.02,4,87.0,843891,7104,838984,2.43,1.83,0.13893103448275862,0.84,99.42
2022-11-20,Madhya Pradesh,1464,19,1461,18289,2452,2124,8.0,0,87.0,845355,7123,840445,2.82,2.44,0.2102183908045977,0.84,99.42
2022-11-21,Madhya Pradesh,888,4,882,10943,3293,847,8.11,2,87.0,846243,7127,841327,3.79,0.97,0.1257816091954023,0.84,99.42
2022-11-22,Madhya Pradesh,1182,6,1177,14636,3583,1530,8.08,0,87.0,847425,7133,842504,4.12,1.76,0.16822988505747127,0.84,99.42
2022-11-23,Madhya Pradesh,430,5,421,5399,3057,764,7.96,4,87.0,847855,7138,842925,3.51,0.88,0.062057471264367815,0.84,99.42
2022-11-24,Madhya Pradesh,1038,5,1037,12738,894,9,8.15,0,87.0,848893,7143,843962,1.03,0.01,0.14641379310344826,0.84,99.42
2022-11-25,Madhya Pradesh,521,2,521,6377,4097,1609,8.17,0,87.0,849414,7145,844483,4.71,1.85,0.07329885057471264,0.84,99.42
2022-11-26,Madhya Pradesh,925,9,924,11408,4626,369,8.11,0,87.0,850339,7154,845407,5.32,0.42,0.1311264367816092,0.84,99.42
2022-11-27,Madhya Pradesh,1483,15,1479,18225,4153,3178,8.14,0,87.0,851822,7169,846886,4.77,3.65,0.20948275862068966,0.84,99.42
2022-11-28,Madhya Pradesh,304,4,303,3765,526,365,8.07,0,87.0,852126,7173,847189,0.6,0.42,0.04327586206896552,0.84,99.42
2022-11-29,Madhya Pradesh,862,7,857,10583,199,172,8.15,0,87.0,852988,7180,848046,0.23,0.2,0.12164367816091955,0.84,99.42
2022-11-30,Madhya Pradesh,375,2,366,4616,1025,339,8.12,7,87.0,853363,7182,848412,1.18,0.39,0.053057471264367814,0.84,99.42
2022-12-01,Madhya Pradesh,1189,4,1181,14709,3254,431,8.08,4,87.0,854552,7186,849593,3.74,0.5,0.16906896551724138,0.84,99.42
2022-12-02,Madhya Pradesh,1198,5,1198,14863,3045,3045,8.06,0,87.0,855750,7191,850791,3.5,3.5,0.17083908045977012,0.84,99.42
2022-12-03,Madhya Pradesh,968,9,963,11992,2679,380,8.07,0,87.0,856718,7200,851754,3.08,0.44,0.1378390804597701,0.84,99.42
2022-12-04,Madhya Pradesh,373,1,370,4367,3130,264,8.54,2,87.0,857091,7201,852124,3.6,0.3,0.050195402298850576,0.84,99.42
2022-12-05,Madhya Pradesh,805,10,802,9886,3703,3224,8.14,0,87.0,857896,7211,852926,4.26,3.71,0.11363218390804598,0.84,99.42
2022-12-06,Madhya Pradesh,587,3,587,6957,2659,2240,8.44,0,87.0,858483,7214,853513,3.06,2.57,0.0799655172413793,0.84,99.42
2022-12-07,Madhya Pradesh,298,4,294,3782,1528,454,7.88,0,87.0,858781,7218,853807,1.76,0.52,0.04347126436781609,0.84,99.42
2022-12-08,Madhya Pradesh,698,4,690,8780,1253,446,7.95,4,87.0,859479,7222,854497,1.44,0.51,0.10091954022988506,0.84,99.42
2022-12-09,Madhya Pradesh,583,5,575,7418,1393,1010,7.86,3,87.0,860062,7227,855072,1.6,1.16,0.08526436781609195,0.84,99.42
2022-12-10,Madhya Pradesh,80,1,71,1303,4617,407,6.14,8,87.0,860142,7228,855143,5.31,0.47,0.014977011494252873,0.84,99.42
2022-12-11,Madhya Pradesh,794,8,792,10245,682,675,7.75,0,87.0,860936,7236,855935,0.78,0.78,0.11775862068965517,0.84,99.42
2022-12-12,Madhya Pradesh,844,9,836,10499,2104,1661,8.04,0,87.0,861780,7245,856771,2.42,1.91,0.12067816091954023,0.84,99.42
2022-12-13,Madhya Pradesh,1527,13,1519,19083,4602,458,8.0,0,87.0,863307,7258,858290,5.29,0.53,0.2193448275862069,0.84,99.42
2022-12-14,Madhya Pradesh,1299,8,1296,16368,2459,1699,7.94,0,87.0,864606,7266,859586,2.83,1.95,0.18813793103448276,0.84,99.42
2022-12-15,Madhya Pradesh,1582,17,1581,19569,2709,810,8.08,0,87.0,866188,7283,861167,3.11,0.93,0.2249310344827586,0.84,99.42
2022-12-16,Madhya Pradesh,271,1,263,3567,4828,2111,7.6,7,87.0,866459,7284,861430,5.55,2.43,0.041,0.84,99.42
2022-12-17,Madhya Pradesh,550,5,550,6616,4826,1244,8.31,0,87.0,867009,7289,861980,5.55,1.43,0.07604597701149425,0.84,99.42
2022-12-18,Madhya Pradesh,803,2,796,9666,3915,384,8.31,5,87.0,867812,7291,862776,4.5,0.44,0.11110344827586206,0.84,99.42
2022-12-19,Madhya Pradesh,1276,8,1268,16271,332,8,7.84,0,87.0,869088,7299,864044,0.38,0.01,0.18702298850574714,0.84,99.42
2022-12-20,Madhya Pradesh,754,5,752,9806,2830,998,7.69,0,87.0,869842,7304,864796,3.25,1.15,0.11271264367816092,0.84,99.42
2022-12-21,Madhya Pradesh,814,8,811,10379,90,51,7.84,0,87.0,870656,7312,865607,0.1,0.06,0.11929885057471265,0.84,99.42
2022-12-22,Madhya Pradesh,397,1,390,4705,3023,2096,8.44,6,87.0,871053,7313,865997,3.47,2.41,0.05408045977011494,0.84,99.42
2022-12-23,Madhya Pradesh,1569,11,1569,19543,445,127,8.03,0,87.0,872622,7324,867566,0.51,0.15,0.22463218390804598,0.84,99.42
2022-12-24,Madhya Pradesh,782,5,773,9605,2216,362,8.14,4,87.0,873404,7329,868339,2.55,0.42,0.11040229885057472,0.84,99.42
2022-12-25,Madhya Pradesh,1442,12,1439,18528,608,378,7.78,0,87.0,874846,7341,869778,0.7,0.43,0.2129655172413793,0.84,99.42
2022-12-26,Madhya Pradesh,1345,16,1345,16808,3882,1365,8.0,0,87.0,876191,7357,871123,4.46,1.57,0.19319540229885057,0.84,99.42
2022-12-27,Madhya Pradesh,884,6,878,10887,3614,2169,8.12,0,87.0,877075,7363,872001,4.15,2.49,0.12513793103448276,0.84,99.42
2022-12-28,Madhya Pradesh,625,5,623,8025,4721,4225,7.79,0,87.0,877700,7368,872624,5.43,4.86,0.09224137931034483,0.84,99.42
2022-12-29,Madhya Pradesh,286,2,278,3655,3461,2687,7.82,6,87.0,877986,7370,872902,3.98,3.09,0.042011494252873566,0.84,99.42
2022-12-30,Madhya Pradesh,376,1,369,4874,3664,2424,7.71,6,87.0,878362,7371,873271,4.21,2.79,0.05602298850574713,0.84,99.42
2022-12-31,Madhya Pradesh,149,0,140,1643,1569,805,9.07,9,87.0,878511,7371,873411,1.8,0.93,0.018885057471264368,0.84,99.42
2020-01-01,Maharashtra,857,10,848,10382,323,260,8.25,0,123.1,857,10,848,0.26,0.21,0.08433793663688058,1.17,98.95
2020-01-02,Maharashtra,233,3,232,2958,4322,1043,7.88,0,123.1,1090,13,1080,3.51,0.85,0.024029244516653128,1.19,99.08
2020-01-03,Maharashtra,788,8,782,9873,4543,1959,7.98,0,123.1,1878,21,1862,3.69,1.59,0.08020308692120227,1.12,99.15
2020-01-04,Maharashtra,968,3,967,12426,3628,1620,7.79,0,123.1,2846,24,2829,2.95,1.32,0.10094232331437855,0.84,99.4
2020-01-05,Maharashtra,1066,4,1061,13560,4696,254,7.86,1,123.1,3912,28,3890,3.81,0.21,0.11015434606011373,0.72,99.44
2020-01-06,Maharashtra,268,2,266,2940,3404,2677,9.12,0,123.1,4180,30,4156,2.77,2.17,0.02388302193338749,0.72,99.43
2020-01-07,Maharashtra,68,0,66,751,4477,1802,9.05,2,123.1,4248,30,4222,3.64,1.46,0.006100731112916328,0.71,99.39
2020-01-08,Maharashtra,1453,18,1449,18209,2101,444,7.98,0,123.1,5701,48,5671,1.71,0.36,0.14792038992688872,0.84,99.47
2020-01-09,Maharashtra,351,3,347,4184,3466,2320,8.39,1,123.1,6052,51,6018,2.82,1.88,0.03398862713241267,0.84,99.44
2020-01-10,Maharashtra,163,0,158,2210,234,103,7.38,5,123.1,6215,51,6176,0.19,0.08,0.01795288383428107,0.82,99.37
2020-01-11,Maharashtra,220,1,219,2288,1691,210,9.62,0,123.1,6435,52,6395,1.37,0.17,0.018586515028432168,0.81,99.38
2020-01-12,Maharashtra,1170,12,1167,14703,1210,339,7.96,0,123.1,7605,64,7562,0.98,0.28,0.11943948009748172,0.84,99.43
2020-01-13,Maharashtra,108,0,100,1503,229,188,7.19,8,123.1,7713,64,7662,0.19,0.15,0.012209585702680747,0.83,99.34
2020-01-14,Maharashtra,770,8,762,9605,444,12,8.02,0,123.1,8483,72,8424,0.36,0.01,0.07802599512591389,0.85,99.3
2020-01-15,Maharashtra,1115,13,1112,13540,101,49,8.23,0,123.1,9598,85,9536,0.08,0.04,0.10999187652315191,0.89,99.35
2020-01-16,Maharashtra,927,13,927,11330,3830,1493,8.18,0,123.1,10525,98,10463,3.11,1.21,0.09203899268887084,0.93,99.41
2020-01-17,Maharashtra,614,4,608,7085,3835,580,8.67,2,123.1,11139,102,11071,3.12,0.47,0.057554833468724614,0.92,99.39
2020-01-18,Maharashtra,1511,21,1510,18322,2990,1736,8.25,0,123.1,12650,123,12581,2.43,1.41,0.148838342810723,0.97,99.45
2020-01-19,Maharashtra,445,2,438,5367,1237,262,8.29,5,123.1,13095,125,13019,1.0,0.21,0.043598700243704304,0.95,99.42
2020-01-20,Maharashtra,1033,12,1033,13072,4183,2871,7.9,0,123.1,14128,137,14052,3.4,2.33,0.10619008935824532,0.97,99.46
2020-01-21,Maharashtra,638,9,638,7973,1390,501,8.0,0,123.1,14766,146,14690,1.13,0.41,0.06476848090982941,0.99,99.49
2020-01-22,Maharashtra,115,1,111,1468,2608,1855,7.83,3,123.1,14881,147,14801,2.12,1.51,0.011925264012997563,0.99,99.46
2020-01-23,Maharashtra,1252,12,1246,15532,1212,319,8.06,0,123.1,16133,159,16047,0.98,0.26,0.12617384240454915,0.99,99.47
2020-01-24,Maharashtra,235,3,229,2428,2720,774,9.68,3,123.1,16368,162,16276,2.21,0.63,0.019723801787164905,0.99,99.44
2020-01-25,Maharashtra,1171,11,1167,15080,3837,3612,7.77,0,123.1,17539,173,17443,3.12,2.93,0.12250203086921202,0.99,99.45
2020-01-26,Maharashtra,1059,10,1058,13152,2441,1198,8.05,0,123.1,18598,183,18501,1.98,0.97,0.1068399675060926,0.98,99.48
2020-01-27,Maharashtra,728,6,725,9102,3126,2437,8.0,0,123.1,19326,189,19226,2.54,1.98,0.07393988627132413,0.98,99.48
2020-01-28,Maharashtra,1213,7,1206,15253,2270,1650,7.95,0,123.1,20539,196,20432,1.84,1.34,0.12390739236393176,0.95,99.48
2020-01-29,Maharashtra,875,8,869,10699,3670,1232,8.18,0,123.1,21414,204,21301,2.98,1.0,0.08691307879772543,0.95,99.47
2020-01-30,Maharashtra,1226,8,1217,15492,4164,2055,7.91,1,123.1,22640,212,22518,3.38,1.67,0.1258489033306255,0.94,99.46
2020-01-31,Maharashtra,178,1,178,2326,4603,3072,7.65,0,123.1,22818,213,22696,3.74,2.5,0.018895207148659627,0.93,99.47
2020-02-01,Maharashtra,110,0,101,2164,4654,4611,5.08,9,123.1,22928,213,22797,3.78,3.75,0.017579203899268887,0.93,99.43
2020-02-02,Maharashtra,1262,16,1259,16021,1554,1388,7.88,0,123.1,24190,229,24056,1.26,1.13,0.13014622258326564,0.95,99.45
2020-02-03,Maharashtra,1554,10,1546,19574,3648,1112,7.94,0,123.1,25744,239,25602,2.96,0.9,0.1590089358245329,0.93,99.45
2020-02-04,Maharashtra,992,8,983,12388,4182,2246,8.01,1,123.1,26736,247,26585,3.4,1.82,0.1006336311941511,0.92,99.44
2020-02-05,Maharashtra,1112,6,1103,14056,3237,1913,7.91,3,123.1,27848,253,27688,2.63,1.55,0.11418359057676686,0.91,99.43
2020-02-06,Maharashtra,1132,8,1129,13652,3012,1545,8.29,0,123.1,28980,261,28817,2.45,1.26,0.1109017059301381,0.9,99.44
2020-02-07,Maharashtra,1084,7,1083,13722,1151,288,7.9,0,123.1,30064,268,29900,0.94,0.23,0.11147034930950447,0.89,99.45
2020-02-08,Maharashtra,873,7,865,10808,3527,2720,8.08,1,123.1,30937,275,30765,2.87,2.21,0.08779853777416734,0.89,99.44
2020-02-09,Maharashtra,996,3,996,12134,3729,3152,8.21,0,123.1,31933,278,31761,3.03,2.56,0.09857026807473598,0.87,99.46
2020-02-10,Maharashtra,190,0,187,2080,2893,662,9.13,3,123.1,32123,278,31948,2.35,0.54,0.016896831844029243,0.87,99.46
2020-02-11,Maharashtra,1536,22,1529,19136,108,78,8.03,0,123.1,33659,300,33477,0.09,0.06,0.15545085296506905,0.89,99.46
2020-02-12,Maharashtra,360,1,356,4853,3156,322,7.42,3,123.1,34019,301,33833,2.56,0.26,0.03942323314378554,0.88,99.45
2020-02-13,Maharashtra,76,0,75,826,2021,291,9.2,1,123.1,34095,301,33908,1.64,0.24,0.006709991876523152,0.88,99.45
2020-02-14,Maharashtra,1149,14,1147,14521,2403,831,7.91,0,123.1,35244,315,35055,1.95,0.68,0.11796100731112916,0.89,99.46
2020-02-15,Maharashtra,369,5,362,4799,558,488,7.69,2,123.1,35613,320,35417,0.45,0.4,0.038984565393988625,0.9,99.45
2020-02-16,Maharashtra,370,2,362,4834,593,486,7.65,6,123.1,35983,322,35779,0.48,0.39,0.039268887083671815,0.89,99.43
2020-02-17,Maharashtra,773,5,764,9706,2769,2031,7.96,4,123.1,36756,327,36543,2.25,1.65,0.07884646628757108,0.89,99.42
2020-02-18,Maharashtra,1285,10,1283,15706,3625,1739,8.18,0,123.1,38041,337,37826,2.94,1.41,0.12758732737611697,0.89,99.43
2020-02-19,Maharashtra,1051,11,1042,13290,2257,2004,7.91,0,123.1,39092,348,38868,1.83,1.63,0.10796100731112916,0.89,99.43
2020-02-20,Maharashtra,480,4,475,5980,2408,1675,8.03,1,123.1,39572,352,39343,1.96,1.36,0.048578391551584076,0.89,99.42
2020-02-21,Maharashtra,62,0,56,585,1911,1649,10.6,6,123.1,39634,352,39399,1.55,1.34,0.004752233956133225,0.89,99.41
2020-02-22,Maharashtra,586,6,586,7373,1792,855,7.95,0,123.1,40220,358,39985,1.46,0.69,0.05989439480097482,0.89,99.42
2020-02-23,Maharashtra,434,3,433,5512,1324,741,7.87,0,123.1,40654,361,40418,1.08,0.6,0.0447766043866775,0.89,99.42
2020-02-24,Maharashtra,806,10,806,10432,3591,543,7.73,0,123.1,41460,371,41224,2.92,0.44,0.08474411047928514,0.89,99.43
2020-02-25,Maharashtra,1369,8,1365,17127,177,177,7.99,0,123.1,42829,379,42589,0.14,0.14,0.13913078797725426,0.88,99.44
2020-02-26,Maharashtra,1165,4,1164,14890,3984,3138,7.82,0,123.1,43994,383,43753,3.24,2.55,0.12095857026807473,0.87,99.45
2020-02-27,Maharashtra,174,1,170,1990,3648,2067,8.74,3,123.1,44168,384,43923,2.96,1.68,0.016165718927701057,0.87,99.45
2020-02-28,Maharashtra,1054,15,1052,13055,948,609,8.07,0,123.1,45222,399,44975,0.77,0.49,0.10605199025182778,0.88,99.45
2020-02-29,Maharashtra,1190,7,1189,14467,765,397,8.23,0,123.1,46412,406,46164,0.62,0.32,0.11752233956133225,0.87,99.47
2020-03-01,Maharashtra,647,6,645,7779,4074,2165,8.32,0,123.1,47059,412,46809,3.31,1.76,0.06319252640129976,0.88,99.47
2020-03-02,Maharashtra,767,11,766,9619,1953,1588,7.97,0,123.1,47826,423,47575,1.59,1.29,0.07813972380178716,0.88,99.48
2020-03-03,Maharashtra,1065,9,1057,13511,2546,486,7.88,0,123.1,48891,432,48632,2.07,0.39,0.10975629569455728,0.88,99.47
2020-03-04,Maharashtra,902,4,901,11196,2074,814,8.06,0,123.1,49793,436,49533,1.68,0.66,0.09095044679122664,0.88,99.48
2020-03-05,Maharashtra,1558,17,1553,19339,1718,348,8.06,0,123.1,51351,453,51086,1.4,0.28,0.15709991876523152,0.88,99.48
2020-03-06,Maharashtra,1031,6,1027,13109,3380,751,7.86,0,123.1,52382,459,52113,2.75,0.61,0.1064906580016247,0.88,99.49
2020-03-07,Maharashtra,1519,6,1514,19201,448,104,7.91,0,123.1,53901,465,53627,0.36,0.08,0.15597887896019497,0.86,99.49
2020-03-08,Maharashtra,875,6,870,10685,1386,710,8.19,0,123.1,54776,471,54497,1.13,0.58,0.08679935012185215,0.86,99.49
2020-03-09,Maharashtra,1410,5,1409,17335,1700,1169,8.13,0,123.1,56186,476,55906,1.38,0.95,0.1408204711616572,0.85,99.5
2020-03-10,Maharashtra,671,4,669,8367,1209,799,8.02,0,123.1,56857,480,56575,0.98,0.65,0.06796913078797726,0.84,99.5
2020-03-11,Maharashtra,1238,16,1233,15682,2380,1451,7.89,0,123.1,58095,496,57808,1.93,1.18,0.1273923639317628,0.85,99.51
2020-03-12,Maharashtra,135,1,133,1934,3818,373,6.98,1,123.1,58230,497,57941,3.1,0.3,0.01571080422420796,0.85,99.5
2020-03-13,Maharashtra,442,5,439,5886,1796,916,7.51,0,123.1,58672,502,58380,1.46,0.74,0.047814784727863525,0.86,99.5
2020-03-14,Maharashtra,1074,7,1068,13764,4608,2699,7.8,0,123.1,59746,509,59448,3.74,2.19,0.11181153533712429,0.85,99.5
2020-03-15,Maharashtra,455,3,451,5419,4444,1192,8.4,1,123.1,60201,512,59899,3.61,0.97,0.04402112103980504,0.85,99.5
2020-03-16,Maharashtra,719,7,712,8600,107,105,8.36,0,123.1,60920,519,60611,0.09,0.09,0.06986190089358245,0.85,99.49
2020-03-17,Maharashtra,1475,16,1475,18943,4643,2574,7.79,0,123.1,62395,535,62086,3.77,2.09,0.1538830219333875,0.86,99.5
2020-03-18,Maharashtra,1559,8,1559,19510,1647,562,7.99,0,123.1,63954,543,63645,1.34,0.46,0.15848903330625508,0.85,99.52
2020-03-19,Maharashtra,669,5,661,8225,370,323,8.13,3,123.1,64623,548,64306,0.3,0.26,0.06681559707554834,0.85,99.51
2020-03-20,Maharashtra,1381,13,1377,17250,2319,713,8.01,0,123.1,66004,561,65683,1.88,0.58,0.14012997562956944,0.85,99.51
2020-03-21,Maharashtra,1202,5,1194,14845,3374,1251,8.1,3,123.1,67206,566,66877,2.74,1.02,0.12059301380991064,0.84,99.51
2020-03-22,Maharashtra,345,4,343,4199,2434,809,8.22,0,123.1,67551,570,67220,1.98,0.66,0.03411047928513404,0.84,99.51
2020-03-23,Maharashtra,895,8,894,10890,409,325,8.22,0,123.1,68446,578,68114,0.33,0.26,0.08846466287571081,0.84,99.51
2020-03-24,Maharashtra,1596,16,1588,19934,1399,1322,8.01,0,123.1,70042,594,69702,1.14,1.07,0.16193338748984565,0.85,99.51
2020-03-25,Maharashtra,556,5,549,7193,2351,537,7.73,2,123.1,70598,599,70251,1.91,0.44,0.05843216896831844,0.85,99.51
2020-03-26,Maharashtra,1104,8,1095,14090,2101,358,7.84,1,123.1,71702,607,71346,1.71,0.29,0.11445978878960195,0.85,99.5
2020-03-27,Maharashtra,457,2,457,5808,3485,2536,7.87,0,123.1,72159,609,71803,2.83,2.06,0.04718115353371243,0.84,99.51
2020-03-28,Maharashtra,1496,16,1493,18737,4400,309,7.98,0,123.1,73655,625,73296,3.57,0.25,0.15220958570268076,0.85,99.51
2020-03-29,Maharashtra,643,9,636,7713,373,146,8.34,0,123.1,74298,634,73932,0.3,0.12,0.06265637692932575,0.85,99.51
2020-03-30,Maharashtra,1041,12,1035,12760,558,255,8.16,0,123.1,75339,646,74967,0.45,0.21,0.10365556458164094,0.86,99.51
2020-03-31,Maharashtra,1276,13,1272,15978,3530,989,7.99,0,123.1,76615,659,76239,2.87,0.8,0.12979691307879773,0.86,99.51
2020-04-01,Maharashtra,466,6,465,5762,1483,509,8.09,0,123.1,77081,665,76704,1.2,0.41,0.046807473598700244,0.86,99.51
2020-04-02,Maharashtra,92,0,85,903,3465,1923,10.19,7,123.1,77173,665,76789,2.81,1.56,0.007335499593826157,0.86,99.5
2020-04-03,Maharashtra,758,8,752,9330,2919,2618,8.12,0,123.1,77931,673,77541,2.37,2.13,0.07579203899268887,0.86,99.5
2020-04-04,Maharashtra,1500,9,1498,18529,1700,576,8.1,0,123.1,79431,682,79039,1.38,0.47,0.15051990251827782,0.86,99.51
2020-04-05,Maharashtra,1503,15,1498,18195,480,69,8.26,0,123.1,80934,697,80537,0.39,0.06,0.14780666125101544,0.86,99.51
2020-04-06,Maharashtra,1430,13,1427,18078,1484,1205,7.91,0,123.1,82364,710,81964,1.21,0.98,0.1468562144597888,0.86,99.51
2020-04-07,Maharashtra,661,9,653,8135,1697,854,8.13,0,123.1,83025,719,82617,1.38,0.69,0.06608448415922015,0.87,99.51
2020-04-08,Maharashtra,437,1,433,5395,4296,3489,8.1,3,123.1,83462,720,83050,3.49,2.83,0.04382615759545085,0.86,99.51
2020-04-09,Maharashtra,721,8,715,9253,66,11,7.79,0,123.1,84183,728,83765,0.05,0.01,0.07516653127538586,0.86,99.5
2020-04-10,Maharashtra,186,2,181,2116,3142,1578,8.79,3,123.1,84369,730,83946,2.55,1.28,0.01718927701056052,0.87,99.5
2020-04-11,Maharashtra,143,1,137,2168,3646,1595,6.6,5,123.1,84512,731,84083,2.96,1.3,0.01761169780666125,0.86,99.49
2020-04-12,Maharashtra,1362,13,1353,17350,1001,366,7.85,0,123.1,85874,744,85436,0.81,0.3,0.14094232331437856,0.87,99.49
2020-04-13,Maharashtra,483,3,483,6346,650,326,7.61,0,123.1,86357,747,85919,0.53,0.26,0.05155158407798538,0.87,99.49
2020-04-14,Maharashtra,398,3,390,5007,1008,658,7.95,5,123.1,86755,750,86309,0.82,0.53,0.04067424857839155,0.86,99.49
2020-04-15,Maharashtra,860,6,855,11040,1044,512,7.79,0,123.1,87615,756,87164,0.85,0.42,0.08968318440292446,0.86,99.49
2020-04-16,Maharashtra,557,3,555,7114,2082,735,7.83,0,123.1,88172,759,87719,1.69,0.6,0.05779041429731925,0.86,99.49
2020-04-17,Maharashtra,690,3,690,8950,117,78,7.71,0,123.1,88862,762,88409,0.1,0.06,0.0727051177904143,0.86,99.49
2020-04-18,Maharashtra,1427,15,1427,17629,1017,541,8.09,0,123.1,90289,777,89836,0.83,0.44,0.14320877335499593,0.86,99.5
2020-04-19,Maharashtra,1086,9,1081,13591,1581,1335,7.99,0,123.1,91375,786,90917,1.28,1.08,0.11040617384240455,0.86,99.5
2020-04-20,Maharashtra,445,4,444,5920,2759,1819,7.52,0,123.1,91820,790,91361,2.24,1.48,0.04809098294069862,0.86,99.5
2020-04-21,Maharashtra,1301,5,1300,15766,3034,1751,8.25,0,123.1,93121,795,92661,2.46,1.42,0.12807473598700245,0.85,99.51
2020-04-22,Maharashtra,1120,12,1117,13900,4259,3215,8.06,0,123.1,94241,807,93778,3.46,2.61,0.11291632818846466,0.86,99.51
2020-04-23,Maharashtra,987,3,986,12483,2395,602,7.91,0,123.1,95228,810,94764,1.95,0.49,0.10140536149471974,0.85,99.51
2020-04-24,Maharashtra,993,8,993,12174,2156,1485,8.16,0,123.1,96221,818,95757,1.75,1.21,0.09889520714865963,0.85,99.52
2020-04-25,Maharashtra,1384,18,1384,17163,3942,772,8.06,0,123.1,97605,836,97141,3.2,0.63,0.13942323314378555,0.86,99.52
2020-04-26,Maharashtra,656,4,654,8363,4987,961,7.84,0,123.1,98261,840,97795,4.05,0.78,0.06793663688058489,0.85,99.53
2020-04-27,Maharashtra,613,6,608,7357,189,61,8.33,0,123.1,98874,846,98403,0.15,0.05,0.05976441917140536,0.86,99.52
2020-04-28,Maharashtra,347,4,339,4546,2619,1003,7.63,4,123.1,99221,850,98742,2.13,0.81,0.03692932575142161,0.86,99.52
2020-04-29,Maharashtra,399,4,395,4797,1757,1364,8.32,0,123.1,99620,854,99137,1.43,1.11,0.03896831844029244,0.86,99.52
2020-04-30,Maharashtra,330,4,321,4123,1884,949,8.0,5,123.1,99950,858,99458,1.53,0.77,0.03349309504467912,0.86,99.51
2020-05-01,Maharashtra,807,8,807,9952,810,633,8.11,0,123.1,100757,866,100265,0.66,0.51,0.08084484159220147,0.86,99.51
2020-05-02,Maharashtra,1006,13,998,12265,690,114,8.2,0,123.1,101763,879,101263,0.56,0.09,0.09963444354183591,0.86,99.51
2020-05-03,Maharashtra,836,8,833,10317,2741,1151,8.1,0,123.1,102599,887,102096,2.23,0.94,0.08380991064175466,0.86,99.51
2020-05-04,Maharashtra,1455,12,1450,18148,2442,1968,8.02,0,123.1,104054,899,103546,1.98,1.6,0.14742485783915515,0.86,99.51
2020-05-05,Maharashtra,1007,13,1004,12356,1781,195,8.15,0,123.1,105061,912,104550,1.45,0.16,0.10037367993501219,0.87,99.51
2020-05-06,Maharashtra,1157,7,1157,14692,2044,1876,7.88,0,123.1,106218,919,105707,1.66,1.52,0.11935012185215273,0.87,99.52
2020-05-07,Maharashtra,1402,16,1396,17799,4255,2087,7.88,0,123.1,107620,935,107103,3.46,1.7,0.1445897644191714,0.87,99.52
2020-05-08,Maharashtra,668,9,659,8183,122,119,8.16,0,123.1,108288,944,107762,0.1,0.1,0.06647441104792852,0.87,99.51
2020-05-09,Maharashtra,1301,14,1297,15779,246,9,8.25,0,123.1,109589,958,109059,0.2,0.01,0.1281803411860276,0.87,99.52
2020-05-10,Maharashtra,544,3,537,6781,815,152,8.02,4,123.1,110133,961,109596,0.66,0.12,0.055085296506904954,0.87,99.51
2020-05-11,Maharashtra,978,11,978,12400,3673,1477,7.89,0,123.1,111111,972,110574,2.98,1.2,0.10073111291632819,0.87,99.52
2020-05-12,Maharashtra,254,3,246,3306,3314,3034,7.68,5,123.1,111365,975,110820,2.69,2.46,0.02685621445978879,0.88,99.51
2020-05-13,Maharashtra,164,1,163,1827,4329,1834,8.98,0,123.1,111529,976,110983,3.52,1.49,0.014841592201462226,0.88,99.51
2020-05-14,Maharashtra,177,1,168,2200,1499,194,8.05,8,123.1,111706,977,111151,1.22,0.16,0.017871649065800164,0.87,99.5
2020-05-15,Maharashtra,80,0,78,782,3691,253,10.23,2,123.1,111786,977,111229,3.0,0.21,0.006352558895207148,0.87,99.5
2020-05-16,Maharashtra,1495,15,1489,19141,196,168,7.81,0,123.1,113281,992,112718,0.16,0.14,0.1554914703493095,0.88,99.5
2020-05-17,Maharashtra,586,7,584,6785,4899,2367,8.64,0,123.1,113867,999,113302,3.98,1.92,0.05511779041429732,0.88,99.5
2020-05-18,Maharashtra,878,5,873,10789,4202,2972,8.14,0,123.1,114745,1004,114175,3.41,2.41,0.08764419171405362,0.87,99.5
2020-05-19,Maharashtra,1082,12,1079,13451,1170,1027,8.04,0,123.1,115827,1016,115254,0.95,0.83,0.10926888708367181,0.88,99.51
2020-05-20,Maharashtra,886,7,877,11100,3138,1661,7.98,2,123.1,116713,1023,116131,2.55,1.35,0.0901705930138099,0.88,99.5
2020-05-21,Maharashtra,1104,3,1096,13964,2864,1005,7.91,5,123.1,117817,1026,117227,2.33,0.82,0.11343623070674248,0.87,99.5
2020-05-22,Maharashtra,157,1,155,1643,724,241,9.56,1,123.1,117974,1027,117382,0.59,0.2,0.013346872461413485,0.87,99.5
2020-05-23,Maharashtra,997,11,988,12456,4283,1517,8.0,0,123.1,118971,1038,118370,3.48,1.23,0.10118602761982129,0.87,99.49
2020-05-24,Maharashtra,779,10,779,9171,2786,2445,8.49,0,123.1,119750,1048,119149,2.26,1.99,0.0745004061738424,0.88,99.5
2020-05-25,Maharashtra,632,2,629,7378,2724,1564,8.57,1,123.1,120382,1050,119778,2.21,1.27,0.05993501218521527,0.87,99.5
2020-05-26,Maharashtra,1106,14,1106,13827,1450,1095,8.0,0,123.1,121488,1064,120884,1.18,0.89,0.11232331437855402,0.88,99.5
2020-05-27,Maharashtra,584,3,578,7786,839,751,7.5,3,123.1,122072,1067,121462,0.68,0.61,0.0632493907392364,0.87,99.5
2020-05-28,Maharashtra,276,3,273,3040,4601,3497,9.08,0,123.1,122348,1070,121735,3.74,2.84,0.02469536961819659,0.87,99.5
2020-05-29,Maharashtra,529,2,521,7116,42,40,7.43,6,123.1,122877,1072,122256,0.03,0.03,0.05780666125101543,0.87,99.49
2020-05-30,Maharashtra,923,6,922,11355,1120,703,8.13,0,123.1,123800,1078,123178,0.91,0.57,0.09224207961007311,0.87,99.5
2020-05-31,Maharashtra,1534,15,1527,19122,3207,1420,8.02,0,123.1,125334,1093,124705,2.61,1.15,0.15533712428919577,0.87,99.5
2020-06-01,Maharashtra,303,3,301,3701,585,216,8.19,0,123.1,125637,1096,125006,0.48,0.18,0.030064987814784727,0.87,99.5
2020-06-02,Maharashtra,1490,16,1481,18636,992,640,8.0,0,123.1,127127,1112,126487,0.81,0.52,0.15138911454102355,0.87,99.5
2020-06-03,Maharashtra,406,3,397,5227,1708,775,7.77,6,123.1,127533,1115,126884,1.39,0.63,0.042461413484971566,0.87,99.49
2020-06-04,Maharashtra,1342,19,1342,16622,2728,591,8.07,0,123.1,128875,1134,128226,2.22,0.48,0.13502843216896832,0.88,99.5
2020-06-05,Maharashtra,490,4,481,6356,668,557,7.71,5,123.1,129365,1138,128707,0.54,0.45,0.05163281884646629,0.88,99.49
2020-06-06,Maharashtra,1106,6,1102,13796,4691,1983,8.02,0,123.1,130471,1144,129809,3.81,1.61,0.1120714865962632,0.88,99.49
2020-06-07,Maharashtra,652,4,651,8128,3611,28,8.02,0,123.1,131123,1148,130460,2.93,0.02,0.06602761982128351,0.88,99.49
2020-06-08,Maharashtra,146,1,143,1824,921,68,8.0,2,123.1,131269,1149,130603,0.75,0.06,0.014817221770917953,0.88,99.49
2020-06-09,Maharashtra,811,10,808,10066,2946,1612,8.06,0,123.1,132080,1159,131411,2.39,1.31,0.08177091795288384,0.88,99.49
2020-06-10,Maharashtra,1482,10,1474,18939,1785,181,7.83,0,123.1,133562,1169,132885,1.45,0.15,0.15385052802599514,0.88,99.49
2020-06-11,Maharashtra,1077,9,1069,13284,4862,1583,8.11,0,123.1,134639,1178,133954,3.95,1.29,0.10791226645004062,0.87,99.49
2020-06-12,Maharashtra,1365,13,1360,17110,1580,1389,7.98,0,123.1,136004,1191,135314,1.28,1.13,0.1389926888708367,0.88,99.49
2020-06-13,Maharashtra,1099,9,1099,13729,294,250,8.0,0,123.1,137103,1200,136413,0.24,0.2,0.1115272136474411,0.88,99.5
2020-06-14,Maharashtra,1059,3,1056,13452,3914,1906,7.87,0,123.1,138162,1203,137469,3.18,1.55,0.1092770105605199,0.87,99.5
2020-06-15,Maharashtra,75,0,72,602,4843,1953,12.46,3,123.1,138237,1203,137541,3.93,1.59,0.004890333062550772,0.87,99.5
2020-06-16,Maharashtra,1468,14,1462,17763,3952,335,8.26,0,123.1,139705,1217,139003,3.21,0.27,0.14429731925264014,0.87,99.5
2020-06-17,Maharashtra,1502,20,1498,18684,4040,2532,8.04,0,123.1,141207,1237,140501,3.28,2.06,0.15177904142973192,0.88,99.5
2020-06-18,Maharashtra,810,3,808,10316,3569,3480,7.85,0,123.1,142017,1240,141309,2.9,2.83,0.08380178716490658,0.87,99.5
2020-06-19,Maharashtra,1107,15,1103,13797,151,52,8.02,0,123.1,143124,1255,142412,0.12,0.04,0.11207961007311129,0.88,99.5
2020-06-20,Maharashtra,818,8,810,10018,1377,613,8.17,0,123.1,143942,1263,143222,1.12,0.5,0.08138099106417547,0.88,99.5
2020-06-21,Maharashtra,963,3,959,12101,3326,664,7.96,1,123.1,144905,1266,144181,2.7,0.54,0.09830219333874898,0.87,99.5
2020-06-22,Maharashtra,48,0,41,533,2560,1667,9.01,7,123.1,144953,1266,144222,2.08,1.35,0.004329813160032494,0.87,99.5
2020-06-23,Maharashtra,1038,9,1032,12529,256,228,8.28,0,123.1,145991,1275,145254,0.21,0.19,0.10177904142973193,0.87,99.5
2020-06-24,Maharashtra,721,6,718,8833,4654,3467,8.16,0,123.1,146712,1281,145972,3.78,2.82,0.07175467099918766,0.87,99.5
2020-06-25,Maharashtra,986,7,980,12298,1295,322,8.02,0,123.1,147698,1288,146952,1.05,0.26,0.09990251827782291,0.87,99.49
2020-06-26,Maharashtra,1536,4,1536,19439,500,9,7.9,0,123.1,149234,1292,148488,0.41,0.01,0.1579122664500406,0.87,99.5
2020-06-27,Maharashtra,772,7,771,9138,4625,2335,8.45,0,123.1,150006,1299,149259,3.76,1.9,0.0742323314378554,0.87,99.5
2020-06-28,Maharashtra,1473,20,1465,18161,2593,991,8.11,0,123.1,151479,1319,150724,2.11,0.81,0.14753046303818035,0.87,99.5
2020-06-29,Maharashtra,1375,8,1374,17034,1119,579,8.07,0,123.1,152854,1327,152098,0.91,0.47,0.1383753046303818,0.87,99.51
2020-06-30,Maharashtra,1466,20,1461,18475,3144,2400,7.94,0,123.1,154320,1347,153559,2.55,1.95,0.1500812347684809,0.87,99.51
2020-07-01,Maharashtra,492,6,487,5973,3776,480,8.24,0,123.1,154812,1353,154046,3.07,0.39,0.04852152721364744,0.87,99.51
2020-07-02,Maharashtra,1264,15,1259,15655,657,141,8.07,0,123.1,156076,1368,155305,0.53,0.11,0.12717303005686434,0.88,99.51
2020-07-03,Maharashtra,271,2,269,3569,3185,3039,7.59,0,123.1,156347,1370,155574,2.59,2.47,0.028992688870836718,0.88,99.51
2020-07-04,Maharashtra,1320,14,1316,16638,898,63,7.93,0,123.1,157667,1384,156890,0.73,0.05,0.13515840779853777,0.88,99.51
2020-07-05,Maharashtra,264,3,255,3391,1028,307,7.79,6,123.1,157931,1387,157145,0.84,0.25,0.027546709991876524,0.88,99.5
2020-07-06,Maharashtra,1322,18,1321,16304,4254,1843,8.11,0,123.1,159253,1405,158466,3.46,1.5,0.1324451665312754,0.88,99.51
2020-07-07,Maharashtra,219,2,212,2571,509,414,8.52,5,123.1,159472,1407,158678,0.41,0.34,0.020885458976441916,0.88,99.5
2020-07-08,Maharashtra,1249,15,1242,15632,3293,2975,7.99,0,123.1,160721,1422,159920,2.68,2.42,0.12698619008935824,0.88,99.5
2020-07-09,Maharashtra,1623,5,1620,19971,3516,3395,8.13,0,123.1,162344,1427,161540,2.86,2.76,0.16223395613322503,0.88,99.5
2020-07-10,Maharashtra,1265,7,1258,15912,4616,1598,7.95,0,123.1,163609,1434,162798,3.75,1.3,0.12926076360682373,0.88,99.5
2020-07-11,Maharashtra,65,0,59,729,4879,1447,8.92,6,123.1,163674,1434,162857,3.96,1.18,0.005922014622258326,0.88,99.5
2020-07-12,Maharashtra,1353,8,1344,16862,119,37,8.02,1,123.1,165027,1442,164201,0.1,0.03,0.13697806661251016,0.87,99.5
2020-07-13,Maharashtra,590,3,589,7748,1972,1401,7.61,0,123.1,165617,1445,164790,1.6,1.14,0.06294069861900893,0.87,99.5
2020-07-14,Maharashtra,1267,12,1261,15650,2602,1826,8.1,0,123.1,166884,1457,166051,2.11,1.48,0.12713241267262387,0.87,99.5
2020-07-15,Maharashtra,1253,11,1249,15507,1326,885,8.08,0,123.1,168137,1468,167300,1.08,0.72,0.12597075548334688,0.87,99.5
2020-07-16,Maharashtra,968,13,959,11868,1797,576,8.16,0,123.1,169105,1481,168259,1.46,0.47,0.09640942323314379,0.88,99.5
2020-07-17,Maharashtra,750,3,750,9348,4484,1841,8.02,0,123.1,169855,1484,169009,3.64,1.5,0.07593826157595451,0.87,99.5
2020-07-18,Maharashtra,258,0,255,2922,2851,556,8.83,3,123.1,170113,1484,169264,2.32,0.45,0.02373679935012185,0.87,99.5
2020-07-19,Maharashtra,420,3,420,5526,2668,1269,7.6,0,123.1,170533,1487,169684,2.17,1.03,0.044890333062550775,0.87,99.5
2020-07-20,Maharashtra,959,3,951,11755,1083,368,8.16,5,123.1,171492,1490,170635,0.88,0.3,0.0954914703493095,0.87,99.5
2020-07-21,Maharashtra,522,6,522,6503,2187,892,8.03,0,123.1,172014,1496,171157,1.78,0.72,0.05282696994313566,0.87,99.5
2020-07-22,Maharashtra,999,8,990,12586,2627,2604,7.94,1,123.1,173013,1504,172147,2.13,2.12,0.10224207961007312,0.87,99.5
2020-07-23,Maharashtra,1216,10,1214,15338,1277,650,7.93,0,123.1,174229,1514,173361,1.04,0.53,0.1245978878960195,0.87,99.5
2020-07-24,Maharashtra,1469,12,1463,18080,4533,1759,8.12,0,123.1,175698,1526,174824,3.68,1.43,0.14687246141348498,0.87,99.5
2020-07-25,Maharashtra,1145,10,1142,14193,4557,2731,8.07,0,123.1,176843,1536,175966,3.7,2.22,0.11529650690495533,0.87,99.5
2020-07-26,Maharashtra,841,3,835,10785,3091,809,7.8,3,123.1,177684,1539,176801,2.51,0.66,0.08761169780666125,0.87,99.5
2020-07-27,Maharashtra,251,3,247,3467,4706,3611,7.24,1,123.1,177935,1542,177048,3.82,2.93,0.02816409423233144,0.87,99.5
2020-07-28,Maharashtra,622,2,614,7806,3940,870,7.97,6,123.1,178557,1544,177662,3.2,0.71,0.06341186027619822,0.86,99.5
2020-07-29,Maharashtra,221,2,217,2588,3197,2320,8.54,2,123.1,178778,1546,177879,2.6,1.88,0.021023558082859464,0.86,99.5
2020-07-30,Maharashtra,1544,7,1536,19393,129,107,7.96,1,123.1,180322,1553,179415,0.1,0.09,0.15753858651502844,0.86,99.5
2020-07-31,Maharashtra,539,6,537,6893,2824,866,7.82,0,123.1,180861,1559,179952,2.29,0.7,0.05599512591389114,0.86,99.5
2020-08-01,Maharashtra,967,8,958,11964,2608,1171,8.08,1,123.1,181828,1567,180910,2.12,0.95,0.09718927701056052,0.86,99.5
2020-08-02,Maharashtra,340,3,336,4158,1929,1755,8.18,1,123.1,182168,1570,181246,1.57,1.43,0.033777416734362305,0.86,99.49
2020-08-03,Maharashtra,479,1,473,6026,1668,903,7.95,5,123.1,182647,1571,181719,1.35,0.73,0.04895207148659626,0.86,99.49
2020-08-04,Maharashtra,387,1,383,5352,3346,1447,7.23,3,123.1,183034,1572,182102,2.72,1.18,0.04347684809098294,0.86,99.49
2020-08-05,Maharashtra,274,1,266,3434,1096,513,7.98,7,123.1,183308,1573,182368,0.89,0.42,0.027896019496344435,0.86,99.49
2020-08-06,Maharashtra,326,3,321,3878,3257,181,8.41,2,123.1,183634,1576,182689,2.65,0.15,0.03150284321689683,0.86,99.49
2020-08-07,Maharashtra,1547,10,1540,19562,2786,480,7.91,0,123.1,185181,1586,184229,2.26,0.39,0.1589114541023558,0.86,99.49
2020-08-08,Maharashtra,1218,16,1211,14662,1911,1100,8.31,0,123.1,186399,1602,185440,1.55,0.89,0.11910641754670999,0.86,99.49
2020-08-09,Maharashtra,523,6,515,6344,4713,3790,8.24,2,123.1,186922,1608,185955,3.83,3.08,0.0515353371242892,0.86,99.48
2020-08-10,Maharashtra,415,1,414,5543,4211,1564,7.49,0,123.1,187337,1609,186369,3.42,1.27,0.04502843216896832,0.86,99.48
2020-08-11,Maharashtra,277,3,272,3374,4315,388,8.21,2,123.1,187614,1612,186641,3.51,0.32,0.027408610885458977,0.86,99.48
2020-08-12,Maharashtra,354,1,346,3932,607,236,9.0,7,123.1,187968,1613,186987,0.49,0.19,0.031941510966693745,0.86,99.48
2020-08-13,Maharashtra,187,0,178,2377,3910,1847,7.87,9,123.1,188155,1613,187165,3.18,1.5,0.019309504467912266,0.86,99.47
2020-08-14,Maharashtra,703,2,698,8703,2622,768,8.08,3,123.1,188858,1615,187863,2.13,0.62,0.07069861900893583,0.86,99.47
2020-08-15,Maharashtra,905,9,903,11314,3078,1030,8.0,0,123.1,189763,1624,188766,2.5,0.84,0.09190901705930138,0.86,99.47
2020-08-16,Maharashtra,809,4,806,10061,2339,2205,8.04,0,123.1,190572,1628,189572,1.9,1.79,0.08173030056864337,0.85,99.48
2020-08-17,Maharashtra,334,2,326,4482,3654,3536,7.45,6,123.1,190906,1630,189898,2.97,2.87,0.036409423233143785,0.85,99.47
2020-08-18,Maharashtra,501,5,496,6644,4864,69,7.54,0,123.1,191407,1635,190394,3.95,0.06,0.05397238017871649,0.85,99.47
2020-08-19,Maharashtra,1429,13,1425,17608,823,329,8.12,0,123.1,192836,1648,191819,0.67,0.27,0.14303818034118604,0.85,99.47
2020-08-20,Maharashtra,268,1,261,3412,51,14,7.85,6,123.1,193104,1649,192080,0.04,0.01,0.027717303005686433,0.85,99.47
2020-08-21,Maharashtra,135,0,130,1572,1614,1289,8.59,5,123.1,193239,1649,192210,1.31,1.05,0.012770105605199025,0.85,99.47
2020-08-22,Maharashtra,144,0,136,2030,537,33,7.09,8,123.1,193383,1649,192346,0.44,0.03,0.016490658001624695,0.85,99.46
2020-08-23,Maharashtra,1204,7,1201,15199,808,322,7.92,0,123.1,194587,1656,193547,0.66,0.26,0.12346872461413486,0.85,99.47
2020-08-24,Maharashtra,998,4,992,12331,1221,916,8.09,2,123.1,195585,1660,194539,0.99,0.74,0.10017059301380991,0.85,99.47
2020-08-25,Maharashtra,340,4,332,4174,503,456,8.15,4,123.1,195925,1664,194871,0.41,0.37,0.03390739236393176,0.85,99.46
2020-08-26,Maharashtra,884,12,884,11013,608,151,8.03,0,123.1,196809,1676,195755,0.49,0.12,0.089463850528026,0.85,99.46
2020-08-27,Maharashtra,951,5,945,12340,199,180,7.71,1,123.1,197760,1681,196700,0.16,0.15,0.10024370430544273,0.85,99.46
2020-08-28,Maharashtra,197,0,195,2170,789,358,9.08,2,123.1,197957,1681,196895,0.64,0.29,0.017627944760357433,0.85,99.46
2020-08-29,Maharashtra,717,8,712,9227,240,180,7.77,0,123.1,198674,1689,197607,0.19,0.15,0.0749553208773355,0.85,99.46
2020-08-30,Maharashtra,889,12,885,11353,683,662,7.83,0,123.1,199563,1701,198492,0.55,0.54,0.09222583265637693,0.85,99.46
2020-08-31,Maharashtra,276,1,271,3296,4993,1815,8.37,4,123.1,199839,1702,198763,4.06,1.47,0.02677497969130788,0.85,99.46
2020-09-01,Maharashtra,577,4,576,7675,1371,312,7.52,0,123.1,200416,1706,199339,1.11,0.25,0.062347684809098296,0.85,99.46
2020-09-02,Maharashtra,319,2,310,4013,27,10,7.95,7,123.1,200735,1708,199649,0.02,0.01,0.032599512591389115,0.85,99.46
2020-09-03,Maharashtra,179,1,178,1958,3337,1519,9.14,0,123.1,200914,1709,199827,2.71,1.23,0.015905767668562144,0.85,99.46
2020-09-04,Maharashtra,1419,20,1417,17820,1516,1290,7.96,0,123.1,202333,1729,201244,1.23,1.05,0.14476035743298132,0.85,99.46
2020-09-05,Maharashtra,567,2,559,6732,3572,562,8.42,6,123.1,202900,1731,201803,2.9,0.46,0.0546872461413485,0.85,99.46
2020-09-06,Maharashtra,815,3,811,10097,294,272,8.07,1,123.1,203715,1734,202614,0.24,0.22,0.08202274573517465,0.85,99.46
2020-09-07,Maharashtra,1346,16,1345,16648,1939,1377,8.09,0,123.1,205061,1750,203959,1.58,1.12,0.13523964256701868,0.85,99.46
2020-09-08,Maharashtra,1191,4,1183,14999,729,627,7.94,4,123.1,206252,1754,205142,0.59,0.51,0.12184402924451665,0.85,99.46
2020-09-09,Maharashtra,375,5,373,4720,806,556,7.94,0,123.1,206627,1759,205515,0.65,0.45,0.03834281072298944,0.85,99.46
2020-09-10,Maharashtra,144,0,144,1726,3142,2837,8.34,0,123.1,206771,1759,205659,2.55,2.3,0.014021121039805037,0.85,99.46
2020-09-11,Maharashtra,516,1,515,6354,3184,264,8.12,0,123.1,207287,1760,206174,2.59,0.21,0.05161657189277011,0.85,99.46
2020-09-12,Maharashtra,408,5,406,5179,359,281,7.88,0,123.1,207695,1765,206580,0.29,0.23,0.042071486596263204,0.85,99.46
2020-09-13,Maharashtra,1364,12,1357,17293,3033,170,7.89,0,123.1,209059,1777,207937,2.46,0.14,0.14047928513403737,0.85,99.46
2020-09-14,Maharashtra,667,2,664,8570,3036,2070,7.78,1,123.1,209726,1779,208601,2.47,1.68,0.06961819658813972,0.85,99.46
2020-09-15,Maharashtra,1239,13,1232,16157,2120,519,7.67,0,123.1,210965,1792,209833,1.72,0.42,0.13125101543460602,0.85,99.46
2020-09-16,Maharashtra,716,7,712,9145,374,319,7.83,0,123.1,211681,1799,210545,0.3,0.26,0.07428919577579204,0.85,99.46
2020-09-17,Maharashtra,697,2,688,8664,1081,605,8.04,7,123.1,212378,1801,211233,0.88,0.49,0.07038180341186027,0.85,99.46
2020-09-18,Maharashtra,1493,14,1489,19066,4589,530,7.83,0,123.1,213871,1815,212722,3.73,0.43,0.15488220958570267,0.85,99.46
2020-09-19,Maharashtra,1267,17,1261,15691,1227,975,8.07,0,123.1,215138,1832,213983,1.0,0.79,0.1274654752233956,0.85,99.46
2020-09-20,Maharashtra,773,7,772,10071,158,144,7.68,0,123.1,215911,1839,214755,0.13,0.12,0.08181153533712429,0.85,99.46
2020-09-21,Maharashtra,618,6,613,8150,3157,221,7.58,0,123.1,216529,1845,215368,2.56,0.18,0.0662063363119415,0.85,99.46
2020-09-22,Maharashtra,407,5,399,5209,1501,631,7.81,3,123.1,216936,1850,215767,1.22,0.51,0.04231519090170593,0.85,99.46
2020-09-23,Maharashtra,1409,12,1408,17848,3892,2761,7.89,0,123.1,218345,1862,217175,3.16,2.24,0.14498781478472786,0.85,99.46
2020-09-24,Maharashtra,302,4,293,3684,579,193,8.2,5,123.1,218647,1866,217468,0.47,0.16,0.02992688870836718,0.85,99.46
2020-09-25,Maharashtra,1402,15,1394,17252,2402,1851,8.13,0,123.1,220049,1881,218862,1.95,1.5,0.14014622258326564,0.85,99.46
2020-09-26,Maharashtra,329,3,327,3982,2790,2697,8.26,0,123.1,220378,1884,219189,2.27,2.19,0.0323476848090983,0.85,99.46
2020-09-27,Maharashtra,275,3,266,3289,2244,1083,8.36,6,123.1,220653,1887,219455,1.82,0.88,0.026718115353371243,0.86,99.46
2020-09-28,Maharashtra,1309,4,1300,16119,4178,1142,8.12,5,123.1,221962,1891,220755,3.39,0.93,0.13094232331437855,0.85,99.46
2020-09-29,Maharashtra,1279,8,1270,16060,4897,4303,7.96,1,123.1,223241,1899,222025,3.98,3.5,0.1304630381803412,0.85,99.46
2020-09-30,Maharashtra,177,2,169,2229,894,390,7.94,6,123.1,223418,1901,222194,0.73,0.32,0.0181072298943948,0.85,99.45
2020-10-01,Maharashtra,468,4,460,5825,2968,2540,8.03,4,123.1,223886,1905,222654,2.41,2.06,0.047319252640129976,0.85,99.45
2020-10-02,Maharashtra,1535,21,1530,18737,3344,3326,8.19,0,123.1,225421,1926,224184,2.72,2.7,0.15220958570268076,0.85,99.45
2020-10-03,Maharashtra,404,1,401,4667,568,171,8.66,2,123.1,225825,1927,224585,0.46,0.14,0.037912266450040616,0.85,99.45
2020-10-04,Maharashtra,1324,10,1322,16304,3047,2059,8.12,0,123.1,227149,1937,225907,2.48,1.67,0.1324451665312754,0.85,99.45
2020-10-05,Maharashtra,713,6,704,8762,4645,3574,8.14,3,123.1,227862,1943,226611,3.77,2.9,0.07117790414297319,0.85,99.45
2020-10-06,Maharashtra,285,3,277,3103,1634,1128,9.18,5,123.1,228147,1946,226888,1.33,0.92,0.02520714865962632,0.85,99.45
2020-10-07,Maharashtra,1560,5,1554,19173,4746,2987,8.14,1,123.1,229707,1951,228442,3.86,2.43,0.1557514216084484,0.85,99.45
2020-10-08,Maharashtra,1287,11,1285,15734,1839,1164,8.18,0,123.1,230994,1962,229727,1.49,0.95,0.12781478472786353,0.85,99.45
2020-10-09,Maharashtra,1531,18,1523,18910,2170,1206,8.1,0,123.1,232525,1980,231250,1.76,0.98,0.1536149471974005,0.85,99.45
2020-10-10,Maharashtra,1187,12,1180,14315,3086,2186,8.29,0,123.1,233712,1992,232430,2.51,1.78,0.11628757108042242,0.85,99.45
2020-10-11,Maharashtra,1246,12,1238,15793,3016,2617,7.89,0,123.1,234958,2004,233668,2.45,2.13,0.1282940698619009,0.85,99.45
2020-10-12,Maharashtra,181,2,175,2134,792,17,8.48,4,123.1,235139,2006,233843,0.64,0.01,0.01733549959382616,0.85,99.45
2020-10-13,Maharashtra,724,4,716,9294,3453,2182,7.79,4,123.1,235863,2010,234559,2.81,1.77,0.07549959382615759,0.85,99.45
2020-10-14,Maharashtra,638,3,636,8281,3878,2139,7.7,0,123.1,236501,2013,235195,3.15,1.74,0.06727051177904143,0.85,99.45
2020-10-15,Maharashtra,1153,9,1153,14441,29,0,7.98,0,123.1,237654,2022,236348,0.02,0.0,0.11731112916328189,0.85,99.45
2020-10-16,Maharashtra,945,4,936,11893,4521,2168,7.95,5,123.1,238599,2026,237284,3.67,1.76,0.09661251015434606,0.85,99.45
2020-10-17,Maharashtra,1500,6,1497,18615,3998,2273,8.06,0,123.1,240099,2032,238781,3.25,1.85,0.15121852152721366,0.85,99.45
2020-10-18,Maharashtra,496,7,487,5468,198,107,9.07,2,123.1,240595,2039,239268,0.16,0.09,0.044419171405361495,0.85,99.45
2020-10-19,Maharashtra,1026,11,1020,12600,2816,2116,8.14,0,123.1,241621,2050,240288,2.29,1.72,0.10235580828594638,0.85,99.45
2020-10-20,Maharashtra,1564,20,1562,19492,2848,2436,8.02,0,123.1,243185,2070,241850,2.31,1.98,0.15834281072298945,0.85,99.45
2020-10-21,Maharashtra,1573,15,1566,19956,283,227,7.88,0,123.1,244758,2085,243416,0.23,0.18,0.16211210398050366,0.85,99.45
2020-10-22,Maharashtra,326,4,324,4035,4380,2596,8.08,0,123.1,245084,2089,243740,3.56,2.11,0.03277822908204712,0.85,99.45
2020-10-23,Maharashtra,857,6,852,10353,1627,1237,8.28,0,123.1,245941,2095,244592,1.32,1.0,0.08410235580828594,0.85,99.45
2020-10-24,Maharashtra,582,6,579,7192,2475,2328,8.09,0,123.1,246523,2101,245171,2.01,1.89,0.05842404549147035,0.85,99.45
2020-10-25,Maharashtra,674,5,668,8857,3249,619,7.61,1,123.1,247197,2106,245839,2.64,0.5,0.07194963444354184,0.85,99.45
2020-10-26,Maharashtra,1584,8,1579,19766,1549,460,8.01,0,123.1,248781,2114,247418,1.26,0.37,0.16056864337936638,0.85,99.45
2020-10-27,Maharashtra,1568,19,1568,19266,1597,245,8.14,0,123.1,250349,2133,248986,1.3,0.2,0.15650690495532088,0.85,99.46
2020-10-28,Maharashtra,1103,12,1102,13798,2334,885,7.99,0,123.1,251452,2145,250088,1.9,0.72,0.11208773354995938,0.85,99.46
2020-10-29,Maharashtra,29,0,28,727,1128,749,3.99,1,123.1,251481,2145,250116,0.92,0.61,0.005905767668562145,0.85,99.46
2020-10-30,Maharashtra,394,3,393,5113,524,384,7.71,0,123.1,251875,2148,250509,0.43,0.31,0.041535337124289196,0.85,99.46
2020-10-31,Maharashtra,420,5,417,5832,2874,1399,7.2,0,123.1,252295,2153,250926,2.33,1.14,0.04737611697806661,0.85,99.46
2020-11-01,Maharashtra,603,6,597,7321,4101,4077,8.24,0,123.1,252898,2159,251523,3.33,3.31,0.059471974004874084,0.85,99.46
2020-11-02,Maharashtra,358,4,356,4196,688,604,8.53,0,123.1,253256,2163,251879,0.56,0.49,0.034086108854589764,0.85,99.46
2020-11-03,Maharashtra,1282,8,1278,15987,63,17,8.02,0,123.1,254538,2171,253157,0.05,0.01,0.12987002437043055,0.85,99.46
2020-11-04,Maharashtra,1066,13,1060,13465,4354,3463,7.92,0,123.1,255604,2184,254217,3.54,2.81,0.10938261575954508,0.85,99.46
2020-11-05,Maharashtra,1118,5,1115,14360,210,179,7.79,0,123.1,256722,2189,255332,0.17,0.15,0.11665312753858652,0.85,99.46
2020-11-06,Maharashtra,1273,17,1270,15735,4159,2088,8.09,0,123.1,257995,2206,256602,3.38,1.7,0.12782290820471162,0.86,99.46
2020-11-07,Maharashtra,882,8,879,11083,256,148,7.96,0,123.1,258877,2214,257481,0.21,0.12,0.09003249390739236,0.86,99.46
2020-11-08,Maharashtra,126,0,122,1179,2266,2053,10.69,4,123.1,259003,2214,257603,1.84,1.67,0.009577579203899268,0.85,99.46
2020-11-09,Maharashtra,972,10,970,12309,3098,2604,7.9,0,123.1,259975,2224,258573,2.52,2.12,0.0999918765231519,0.86,99.46
2020-11-10,Maharashtra,588,3,585,7235,3654,1612,8.13,0,123.1,260563,2227,259158,2.97,1.31,0.05877335499593826,0.85,99.46
2020-11-11,Maharashtra,984,8,977,12676,1708,1413,7.76,0,123.1,261547,2235,260135,1.39,1.15,0.1029731925264013,0.85,99.46
2020-11-12,Maharashtra,1266,5,1266,16064,1182,301,7.88,0,123.1,262813,2240,261401,0.96,0.24,0.13049553208773354,0.85,99.46
2020-11-13,Maharashtra,1134,7,1128,14122,855,251,8.03,0,123.1,263947,2247,262529,0.69,0.2,0.11471974004874086,0.85,99.46
2020-11-14,Maharashtra,547,6,544,7004,4093,3821,7.81,0,123.1,264494,2253,263073,3.32,3.1,0.056896831844029244,0.85,99.46
2020-11-15,Maharashtra,460,1,454,5856,2485,1705,7.86,5,123.1,264954,2254,263527,2.02,1.39,0.047571080422420794,0.85,99.46
2020-11-16,Maharashtra,1405,18,1403,17462,1452,318,8.05,0,123.1,266359,2272,264930,1.18,0.26,0.14185215272136475,0.85,99.46
2020-11-17,Maharashtra,1256,4,1256,15538,3265,1430,8.08,0,123.1,267615,2276,266186,2.65,1.16,0.1262225832656377,0.85,99.47
2020-11-18,Maharashtra,917,12,909,11559,388,306,7.93,0,123.1,268532,2288,267095,0.32,0.25,0.09389926888708368,0.85,99.46
2020-11-19,Maharashtra,661,4,656,8127,124,8,8.13,1,123.1,269193,2292,267751,0.1,0.01,0.06601949634443542,0.85,99.46
2020-11-20,Maharashtra,282,1,276,3333,1030,300,8.46,5,123.1,269475,2293,268027,0.84,0.24,0.027075548334687245,0.85,99.46
2020-11-21,Maharashtra,835,8,833,10767,3254,2095,7.76,0,123.1,270310,2301,268860,2.64,1.7,0.08746547522339561,0.85,99.46
2020-11-22,Maharashtra,1309,16,1308,16477,3972,2874,7.94,0,123.1,271619,2317,270168,3.23,2.33,0.13385052802599512,0.85,99.47
2020-11-23,Maharashtra,403,3,399,4690,1607,516,8.59,1,123.1,272022,2320,270567,1.31,0.42,0.03809910641754671,0.85,99.47
2020-11-24,Maharashtra,64,0,63,652,1128,810,9.82,1,123.1,272086,2320,270630,0.92,0.66,0.005296506904955321,0.85,99.46
2020-11-25,Maharashtra,1457,12,1456,18458,4797,3596,7.89,0,123.1,273543,2332,272086,3.9,2.92,0.14994313566206335,0.85,99.47
2020-11-26,Maharashtra,1000,4,994,12566,4363,2038,7.96,2,123.1,274543,2336,273080,3.54,1.66,0.1020796100731113,0.85,99.47
2020-11-27,Maharashtra,1398,19,1397,17417,2095,749,8.03,0,123.1,275941,2355,274477,1.7,0.61,0.14148659626320065,0.85,99.47
2020-11-28,Maharashtra,299,1,293,3950,2470,1220,7.57,5,123.1,276240,2356,274770,2.01,0.99,0.032087733549959384,0.85,99.47
2020-11-29,Maharashtra,1241,6,1236,15294,3770,628,8.11,0,123.1,277481,2362,276006,3.06,0.51,0.1242404549147035,0.85,99.47
2020-11-30,Maharashtra,946,3,942,11816,3356,2929,8.01,1,123.1,278427,2365,276948,2.73,2.38,0.09598700243704306,0.85,99.47
2020-12-01,Maharashtra,966,13,964,12457,1571,1086,7.75,0,123.1,279393,2378,277912,1.28,0.88,0.10119415109666938,0.85,99.47
2020-12-02,Maharashtra,1100,6,1100,13622,1452,898,8.08,0,123.1,280493,2384,279012,1.18,0.73,0.11065800162469537,0.85,99.47
2020-12-03,Maharashtra,285,2,281,3751,2270,1569,7.6,2,123.1,280778,2386,279293,1.84,1.27,0.030471161657189275,0.85,99.47
2020-12-04,Maharashtra,654,9,654,8179,2302,290,8.0,0,123.1,281432,2395,279947,1.87,0.24,0.06644191714053616,0.85,99.47
2020-12-05,Maharashtra,184,0,178,2586,3170,1881,7.12,6,123.1,281616,2395,280125,2.58,1.53,0.02100731112916328,0.85,99.47
2020-12-06,Maharashtra,1328,15,1326,16573,3790,1746,8.01,0,123.1,282944,2410,281451,3.08,1.42,0.13463038180341186,0.85,99.47
2020-12-07,Maharashtra,936,11,936,11843,3437,2370,7.9,0,123.1,283880,2421,282387,2.79,1.93,0.09620633631194152,0.85,99.47
2020-12-08,Maharashtra,700,8,695,8506,2105,471,8.23,0,123.1,284580,2429,283082,1.71,0.38,0.0690982940698619,0.85,99.47
2020-12-09,Maharashtra,1109,14,1103,14037,3709,3564,7.9,0,123.1,285689,2443,284185,3.01,2.9,0.11402924451665312,0.86,99.47
2020-12-10,Maharashtra,701,8,694,8407,1695,1472,8.34,0,123.1,286390,2451,284879,1.38,1.2,0.0682940698619009,0.86,99.47
2020-12-11,Maharashtra,275,3,268,3297,1464,1287,8.34,4,123.1,286665,2454,285147,1.19,1.05,0.02678310316815597,0.86,99.47
2020-12-12,Maharashtra,687,6,686,8734,2461,1427,7.87,0,123.1,287352,2460,285833,2.0,1.16,0.07095044679122664,0.86,99.47
2020-12-13,Maharashtra,903,5,902,11496,4610,1077,7.85,0,123.1,288255,2465,286735,3.74,0.87,0.09338748984565394,0.86,99.47
2020-12-14,Maharashtra,736,7,730,9386,2242,2,7.84,0,123.1,288991,2472,287465,1.82,0.0,0.07624695369618197,0.86,99.47
2020-12-15,Maharashtra,125,1,121,1928,3984,2228,6.48,3,123.1,289116,2473,287586,3.24,1.81,0.015662063363119413,0.86,99.47
2020-12-16,Maharashtra,1588,23,1583,19891,4325,684,7.98,0,123.1,290704,2496,289169,3.51,0.56,0.16158407798537774,0.86,99.47
2020-12-17,Maharashtra,330,1,324,4385,2558,1193,7.53,5,123.1,291034,2497,289493,2.08,0.97,0.03562144597887896,0.86,99.47
2020-12-18,Maharashtra,875,4,870,10384,4402,4147,8.43,1,123.1,291909,2501,290363,3.58,3.37,0.08435418359057677,0.86,99.47
2020-12-19,Maharashtra,1423,19,1419,17493,2591,1828,8.13,0,123.1,293332,2520,291782,2.1,1.48,0.14210398050365555,0.86,99.47
2020-12-20,Maharashtra,745,3,742,9515,366,82,7.83,0,123.1,294077,2523,292524,0.3,0.07,0.0772948822095857,0.86,99.47
2020-12-21,Maharashtra,710,2,706,8623,2427,1601,8.23,2,123.1,294787,2525,293230,1.97,1.3,0.07004874086108855,0.86,99.47
2020-12-22,Maharashtra,1390,9,1387,17420,2200,1410,7.98,0,123.1,296177,2534,294617,1.79,1.15,0.1415109666937449,0.86,99.47
2020-12-23,Maharashtra,450,5,441,5779,3363,1854,7.79,4,123.1,296627,2539,295058,2.73,1.51,0.04694557270511779,0.86,99.47
2020-12-24,Maharashtra,59,0,58,987,456,443,5.98,1,123.1,296686,2539,295116,0.37,0.36,0.0080178716490658,0.86,99.47
2020-12-25,Maharashtra,1570,13,1563,19718,2886,1251,7.96,0,123.1,298256,2552,296679,2.34,1.02,0.160178716490658,0.86,99.47
2020-12-26,Maharashtra,412,4,408,5355,1698,169,7.69,0,123.1,298668,2556,297087,1.38,0.14,0.04350121852152721,0.86,99.47
2020-12-27,Maharashtra,961,3,955,12036,410,112,7.98,3,123.1,299629,2559,298042,0.33,0.09,0.09777416734362307,0.85,99.47
2020-12-28,Maharashtra,447,5,442,5005,4646,3866,8.93,0,123.1,300076,2564,298484,3.77,3.14,0.04065800162469537,0.85,99.47
2020-12-29,Maharashtra,887,9,880,11148,4195,2437,7.96,0,123.1,300963,2573,299364,3.41,1.98,0.09056051990251827,0.85,99.47
2020-12-30,Maharashtra,1187,11,1183,14974,3026,610,7.93,0,123.1,302150,2584,300547,2.46,0.5,0.12164094232331438,0.86,99.47
2020-12-31,Maharashtra,550,4,543,6884,2460,415,7.99,3,123.1,302700,2588,301090,2.0,0.34,0.05592201462225833,0.85,99.47
2021-01-01,Maharashtra,842,2,834,10300,4664,1364,8.17,6,123.1,303542,2590,301924,3.79,1.11,0.08367181153533712,0.85,99.47
2021-01-02,Maharashtra,1140,11,1138,13969,3289,812,8.16,0,123.1,304682,2601,303062,2.67,0.66,0.11347684809098293,0.85,99.47
2021-01-03,Maharashtra,330,4,325,4112,3279,3224,8.03,1,123.1,305012,2605,303387,2.66,2.62,0.033403736799350124,0.85,99.47
2021-01-04,Maharashtra,843,9,835,10369,1980,594,8.13,0,123.1,305855,2614,304222,1.61,0.48,0.0842323314378554,0.85,99.47
2021-01-05,Maharashtra,925,3,923,11576,3333,3295,7.99,0,123.1,306780,2617,305145,2.71,2.68,0.09403736799350122,0.85,99.47
2021-01-06,Maharashtra,515,1,514,6636,3899,644,7.76,0,123.1,307295,2618,305659,3.17,0.52,0.053907392363931765,0.85,99.47
2021-01-07,Maharashtra,68,0,64,846,1107,421,8.04,4,123.1,307363,2618,305723,0.9,0.34,0.006872461413484972,0.85,99.47
2021-01-08,Maharashtra,402,3,397,4708,2983,2271,8.54,2,123.1,307765,2621,306120,2.42,1.84,0.038245329000812345,0.85,99.47
2021-01-09,Maharashtra,629,6,628,8022,725,600,7.84,0,123.1,308394,2627,306748,0.59,0.49,0.06516653127538587,0.85,99.47
2021-01-10,Maharashtra,227,3,221,3030,2334,1589,7.49,3,123.1,308621,2630,306969,1.9,1.29,0.02461413484971568,0.85,99.46
2021-01-11,Maharashtra,1047,9,1045,12871,3176,676,8.13,0,123.1,309668,2639,308014,2.58,0.55,0.10455727051177904,0.85,99.47
2021-01-12,Maharashtra,823,9,822,10414,1880,657,7.9,0,123.1,310491,2648,308836,1.53,0.53,0.08459788789601949,0.85,99.47
2021-01-13,Maharashtra,1090,10,1081,13672,2253,945,7.97,0,123.1,311581,2658,309917,1.83,0.77,0.11106417546709992,0.85,99.47
2021-01-14,Maharashtra,461,2,452,5496,2272,2252,8.39,7,123.1,312042,2660,310369,1.85,1.83,0.044646628757108044,0.85,99.46
2021-01-15,Maharashtra,841,12,835,10101,840,451,8.33,0,123.1,312883,2672,311204,0.68,0.37,0.08205523964256702,0.85,99.46
2021-01-16,Maharashtra,1514,6,1507,18806,4312,3602,8.05,1,123.1,314397,2678,312711,3.5,2.93,0.15277010560519902,0.85,99.46
2021-01-17,Maharashtra,36,0,30,627,3783,694,5.74,6,123.1,314433,2678,312741,3.07,0.56,0.005093419983753046,0.85,99.46
2021-01-18,Maharashtra,1065,10,1063,13157,470,77,8.09,0,123.1,315498,2688,313804,0.38,0.06,0.10688058489033306,0.85,99.46
2021-01-19,Maharashtra,124,0,123,1511,650,590,8.21,1,123.1,315622,2688,313927,0.53,0.48,0.012274573517465475,0.85,99.46
2021-01-20,Maharashtra,1177,14,1172,14528,3835,862,8.1,0,123.1,316799,2702,315099,3.12,0.7,0.1180178716490658,0.85,99.46
2021-01-21,Maharashtra,623,6,620,8219,3379,2834,7.58,0,123.1,317422,2708,315719,2.74,2.3,0.06676685621445978,0.85,99.46
2021-01-22,Maharashtra,801,2,793,10154,1345,703,7.89,6,123.1,318223,2710,316512,1.09,0.57,0.08248578391551584,0.85,99.46
2021-01-23,Maharashtra,876,11,867,10829,4295,543,8.09,0,123.1,319099,2721,317379,3.49,0.44,0.08796913078797726,0.85,99.46
2021-01-24,Maharashtra,293,1,284,3229,879,290,9.07,8,123.1,319392,2722,317663,0.71,0.24,0.026230706742485784,0.85,99.46
2021-01-25,Maharashtra,951,7,950,12182,1708,1653,7.81,0,123.1,320343,2729,318613,1.39,1.34,0.09896019496344435,0.85,99.46
2021-01-26,Maharashtra,1193,15,1184,14254,4081,2382,8.37,0,123.1,321536,2744,319797,3.32,1.94,0.11579203899268888,0.85,99.46
2021-01-27,Maharashtra,1218,8,1214,15157,1859,816,8.04,0,123.1,322754,2752,321011,1.51,0.66,0.12312753858651503,0.85,99.46
2021-01-28,Maharashtra,1265,12,1259,15757,182,44,8.03,0,123.1,324019,2764,322270,0.15,0.04,0.12800162469536963,0.85,99.46
2021-01-29,Maharashtra,100,1,91,1425,3801,2775,7.02,8,123.1,324119,2765,322361,3.09,2.25,0.01157595450852965,0.85,99.46
2021-01-30,Maharashtra,1074,5,1069,13468,4654,3975,7.97,0,123.1,325193,2770,323430,3.78,3.23,0.10940698619008936,0.85,99.46
2021-01-31,Maharashtra,696,8,687,8382,4358,2985,8.3,1,123.1,325889,2778,324117,3.54,2.42,0.06809098294069862,0.85,99.46
2021-02-01,Maharashtra,1057,5,1055,12766,1479,1422,8.28,0,123.1,326946,2783,325172,1.2,1.16,0.10370430544272949,0.85,99.46
2021-02-02,Maharashtra,211,2,204,2290,4796,4704,9.21,5,123.1,327157,2785,325376,3.9,3.82,0.01860276198212835,0.85,99.46
2021-02-03,Maharashtra,918,8,918,11650,3727,1396,7.88,0,123.1,328075,2793,326294,3.03,1.13,0.09463850528025995,0.85,99.46
2021-02-04,Maharashtra,548,2,542,7004,869,237,7.82,4,123.1,328623,2795,326836,0.71,0.19,0.056896831844029244,0.85,99.46
2021-02-05,Maharashtra,675,8,674,8055,1069,435,8.38,0,123.1,329298,2803,327510,0.87,0.35,0.06543460601137287,0.85,99.46
2021-02-06,Maharashtra,79,0,77,1146,89,76,6.89,2,123.1,329377,2803,327587,0.07,0.06,0.009309504467912266,0.85,99.46
2021-02-07,Maharashtra,1198,5,1194,14680,2701,715,8.16,0,123.1,330575,2808,328781,2.19,0.58,0.11925264012997563,0.85,99.46
2021-02-08,Maharashtra,135,1,126,1979,3011,681,6.82,8,123.1,330710,2809,328907,2.45,0.55,0.016076360682372056,0.85,99.45
2021-02-09,Maharashtra,745,10,741,9471,2707,1389,7.87,0,123.1,331455,2819,329648,2.2,1.13,0.0769374492282697,0.85,99.45
2021-02-10,Maharashtra,1490,15,1490,18669,2005,5,7.98,0,123.1,332945,2834,331138,1.63,0.0,0.15165718927701055,0.85,99.46
2021-02-11,Maharashtra,502,2,499,5978,4373,2803,8.4,1,123.1,333447,2836,331637,3.55,2.28,0.048562144597887894,0.85,99.46
2021-02-12,Maharashtra,354,2,354,4267,1416,1077,8.3,0,123.1,333801,2838,331991,1.15,0.87,0.034662875710804224,0.85,99.46
2021-02-13,Maharashtra,186,1,178,2640,1890,1345,7.05,7,123.1,333987,2839,332169,1.54,1.09,0.021445978878960194,0.85,99.46
2021-02-14,Maharashtra,817,10,808,9884,793,548,8.27,0,123.1,334804,2849,332977,0.64,0.45,0.08029244516653128,0.85,99.45
2021-02-15,Maharashtra,1390,5,1383,17734,4227,3803,7.84,2,123.1,336194,2854,334360,3.43,3.09,0.1440617384240455,0.85,99.45
2021-02-16,Maharashtra,1274,8,1272,15793,4399,3450,8.07,0,123.1,337468,2862,335632,3.57,2.8,0.1282940698619009,0.85,99.46
2021-02-17,Maharashtra,180,1,172,2042,3065,2870,8.81,7,123.1,337648,2863,335804,2.49,2.33,0.016588139723801788,0.85,99.45
2021-02-18,Maharashtra,1352,14,1343,16779,1235,250,8.06,0,123.1,339000,2877,337147,1.0,0.2,0.1363038180341186,0.85,99.45
2021-02-19,Maharashtra,46,0,37,610,2190,1561,7.54,9,123.1,339046,2877,337184,1.78,1.27,0.004955320877335499,0.85,99.45
2021-02-20,Maharashtra,1221,17,1213,15585,2141,1058,7.83,0,123.1,340267,2894,338397,1.74,0.86,0.12660438667749796,0.85,99.45
2021-02-21,Maharashtra,1562,17,1557,19437,195,72,8.04,0,123.1,341829,2911,339954,0.16,0.06,0.15789601949634444,0.85,99.45
2021-02-22,Maharashtra,254,1,247,3624,3032,1536,7.01,6,123.1,342083,2912,340201,2.46,1.25,0.02943948009748172,0.85,99.45
2021-02-23,Maharashtra,801,5,793,10510,804,270,7.62,3,123.1,342884,2917,340994,0.65,0.22,0.08537774167343623,0.85,99.45
2021-02-24,Maharashtra,986,10,979,12217,2394,1138,8.07,0,123.1,343870,2927,341973,1.94,0.92,0.09924451665312754,0.85,99.45
2021-02-25,Maharashtra,565,3,561,6667,4805,1184,8.47,1,123.1,344435,2930,342534,3.9,0.96,0.054159220146222584,0.85,99.45
2021-02-26,Maharashtra,1437,15,1433,17821,4433,1132,8.06,0,123.1,345872,2945,343967,3.6,0.92,0.1447684809098294,0.85,99.45
2021-02-27,Maharashtra,1312,10,1306,16283,3133,998,8.06,0,123.1,347184,2955,345273,2.55,0.81,0.13227457351746547,0.85,99.45
2021-02-28,Maharashtra,595,8,592,7359,4075,1374,8.09,0,123.1,347779,2963,345865,3.31,1.12,0.05978066612510154,0.85,99.45
2021-03-01,Maharashtra,1534,15,1532,19106,3329,2665,8.03,0,123.1,349313,2978,347397,2.7,2.16,0.15520714865962632,0.85,99.45
2021-03-02,Maharashtra,870,11,865,10711,3871,2162,8.12,0,123.1,350183,2989,348262,3.14,1.76,0.08701056051990252,0.85,99.45
2021-03-03,Maharashtra,331,1,330,4125,4599,2724,8.02,0,123.1,350514,2990,348592,3.74,2.21,0.033509341998375304,0.85,99.45
2021-03-04,Maharashtra,1556,17,1551,19235,240,170,8.09,0,123.1,352070,3007,350143,0.19,0.14,0.15625507717303005,0.85,99.45
2021-03-05,Maharashtra,1419,4,1410,18117,2607,1232,7.83,5,123.1,353489,3011,351553,2.12,1.0,0.14717303005686433,0.85,99.45
2021-03-06,Maharashtra,1017,10,1016,12447,572,358,8.17,0,123.1,354506,3021,352569,0.46,0.29,0.10111291632818846,0.85,99.45
2021-03-07,Maharashtra,1127,11,1120,13565,2483,2233,8.31,0,123.1,355633,3032,353689,2.02,1.81,0.11019496344435419,0.85,99.45
2021-03-08,Maharashtra,93,1,84,1150,2508,973,8.09,8,123.1,355726,3033,353773,2.04,0.79,0.00934199837530463,0.85,99.45
2021-03-09,Maharashtra,1116,12,1109,13925,2012,1070,8.01,0,123.1,356842,3045,354882,1.63,0.87,0.11311941510966694,0.85,99.45
2021-03-10,Maharashtra,1482,20,1476,18728,1498,652,7.91,0,123.1,358324,3065,356358,1.22,0.53,0.15213647441104794,0.86,99.45
2021-03-11,Maharashtra,1167,6,1161,14568,1846,1074,8.01,0,123.1,359491,3071,357519,1.5,0.87,0.11834281072298944,0.85,99.45
2021-03-12,Maharashtra,1563,9,1563,19516,1344,1135,8.01,0,123.1,361054,3080,359082,1.09,0.92,0.15853777416734363,0.85,99.45
2021-03-13,Maharashtra,1114,3,1108,14025,3536,1252,7.94,3,123.1,362168,3083,360190,2.87,1.02,0.11393176279447603,0.85,99.45
2021-03-14,Maharashtra,1494,14,1485,18551,4067,3877,8.05,0,123.1,363662,3097,361675,3.3,3.15,0.15069861900893583,0.85,99.45
2021-03-15,Maharashtra,484,7,484,6154,2241,558,7.86,0,123.1,364146,3104,362159,1.82,0.45,0.04999187652315191,0.85,99.45
2021-03-16,Maharashtra,1173,16,1165,14795,1242,1111,7.93,0,123.1,365319,3120,363324,1.01,0.9,0.12018683996750609,0.85,99.45
2021-03-17,Maharashtra,358,3,356,4557,1201,664,7.86,0,123.1,365677,3123,363680,0.98,0.54,0.03701868399675061,0.85,99.45
2021-03-18,Maharashtra,1048,11,1046,13193,3405,219,7.94,0,123.1,366725,3134,364726,2.77,0.18,0.10717303005686434,0.85,99.45
2021-03-19,Maharashtra,91,0,83,996,2790,2614,9.14,8,123.1,366816,3134,364809,2.27,2.12,0.00809098294069862,0.85,99.45
2021-03-20,Maharashtra,1540,12,1540,18940,4864,2606,8.13,0,123.1,368356,3146,366349,3.95,2.12,0.15385865150284322,0.85,99.46
2021-03-21,Maharashtra,1052,4,1047,12974,2021,633,8.11,1,123.1,369408,3150,367396,1.64,0.51,0.10539398862713241,0.85,99.46
2021-03-22,Maharashtra,378,3,374,5036,2313,608,7.51,1,123.1,369786,3153,367770,1.88,0.49,0.04090982940698619,0.85,99.45
2021-03-23,Maharashtra,237,0,232,3287,2601,2130,7.21,5,123.1,370023,3153,368002,2.11,1.73,0.02670186839967506,0.85,99.45
2021-03-24,Maharashtra,857,6,853,10646,492,424,8.05,0,123.1,370880,3159,368855,0.4,0.34,0.08648253452477661,0.85,99.45
2021-03-25,Maharashtra,296,1,292,4211,4289,779,7.03,3,123.1,371176,3160,369147,3.48,0.63,0.034207961007311126,0.85,99.45
2021-03-26,Maharashtra,1156,9,1155,14462,1284,780,7.99,0,123.1,372332,3169,370302,1.04,0.63,0.1174817221770918,0.85,99.45
2021-03-27,Maharashtra,939,3,939,12070,3559,652,7.78,0,123.1,373271,3172,371241,2.89,0.53,0.09805036555645816,0.85,99.46
2021-03-28,Maharashtra,537,5,530,6698,2877,2459,8.02,2,123.1,373808,3177,371771,2.34,2.0,0.0544110479285134,0.85,99.46
2021-03-29,Maharashtra,879,2,879,10978,2824,1971,8.01,0,123.1,374687,3179,372650,2.29,1.6,0.0891795288383428,0.85,99.46
2021-03-30,Maharashtra,911,13,909,11593,315,165,7.86,0,123.1,375598,3192,373559,0.26,0.13,0.09417546709991877,0.85,99.46
2021-03-31,Maharashtra,404,3,401,4558,1955,350,8.86,0,123.1,376002,3195,373960,1.59,0.28,0.0370268074735987,0.85,99.46
2021-04-01,Maharashtra,433,6,430,5114,4838,1617,8.47,0,123.1,376435,3201,374390,3.93,1.31,0.04154346060113729,0.85,99.46
2021-04-02,Maharashtra,271,2,270,3639,3846,2517,7.45,0,123.1,376706,3203,374660,3.12,2.04,0.029561332250203087,0.85,99.46
2021-04-03,Maharashtra,1427,14,1421,17818,4580,2990,8.01,0,123.1,378133,3217,376081,3.72,2.43,0.14474411047928512,0.85,99.46
2021-04-04,Maharashtra,89,1,81,1246,2472,1515,7.14,7,123.1,378222,3218,376162,2.01,1.23,0.010121852152721364,0.85,99.46
2021-04-05,Maharashtra,404,1,396,5182,388,199,7.8,7,123.1,378626,3219,376558,0.32,0.16,0.04209585702680747,0.85,99.45
2021-04-06,Maharashtra,688,9,687,8317,3082,1739,8.27,0,123.1,379314,3228,377245,2.5,1.41,0.06756295694557271,0.85,99.45
2021-04-07,Maharashtra,459,5,457,6104,4202,2187,7.52,0,123.1,379773,3233,377702,3.41,1.78,0.04958570268074736,0.85,99.45
2021-04-08,Maharashtra,288,1,284,3390,4885,2685,8.5,3,123.1,380061,3234,377986,3.97,2.18,0.027538586515028433,0.85,99.45
2021-04-09,Maharashtra,1458,10,1456,18219,1382,832,8.0,0,123.1,381519,3244,379442,1.12,0.68,0.14800162469536962,0.85,99.46
2021-04-10,Maharashtra,1416,16,1408,18229,1897,82,7.77,0,123.1,382935,3260,380850,1.54,0.07,0.14808285946385052,0.85,99.46
2021-04-11,Maharashtra,857,8,856,10679,594,335,8.03,0,123.1,383792,3268,381706,0.48,0.27,0.08675060926076361,0.85,99.46
2021-04-12,Maharashtra,1037,4,1028,13042,4969,2491,7.95,5,123.1,384829,3272,382734,4.04,2.02,0.1059463850528026,0.85,99.46
2021-04-13,Maharashtra,1284,16,1278,16428,3629,845,7.82,0,123.1,386113,3288,384012,2.95,0.69,0.13345247766043866,0.85,99.46
2021-04-14,Maharashtra,623,6,623,7954,2585,1263,7.83,0,123.1,386736,3294,384635,2.1,1.03,0.06461413484971568,0.85,99.46
2021-04-15,Maharashtra,212,2,210,2853,4237,17,7.43,0,123.1,386948,3296,384845,3.44,0.01,0.023176279447603573,0.85,99.46
2021-04-16,Maharashtra,1343,8,1341,17063,4712,1736,7.87,0,123.1,388291,3304,386186,3.83,1.41,0.13861088545897643,0.85,99.46
2021-04-17,Maharashtra,1534,8,1529,19720,3452,565,7.78,0,123.1,389825,3312,387715,2.8,0.46,0.1601949634443542,0.85,99.46
2021-04-18,Maharashtra,293,2,286,3958,1173,249,7.4,5,123.1,390118,3314,388001,0.95,0.2,0.03215272136474411,0.85,99.46
2021-04-19,Maharashtra,1508,5,1500,18745,242,112,8.04,3,123.1,391626,3319,389501,0.2,0.09,0.15227457351746548,0.85,99.46
2021-04-20,Maharashtra,1312,15,1310,16664,1076,70,7.87,0,123.1,392938,3334,390811,0.87,0.06,0.13536961819658813,0.85,99.46
2021-04-21,Maharashtra,389,1,382,4688,1665,1602,8.3,6,123.1,393327,3335,391193,1.35,1.3,0.03808285946385053,0.85,99.46
2021-04-22,Maharashtra,940,13,932,11778,4116,1368,7.98,0,123.1,394267,3348,392125,3.34,1.11,0.09567831031681559,0.85,99.46
2021-04-23,Maharashtra,1079,5,1074,13019,466,224,8.29,0,123.1,395346,3353,393199,0.38,0.18,0.1057595450852965,0.85,99.46
2021-04-24,Maharashtra,1040,9,1034,13504,2006,1764,7.7,0,123.1,396386,3362,394233,1.63,1.43,0.10969943135662064,0.85,99.46
2021-04-25,Maharashtra,276,3,268,3456,4417,666,7.99,5,123.1,396662,3365,394501,3.59,0.54,0.028074735987002438,0.85,99.46
2021-04-26,Maharashtra,574,3,565,7075,1404,1249,8.11,6,123.1,397236,3368,395066,1.14,1.01,0.057473598700243704,0.85,99.45
2021-04-27,Maharashtra,1583,23,1578,19889,2653,803,7.96,0,123.1,398819,3391,396644,2.16,0.65,0.16156783103168157,0.85,99.45
2021-04-28,Maharashtra,1294,6,1291,16182,4677,4512,8.0,0,123.1,400113,3397,397935,3.8,3.67,0.1314541023558083,0.85,99.46
2021-04-29,Maharashtra,1220,4,1212,15252,1277,363,8.0,4,123.1,401333,3401,399147,1.04,0.29,0.12389926888708368,0.85,99.46
2021-04-30,Maharashtra,1316,14,1308,16613,2130,2067,7.92,0,123.1,402649,3415,400455,1.73,1.68,0.1349553208773355,0.85,99.46
2021-05-01,Maharashtra,1283,13,1279,15855,3025,1662,8.09,0,123.1,403932,3428,401734,2.46,1.35,0.12879772542648255,0.85,99.46
2021-05-02,Maharashtra,643,7,635,7922,2409,2240,8.12,1,123.1,404575,3435,402369,1.96,1.82,0.06435418359057676,0.85,99.45
2021-05-03,Maharashtra,344,2,335,4689,1580,1283,7.34,7,123.1,404919,3437,402704,1.28,1.04,0.03809098294069862,0.85,99.45
2021-05-04,Maharashtra,1092,3,1090,13336,3647,19,8.19,0,123.1,406011,3440,403794,2.96,0.02,0.10833468724614134,0.85,99.45
2021-05-05,Maharashtra,1424,5,1415,17830,1850,1617,7.99,4,123.1,407435,3445,405209,1.5,1.31,0.14484159220146223,0.85,99.45
2021-05-06,Maharashtra,168,1,167,2183,4494,1452,7.7,0,123.1,407603,3446,405376,3.65,1.18,0.017733549959382616,0.85,99.45
2021-05-07,Maharashtra,189,2,185,2485,4405,715,7.61,2,123.1,407792,3448,405561,3.58,0.58,0.020186839967506094,0.85,99.45
2021-05-08,Maharashtra,1030,6,1023,12722,224,28,8.1,1,123.1,408822,3454,406584,0.18,0.02,0.10334687246141348,0.84,99.45
2021-05-09,Maharashtra,176,2,170,2320,1149,501,7.59,4,123.1,408998,3456,406754,0.93,0.41,0.01884646628757108,0.84,99.45
2021-05-10,Maharashtra,707,7,707,8430,1425,199,8.39,0,123.1,409705,3463,407461,1.16,0.16,0.06848090982940698,0.85,99.45
2021-05-11,Maharashtra,590,3,589,7346,114,3,8.03,0,123.1,410295,3466,408050,0.09,0.0,0.05967506092607636,0.84,99.45
2021-05-12,Maharashtra,682,6,680,8499,4036,3119,8.02,0,123.1,410977,3472,408730,3.28,2.53,0.06904142973192526,0.84,99.45
2021-05-13,Maharashtra,1062,15,1059,13262,2575,1302,8.01,0,123.1,412039,3487,409789,2.09,1.06,0.10773354995938261,0.85,99.45
2021-05-14,Maharashtra,1274,5,1268,15941,4305,812,7.99,1,123.1,413313,3492,411057,3.5,0.66,0.12949634443541835,0.84,99.45
2021-05-15,Maharashtra,1087,16,1085,13671,58,48,7.95,0,123.1,414400,3508,412142,0.05,0.04,0.11105605199025183,0.85,99.46
2021-05-16,Maharashtra,1466,8,1466,18765,3939,3703,7.81,0,123.1,415866,3516,413608,3.2,3.01,0.1524370430544273,0.85,99.46
2021-05-17,Maharashtra,754,7,753,9144,4340,1581,8.25,0,123.1,416620,3523,414361,3.53,1.28,0.07428107229894394,0.85,99.46
2021-05-18,Maharashtra,1380,15,1373,17224,4541,2225,8.01,0,123.1,418000,3538,415734,3.69,1.81,0.13991876523151908,0.85,99.46
2021-05-19,Maharashtra,1560,18,1560,19642,2210,867,7.94,0,123.1,419560,3556,417294,1.8,0.7,0.15956133225020308,0.85,99.46
2021-05-20,Maharashtra,1297,5,1292,16252,1131,127,7.98,0,123.1,420857,3561,418586,0.92,0.1,0.13202274573517467,0.85,99.46
2021-05-21,Maharashtra,1057,15,1054,13294,3926,2629,7.95,0,123.1,421914,3576,419640,3.19,2.14,0.10799350121852153,0.85,99.46
2021-05-22,Maharashtra,115,0,112,1684,3888,3486,6.83,3,123.1,422029,3576,419752,3.16,2.83,0.013679935012185215,0.85,99.46
2021-05-23,Maharashtra,595,7,593,7677,2522,1513,7.75,0,123.1,422624,3583,420345,2.05,1.23,0.06236393176279448,0.85,99.46
2021-05-24,Maharashtra,1299,5,1290,16590,1407,1071,7.83,4,123.1,423923,3588,421635,1.14,0.87,0.1347684809098294,0.85,99.46
2021-05-25,Maharashtra,738,3,738,9024,3892,1628,8.18,0,123.1,424661,3591,422373,3.16,1.32,0.07330625507717303,0.85,99.46
2021-05-26,Maharashtra,850,6,845,10909,3148,262,7.79,0,123.1,425511,3597,423218,2.56,0.21,0.08861900893582453,0.85,99.46
2021-05-27,Maharashtra,933,8,929,11212,2673,866,8.32,0,123.1,426444,3605,424147,2.17,0.7,0.0910804224207961,0.85,99.46
2021-05-28,Maharashtra,231,1,231,3175,4828,1877,7.28,0,123.1,426675,3606,424378,3.92,1.52,0.025792038992688872,0.85,99.46
2021-05-29,Maharashtra,945,13,943,11681,4426,51,8.09,0,123.1,427620,3619,425321,3.6,0.04,0.09489033306255078,0.85,99.46
2021-05-30,Maharashtra,1560,19,1552,19562,644,430,7.97,0,123.1,429180,3638,426873,0.52,0.35,0.1589114541023558,0.85,99.46
2021-05-31,Maharashtra,1423,18,1421,17542,1109,130,8.11,0,123.1,430603,3656,428294,0.9,0.11,0.142502030869212,0.85,99.46
2021-06-01,Maharashtra,1396,9,1392,17112,4157,421,8.16,0,123.1,431999,3665,429686,3.38,0.34,0.1390089358245329,0.85,99.46
2021-06-02,Maharashtra,516,6,510,5938,2515,2230,8.69,0,123.1,432515,3671,430196,2.04,1.81,0.04823720552396426,0.85,99.46
2021-06-03,Maharashtra,1542,15,1539,18689,3140,1130,8.25,0,123.1,434057,3686,431735,2.55,0.92,0.15181965881397239,0.85,99.47
2021-06-04,Maharashtra,1321,8,1317,16783,4495,2007,7.87,0,123.1,435378,3694,433052,3.65,1.63,0.13633631194151097,0.85,99.47
2021-06-05,Maharashtra,650,7,643,8011,2779,2715,8.11,0,123.1,436028,3701,433695,2.26,2.21,0.06507717303005686,0.85,99.46
2021-06-06,Maharashtra,406,4,400,5374,81,25,7.55,2,123.1,436434,3705,434095,0.07,0.02,0.043655564581640945,0.85,99.46
2021-06-07,Maharashtra,1433,5,1431,17772,1146,333,8.06,0,123.1,437867,3710,435526,0.93,0.27,0.14437043054427295,0.85,99.47
2021-06-08,Maharashtra,1137,14,1129,14127,3899,3283,8.05,0,123.1,439004,3724,436655,3.17,2.67,0.11476035743298131,0.85,99.46
2021-06-09,Maharashtra,37,0,37,638,4666,2291,5.8,0,123.1,439041,3724,436692,3.79,1.86,0.0051827782290820475,0.85,99.46
2021-06-10,Maharashtra,1194,17,1187,15338,3362,2619,7.78,0,123.1,440235,3741,437879,2.73,2.13,0.1245978878960195,0.85,99.46
2021-06-11,Maharashtra,673,3,671,8307,195,101,8.1,0,123.1,440908,3744,438550,0.16,0.08,0.0674817221770918,0.85,99.47
2021-06-12,Maharashtra,670,3,666,8425,4683,1342,7.95,1,123.1,441578,3747,439216,3.8,1.09,0.06844029244516653,0.85,99.47
2021-06-13,Maharashtra,1332,13,1331,16284,2834,395,8.18,0,123.1,442910,3760,440547,2.3,0.32,0.13228269699431355,0.85,99.47
2021-06-14,Maharashtra,740,4,739,9362,4756,3608,7.9,0,123.1,443650,3764,441286,3.86,2.93,0.07605199025182778,0.85,99.47
2021-06-15,Maharashtra,1147,14,1146,13899,3052,1523,8.25,0,123.1,444797,3778,442432,2.48,1.24,0.11290820471161657,0.85,99.47
2021-06-16,Maharashtra,698,10,691,8780,3806,2852,7.95,0,123.1,445495,3788,443123,3.09,2.32,0.07132412672623883,0.85,99.47
2021-06-17,Maharashtra,472,2,463,6559,993,447,7.2,7,123.1,445967,3790,443586,0.81,0.36,0.05328188464662876,0.85,99.47
2021-06-18,Maharashtra,1054,14,1046,13134,3509,193,8.02,0,123.1,447021,3804,444632,2.85,0.16,0.10669374492282697,0.85,99.47
2021-06-19,Maharashtra,479,3,475,6059,2770,2752,7.91,1,123.1,447500,3807,445107,2.25,2.24,0.049220146222583264,0.85,99.47
2021-06-20,Maharashtra,328,1,322,4232,30,9,7.75,5,123.1,447828,3808,445429,0.02,0.01,0.03437855402112104,0.85,99.46
2021-06-21,Maharashtra,1306,14,1297,16283,3067,677,8.02,0,123.1,449134,3822,446726,2.49,0.55,0.13227457351746547,0.85,99.46
2021-06-22,Maharashtra,1060,10,1056,13114,4976,4743,8.08,0,123.1,450194,3832,447782,4.04,3.85,0.10653127538586515,0.85,99.46
2021-06-23,Maharashtra,605,4,598,7589,2562,2271,7.97,3,123.1,450799,3836,448380,2.08,1.84,0.06164906580016247,0.85,99.46
2021-06-24,Maharashtra,1552,19,1545,19633,4173,1318,7.91,0,123.1,452351,3855,449925,3.39,1.07,0.15948822095857026,0.85,99.46
2021-06-25,Maharashtra,1509,20,1500,19088,1692,34,7.91,0,123.1,453860,3875,451425,1.37,0.03,0.15506092607636068,0.85,99.46
2021-06-26,Maharashtra,538,7,537,6767,544,477,7.95,0,123.1,454398,3882,451962,0.44,0.39,0.05497156783103168,0.85,99.46
2021-06-27,Maharashtra,892,11,887,11053,815,559,8.07,0,123.1,455290,3893,452849,0.66,0.45,0.08978878960194964,0.86,99.46
2021-06-28,Maharashtra,270,3,265,3261,4792,3241,8.28,2,123.1,455560,3896,453114,3.89,2.63,0.026490658001624694,0.86,99.46
2021-06-29,Maharashtra,791,10,789,9667,4708,3038,8.18,0,123.1,456351,3906,453903,3.82,2.47,0.07852965069049553,0.86,99.46
2021-06-30,Maharashtra,993,4,989,12407,339,267,8.0,0,123.1,457344,3910,454892,0.28,0.22,0.10078797725426483,0.85,99.46
2021-07-01,Maharashtra,397,5,397,5041,1986,1718,7.88,0,123.1,457741,3915,455289,1.61,1.4,0.04095044679122665,0.86,99.46
2021-07-02,Maharashtra,156,1,147,2402,2875,1840,6.49,8,123.1,457897,3916,455436,2.34,1.49,0.019512591389114542,0.86,99.46
2021-07-03,Maharashtra,1179,14,1171,15025,1147,1030,7.85,0,123.1,459076,3930,456607,0.93,0.84,0.12205523964256702,0.86,99.46
2021-07-04,Maharashtra,1051,12,1048,12726,4517,1730,8.26,0,123.1,460127,3942,457655,3.67,1.41,0.10337936636880585,0.86,99.46
2021-07-05,Maharashtra,279,3,275,3481,3666,1996,8.01,1,123.1,460406,3945,457930,2.98,1.62,0.02827782290820471,0.86,99.46
2021-07-06,Maharashtra,1089,7,1084,13224,1080,479,8.24,0,123.1,461495,3952,459014,0.88,0.39,0.10742485783915516,0.86,99.46
2021-07-07,Maharashtra,440,3,438,5409,4769,1106,8.13,0,123.1,461935,3955,459452,3.87,0.9,0.04393988627132413,0.86,99.46
2021-07-08,Maharashtra,1031,13,1027,12909,2716,1603,7.99,0,123.1,462966,3968,460479,2.21,1.3,0.1048659626320065,0.86,99.46
2021-07-09,Maharashtra,817,9,817,10200,4332,3214,8.01,0,123.1,463783,3977,461296,3.52,2.61,0.08285946385052803,0.86,99.46
2021-07-10,Maharashtra,1573,19,1569,19474,4015,2376,8.08,0,123.1,465356,3996,462865,3.26,1.93,0.15819658813972381,0.86,99.46
2021-07-11,Maharashtra,612,7,603,7827,689,24,7.82,2,123.1,465968,4003,463468,0.56,0.02,0.06358245329000813,0.86,99.46
2021-07-12,Maharashtra,1195,12,1193,15231,76,15,7.85,0,123.1,467163,4015,464661,0.06,0.01,0.12372867587327376,0.86,99.46
2021-07-13,Maharashtra,1524,21,1516,18737,4215,2569,8.13,0,123.1,468687,4036,466177,3.42,2.09,0.15220958570268076,0.86,99.46
2021-07-14,Maharashtra,308,3,305,3800,2303,1074,8.11,0,123.1,468995,4039,466482,1.87,0.87,0.030869212022745736,0.86,99.46
2021-07-15,Maharashtra,1039,7,1036,12818,4060,133,8.11,0,123.1,470034,4046,467518,3.3,0.11,0.10412672623883022,0.86,99.46
2021-07-16,Maharashtra,1248,8,1248,15632,1137,969,7.98,0,123.1,471282,4054,468766,0.92,0.79,0.12698619008935824,0.86,99.47
2021-07-17,Maharashtra,430,5,423,5328,4731,1106,8.07,2,123.1,471712,4059,469189,3.84,0.9,0.04328188464662876,0.86,99.47
2021-07-18,Maharashtra,142,1,134,1657,3722,928,8.57,7,123.1,471854,4060,469323,3.02,0.75,0.01346060113728676,0.86,99.46
2021-07-19,Maharashtra,478,5,472,6227,2362,2120,7.68,1,123.1,472332,4065,469795,1.92,1.72,0.05058489033306255,0.86,99.46
2021-07-20,Maharashtra,749,3,742,9370,1319,1152,7.99,4,123.1,473081,4068,470537,1.07,0.94,0.07611697806661251,0.86,99.46
2021-07-21,Maharashtra,1495,17,1487,19157,1883,1346,7.8,0,123.1,474576,4085,472024,1.53,1.09,0.15562144597887895,0.86,99.46
2021-07-22,Maharashtra,1507,7,1500,18780,1076,936,8.02,0,123.1,476083,4092,473524,0.87,0.76,0.15255889520714866,0.86,99.46
2021-07-23,Maharashtra,940,6,936,11437,4139,1424,8.22,0,123.1,477023,4098,474460,3.36,1.16,0.09290820471161657,0.86,99.46
2021-07-24,Maharashtra,864,9,863,11011,3972,771,7.85,0,123.1,477887,4107,475323,3.23,0.63,0.0894476035743298,0.86,99.46
2021-07-25,Maharashtra,86,0,84,793,792,222,10.84,2,123.1,477973,4107,475407,0.64,0.18,0.00644191714053615,0.86,99.46
2021-07-26,Maharashtra,420,1,414,5472,79,73,7.68,5,123.1,478393,4108,475821,0.06,0.06,0.04445166531275386,0.86,99.46
2021-07-27,Maharashtra,288,3,285,3658,981,290,7.87,0,123.1,478681,4111,476106,0.8,0.24,0.029715678310316816,0.86,99.46
2021-07-28,Maharashtra,245,2,239,2947,3877,2328,8.31,4,123.1,478926,4113,476345,3.15,1.89,0.023939886271324127,0.86,99.46
2021-07-29,Maharashtra,777,8,769,9787,4683,4109,7.94,0,123.1,479703,4121,477114,3.8,3.34,0.07950446791226645,0.86,99.46
2021-07-30,Maharashtra,542,3,542,6904,1851,868,7.85,0,123.1,480245,4124,477656,1.5,0.71,0.05608448415922015,0.86,99.46
2021-07-31,Maharashtra,1264,16,1264,15807,1146,942,8.0,0,123.1,481509,4140,478920,0.93,0.77,0.12840779853777418,0.86,99.46
2021-08-01,Maharashtra,373,2,364,4227,959,550,8.82,7,123.1,481882,4142,479284,0.78,0.45,0.03433793663688058,0.86,99.46
2021-08-02,Maharashtra,104,0,98,1428,2371,332,7.28,6,123.1,481986,4142,479382,1.93,0.27,0.011600324939073923,0.86,99.46
2021-08-03,Maharashtra,633,6,629,8192,3189,2504,7.73,0,123.1,482619,4148,480011,2.59,2.03,0.06654752233956134,0.86,99.46
2021-08-04,Maharashtra,553,5,547,7086,4607,3602,7.8,1,123.1,483172,4153,480558,3.74,2.93,0.0575629569455727,0.86,99.46
2021-08-05,Maharashtra,789,9,788,9790,2728,705,8.06,0,123.1,483961,4162,481346,2.22,0.57,0.07952883834281073,0.86,99.46
2021-08-06,Maharashtra,70,0,62,888,4179,3030,7.88,8,123.1,484031,4162,481408,3.39,2.46,0.0072136474411047926,0.86,99.46
2021-08-07,Maharashtra,1198,17,1190,14641,3886,1490,8.18,0,123.1,485229,4179,482598,3.16,1.21,0.11893582453290008,0.86,99.46
2021-08-08,Maharashtra,660,7,657,8382,2779,2562,7.87,0,123.1,485889,4186,483255,2.26,2.08,0.06809098294069862,0.86,99.46
2021-08-09,Maharashtra,297,4,293,3690,375,96,8.05,0,123.1,486186,4190,483548,0.3,0.08,0.029975629569455726,0.86,99.46
2021-08-10,Maharashtra,575,4,573,6779,1663,1059,8.48,0,123.1,486761,4194,484121,1.35,0.86,0.05506904955320877,0.86,99.46
2021-08-11,Maharashtra,1263,13,1259,15638,3199,1521,8.08,0,123.1,488024,4207,485380,2.6,1.24,0.1270349309504468,0.86,99.46
2021-08-12,Maharashtra,42,0,37,743,4477,1482,5.65,5,123.1,488066,4207,485417,3.64,1.2,0.006035743298131601,0.86,99.46
2021-08-13,Maharashtra,1456,5,1449,18322,3549,2701,7.95,2,123.1,489522,4212,486866,2.88,2.19,0.148838342810723,0.86,99.46
2021-08-14,Maharashtra,1452,21,1443,17918,584,453,8.1,0,123.1,490974,4233,488309,0.47,0.37,0.14555645816409424,0.86,99.46
2021-08-15,Maharashtra,510,5,506,6170,1052,147,8.27,0,123.1,491484,4238,488815,0.85,0.12,0.050121852152721365,0.86,99.46
2021-08-16,Maharashtra,1304,5,1297,16259,3667,3443,8.02,2,123.1,492788,4243,490112,2.98,2.8,0.13207961007311128,0.86,99.46
2021-08-17,Maharashtra,1031,14,1029,12695,1598,1005,8.12,0,123.1,493819,4257,491141,1.3,0.82,0.10312753858651502,0.86,99.46
2021-08-18,Maharashtra,899,4,895,11534,4777,353,7.79,0,123.1,494718,4261,492036,3.88,0.29,0.09369618196588139,0.86,99.46
2021-08-19,Maharashtra,1415,13,1406,17966,1779,329,7.88,0,123.1,496133,4274,493442,1.45,0.27,0.1459463850528026,0.86,99.46
2021-08-20,Maharashtra,229,2,226,2625,4767,1213,8.72,1,123.1,496362,4276,493668,3.87,0.99,0.021324126726238832,0.86,99.46
2021-08-21,Maharashtra,744,9,738,9378,2075,948,7.93,0,123.1,497106,4285,494406,1.69,0.77,0.07618196588139724,0.86,99.46
2021-08-22,Maharashtra,1496,7,1488,18951,2344,1196,7.89,1,123.1,498602,4292,495894,1.9,0.97,0.15394800974817222,0.86,99.46
2021-08-23,Maharashtra,1296,15,1291,16131,1419,249,8.03,0,123.1,499898,4307,497185,1.15,0.2,0.13103980503655566,0.86,99.46
2021-08-24,Maharashtra,230,1,227,2528,3018,2905,9.1,2,123.1,500128,4308,497412,2.45,2.36,0.020536149471974005,0.86,99.46
2021-08-25,Maharashtra,312,4,304,3928,1820,975,7.94,4,123.1,500440,4312,497716,1.48,0.79,0.03190901705930138,0.86,99.46
2021-08-26,Maharashtra,1382,5,1375,17424,3375,2293,7.93,2,123.1,501822,4317,499091,2.74,1.86,0.1415434606011373,0.86,99.46
2021-08-27,Maharashtra,476,3,468,6332,4804,3235,7.52,5,123.1,502298,4320,499559,3.9,2.63,0.051437855402112105,0.86,99.45
2021-08-28,Maharashtra,222,0,215,2807,265,62,7.91,7,123.1,502520,4320,499774,0.22,0.05,0.02280259951259139,0.86,99.45
2021-08-29,Maharashtra,497,5,493,5818,4677,3801,8.54,0,123.1,503017,4325,500267,3.8,3.09,0.04726238830219334,0.86,99.45
2021-08-30,Maharashtra,1223,11,1220,15425,2933,545,7.93,0,123.1,504240,4336,501487,2.38,0.44,0.12530463038180342,0.86,99.45
2021-08-31,Maharashtra,1071,12,1067,13518,1744,314,7.92,0,123.1,505311,4348,502554,1.42,0.26,0.1098131600324939,0.86,99.45
2021-09-01,Maharashtra,769,11,768,9354,51,36,8.22,0,123.1,506080,4359,503322,0.04,0.03,0.07598700243704305,0.86,99.46
2021-09-02,Maharashtra,896,5,896,11290,2626,1262,7.94,0,123.1,506976,4364,504218,2.13,1.03,0.0917140536149472,0.86,99.46
2021-09-03,Maharashtra,352,2,345,4816,3348,2714,7.31,5,123.1,507328,4366,504563,2.72,2.2,0.039122664500406176,0.86,99.45
2021-09-04,Maharashtra,1135,10,1129,14158,3324,1061,8.02,0,123.1,508463,4376,505692,2.7,0.86,0.11501218521527214,0.86,99.46
2021-09-05,Maharashtra,1014,10,1013,12537,3016,1462,8.09,0,123.1,509477,4386,506705,2.45,1.19,0.10184402924451666,0.86,99.46
2021-09-06,Maharashtra,965,7,960,12137,1256,493,7.95,0,123.1,510442,4393,507665,1.02,0.4,0.09859463850528026,0.86,99.46
2021-09-07,Maharashtra,1348,14,1342,16946,2511,2063,7.95,0,123.1,511790,4407,509007,2.04,1.68,0.1376604386677498,0.86,99.46
2021-09-08,Maharashtra,1429,9,1427,17463,4127,3872,8.18,0,123.1,513219,4416,510434,3.35,3.15,0.14186027619821284,0.86,99.46
2021-09-09,Maharashtra,408,5,406,4952,4836,4244,8.24,0,123.1,513627,4421,510840,3.93,3.45,0.04022745735174655,0.86,99.46
2021-09-10,Maharashtra,1432,19,1424,17855,4344,755,8.02,0,123.1,515059,4440,512264,3.53,0.61,0.1450446791226645,0.86,99.46
2021-09-11,Maharashtra,569,4,561,7290,1647,251,7.81,4,123.1,515628,4444,512825,1.34,0.2,0.059220146222583266,0.86,99.46
2021-09-12,Maharashtra,1278,4,1272,15696,1500,1216,8.14,2,123.1,516906,4448,514097,1.22,0.99,0.12750609260763607,0.86,99.46
2021-09-13,Maharashtra,697,8,689,8686,2679,1602,8.02,0,123.1,517603,4456,514786,2.18,1.3,0.07056051990251828,0.86,99.46
2021-09-14,Maharashtra,497,1,491,6131,4453,2206,8.11,5,123.1,518100,4457,515277,3.62,1.79,0.04980503655564582,0.86,99.46
2021-09-15,Maharashtra,1315,18,1311,16220,905,669,8.11,0,123.1,519415,4475,516588,0.74,0.54,0.13176279447603576,0.86,99.46
2021-09-16,Maharashtra,384,2,384,4551,3663,2465,8.44,0,123.1,519799,4477,516972,2.98,2.0,0.03696994313566206,0.86,99.46
2021-09-17,Maharashtra,867,9,865,11011,1303,27,7.87,0,123.1,520666,4486,517837,1.06,0.02,0.0894476035743298,0.86,99.46
2021-09-18,Maharashtra,1071,9,1069,12961,216,109,8.26,0,123.1,521737,4495,518906,0.18,0.09,0.10528838342810723,0.86,99.46
2021-09-19,Maharashtra,758,9,755,9509,4629,3517,7.97,0,123.1,522495,4504,519661,3.76,2.86,0.07724614134849715,0.86,99.46
2021-09-20,Maharashtra,907,12,905,11865,261,26,7.64,0,123.1,523402,4516,520566,0.21,0.02,0.09638505280259951,0.86,99.46
2021-09-21,Maharashtra,251,3,248,2884,642,228,8.7,0,123.1,523653,4519,520814,0.52,0.19,0.023428107229894395,0.86,99.46
2021-09-22,Maharashtra,391,1,382,4569,4936,1780,8.56,8,123.1,524044,4520,521196,4.01,1.45,0.0371161657189277,0.86,99.46
2021-09-23,Maharashtra,1045,7,1042,12497,4400,257,8.36,0,123.1,525089,4527,522238,3.57,0.21,0.10151909017059302,0.86,99.46
2021-09-24,Maharashtra,993,7,990,11837,2606,1809,8.39,0,123.1,526082,4534,523228,2.12,1.47,0.09615759545085296,0.86,99.46
2021-09-25,Maharashtra,1230,15,1223,15453,2397,2127,7.96,0,123.1,527312,4549,524451,1.95,1.73,0.12553208773354996,0.86,99.46
2021-09-26,Maharashtra,676,6,674,8191,2682,1056,8.25,0,123.1,527988,4555,525125,2.18,0.86,0.06653939886271325,0.86,99.46
2021-09-27,Maharashtra,1374,6,1373,17047,620,7,8.06,0,123.1,529362,4561,526498,0.5,0.01,0.13848090982940697,0.86,99.46
2021-09-28,Maharashtra,1045,11,1045,12983,4934,1975,8.05,0,123.1,530407,4572,527543,4.01,1.6,0.10546709991876523,0.86,99.46
2021-09-29,Maharashtra,163,0,155,2048,1020,648,7.96,8,123.1,530570,4572,527698,0.83,0.53,0.016636880584890334,0.86,99.46
2021-09-30,Maharashtra,1128,14,1128,14063,733,10,8.02,0,123.1,531698,4586,528826,0.6,0.01,0.1142404549147035,0.86,99.46
2021-10-01,Maharashtra,148,0,144,1488,2972,2554,9.95,4,123.1,531846,4586,528970,2.41,2.07,0.012087733549959383,0.86,99.46
2021-10-02,Maharashtra,656,1,650,8022,2750,876,8.18,5,123.1,532502,4587,529620,2.23,0.71,0.06516653127538587,0.86,99.46
2021-10-03,Maharashtra,824,3,822,10663,2258,675,7.73,0,123.1,533326,4590,530442,1.83,0.55,0.08662063363119415,0.86,99.46
2021-10-04,Maharashtra,694,6,694,8260,2660,2495,8.4,0,123.1,534020,4596,531136,2.16,2.03,0.06709991876523153,0.86,99.46
2021-10-05,Maharashtra,359,5,356,4377,4097,2641,8.2,0,123.1,534379,4601,531492,3.33,2.15,0.03555645816409423,0.86,99.46
2021-10-06,Maharashtra,517,4,513,6177,2522,2492,8.37,0,123.1,534896,4605,532005,2.05,2.02,0.050178716490658,0.86,99.46
2021-10-07,Maharashtra,869,8,863,10474,4988,1673,8.3,0,123.1,535765,4613,532868,4.05,1.36,0.08508529650690495,0.86,99.46
2021-10-08,Maharashtra,1146,14,1145,14558,3062,1809,7.87,0,123.1,536911,4627,534013,2.49,1.47,0.11826157595450854,0.86,99.46
2021-10-09,Maharashtra,583,6,583,6981,2540,245,8.35,0,123.1,537494,4633,534596,2.06,0.2,0.056709991876523154,0.86,99.46
2021-10-10,Maharashtra,1232,9,1226,15327,1878,582,8.04,0,123.1,538726,4642,535822,1.53,0.47,0.1245085296506905,0.86,99.46
2021-10-11,Maharashtra,729,2,729,8916,2693,1480,8.18,0,123.1,539455,4644,536551,2.19,1.2,0.0724289195775792,0.86,99.46
2021-10-12,Maharashtra,462,4,456,5828,3694,1194,7.93,2,123.1,539917,4648,537007,3.0,0.97,0.047343623070674246,0.86,99.46
2021-10-13,Maharashtra,163,0,154,2181,4606,1213,7.47,9,123.1,540080,4648,537161,3.74,0.99,0.017717303005686434,0.86,99.46
2021-10-14,Maharashtra,200,1,198,2481,3562,3099,8.06,1,123.1,540280,4649,537359,2.89,2.52,0.02015434606011373,0.86,99.46
2021-10-15,Maharashtra,201,1,197,2571,4148,2265,7.82,3,123.1,540481,4650,537556,3.37,1.84,0.020885458976441916,0.86,99.46
2021-10-16,Maharashtra,1221,5,1220,15416,580,481,7.92,0,123.1,541702,4655,538776,0.47,0.39,0.1252315190901706,0.86,99.46
2021-10-17,Maharashtra,1065,14,1058,12954,3793,1224,8.22,0,123.1,542767,4669,539834,3.08,0.99,0.10523151909017059,0.86,99.46
2021-10-18,Maharashtra,148,1,148,1393,914,876,10.62,0,123.1,542915,4670,539982,0.74,0.71,0.011316003249390739,0.86,99.46
2021-10-19,Maharashtra,1329,14,1325,16833,167,71,7.9,0,123.1,544244,4684,541307,0.14,0.06,0.1367424857839155,0.86,99.46
2021-10-20,Maharashtra,809,4,808,10028,3609,1792,8.07,0,123.1,545053,4688,542115,2.93,1.46,0.08146222583265637,0.86,99.46
2021-10-21,Maharashtra,1073,15,1073,13512,1710,1313,7.94,0,123.1,546126,4703,543188,1.39,1.07,0.10976441917140536,0.86,99.46
2021-10-22,Maharashtra,894,3,894,11260,4624,4019,7.94,0,123.1,547020,4706,544082,3.76,3.26,0.09147034930950447,0.86,99.46
2021-10-23,Maharashtra,1543,22,1538,19390,4166,1758,7.96,0,123.1,548563,4728,545620,3.38,1.43,0.15751421608448415,0.86,99.46
2021-10-24,Maharashtra,908,10,904,11427,4736,3858,7.95,0,123.1,549471,4738,546524,3.85,3.13,0.09282696994313566,0.86,99.46
2021-10-25,Maharashtra,1150,6,1146,14508,979,504,7.93,0,123.1,550621,4744,547670,0.8,0.41,0.11785540211210398,0.86,99.46
2021-10-26,Maharashtra,1248,9,1239,15941,4852,3184,7.83,0,123.1,551869,4753,548909,3.94,2.59,0.12949634443541835,0.86,99.46
2021-10-27,Maharashtra,1179,8,1173,14755,2835,1148,7.99,0,123.1,553048,4761,550082,2.3,0.93,0.11986190089358245,0.86,99.46
2021-10-28,Maharashtra,390,4,383,4925,1791,1530,7.92,3,123.1,553438,4765,550465,1.45,1.24,0.04000812347684809,0.86,99.46
2021-10-29,Maharashtra,1243,12,1238,15881,2136,999,7.83,0,123.1,554681,4777,551703,1.74,0.81,0.1290089358245329,0.86,99.46
2021-10-30,Maharashtra,436,2,433,4819,620,502,9.05,1,123.1,555117,4779,552136,0.5,0.41,0.039147034930950446,0.86,99.46
2021-10-31,Maharashtra,983,11,974,12455,1276,585,7.89,0,123.1,556100,4790,553110,1.04,0.48,0.10117790414297319,0.86,99.46
2021-11-01,Maharashtra,441,4,438,5295,4013,3167,8.33,0,123.1,556541,4794,553548,3.26,2.57,0.043013809910641757,0.86,99.46
2021-11-02,Maharashtra,885,5,884,11035,4722,2762,8.02,0,123.1,557426,4799,554432,3.84,2.24,0.08964256701868399,0.86,99.46
2021-11-03,Maharashtra,902,8,901,11213,35,6,8.04,0,123.1,558328,4807,555333,0.03,0.0,0.09108854589764419,0.86,99.46
2021-11-04,Maharashtra,1497,11,1497,18362,4420,1644,8.15,0,123.1,559825,4818,556830,3.59,1.34,0.14916328188464664,0.86,99.47
2021-11-05,Maharashtra,951,9,949,11738,2911,1877,8.1,0,123.1,560776,4827,557779,2.36,1.52,0.09535337124289196,0.86,99.47
2021-11-06,Maharashtra,1344,8,1343,16392,4259,2678,8.2,0,123.1,562120,4835,559122,3.46,2.18,0.1331600324939074,0.86,99.47
2021-11-07,Maharashtra,665,4,662,8081,2574,2322,8.23,0,123.1,562785,4839,559784,2.09,1.89,0.06564581640942323,0.86,99.47
2021-11-08,Maharashtra,859,12,857,10833,2697,1516,7.93,0,123.1,563644,4851,560641,2.19,1.23,0.08800162469536962,0.86,99.47
2021-11-09,Maharashtra,1376,8,1376,17399,3556,2421,7.91,0,123.1,565020,4859,562017,2.89,1.97,0.14134037367993502,0.86,99.47
2021-11-10,Maharashtra,679,9,676,8801,1769,1193,7.72,0,123.1,565699,4868,562693,1.44,0.97,0.07149471974004874,0.86,99.47
2021-11-11,Maharashtra,267,1,264,3378,2445,1947,7.9,2,123.1,565966,4869,562957,1.99,1.58,0.02744110479285134,0.86,99.47
2021-11-12,Maharashtra,1052,12,1052,13405,2522,474,7.85,0,123.1,567018,4881,564009,2.05,0.39,0.10889520714865962,0.86,99.47
2021-11-13,Maharashtra,433,2,429,4932,2715,722,8.78,2,123.1,567451,4883,564438,2.21,0.59,0.04006498781478473,0.86,99.47
2021-11-14,Maharashtra,1131,4,1130,14118,1328,810,8.01,0,123.1,568582,4887,565568,1.08,0.66,0.1146872461413485,0.86,99.47
2021-11-15,Maharashtra,226,1,225,2793,4443,174,8.09,0,123.1,568808,4888,565793,3.61,0.14,0.022688870836718115,0.86,99.47
2021-11-16,Maharashtra,372,3,371,4957,2386,1622,7.5,0,123.1,569180,4891,566164,1.94,1.32,0.040268074735987,0.86,99.47
2021-11-17,Maharashtra,1532,12,1526,19591,2614,1019,7.82,0,123.1,570712,4903,567690,2.12,0.83,0.15914703493095045,0.86,99.47
2021-11-18,Maharashtra,1171,16,1167,14180,41,30,8.26,0,123.1,571883,4919,568857,0.03,0.02,0.11519090170593013,0.86,99.47
2021-11-19,Maharashtra,631,2,629,7735,443,320,8.16,0,123.1,572514,4921,569486,0.36,0.26,0.06283509341998375,0.86,99.47
2021-11-20,Maharashtra,56,0,55,943,4407,3617,5.94,1,123.1,572570,4921,569541,3.58,2.94,0.007660438667749797,0.86,99.47
2021-11-21,Maharashtra,98,0,92,1172,351,280,8.36,6,123.1,572668,4921,569633,0.29,0.23,0.009520714865962633,0.86,99.47
2021-11-22,Maharashtra,1287,8,1279,16082,4628,3414,8.0,0,123.1,573955,4929,570912,3.76,2.77,0.1306417546709992,0.86,99.47
2021-11-23,Maharashtra,663,2,662,8399,1323,1007,7.89,0,123.1,574618,4931,571574,1.07,0.82,0.06822908204711617,0.86,99.47
2021-11-24,Maharashtra,432,2,428,5569,7,4,7.76,2,123.1,575050,4933,572002,0.01,0.0,0.045239642567018686,0.86,99.47
2021-11-25,Maharashtra,1427,6,1424,17902,2593,2243,7.97,0,123.1,576477,4939,573426,2.11,1.82,0.14542648253452478,0.86,99.47
2021-11-26,Maharashtra,153,2,148,2218,844,45,6.9,3,123.1,576630,4941,573574,0.69,0.04,0.0180178716490658,0.86,99.47
2021-11-27,Maharashtra,780,2,771,10160,201,170,7.68,7,123.1,577410,4943,574345,0.16,0.14,0.08253452477660439,0.86,99.47
2021-11-28,Maharashtra,1112,5,1110,13787,3651,89,8.07,0,123.1,578522,4948,575455,2.97,0.07,0.11199837530463039,0.86,99.47
2021-11-29,Maharashtra,249,2,245,3138,2733,2482,7.93,2,123.1,578771,4950,575700,2.22,2.02,0.025491470349309504,0.86,99.47
2021-11-30,Maharashtra,1537,19,1532,19202,3480,2766,8.0,0,123.1,580308,4969,577232,2.83,2.25,0.15598700243704305,0.86,99.47
2021-12-01,Maharashtra,1635,13,1635,19990,1358,508,8.18,0,123.1,581943,4982,578867,1.1,0.41,0.16238830219333875,0.86,99.47
2021-12-02,Maharashtra,825,9,816,10417,333,163,7.92,0,123.1,582768,4991,579683,0.27,0.13,0.08462225832656377,0.86,99.47
2021-12-03,Maharashtra,654,2,650,7438,3104,742,8.79,2,123.1,583422,4993,580333,2.52,0.6,0.06042242079610073,0.86,99.47
2021-12-04,Maharashtra,532,5,523,6099,2605,1050,8.72,4,123.1,583954,4998,580856,2.12,0.85,0.049545085296506905,0.86,99.47
2021-12-05,Maharashtra,267,2,264,2729,4269,470,9.78,1,123.1,584221,5000,581120,3.47,0.38,0.022168968318440292,0.86,99.47
2021-12-06,Maharashtra,1462,12,1461,18416,2446,1814,7.94,0,123.1,585683,5012,582581,1.99,1.47,0.14960194963444354,0.86,99.47
2021-12-07,Maharashtra,918,12,912,11268,522,339,8.15,0,123.1,586601,5024,583493,0.42,0.28,0.0915353371242892,0.86,99.47
2021-12-08,Maharashtra,74,0,73,1215,3115,2186,6.09,1,123.1,586675,5024,583566,2.53,1.78,0.009870024370430544,0.86,99.47
2021-12-09,Maharashtra,496,6,488,5879,1282,5,8.44,2,123.1,587171,5030,584054,1.04,0.0,0.04775792038992689,0.86,99.47
2021-12-10,Maharashtra,1341,4,1335,16675,233,105,8.04,2,123.1,588512,5034,585389,0.19,0.09,0.13545897644191715,0.86,99.47
2021-12-11,Maharashtra,1162,4,1157,14299,3271,907,8.13,1,123.1,589674,5038,586546,2.66,0.74,0.11615759545085297,0.85,99.47
2021-12-12,Maharashtra,1324,19,1318,16791,4844,2276,7.89,0,123.1,590998,5057,587864,3.94,1.85,0.1364012997562957,0.86,99.47
2021-12-13,Maharashtra,45,0,39,610,170,116,7.38,6,123.1,591043,5057,587903,0.14,0.09,0.004955320877335499,0.86,99.47
2021-12-14,Maharashtra,265,1,265,3434,1770,589,7.72,0,123.1,591308,5058,588168,1.44,0.48,0.027896019496344435,0.86,99.47
2021-12-15,Maharashtra,569,5,561,7252,150,59,7.85,3,123.1,591877,5063,588729,0.12,0.05,0.058911454102355806,0.86,99.47
2021-12-16,Maharashtra,831,7,829,10294,2435,458,8.07,0,123.1,592708,5070,589558,1.98,0.37,0.08362307067424858,0.86,99.47
2021-12-17,Maharashtra,583,6,578,7333,1628,1082,7.95,0,123.1,593291,5076,590136,1.32,0.88,0.059569455727051177,0.86,99.47
2021-12-18,Maharashtra,1356,9,1353,17090,415,405,7.93,0,123.1,594647,5085,591489,0.34,0.33,0.1388302193338749,0.86,99.47
2021-12-19,Maharashtra,1181,15,1173,14830,4237,2554,7.96,0,123.1,595828,5100,592662,3.44,2.07,0.12047116165718928,0.86,99.47
2021-12-20,Maharashtra,847,8,841,10205,456,343,8.3,0,123.1,596675,5108,593503,0.37,0.28,0.08290008123476848,0.86,99.47
2021-12-21,Maharashtra,166,1,163,2425,4373,97,6.85,2,123.1,596841,5109,593666,3.55,0.08,0.019699431356620632,0.86,99.47
2021-12-22,Maharashtra,135,0,132,1697,2068,576,7.96,3,123.1,596976,5109,593798,1.68,0.47,0.013785540211210399,0.86,99.47
2021-12-23,Maharashtra,1437,16,1429,18427,4319,621,7.8,0,123.1,598413,5125,595227,3.51,0.5,0.14969130787977256,0.86,99.47
2021-12-24,Maharashtra,1304,10,1303,16220,2673,1463,8.04,0,123.1,599717,5135,596530,2.17,1.19,0.13176279447603576,0.86,99.47
2021-12-25,Maharashtra,1485,17,1477,18345,4878,495,8.09,0,123.1,601202,5152,598007,3.96,0.4,0.14902518277822907,0.86,99.47
2021-12-26,Maharashtra,839,8,832,10791,1256,304,7.77,0,123.1,602041,5160,598839,1.02,0.25,0.0876604386677498,0.86,99.47
2021-12-27,Maharashtra,697,6,693,8619,316,72,8.09,0,123.1,602738,5166,599532,0.26,0.06,0.07001624695369618,0.86,99.47
2021-12-28,Maharashtra,859,5,858,10528,2803,2173,8.16,0,123.1,603597,5171,600390,2.28,1.77,0.08552396425670186,0.86,99.47
2021-12-29,Maharashtra,1505,21,1503,18178,1021,571,8.28,0,123.1,605102,5192,601893,0.83,0.46,0.1476685621445979,0.86,99.47
2021-12-30,Maharashtra,798,2,796,9646,1988,1633,8.27,0,123.1,605900,5194,602689,1.61,1.33,0.07835905767668562,0.86,99.47
2021-12-31,Maharashtra,710,2,709,8973,4328,3950,7.91,0,123.1,606610,5196,603398,3.52,3.21,0.07289195775792039,0.86,99.47
2022-01-01,Maharashtra,839,6,830,10767,440,88,7.79,3,123.1,607449,5202,604228,0.36,0.07,0.08746547522339561,0.86,99.47
2022-01-02,Maharashtra,1348,9,1340,16962,3840,1043,7.95,0,123.1,608797,5211,605568,3.12,0.85,0.13779041429731925,0.86,99.47
2022-01-03,Maharashtra,521,5,512,6256,4149,3088,8.33,4,123.1,609318,5216,606080,3.37,2.51,0.05082047116165719,0.86,99.47
2022-01-04,Maharashtra,115,1,111,1386,3078,765,8.3,3,123.1,609433,5217,606191,2.5,0.62,0.011259138911454102,0.86,99.47
2022-01-05,Maharashtra,883,4,877,10571,2744,2136,8.35,2,123.1,610316,5221,607068,2.23,1.74,0.08587327376116978,0.86,99.47
2022-01-06,Maharashtra,1434,12,1426,17406,2751,1875,8.24,0,123.1,611750,5233,608494,2.23,1.52,0.14139723801787166,0.86,99.47
2022-01-07,Maharashtra,395,3,390,4831,385,196,8.18,2,123.1,612145,5236,608884,0.31,0.16,0.03924451665312754,0.86,99.47
2022-01-08,Maharashtra,951,8,950,12114,3461,1230,7.85,0,123.1,613096,5244,609834,2.81,1.0,0.09840779853777416,0.86,99.47
2022-01-09,Maharashtra,418,3,418,5307,938,649,7.88,0,123.1,613514,5247,610252,0.76,0.53,0.04311129163281885,0.86,99.47
2022-01-10,Maharashtra,373,2,366,4903,1071,971,7.61,5,123.1,613887,5249,610618,0.87,0.79,0.03982940698619009,0.86,99.47
2022-01-11,Maharashtra,231,1,228,2928,3016,2053,7.89,2,123.1,614118,5250,610846,2.45,1.67,0.023785540211210397,0.85,99.47
2022-01-12,Maharashtra,838,3,836,10616,598,79,7.89,0,123.1,614956,5253,611682,0.49,0.06,0.08623883021933387,0.85,99.47
2022-01-13,Maharashtra,54,0,47,673,2393,636,8.02,7,123.1,615010,5253,611729,1.94,0.52,0.005467099918765232,0.85,99.47
2022-01-14,Maharashtra,818,3,812,10426,1412,558,7.85,3,123.1,615828,5256,612541,1.15,0.45,0.08469536961819658,0.85,99.47
2022-01-15,Maharashtra,1032,8,1028,12756,3508,1554,8.09,0,123.1,616860,5264,613569,2.85,1.26,0.10362307067424859,0.85,99.47
2022-01-16,Maharashtra,1036,6,1034,13219,3586,2976,7.84,0,123.1,617896,5270,614603,2.91,2.42,0.10738424045491471,0.85,99.47
2022-01-17,Maharashtra,1167,15,1164,14268,536,38,8.18,0,123.1,619063,5285,615767,0.44,0.03,0.11590576766856214,0.85,99.47
2022-01-18,Maharashtra,75,0,72,969,4789,534,7.74,3,123.1,619138,5285,615839,3.89,0.43,0.007871649065800162,0.85,99.47
2022-01-19,Maharashtra,1519,11,1516,18847,2523,1246,8.06,0,123.1,620657,5296,617355,2.05,1.01,0.15310316815597075,0.85,99.47
2022-01-20,Maharashtra,662,9,661,8231,4772,1987,8.04,0,123.1,621319,5305,618016,3.88,1.61,0.06686433793663688,0.85,99.47
2022-01-21,Maharashtra,771,9,765,9562,906,408,8.06,0,123.1,622090,5314,618781,0.74,0.33,0.07767668562144597,0.85,99.47
2022-01-22,Maharashtra,712,8,707,9232,229,51,7.71,0,123.1,622802,5322,619488,0.19,0.04,0.07499593826157595,0.85,99.47
2022-01-23,Maharashtra,1257,18,1257,15680,4196,3815,8.02,0,123.1,624059,5340,620745,3.41,3.1,0.1273761169780666,0.86,99.47
2022-01-24,Maharashtra,326,3,321,4007,4235,999,8.14,2,123.1,624385,5343,621066,3.44,0.81,0.03255077173030057,0.86,99.47
2022-01-25,Maharashtra,1096,5,1092,13171,2500,2495,8.32,0,123.1,625481,5348,622158,2.03,2.03,0.10699431356620634,0.86,99.47
2022-01-26,Maharashtra,273,2,271,3551,3515,2301,7.69,0,123.1,625754,5350,622429,2.86,1.87,0.02884646628757108,0.85,99.47
2022-01-27,Maharashtra,1373,7,1369,17241,659,54,7.96,0,123.1,627127,5357,623798,0.54,0.04,0.14005686433793663,0.85,99.47
2022-01-28,Maharashtra,334,4,332,4257,1303,614,7.85,0,123.1,627461,5361,624130,1.06,0.5,0.03458164094232331,0.85,99.47
2022-01-29,Maharashtra,1201,17,1198,15326,198,88,7.84,0,123.1,628662,5378,625328,0.16,0.07,0.1245004061738424,0.86,99.47
2022-01-30,Maharashtra,791,8,788,10056,3949,3716,7.87,0,123.1,629453,5386,626116,3.21,3.02,0.08168968318440292,0.86,99.47
2022-01-31,Maharashtra,271,3,271,2656,3849,636,10.2,0,123.1,629724,5389,626387,3.13,0.52,0.02157595450852965,0.86,99.47
2022-02-01,Maharashtra,1440,6,1440,17910,4146,893,8.04,0,123.1,631164,5395,627827,3.37,0.73,0.1454914703493095,0.85,99.47
2022-02-02,Maharashtra,1321,15,1316,16599,549,210,7.96,0,123.1,632485,5410,629143,0.45,0.17,0.13484159220146222,0.86,99.47
2022-02-03,Maharashtra,417,3,414,5117,3960,1966,8.15,0,123.1,632902,5413,629557,3.22,1.6,0.04156783103168156,0.86,99.47
2022-02-04,Maharashtra,1620,15,1615,19777,3349,815,8.19,0,123.1,634522,5428,631172,2.72,0.66,0.16065800162469537,0.86,99.47
2022-02-05,Maharashtra,709,3,708,8818,698,440,8.04,0,123.1,635231,5431,631880,0.57,0.36,0.07163281884646629,0.85,99.47
2022-02-06,Maharashtra,121,1,119,1298,4166,1220,9.32,1,123.1,635352,5432,631999,3.38,0.99,0.010544272948822096,0.85,99.47
2022-02-07,Maharashtra,1154,16,1151,13950,3705,3548,8.27,0,123.1,636506,5448,633150,3.01,2.88,0.11332250203086922,0.86,99.47
2022-02-08,Maharashtra,1422,16,1413,17914,4627,4370,7.94,0,123.1,637928,5464,634563,3.76,3.55,0.14552396425670186,0.86,99.47
2022-02-09,Maharashtra,1426,20,1423,17860,139,112,7.98,0,123.1,639354,5484,635986,0.11,0.09,0.14508529650690496,0.86,99.47
2022-02-10,Maharashtra,1387,9,1383,17421,3361,1531,7.96,0,123.1,640741,5493,637369,2.73,1.24,0.14151909017059303,0.86,99.47
2022-02-11,Maharashtra,1101,12,1098,14069,528,83,7.83,0,123.1,641842,5505,638467,0.43,0.07,0.11428919577579204,0.86,99.47
2022-02-12,Maharashtra,1512,21,1510,18322,1019,41,8.25,0,123.1,643354,5526,639977,0.83,0.03,0.148838342810723,0.86,99.48
2022-02-13,Maharashtra,602,8,595,7216,3335,94,8.34,0,123.1,643956,5534,640572,2.71,0.08,0.058619008935824536,0.86,99.47
2022-02-14,Maharashtra,1181,6,1179,15077,2493,295,7.83,0,123.1,645137,5540,641751,2.03,0.24,0.12247766043866774,0.86,99.48
2022-02-15,Maharashtra,1151,7,1150,14754,3160,587,7.8,0,123.1,646288,5547,642901,2.57,0.48,0.11985377741673436,0.86,99.48
2022-02-16,Maharashtra,842,3,840,10397,473,248,8.1,0,123.1,647130,5550,643741,0.38,0.2,0.08445978878960195,0.86,99.48
2022-02-17,Maharashtra,122,0,116,1368,2241,737,8.92,6,123.1,647252,5550,643857,1.82,0.6,0.011112916328188465,0.86,99.48
2022-02-18,Maharashtra,291,1,285,3249,161,96,8.96,5,123.1,647543,5551,644142,0.13,0.08,0.026393176279447605,0.86,99.47
2022-02-19,Maharashtra,1477,19,1468,17948,2503,1087,8.23,0,123.1,649020,5570,645610,2.03,0.88,0.14580016246953695,0.86,99.47
2022-02-20,Maharashtra,993,5,988,12282,203,155,8.09,0,123.1,650013,5575,646598,0.16,0.13,0.09977254264825346,0.86,99.47
2022-02-21,Maharashtra,1297,17,1291,16334,4120,642,7.94,0,123.1,651310,5592,647889,3.35,0.52,0.13268887083671813,0.86,99.47
2022-02-22,Maharashtra,1025,13,1016,13063,1480,52,7.85,0,123.1,652335,5605,648905,1.2,0.04,0.10611697806661251,0.86,99.47
2022-02-23,Maharashtra,895,8,893,10896,4995,1030,8.21,0,123.1,653230,5613,649798,4.06,0.84,0.08851340373679935,0.86,99.47
2022-02-24,Maharashtra,1376,13,1369,16328,2202,691,8.43,0,123.1,654606,5626,651167,1.79,0.56,0.13264012997562957,0.86,99.47
2022-02-25,Maharashtra,1328,11,1319,16803,783,329,7.9,0,123.1,655934,5637,652486,0.64,0.27,0.13649878147847277,0.86,99.47
2022-02-26,Maharashtra,1239,4,1238,15295,3873,1909,8.1,0,123.1,657173,5641,653724,3.15,1.55,0.12424857839155158,0.86,99.48
2022-02-27,Maharashtra,689,5,680,8433,3071,1008,8.17,4,123.1,657862,5646,654404,2.49,0.82,0.06850528025995126,0.86,99.47
2022-02-28,Maharashtra,407,4,402,5073,3917,2344,8.02,1,123.1,658269,5650,654806,3.18,1.9,0.041210398050365554,0.86,99.47
2022-03-01,Maharashtra,810,9,805,10399,2771,43,7.79,0,123.1,659079,5659,655611,2.25,0.03,0.08447603574329814,0.86,99.47
2022-03-02,Maharashtra,408,1,408,5279,2427,1155,7.73,0,123.1,659487,5660,656019,1.97,0.94,0.0428838342810723,0.86,99.47
2022-03-03,Maharashtra,276,2,270,3543,4723,3740,7.79,4,123.1,659763,5662,656289,3.84,3.04,0.02878147847278635,0.86,99.47
2022-03-04,Maharashtra,895,10,887,11275,1415,1126,7.94,0,123.1,660658,5672,657176,1.15,0.91,0.09159220146222584,0.86,99.47
2022-03-05,Maharashtra,1106,14,1098,14008,1852,1312,7.9,0,123.1,661764,5686,658274,1.5,1.07,0.11379366368805849,0.86,99.47
2022-03-06,Maharashtra,602,2,600,7343,4719,3850,8.2,0,123.1,662366,5688,658874,3.83,3.13,0.05965069049553209,0.86,99.47
2022-03-07,Maharashtra,1292,12,1284,15754,4290,4246,8.2,0,123.1,663658,5700,660158,3.48,3.45,0.12797725426482534,0.86,99.47
2022-03-08,Maharashtra,1366,13,1357,17341,2755,1913,7.88,0,123.1,665024,5713,661515,2.24,1.55,0.14086921202274574,0.86,99.47
2022-03-09,Maharashtra,1099,3,1091,13551,1572,757,8.11,5,123.1,666123,5716,662606,1.28,0.61,0.1100812347684809,0.86,99.47
2022-03-10,Maharashtra,392,2,385,4017,1989,793,9.76,5,123.1,666515,5718,662991,1.62,0.64,0.03263200649878148,0.86,99.47
2022-03-11,Maharashtra,924,10,921,11334,1717,355,8.15,0,123.1,667439,5728,663912,1.39,0.29,0.0920714865962632,0.86,99.47
2022-03-12,Maharashtra,426,2,421,5087,178,153,8.37,3,123.1,667865,5730,664333,0.14,0.12,0.04132412672623883,0.86,99.47
2022-03-13,Maharashtra,294,2,287,3579,2707,2512,8.21,5,123.1,668159,5732,664620,2.2,2.04,0.029073923639317628,0.86,99.47
2022-03-14,Maharashtra,1288,10,1282,16351,4483,437,7.88,0,123.1,669447,5742,665902,3.64,0.35,0.13282696994313567,0.86,99.47
2022-03-15,Maharashtra,1386,20,1384,17498,1776,1172,7.92,0,123.1,670833,5762,667286,1.44,0.95,0.14214459788789602,0.86,99.47
2022-03-16,Maharashtra,400,1,397,4866,1470,1272,8.22,2,123.1,671233,5763,667683,1.19,1.03,0.03952883834281072,0.86,99.47
2022-03-17,Maharashtra,199,1,197,2357,3013,2502,8.44,1,123.1,671432,5764,667880,2.45,2.03,0.019147034930950445,0.86,99.47
2022-03-18,Maharashtra,1420,7,1412,17690,1680,353,8.03,1,123.1,672852,5771,669292,1.36,0.29,0.1437043054427295,0.86,99.47
2022-03-19,Maharashtra,1391,19,1386,17470,4735,1068,7.96,0,123.1,674243,5790,670678,3.85,0.87,0.14191714053614948,0.86,99.47
2022-03-20,Maharashtra,249,3,242,3241,1787,1391,7.68,4,123.1,674492,5793,670920,1.45,1.13,0.026328188464662877,0.86,99.47
2022-03-21,Maharashtra,858,4,849,10837,2873,2118,7.92,5,123.1,675350,5797,671769,2.33,1.72,0.08803411860276199,0.86,99.47
2022-03-22,Maharashtra,78,0,71,761,4690,4369,10.25,7,123.1,675428,5797,671840,3.81,3.55,0.006181965881397238,0.86,99.47
2022-03-23,Maharashtra,284,2,282,2953,325,80,9.62,0,123.1,675712,5799,672122,0.26,0.06,0.023988627132412673,0.86,99.47
2022-03-24,Maharashtra,1424,19,1416,17958,209,134,7.93,0,123.1,677136,5818,673538,0.17,0.11,0.14588139723801788,0.86,99.47
2022-03-25,Maharashtra,294,2,291,3571,2280,1099,8.23,1,123.1,677430,5820,673829,1.85,0.89,0.0290089358245329,0.86,99.47
2022-03-26,Maharashtra,265,3,262,3201,2651,1168,8.28,0,123.1,677695,5823,674091,2.15,0.95,0.026003249390739235,0.86,99.47
2022-03-27,Maharashtra,984,5,978,12229,1732,1536,8.05,1,123.1,678679,5828,675069,1.41,1.25,0.09934199837530464,0.86,99.47
2022-03-28,Maharashtra,315,1,308,3862,3327,1994,8.16,6,123.1,678994,5829,675377,2.7,1.62,0.03137286758732737,0.86,99.47
2022-03-29,Maharashtra,500,5,493,6351,2156,1395,7.87,2,123.1,679494,5834,675870,1.75,1.13,0.05159220146222583,0.86,99.47
2022-03-30,Maharashtra,400,2,391,4929,3673,454,8.12,7,123.1,679894,5836,676261,2.98,0.37,0.04004061738424045,0.86,99.47
2022-03-31,Maharashtra,1582,11,1578,19651,1511,1287,8.05,0,123.1,681476,5847,677839,1.23,1.05,0.1596344435418359,0.86,99.47
2022-04-01,Maharashtra,70,0,63,1055,4839,207,6.64,7,123.1,681546,5847,677902,3.93,0.17,0.008570268074735987,0.86,99.47
2022-04-02,Maharashtra,697,6,690,8547,2176,302,8.15,1,123.1,682243,5853,678592,1.77,0.25,0.06943135662063363,0.86,99.46
2022-04-03,Maharashtra,401,3,397,5406,2959,2071,7.42,1,123.1,682644,5856,678989,2.4,1.68,0.04391551584077985,0.86,99.46
2022-04-04,Maharashtra,556,2,553,6972,4942,4370,7.97,1,123.1,683200,5858,679542,4.01,3.55,0.05663688058489033,0.86,99.46
2022-04-05,Maharashtra,311,3,311,3970,1182,5,7.83,0,123.1,683511,5861,679853,0.96,0.0,0.032250203086921204,0.86,99.46
2022-04-06,Maharashtra,1100,9,1095,13601,1454,599,8.09,0,123.1,684611,5870,680948,1.18,0.49,0.11048740861088546,0.86,99.46
2022-04-07,Maharashtra,1301,12,1299,16400,2300,830,7.93,0,123.1,685912,5882,682247,1.87,0.67,0.13322502030869213,0.86,99.47
2022-04-08,Maharashtra,892,7,883,10947,265,259,8.15,2,123.1,686804,5889,683130,0.22,0.21,0.088927701056052,0.86,99.47
2022-04-09,Maharashtra,431,5,429,5188,1161,1000,8.31,0,123.1,687235,5894,683559,0.94,0.81,0.04214459788789602,0.86,99.47
2022-04-10,Maharashtra,1520,8,1519,19398,1341,821,7.84,0,123.1,688755,5902,685078,1.09,0.67,0.15757920389926888,0.86,99.47
2022-04-11,Maharashtra,1337,17,1336,17084,760,728,7.83,0,123.1,690092,5919,686414,0.62,0.59,0.13878147847278635,0.86,99.47
2022-04-12,Maharashtra,1053,4,1052,13238,185,40,7.95,0,123.1,691145,5923,687466,0.15,0.03,0.10753858651502843,0.86,99.47
2022-04-13,Maharashtra,230,0,222,2559,1868,1722,8.99,8,123.1,691375,5923,687688,1.52,1.4,0.020787977254264824,0.86,99.47
2022-04-14,Maharashtra,618,7,617,8113,2200,694,7.62,0,123.1,691993,5930,688305,1.79,0.56,0.06590576766856214,0.86,99.47
2022-04-15,Maharashtra,1097,4,1091,13691,2887,1063,8.01,2,123.1,693090,5934,689396,2.35,0.86,0.11121852152721365,0.86,99.47
2022-04-16,Maharashtra,220,2,216,2469,2241,1304,8.91,2,123.1,693310,5936,689612,1.82,1.06,0.020056864337936638,0.86,99.47
2022-04-17,Maharashtra,1243,15,1241,15325,23,10,8.11,0,123.1,694553,5951,690853,0.02,0.01,0.12449228269699432,0.86,99.47
2022-04-18,Maharashtra,134,1,133,1864,768,597,7.19,0,123.1,694687,5952,690986,0.62,0.48,0.015142160844841593,0.86,99.47
2022-04-19,Maharashtra,660,4,659,8309,1569,847,7.94,0,123.1,695347,5956,691645,1.27,0.69,0.06749796913078798,0.86,99.47
2022-04-20,Maharashtra,1363,15,1354,16857,523,206,8.09,0,123.1,696710,5971,692999,0.42,0.17,0.1369374492282697,0.86,99.47
2022-04-21,Maharashtra,735,10,730,8928,1700,872,8.23,0,123.1,697445,5981,693729,1.38,0.71,0.0725264012997563,0.86,99.47
2022-04-22,Maharashtra,1016,8,1012,12954,1869,1097,7.84,0,123.1,698461,5989,694741,1.52,0.89,0.10523151909017059,0.86,99.47
2022-04-23,Maharashtra,1543,9,1541,19050,1272,722,8.1,0,123.1,700004,5998,696282,1.03,0.59,0.15475223395613322,0.86,99.47
2022-04-24,Maharashtra,1181,17,1181,14504,2982,1901,8.14,0,123.1,701185,6015,697463,2.42,1.54,0.11782290820471161,0.86,99.47
2022-04-25,Maharashtra,515,5,506,6796,3456,2751,7.58,4,123.1,701700,6020,697969,2.81,2.23,0.05520714865962632,0.86,99.47
2022-04-26,Maharashtra,263,2,257,3505,4322,3789,7.5,4,123.1,701963,6022,698226,3.51,3.08,0.028472786352558895,0.86,99.47
2022-04-27,Maharashtra,765,4,756,9539,4832,619,8.02,5,123.1,702728,6026,698982,3.93,0.5,0.07748984565393989,0.86,99.47
2022-04-28,Maharashtra,419,4,410,4893,2808,7,8.56,5,123.1,703147,6030,699392,2.28,0.01,0.03974817221770918,0.86,99.47
2022-04-29,Maharashtra,1119,5,1118,13737,1964,213,8.15,0,123.1,704266,6035,700510,1.6,0.17,0.11159220146222583,0.86,99.47
2022-04-30,Maharashtra,852,10,852,10664,1092,619,7.99,0,123.1,705118,6045,701362,0.89,0.5,0.08662875710804224,0.86,99.47
2022-05-01,Maharashtra,307,1,301,3379,4962,2477,9.09,5,123.1,705425,6046,701663,4.03,2.01,0.027449228269699432,0.86,99.47
2022-05-02,Maharashtra,1076,5,1071,13370,567,175,8.05,0,123.1,706501,6051,702734,0.46,0.14,0.10861088545897644,0.86,99.47
2022-05-03,Maharashtra,533,5,530,6805,4584,1259,7.83,0,123.1,707034,6056,703264,3.72,1.02,0.05528025995125914,0.86,99.47
2022-05-04,Maharashtra,1498,13,1490,18752,4516,1291,7.99,0,123.1,708532,6069,704754,3.67,1.05,0.15233143785540212,0.86,99.47
2022-05-05,Maharashtra,1337,5,1332,16401,214,212,8.15,0,123.1,709869,6074,706086,0.17,0.17,0.13323314378554021,0.86,99.47
2022-05-06,Maharashtra,940,10,936,11831,4196,841,7.95,0,123.1,710809,6084,707022,3.41,0.68,0.09610885458976443,0.86,99.47
2022-05-07,Maharashtra,1162,10,1158,14937,192,38,7.78,0,123.1,711971,6094,708180,0.16,0.03,0.12134037367993501,0.86,99.47
2022-05-08,Maharashtra,151,1,149,2345,1353,930,6.44,1,123.1,712122,6095,708329,1.1,0.76,0.019049553208773357,0.86,99.47
2022-05-09,Maharashtra,580,2,580,6916,2325,349,8.39,0,123.1,712702,6097,708909,1.89,0.28,0.05618196588139724,0.86,99.47
2022-05-10,Maharashtra,671,3,663,8076,4881,1102,8.31,5,123.1,713373,6100,709572,3.97,0.9,0.06560519902518278,0.86,99.47
2022-05-11,Maharashtra,356,2,352,4424,645,224,8.05,2,123.1,713729,6102,709924,0.52,0.18,0.035938261575954505,0.85,99.47
2022-05-12,Maharashtra,583,4,579,7419,3491,1849,7.86,0,123.1,714312,6106,710503,2.84,1.5,0.060268074735987005,0.85,99.47
2022-05-13,Maharashtra,1212,18,1210,15334,4478,666,7.9,0,123.1,715524,6124,711713,3.64,0.54,0.12456539398862713,0.86,99.47
2022-05-14,Maharashtra,1119,10,1110,14074,2432,2409,7.95,0,123.1,716643,6134,712823,1.98,1.96,0.11432981316003249,0.86,99.47
2022-05-15,Maharashtra,284,1,275,3349,2891,1559,8.48,8,123.1,716927,6135,713098,2.35,1.27,0.0272055239642567,0.86,99.47
2022-05-16,Maharashtra,103,0,102,1345,3130,2140,7.66,1,123.1,717030,6135,713200,2.54,1.74,0.010926076360682373,0.86,99.47
2022-05-17,Maharashtra,1572,9,1570,19768,4919,3258,7.95,0,123.1,718602,6144,714770,4.0,2.65,0.16058489033306256,0.85,99.47
2022-05-18,Maharashtra,1018,13,1011,12305,1091,878,8.27,0,123.1,719620,6157,715781,0.89,0.71,0.09995938261575954,0.86,99.47
2022-05-19,Maharashtra,303,1,301,3314,2616,880,9.14,1,123.1,719923,6158,716082,2.13,0.71,0.02692120227457352,0.86,99.47
2022-05-20,Maharashtra,1055,3,1049,13002,2711,540,8.11,3,123.1,720978,6161,717131,2.2,0.44,0.10562144597887896,0.85,99.47
2022-05-21,Maharashtra,293,3,288,3448,4832,1607,8.5,2,123.1,721271,6164,717419,3.93,1.31,0.02800974817221771,0.85,99.47
2022-05-22,Maharashtra,374,4,367,4340,3907,3136,8.62,3,123.1,721645,6168,717786,3.17,2.55,0.035255889520714866,0.85,99.47
2022-05-23,Maharashtra,902,6,893,11000,2955,792,8.2,3,123.1,722547,6174,718679,2.4,0.64,0.08935824532900082,0.85,99.46
2022-05-24,Maharashtra,42,0,39,601,3117,855,6.99,3,123.1,722589,6174,718718,2.53,0.69,0.004882209585702681,0.85,99.46
2022-05-25,Maharashtra,982,11,973,11950,4417,793,8.22,0,123.1,723571,6185,719691,3.59,0.64,0.09707554833468725,0.85,99.46
2022-05-26,Maharashtra,218,0,217,2539,4015,818,8.59,1,123.1,723789,6185,719908,3.26,0.66,0.020625507717303006,0.85,99.46
2022-05-27,Maharashtra,1488,21,1479,18394,2259,1803,8.09,0,123.1,725277,6206,721387,1.84,1.46,0.14942323314378553,0.86,99.46
2022-05-28,Maharashtra,985,11,976,12409,247,150,7.94,0,123.1,726262,6217,722363,0.2,0.12,0.10080422420796101,0.86,99.46
2022-05-29,Maharashtra,1318,18,1313,16558,4317,3722,7.96,0,123.1,727580,6235,723676,3.51,3.02,0.1345085296506905,0.86,99.46
2022-05-30,Maharashtra,192,1,186,2806,3166,1967,6.84,5,123.1,727772,6236,723862,2.57,1.6,0.022794476035743298,0.86,99.46
2022-05-31,Maharashtra,457,6,448,5695,880,450,8.02,3,123.1,728229,6242,724310,0.71,0.37,0.04626320064987815,0.86,99.46
2022-06-01,Maharashtra,466,3,460,5773,792,218,8.07,3,123.1,728695,6245,724770,0.64,0.18,0.04689683184402924,0.86,99.46
2022-06-02,Maharashtra,1509,8,1501,18834,14,2,8.01,0,123.1,730204,6253,726271,0.01,0.0,0.15299756295694558,0.86,99.46
2022-06-03,Maharashtra,1241,17,1233,15399,320,81,8.06,0,123.1,731445,6270,727504,0.26,0.07,0.12509341998375303,0.86,99.46
2022-06-04,Maharashtra,1156,10,1156,14170,1467,1355,8.16,0,123.1,732601,6280,728660,1.19,1.1,0.11510966693744923,0.86,99.46
2022-06-05,Maharashtra,1537,14,1535,19322,850,404,7.95,0,123.1,734138,6294,730195,0.69,0.33,0.15696181965881398,0.86,99.46
2022-06-06,Maharashtra,1342,7,1336,16920,264,150,7.93,0,123.1,735480,6301,731531,0.21,0.12,0.13744922826969944,0.86,99.46
2022-06-07,Maharashtra,21,0,20,772,382,122,2.72,1,123.1,735501,6301,731551,0.31,0.1,0.006271324126726239,0.86,99.46
2022-06-08,Maharashtra,467,6,462,5616,1761,661,8.32,0,123.1,735968,6307,732013,1.43,0.54,0.04562144597887896,0.86,99.46
2022-06-09,Maharashtra,561,2,559,6719,1456,1174,8.35,0,123.1,736529,6309,732572,1.18,0.95,0.05458164094232332,0.86,99.46
2022-06-10,Maharashtra,866,8,860,10883,963,29,7.96,0,123.1,737395,6317,733432,0.78,0.02,0.08840779853777417,0.86,99.46
2022-06-11,Maharashtra,154,0,154,1590,2010,380,9.69,0,123.1,737549,6317,733586,1.63,0.31,0.012916328188464664,0.86,99.46
2022-06-12,Maharashtra,924,8,921,11540,1483,478,8.01,0,123.1,738473,6325,734507,1.2,0.39,0.09374492282696995,0.86,99.46
2022-06-13,Maharashtra,828,3,827,10271,2279,1077,8.06,0,123.1,739301,6328,735334,1.85,0.87,0.08343623070674248,0.86,99.46
2022-06-14,Maharashtra,1013,7,1006,12685,4665,1513,7.99,0,123.1,740314,6335,736340,3.79,1.23,0.10304630381803412,0.86,99.46
2022-06-15,Maharashtra,256,1,248,3122,4043,2096,8.2,7,123.1,740570,6336,736588,3.28,1.7,0.025361494719740047,0.86,99.46
2022-06-16,Maharashtra,1549,21,1544,19185,854,770,8.07,0,123.1,742119,6357,738132,0.69,0.63,0.1558489033306255,0.86,99.46
2022-06-17,Maharashtra,422,5,421,5576,3715,602,7.57,0,123.1,742541,6362,738553,3.02,0.49,0.04529650690495532,0.86,99.46
2022-06-18,Maharashtra,338,3,331,4403,292,288,7.68,4,123.1,742879,6365,738884,0.24,0.23,0.0357676685621446,0.86,99.46
2022-06-19,Maharashtra,306,3,301,3761,22,19,8.14,2,123.1,743185,6368,739185,0.02,0.02,0.030552396425670186,0.86,99.46
2022-06-20,Maharashtra,529,3,524,6754,3923,724,7.83,2,123.1,743714,6371,739709,3.19,0.59,0.0548659626320065,0.86,99.46
2022-06-21,Maharashtra,482,3,475,6068,406,245,7.94,4,123.1,744196,6374,740184,0.33,0.2,0.049293257514216086,0.86,99.46
2022-06-22,Maharashtra,591,5,587,7343,1055,703,8.05,0,123.1,744787,6379,740771,0.86,0.57,0.05965069049553209,0.86,99.46
2022-06-23,Maharashtra,835,3,831,10100,2292,1810,8.27,1,123.1,745622,6382,741602,1.86,1.47,0.08204711616571893,0.86,99.46
2022-06-24,Maharashtra,840,8,832,10953,2312,979,7.67,0,123.1,746462,6390,742434,1.88,0.8,0.08897644191714053,0.86,99.46
2022-06-25,Maharashtra,716,8,716,8937,2143,1533,8.01,0,123.1,747178,6398,743150,1.74,1.25,0.07259951259138911,0.86,99.46
2022-06-26,Maharashtra,1337,17,1330,16655,1370,916,8.03,0,123.1,748515,6415,744480,1.11,0.74,0.13529650690495532,0.86,99.46
2022-06-27,Maharashtra,1179,15,1171,14731,4607,892,8.0,0,123.1,749694,6430,745651,3.74,0.72,0.11966693744922827,0.86,99.46
2022-06-28,Maharashtra,563,2,562,7152,242,196,7.87,0,123.1,750257,6432,746213,0.2,0.16,0.05809910641754671,0.86,99.46
2022-06-29,Maharashtra,1482,6,1476,18438,2699,1633,8.04,0,123.1,751739,6438,747689,2.19,1.33,0.14978066612510155,0.86,99.46
2022-06-30,Maharashtra,523,6,518,6403,3433,2922,8.17,0,123.1,752262,6444,748207,2.79,2.37,0.052014622258326565,0.86,99.46
2022-07-01,Maharashtra,969,6,969,12127,4688,2877,7.99,0,123.1,753231,6450,749176,3.81,2.34,0.09851340373679936,0.86,99.46
2022-07-02,Maharashtra,847,9,845,10364,2785,1297,8.17,0,123.1,754078,6459,750021,2.26,1.05,0.08419171405361495,0.86,99.46
2022-07-03,Maharashtra,1426,10,1418,17850,3958,3187,7.99,0,123.1,755504,6469,751439,3.22,2.59,0.14500406173842403,0.86,99.46
2022-07-04,Maharashtra,1417,15,1410,17890,1926,1880,7.92,0,123.1,756921,6484,752849,1.56,1.53,0.14532900081234768,0.86,99.46
2022-07-05,Maharashtra,1173,8,1166,14740,3900,1829,7.96,0,123.1,758094,6492,754015,3.17,1.49,0.11974004874086108,0.86,99.46
2022-07-06,Maharashtra,539,1,535,6470,4696,936,8.33,3,123.1,758633,6493,754550,3.81,0.76,0.05255889520714866,0.86,99.46
2022-07-07,Maharashtra,733,7,728,9019,71,67,8.13,0,123.1,759366,6500,755278,0.06,0.05,0.07326563769293258,0.86,99.46
2022-07-08,Maharashtra,865,10,860,11034,3101,2527,7.84,0,123.1,760231,6510,756138,2.52,2.05,0.0896344435418359,0.86,99.46
2022-07-09,Maharashtra,910,12,903,10984,4133,3954,8.28,0,123.1,761141,6522,757041,3.36,3.21,0.08922826969943136,0.86,99.46
2022-07-10,Maharashtra,389,3,388,4459,2587,2302,8.72,0,123.1,761530,6525,757429,2.1,1.87,0.036222583265637695,0.86,99.46
2022-07-11,Maharashtra,1056,10,1047,13186,4389,1693,8.01,0,123.1,762586,6535,758476,3.57,1.38,0.1071161657189277,0.86,99.46
2022-07-12,Maharashtra,612,5,607,7980,174,19,7.67,0,123.1,763198,6540,759083,0.14,0.02,0.06482534524776605,0.86,99.46
2022-07-13,Maharashtra,887,8,886,10866,3973,2935,8.16,0,123.1,764085,6548,759969,3.23,2.38,0.08826969943135662,0.86,99.46
2022-07-14,Maharashtra,616,8,610,7652,2705,1209,8.05,0,123.1,764701,6556,760579,2.2,0.98,0.0621608448415922,0.86,99.46
2022-07-15,Maharashtra,1537,19,1532,19060,123,63,8.06,0,123.1,766238,6575,762111,0.1,0.05,0.15483346872461415,0.86,99.46
2022-07-16,Maharashtra,817,5,816,10288,2085,557,7.94,0,123.1,767055,6580,762927,1.69,0.45,0.08357432981316003,0.86,99.46
2022-07-17,Maharashtra,1377,12,1371,17446,2393,2098,7.89,0,123.1,768432,6592,764298,1.94,1.7,0.1417221770917953,0.86,99.46
2022-07-18,Maharashtra,536,6,528,7028,3328,119,7.63,2,123.1,768968,6598,764826,2.7,0.1,0.05709179528838343,0.86,99.46
2022-07-19,Maharashtra,54,0,50,825,1767,415,6.55,4,123.1,769022,6598,764876,1.44,0.34,0.006701868399675061,0.86,99.46
2022-07-20,Maharashtra,1552,19,1545,19310,3788,2972,8.04,0,123.1,770574,6617,766421,3.08,2.41,0.15686433793663687,0.86,99.46
2022-07-21,Maharashtra,785,10,780,9770,1315,564,8.03,0,123.1,771359,6627,767201,1.07,0.46,0.07936636880584891,0.86,99.46
2022-07-22,Maharashtra,1139,6,1133,14595,3916,736,7.8,0,123.1,772498,6633,768334,3.18,0.6,0.1185621445978879,0.86,99.46
2022-07-23,Maharashtra,720,10,713,9047,2404,67,7.96,0,123.1,773218,6643,769047,1.95,0.05,0.07349309504467912,0.86,99.46
2022-07-24,Maharashtra,515,5,512,5861,2545,178,8.79,0,123.1,773733,6648,769559,2.07,0.14,0.04761169780666125,0.86,99.46
2022-07-25,Maharashtra,721,8,712,9589,480,311,7.52,1,123.1,774454,6656,770271,0.39,0.25,0.07789601949634443,0.86,99.46
2022-07-26,Maharashtra,554,5,550,7003,1321,141,7.91,0,123.1,775008,6661,770821,1.07,0.11,0.05688870836718116,0.86,99.46
2022-07-27,Maharashtra,1533,12,1524,19189,2982,1736,7.99,0,123.1,776541,6673,772345,2.42,1.41,0.15588139723801786,0.86,99.46
2022-07-28,Maharashtra,1257,13,1248,15667,3279,2570,8.02,0,123.1,777798,6686,773593,2.66,2.09,0.12727051177904142,0.86,99.46
2022-07-29,Maharashtra,1508,13,1504,18730,2029,238,8.05,0,123.1,779306,6699,775097,1.65,0.19,0.15215272136474411,0.86,99.46
2022-07-30,Maharashtra,1318,10,1317,16091,1797,467,8.19,0,123.1,780624,6709,776414,1.46,0.38,0.13071486596263202,0.86,99.46
2022-07-31,Maharashtra,1185,7,1176,15215,635,523,7.79,2,123.1,781809,6716,777590,0.52,0.42,0.1235987002437043,0.86,99.46
2022-08-01,Maharashtra,1459,14,1455,18227,1346,945,8.0,0,123.1,783268,6730,779045,1.09,0.77,0.14806661251015435,0.86,99.46
2022-08-02,Maharashtra,1230,17,1227,15471,310,31,7.95,0,123.1,784498,6747,780272,0.25,0.03,0.1256783103168156,0.86,99.46
2022-08-03,Maharashtra,427,5,423,5213,454,447,8.19,0,123.1,784925,6752,780695,0.37,0.36,0.04234768480909829,0.86,99.46
2022-08-04,Maharashtra,141,2,132,1867,1723,1505,7.55,7,123.1,785066,6754,780827,1.4,1.22,0.015166531275385866,0.86,99.46
2022-08-05,Maharashtra,595,6,586,7896,4512,1594,7.54,3,123.1,785661,6760,781413,3.67,1.29,0.0641429731925264,0.86,99.46
2022-08-06,Maharashtra,264,2,258,3579,1275,407,7.38,4,123.1,785925,6762,781671,1.04,0.33,0.029073923639317628,0.86,99.46
2022-08-07,Maharashtra,1050,13,1043,13266,932,14,7.91,0,123.1,786975,6775,782714,0.76,0.01,0.10776604386677498,0.86,99.46
2022-08-08,Maharashtra,757,7,754,9700,635,173,7.8,0,123.1,787732,6782,783468,0.52,0.14,0.07879772542648253,0.86,99.46
2022-08-09,Maharashtra,134,1,125,1704,4117,520,7.86,8,123.1,787866,6783,783593,3.34,0.42,0.013842404549147034,0.86,99.46
2022-08-10,Maharashtra,960,12,957,12145,2087,2031,7.9,0,123.1,788826,6795,784550,1.7,1.65,0.09865962632006499,0.86,99.46
2022-08-11,Maharashtra,109,0,102,1573,4567,1217,6.93,7,123.1,788935,6795,784652,3.71,0.99,0.012778229082047116,0.86,99.46
2022-08-12,Maharashtra,938,4,930,11669,3624,3488,8.04,4,123.1,789873,6799,785582,2.94,2.83,0.09479285134037368,0.86,99.46
2022-08-13,Maharashtra,884,4,882,11022,3697,3180,8.02,0,123.1,790757,6803,786464,3.0,2.58,0.08953696181965881,0.86,99.46
2022-08-14,Maharashtra,776,7,767,9478,2189,14,8.19,2,123.1,791533,6810,787231,1.78,0.01,0.07699431356620634,0.86,99.46
2022-08-15,Maharashtra,886,4,878,10952,3204,2156,8.09,4,123.1,792419,6814,788109,2.6,1.75,0.08896831844029245,0.86,99.46
2022-08-16,Maharashtra,1303,12,1303,16279,4375,1678,8.0,0,123.1,793722,6826,789412,3.55,1.36,0.13224207961007312,0.86,99.46
2022-08-17,Maharashtra,1096,8,1089,13820,2858,959,7.93,0,123.1,794818,6834,790501,2.32,0.78,0.11226645004061739,0.86,99.46
2022-08-18,Maharashtra,999,3,993,12665,26,13,7.89,3,123.1,795817,6837,791494,0.02,0.01,0.1028838342810723,0.86,99.46
2022-08-19,Maharashtra,984,4,976,12093,2622,1134,8.14,4,123.1,796801,6841,792470,2.13,0.92,0.09823720552396425,0.86,99.46
2022-08-20,Maharashtra,611,7,609,8070,3010,2267,7.57,0,123.1,797412,6848,793079,2.45,1.84,0.06555645816409424,0.86,99.46
2022-08-21,Maharashtra,1589,11,1588,19569,4882,907,8.12,0,123.1,799001,6859,794667,3.97,0.74,0.15896831844029244,0.86,99.46
2022-08-22,Maharashtra,761,6,757,10011,3674,2046,7.6,0,123.1,799762,6865,795424,2.98,1.66,0.08132412672623883,0.86,99.46
2022-08-23,Maharashtra,1168,12,1162,14462,3515,277,8.08,0,123.1,800930,6877,796586,2.86,0.23,0.1174817221770918,0.86,99.46
2022-08-24,Maharashtra,485,2,482,6245,1181,464,7.77,1,123.1,801415,6879,797068,0.96,0.38,0.05073111291632819,0.86,99.46
2022-08-25,Maharashtra,117,0,109,1441,870,719,8.12,8,123.1,801532,6879,797177,0.71,0.58,0.011705930138099107,0.86,99.46
2022-08-26,Maharashtra,941,11,939,11717,997,542,8.03,0,123.1,802473,6890,798116,0.81,0.44,0.09518277822908204,0.86,99.46
2022-08-27,Maharashtra,943,13,936,11493,457,157,8.2,0,123.1,803416,6903,799052,0.37,0.13,0.09336311941510966,0.86,99.46
2022-08-28,Maharashtra,710,2,705,8595,2310,2004,8.26,3,123.1,804126,6905,799757,1.88,1.63,0.069821283509342,0.86,99.46
2022-08-29,Maharashtra,98,0,93,1439,850,490,6.81,5,123.1,804224,6905,799850,0.69,0.4,0.011689683184402925,0.86,99.46
2022-08-30,Maharashtra,118,1,116,1436,4076,3112,8.22,1,123.1,804342,6906,799966,3.31,2.53,0.011665312753858651,0.86,99.46
2022-08-31,Maharashtra,421,2,415,5403,4337,1912,7.79,4,123.1,804763,6908,800381,3.52,1.55,0.04389114541023558,0.86,99.46
2022-09-01,Maharashtra,319,3,310,4012,1190,701,7.95,6,123.1,805082,6911,800691,0.97,0.57,0.03259138911454102,0.86,99.45
2022-09-02,Maharashtra,758,9,752,9731,3873,3405,7.79,0,123.1,805840,6920,801443,3.15,2.77,0.07904955320877335,0.86,99.45
2022-09-03,Maharashtra,404,1,399,4777,2105,1237,8.46,4,123.1,806244,6921,801842,1.71,1.0,0.03880584890333062,0.86,99.45
2022-09-04,Maharashtra,1000,4,999,12554,3526,3272,7.97,0,123.1,807244,6925,802841,2.86,2.66,0.1019821283509342,0.86,99.45
2022-09-05,Maharashtra,1408,8,1408,17448,1985,509,8.07,0,123.1,808652,6933,804249,1.61,0.41,0.14173842404549147,0.86,99.46
2022-09-06,Maharashtra,315,2,314,3730,686,592,8.45,0,123.1,808967,6935,804563,0.56,0.48,0.030300568643379367,0.86,99.46
2022-09-07,Maharashtra,898,7,892,11487,3052,2496,7.82,0,123.1,809865,6942,805455,2.48,2.03,0.09331437855402112,0.86,99.46
2022-09-08,Maharashtra,1033,12,1027,12729,1703,276,8.12,0,123.1,810898,6954,806482,1.38,0.22,0.10340373679935012,0.86,99.46
2022-09-09,Maharashtra,1003,9,1001,13128,1333,126,7.64,0,123.1,811901,6963,807483,1.08,0.1,0.10664500406173842,0.86,99.46
2022-09-10,Maharashtra,415,1,408,5340,1043,422,7.77,6,123.1,812316,6964,807891,0.85,0.34,0.04337936636880585,0.86,99.46
2022-09-11,Maharashtra,543,3,542,6506,4977,2630,8.35,0,123.1,812859,6967,808433,4.04,2.14,0.05285134037367994,0.86,99.46
2022-09-12,Maharashtra,1310,18,1304,16927,4087,2631,7.74,0,123.1,814169,6985,809737,3.32,2.14,0.13750609260763608,0.86,99.46
2022-09-13,Maharashtra,410,4,403,5249,4624,1381,7.81,3,123.1,814579,6989,810140,3.76,1.12,0.04264012997562957,0.86,99.46
2022-09-14,Maharashtra,51,0,44,1014,4535,1496,5.03,7,123.1,814630,6989,810184,3.68,1.22,0.008237205523964257,0.86,99.45
2022-09-15,Maharashtra,233,2,228,2621,200,50,8.89,3,123.1,814863,6991,810412,0.16,0.04,0.021291632818846468,0.86,99.45
2022-09-16,Maharashtra,1026,12,1022,12875,4882,4370,7.97,0,123.1,815889,7003,811434,3.97,3.55,0.10458976441917141,0.86,99.45
2022-09-17,Maharashtra,456,4,456,5947,1395,724,7.67,0,123.1,816345,7007,811890,1.13,0.59,0.048310316815597075,0.86,99.45
2022-09-18,Maharashtra,1412,15,1412,17625,4869,330,8.01,0,123.1,817757,7022,813302,3.96,0.27,0.14317627944760358,0.86,99.46
2022-09-19,Maharashtra,819,6,814,10144,3971,875,8.07,0,123.1,818576,7028,814116,3.23,0.71,0.08240454914703493,0.86,99.46
2022-09-20,Maharashtra,1473,11,1472,18495,3732,3500,7.96,0,123.1,820049,7039,815588,3.03,2.84,0.15024370430544273,0.86,99.46
2022-09-21,Maharashtra,1144,8,1135,14354,4553,466,7.97,1,123.1,821193,7047,816723,3.7,0.38,0.11660438667749796,0.86,99.46
2022-09-22,Maharashtra,65,0,62,1103,550,362,5.89,3,123.1,821258,7047,816785,0.45,0.29,0.008960194963444355,0.86,99.46
2022-09-23,Maharashtra,802,4,793,9715,2428,2102,8.26,5,123.1,822060,7051,817578,1.97,1.71,0.0789195775792039,0.86,99.45
2022-09-24,Maharashtra,53,0,49,927,4193,492,5.72,4,123.1,822113,7051,817627,3.41,0.4,0.007530463038180341,0.86,99.45
2022-09-25,Maharashtra,475,1,469,6048,2845,885,7.85,5,123.1,822588,7052,818096,2.31,0.72,0.049130787977254266,0.86,99.45
2022-09-26,Maharashtra,793,7,786,10189,1032,61,7.78,0,123.1,823381,7059,818882,0.84,0.05,0.08277010560519903,0.86,99.45
2022-09-27,Maharashtra,440,5,435,5927,4393,2991,7.42,0,123.1,823821,7064,819317,3.57,2.43,0.048147847278635254,0.86,99.45
2022-09-28,Maharashtra,902,9,893,11353,264,192,7.95,0,123.1,824723,7073,820210,0.21,0.16,0.09222583265637693,0.86,99.45
2022-09-29,Maharashtra,1173,7,1164,14866,4863,2838,7.89,2,123.1,825896,7080,821374,3.95,2.31,0.12076360682372055,0.86,99.45
2022-09-30,Maharashtra,409,4,400,4801,3016,1462,8.52,5,123.1,826305,7084,821774,2.45,1.19,0.03900081234768481,0.86,99.45
2022-10-01,Maharashtra,503,6,501,6104,1598,403,8.24,0,123.1,826808,7090,822275,1.3,0.33,0.04958570268074736,0.86,99.45
2022-10-02,Maharashtra,1344,13,1336,16620,1865,370,8.09,0,123.1,828152,7103,823611,1.52,0.3,0.13501218521527214,0.86,99.45
2022-10-03,Maharashtra,976,10,968,11839,1378,684,8.24,0,123.1,829128,7113,824579,1.12,0.56,0.09617384240454915,0.86,99.45
2022-10-04,Maharashtra,1231,6,1227,15571,2966,966,7.91,0,123.1,830359,7119,825806,2.41,0.78,0.1264906580016247,0.86,99.45
2022-10-05,Maharashtra,835,7,826,10649,4273,1805,7.84,2,123.1,831194,7126,826632,3.47,1.47,0.08650690495532087,0.86,99.45
2022-10-06,Maharashtra,981,13,975,12162,2686,104,8.07,0,123.1,832175,7139,827607,2.18,0.08,0.09879772542648253,0.86,99.45
2022-10-07,Maharashtra,501,2,492,6468,3747,12,7.75,7,123.1,832676,7141,828099,3.04,0.01,0.05254264825345248,0.86,99.45
2022-10-08,Maharashtra,78,0,70,968,1387,639,8.06,8,123.1,832754,7141,828169,1.13,0.52,0.00786352558895207,0.86,99.45
2022-10-09,Maharashtra,1195,13,1194,15203,4878,869,7.86,0,123.1,833949,7154,829363,3.96,0.71,0.12350121852152722,0.86,99.45
2022-10-10,Maharashtra,1544,15,1536,19341,2727,2427,7.98,0,123.1,835493,7169,830899,2.22,1.97,0.1571161657189277,0.86,99.45
2022-10-11,Maharashtra,1281,7,1275,16257,2270,744,7.88,0,123.1,836774,7176,832174,1.84,0.6,0.1320633631194151,0.86,99.45
2022-10-12,Maharashtra,147,1,141,2040,4259,1884,7.21,5,123.1,836921,7177,832315,3.46,1.53,0.016571892770105606,0.86,99.45
2022-10-13,Maharashtra,938,11,935,11932,3691,465,7.86,0,123.1,837859,7188,833250,3.0,0.38,0.0969293257514216,0.86,99.45
2022-10-14,Maharashtra,406,2,397,5130,365,101,7.91,7,123.1,838265,7190,833647,0.3,0.08,0.04167343623070674,0.86,99.45
2022-10-15,Maharashtra,1001,8,1001,12767,4475,483,7.84,0,123.1,839266,7198,834648,3.64,0.39,0.10371242891957758,0.86,99.45
2022-10-16,Maharashtra,459,2,452,5637,2521,1549,8.14,5,123.1,839725,7200,835100,2.05,1.26,0.04579203899268887,0.86,99.45
2022-10-17,Maharashtra,1032,8,1029,13042,212,121,7.91,0,123.1,840757,7208,836129,0.17,0.1,0.1059463850528026,0.86,99.45
2022-10-18,Maharashtra,314,4,311,4102,463,106,7.65,0,123.1,841071,7212,836440,0.38,0.09,0.033322502030869214,0.86,99.45
2022-10-19,Maharashtra,1363,4,1358,16729,2763,2054,8.15,1,123.1,842434,7216,837798,2.24,1.67,0.13589764419171405,0.86,99.45
2022-10-20,Maharashtra,43,0,34,768,2676,565,5.6,9,123.1,842477,7216,837832,2.17,0.46,0.006238830219333875,0.86,99.45
2022-10-21,Maharashtra,880,11,875,10817,4105,3966,8.14,0,123.1,843357,7227,838707,3.33,3.22,0.08787164906580017,0.86,99.45
2022-10-22,Maharashtra,968,9,966,12182,3497,715,7.95,0,123.1,844325,7236,839673,2.84,0.58,0.09896019496344435,0.86,99.45
2022-10-23,Maharashtra,391,4,382,4911,2596,960,7.96,5,123.1,844716,7240,840055,2.11,0.78,0.039894394800974814,0.86,99.45
2022-10-24,Maharashtra,260,3,254,2950,2320,1230,8.81,3,123.1,844976,7243,840309,1.88,1.0,0.0239642567018684,0.86,99.45
2022-10-25,Maharashtra,752,10,745,9869,2652,1692,7.62,0,123.1,845728,7253,841054,2.15,1.37,0.08017059301380991,0.86,99.45
2022-10-26,Maharashtra,897,9,888,11293,2546,148,7.94,0,123.1,846625,7262,841942,2.07,0.12,0.09173842404549147,0.86,99.45
2022-10-27,Maharashtra,875,8,871,10509,1718,1179,8.33,0,123.1,847500,7270,842813,1.4,0.96,0.08536961819658814,0.86,99.45
2022-10-28,Maharashtra,681,5,677,8550,1390,290,7.96,0,123.1,848181,7275,843490,1.13,0.24,0.0694557270511779,0.86,99.45
2022-10-29,Maharashtra,385,4,383,4768,4945,4564,8.07,0,123.1,848566,7279,843873,4.02,3.71,0.03873273761169781,0.86,99.45
2022-10-30,Maharashtra,1152,10,1147,14264,159,157,8.08,0,123.1,849718,7289,845020,0.13,0.13,0.11587327376116978,0.86,99.45
2022-10-31,Maharashtra,1309,14,1303,16525,634,146,7.92,0,123.1,851027,7303,846323,0.52,0.12,0.1342404549147035,0.86,99.45
2022-11-01,Maharashtra,1300,12,1296,16485,4913,2401,7.89,0,123.1,852327,7315,847619,3.99,1.95,0.13391551584077985,0.86,99.45
2022-11-02,Maharashtra,878,13,870,11153,154,143,7.87,0,123.1,853205,7328,848489,0.13,0.12,0.09060113728675873,0.86,99.45
2022-11-03,Maharashtra,278,2,274,3454,293,108,8.05,2,123.1,853483,7330,848763,0.24,0.09,0.028058489033306256,0.86,99.45
2022-11-04,Maharashtra,1348,12,1342,16878,4680,511,7.99,0,123.1,854831,7342,850105,3.8,0.42,0.13710804224207962,0.86,99.45
2022-11-05,Maharashtra,475,1,466,6114,4088,1170,7.77,8,123.1,855306,7343,850571,3.32,0.95,0.04966693744922827,0.86,99.45
2022-11-06,Maharashtra,286,3,283,3314,1499,1065,8.63,0,123.1,855592,7346,850854,1.22,0.87,0.02692120227457352,0.86,99.45
2022-11-07,Maharashtra,518,4,515,6453,4840,1649,8.03,0,123.1,856110,7350,851369,3.93,1.34,0.05242079610073111,0.86,99.45
2022-11-08,Maharashtra,765,4,756,9202,898,329,8.31,5,123.1,856875,7354,852125,0.73,0.27,0.07475223395613323,0.86,99.45
2022-11-09,Maharashtra,1135,7,1134,14148,3120,2937,8.02,0,123.1,858010,7361,853259,2.53,2.39,0.11493095044679123,0.86,99.45
2022-11-10,Maharashtra,1431,11,1424,18026,425,70,7.94,0,123.1,859441,7372,854683,0.35,0.06,0.14643379366368806,0.86,99.45
2022-11-11,Maharashtra,1185,10,1185,14961,4482,145,7.92,0,123.1,860626,7382,855868,3.64,0.12,0.1215353371242892,0.86,99.45
2022-11-12,Maharashtra,1012,12,1012,12399,3499,2405,8.16,0,123.1,861638,7394,856880,2.84,1.95,0.1007229894394801,0.86,99.45
2022-11-13,Maharashtra,547,4,540,6735,892,549,8.12,3,123.1,862185,7398,857420,0.72,0.45,0.05471161657189277,0.86,99.45
2022-11-14,Maharashtra,1057,3,1056,12822,2991,94,8.24,0,123.1,863242,7401,858476,2.43,0.08,0.10415922014622259,0.86,99.45
2022-11-15,Maharashtra,969,5,969,12039,835,357,8.05,0,123.1,864211,7406,859445,0.68,0.29,0.09779853777416735,0.86,99.45
2022-11-16,Maharashtra,467,4,462,5911,3508,2250,7.9,1,123.1,864678,7410,859907,2.85,1.83,0.0480178716490658,0.86,99.45
2022-11-17,Maharashtra,1171,8,1164,14719,2452,1032,7.96,0,123.1,865849,7418,861071,1.99,0.84,0.11956945572705117,0.86,99.45
2022-11-18,Maharashtra,1205,16,1201,15457,898,263,7.8,0,123.1,867054,7434,862272,0.73,0.21,0.12556458164094234,0.86,99.45
2022-11-19,Maharashtra,948,12,942,11739,4367,3316,8.08,0,123.1,868002,7446,863214,3.55,2.69,0.09536149471974005,0.86,99.45
2022-11-20,Maharashtra,1410,14,1408,17787,4740,3269,7.93,0,123.1,869412,7460,864622,3.85,2.66,0.14449228269699432,0.86,99.45
2022-11-21,Maharashtra,391,3,387,4944,3688,963,7.91,1,123.1,869803,7463,865009,3.0,0.78,0.04016246953696182,0.86,99.45
2022-11-22,Maharashtra,928,7,921,11791,3950,1508,7.87,0,123.1,870731,7470,865930,3.21,1.23,0.09578391551584078,0.86,99.45
2022-11-23,Maharashtra,587,2,582,7407,3960,1134,7.92,3,123.1,871318,7472,866512,3.22,0.92,0.06017059301380991,0.86,99.45
2022-11-24,Maharashtra,936,7,928,11823,2829,1618,7.92,1,123.1,872254,7479,867440,2.3,1.31,0.0960438667749797,0.86,99.45
2022-11-25,Maharashtra,618,3,618,7584,3149,2405,8.15,0,123.1,872872,7482,868058,2.56,1.95,0.061608448415922015,0.86,99.45
2022-11-26,Maharashtra,748,11,743,9237,2905,1348,8.1,0,123.1,873620,7493,868801,2.36,1.1,0.0750365556458164,0.86,99.45
2022-11-27,Maharashtra,1217,16,1208,15315,3824,1617,7.95,0,123.1,874837,7509,870009,3.11,1.31,0.1244110479285134,0.86,99.45
2022-11-28,Maharashtra,623,3,615,7859,586,137,7.93,5,123.1,875460,7512,870624,0.48,0.11,0.06384240454914704,0.86,99.45
2022-11-29,Maharashtra,1488,13,1488,18255,1511,161,8.15,0,123.1,876948,7525,872112,1.23,0.13,0.14829406986190088,0.86,99.45
2022-11-30,Maharashtra,1348,17,1348,16674,4039,1231,8.08,0,123.1,878296,7542,873460,3.28,1.0,0.13545085296506906,0.86,99.45
2022-12-01,Maharashtra,1209,10,1206,14906,1706,1124,8.11,0,123.1,879505,7552,874666,1.39,0.91,0.12108854589764419,0.86,99.45
2022-12-02,Maharashtra,960,6,951,12101,2337,456,7.93,3,123.1,880465,7558,875617,1.9,0.37,0.09830219333874898,0.86,99.45
2022-12-03,Maharashtra,945,8,937,11957,4130,245,7.9,0,123.1,881410,7566,876554,3.35,0.2,0.09713241267262389,0.86,99.45
2022-12-04,Maharashtra,9,0,1,580,4476,3378,1.55,8,123.1,881419,7566,876555,3.64,2.74,0.00471161657189277,0.86,99.45
2022-12-05,Maharashtra,161,1,158,2418,649,553,6.66,2,123.1,881580,7567,876713,0.53,0.45,0.019642567018684,0.86,99.45
2022-12-06,Maharashtra,883,4,883,11511,1298,146,7.67,0,123.1,882463,7571,877596,1.05,0.12,0.09350934199837531,0.86,99.45
2022-12-07,Maharashtra,1480,19,1477,18549,4038,568,7.98,0,123.1,883943,7590,879073,3.28,0.46,0.15068237205523966,0.86,99.45
2022-12-08,Maharashtra,1437,4,1431,18280,226,198,7.86,2,123.1,885380,7594,880504,0.18,0.16,0.14849715678310316,0.86,99.45
2022-12-09,Maharashtra,247,2,246,2775,508,402,8.9,0,123.1,885627,7596,880750,0.41,0.33,0.022542648253452476,0.86,99.45
2022-12-10,Maharashtra,619,6,619,7499,1598,1324,8.25,0,123.1,886246,7602,881369,1.3,1.08,0.06091795288383428,0.86,99.45
2022-12-11,Maharashtra,380,4,374,4923,524,460,7.72,2,123.1,886626,7606,881743,0.43,0.37,0.039991876523151906,0.86,99.45
2022-12-12,Maharashtra,872,5,869,10767,70,49,8.1,0,123.1,887498,7611,882612,0.06,0.04,0.08746547522339561,0.86,99.45
2022-12-13,Maharashtra,323,2,317,3372,2732,1674,9.58,4,123.1,887821,7613,882929,2.22,1.36,0.027392363931762795,0.86,99.45
2022-12-14,Maharashtra,312,3,311,3597,4834,3518,8.67,0,123.1,888133,7616,883240,3.93,2.86,0.029220146222583267,0.86,99.45
2022-12-15,Maharashtra,184,2,177,2469,4381,4322,7.45,5,123.1,888317,7618,883417,3.56,3.51,0.020056864337936638,0.86,99.45
2022-12-16,Maharashtra,1188,10,1187,14972,3165,471,7.93,0,123.1,889505,7628,884604,2.57,0.38,0.1216246953696182,0.86,99.45
2022-12-17,Maharashtra,448,2,439,5301,2292,2092,8.45,7,123.1,889953,7630,885043,1.86,1.7,0.0430625507717303,0.86,99.45
2022-12-18,Maharashtra,930,11,930,11496,2146,1058,8.09,0,123.1,890883,7641,885973,1.74,0.86,0.09338748984565394,0.86,99.45
2022-12-19,Maharashtra,596,8,593,7432,1088,781,8.02,0,123.1,891479,7649,886566,0.88,0.63,0.060373679935012185,0.86,99.45
2022-12-20,Maharashtra,1503,14,1498,18436,373,186,8.15,0,123.1,892982,7663,888064,0.3,0.15,0.14976441917140537,0.86,99.45
2022-12-21,Maharashtra,865,9,862,10533,424,224,8.21,0,123.1,893847,7672,888926,0.34,0.18,0.08556458164094233,0.86,99.45
2022-12-22,Maharashtra,1224,12,1220,15415,2127,689,7.94,0,123.1,895071,7684,890146,1.73,0.56,0.1252233956133225,0.86,99.45
2022-12-23,Maharashtra,1553,20,1550,19160,824,437,8.11,0,123.1,896624,7704,891696,0.67,0.35,0.15564581640942324,0.86,99.45
2022-12-24,Maharashtra,172,1,168,2082,2704,1984,8.26,3,123.1,896796,7705,891864,2.2,1.61,0.016913078797725425,0.86,99.45
2022-12-25,Maharashtra,1524,13,1523,19567,3567,1853,7.79,0,123.1,898320,7718,893387,2.9,1.51,0.15895207148659626,0.86,99.45
2022-12-26,Maharashtra,437,2,435,5193,1869,931,8.42,0,123.1,898757,7720,893822,1.52,0.76,0.04218521527213647,0.86,99.45
2022-12-27,Maharashtra,647,4,641,8101,4485,2472,7.99,2,123.1,899404,7724,894463,3.64,2.01,0.06580828594638505,0.86,99.45
2022-12-28,Maharashtra,15,0,7,593,1673,938,2.53,8,123.1,899419,7724,894470,1.36,0.76,0.004817221770917953,0.86,99.45
2022-12-29,Maharashtra,783,9,781,9999,4068,3544,7.83,0,123.1,900202,7733,895251,3.3,2.88,0.08122664500406174,0.86,99.45
2022-12-30,Maharashtra,355,3,354,4135,642,334,8.59,0,123.1,900557,7736,895605,0.52,0.27,0.033590576766856214,0.86,99.45
2022-12-31,Maharashtra,1241,6,1236,15739,3570,192,7.88,0,123.1,901798,7742,896841,2.9,0.16,0.12785540211210397,0.86,99.45
2020-01-01,Manipur,828,11,824,10292,2939,821,8.05,0,3.1,828,11,824,94.81,26.48,3.32,1.33,99.52
2020-01-02,Manipur,1495,12,1491,18882,1978,989,7.92,0,3.1,2323,23,2315,63.81,31.9,6.090967741935484,0.99,99.66
2020-01-03,Manipur,771,2,764,9885,4054,1952,7.8,5,3.1,3094,25,3079,130.77,62.97,3.1887096774193546,0.81,99.52
2020-01-04,Manipur,1305,12,1297,16445,2932,2591,7.94,0,3.1,4399,37,4376,94.58,83.58,5.304838709677419,0.84,99.48
2020-01-05,Manipur,357,4,348,4302,3764,337,8.3,5,3.1,4756,41,4724,121.42,10.87,1.387741935483871,0.86,99.33
2020-01-06,Manipur,1014,14,1009,12654,456,242,8.01,0,3.1,5770,55,5733,14.71,7.81,4.081935483870968,0.95,99.36
2020-01-07,Manipur,373,5,368,4276,4754,3787,8.72,0,3.1,6143,60,6101,153.35,122.16,1.3793548387096775,0.98,99.32
2020-01-08,Manipur,1113,15,1109,13662,3853,3424,8.15,0,3.1,7256,75,7210,124.29,110.45,4.4070967741935485,1.03,99.37
2020-01-09,Manipur,549,7,546,6326,1597,236,8.68,0,3.1,7805,82,7756,51.52,7.61,2.0406451612903225,1.05,99.37
2020-01-10,Manipur,693,8,687,8155,486,352,8.5,0,3.1,8498,90,8443,15.68,11.35,2.6306451612903228,1.06,99.35
2020-01-11,Manipur,1550,11,1545,19584,186,124,7.91,0,3.1,10048,101,9988,6.0,4.0,6.31741935483871,1.01,99.4
2020-01-12,Manipur,893,11,893,11732,16,16,7.61,0,3.1,10941,112,10881,0.52,0.52,3.784516129032258,1.02,99.45
2020-01-13,Manipur,419,4,414,5542,1198,936,7.56,1,3.1,11360,116,11295,38.65,30.19,1.787741935483871,1.02,99.43
2020-01-14,Manipur,1116,8,1111,14081,2388,1161,7.93,0,3.1,12476,124,12406,77.03,37.45,4.542258064516129,0.99,99.44
2020-01-15,Manipur,1492,21,1492,18627,849,549,8.01,0,3.1,13968,145,13898,27.39,17.71,6.008709677419355,1.04,99.5
2020-01-16,Manipur,608,1,606,7544,1816,1809,8.06,1,3.1,14576,146,14504,58.58,58.35,2.4335483870967742,1.0,99.51
2020-01-17,Manipur,640,3,635,8419,1838,1044,7.6,2,3.1,15216,149,15139,59.29,33.68,2.7158064516129032,0.98,99.49
2020-01-18,Manipur,1577,20,1576,19673,985,91,8.02,0,3.1,16793,169,16715,31.77,2.94,6.346129032258064,1.01,99.54
2020-01-19,Manipur,1476,21,1473,18632,2019,1106,7.92,0,3.1,18269,190,18188,65.13,35.68,6.010322580645162,1.04,99.56
2020-01-20,Manipur,926,4,917,11760,1204,757,7.87,5,3.1,19195,194,19105,38.84,24.42,3.793548387096774,1.01,99.53
2020-01-21,Manipur,1186,4,1178,14359,492,135,8.26,4,3.1,20381,198,20283,15.87,4.35,4.631935483870968,0.97,99.52
2020-01-22,Manipur,821,7,821,10595,2444,2274,7.75,0,3.1,21202,205,21104,78.84,73.35,3.417741935483871,0.97,99.54
2020-01-23,Manipur,295,3,293,4250,1877,234,6.94,0,3.1,21497,208,21397,60.55,7.55,1.3709677419354838,0.97,99.53
2020-01-24,Manipur,983,9,974,12271,4096,2071,8.01,0,3.1,22480,217,22371,132.13,66.81,3.9583870967741936,0.97,99.52
2020-01-25,Manipur,1089,11,1083,13687,1326,915,7.96,0,3.1,23569,228,23454,42.77,29.52,4.4151612903225805,0.97,99.51
2020-01-26,Manipur,1472,14,1469,18108,2493,309,8.13,0,3.1,25041,242,24923,80.42,9.97,5.841290322580645,0.97,99.53
2020-01-27,Manipur,382,3,375,5377,3732,1092,7.1,4,3.1,25423,245,25298,120.39,35.23,1.7345161290322582,0.96,99.51
2020-01-28,Manipur,493,2,486,5943,267,96,8.3,5,3.1,25916,247,25784,8.61,3.1,1.9170967741935483,0.95,99.49
2020-01-29,Manipur,640,6,635,8272,2793,1134,7.74,0,3.1,26556,253,26419,90.1,36.58,2.6683870967741936,0.95,99.48
2020-01-30,Manipur,730,7,725,9601,2434,1682,7.6,0,3.1,27286,260,27144,78.52,54.26,3.0970967741935485,0.95,99.48
2020-01-31,Manipur,1298,9,1296,15980,3629,843,8.12,0,3.1,28584,269,28440,117.06,27.19,5.15483870967742,0.94,99.5
2020-02-01,Manipur,780,6,775,9698,2643,582,8.04,0,3.1,29364,275,29215,85.26,18.77,3.1283870967741936,0.94,99.49
2020-02-02,Manipur,622,2,616,8076,1387,12,7.7,4,3.1,29986,277,29831,44.74,0.39,2.6051612903225805,0.92,99.48
2020-02-03,Manipur,206,2,197,2503,4953,2665,8.23,7,3.1,30192,279,30028,159.77,85.97,0.8074193548387096,0.92,99.46
2020-02-04,Manipur,1138,9,1131,14345,3725,5,7.93,0,3.1,31330,288,31159,120.16,0.16,4.627419354838709,0.92,99.45
2020-02-05,Manipur,1487,22,1482,18525,4251,675,8.03,0,3.1,32817,310,32641,137.13,21.77,5.975806451612903,0.94,99.46
2020-02-06,Manipur,234,2,225,2679,4974,3295,8.73,7,3.1,33051,312,32866,160.45,106.29,0.8641935483870967,0.94,99.44
2020-02-07,Manipur,825,10,819,10468,3970,1210,7.88,0,3.1,33876,322,33685,128.06,39.03,3.3767741935483873,0.95,99.44
2020-02-08,Manipur,1590,22,1584,19609,3920,391,8.11,0,3.1,35466,344,35269,126.45,12.61,6.325483870967742,0.97,99.44
2020-02-09,Manipur,294,2,290,3679,3534,3254,7.99,2,3.1,35760,346,35559,114.0,104.97,1.186774193548387,0.97,99.44
2020-02-10,Manipur,1312,8,1306,16097,2663,2565,8.15,0,3.1,37072,354,36865,85.9,82.74,5.19258064516129,0.95,99.44
2020-02-11,Manipur,917,9,911,11618,2138,755,7.89,0,3.1,37989,363,37776,68.97,24.35,3.747741935483871,0.96,99.44
2020-02-12,Manipur,194,1,194,2430,1299,969,7.98,0,3.1,38183,364,37970,41.9,31.26,0.7838709677419354,0.95,99.44
2020-02-13,Manipur,1487,21,1486,18729,3358,1643,7.94,0,3.1,39670,385,39456,108.32,53.0,6.041612903225807,0.97,99.46
2020-02-14,Manipur,1285,10,1278,15940,3406,2219,8.06,0,3.1,40955,395,40734,109.87,71.58,5.141935483870967,0.96,99.46
2020-02-15,Manipur,1583,14,1580,19748,3049,315,8.02,0,3.1,42538,409,42314,98.35,10.16,6.370322580645161,0.96,99.47
2020-02-16,Manipur,506,7,503,6472,1211,655,7.82,0,3.1,43044,416,42817,39.06,21.13,2.087741935483871,0.97,99.47
2020-02-17,Manipur,794,7,790,9666,3687,3213,8.21,0,3.1,43838,423,43607,118.94,103.65,3.1180645161290323,0.96,99.47
2020-02-18,Manipur,490,5,481,6019,993,349,8.14,4,3.1,44328,428,44088,32.03,11.26,1.9416129032258065,0.97,99.46
2020-02-19,Manipur,76,0,74,864,3253,2609,8.8,2,3.1,44404,428,44162,104.94,84.16,0.2787096774193548,0.96,99.46
2020-02-20,Manipur,593,8,586,7341,3364,1354,8.08,0,3.1,44997,436,44748,108.52,43.68,2.3680645161290323,0.97,99.45
2020-02-21,Manipur,1533,14,1530,19286,4953,1825,7.95,0,3.1,46530,450,46278,159.77,58.87,6.2212903225806455,0.97,99.46
2020-02-22,Manipur,1658,7,1650,19890,680,555,8.34,1,3.1,48188,457,47928,21.94,17.9,6.416129032258064,0.95,99.46
2020-02-23,Manipur,1312,8,1312,16624,2134,364,7.89,0,3.1,49500,465,49240,68.84,11.74,5.36258064516129,0.94,99.47
2020-02-24,Manipur,317,2,311,3978,2779,2709,7.97,4,3.1,49817,467,49551,89.65,87.39,1.2832258064516129,0.94,99.47
2020-02-25,Manipur,568,5,568,6749,94,16,8.42,0,3.1,50385,472,50119,3.03,0.52,2.1770967741935485,0.94,99.47
2020-02-26,Manipur,901,13,895,11394,918,299,7.91,0,3.1,51286,485,51014,29.61,9.65,3.6754838709677418,0.95,99.47
2020-02-27,Manipur,641,4,641,8236,2246,2070,7.78,0,3.1,51927,489,51655,72.45,66.77,2.656774193548387,0.94,99.48
2020-02-28,Manipur,1177,11,1175,14762,4288,3760,7.97,0,3.1,53104,500,52830,138.32,121.29,4.7619354838709675,0.94,99.48
2020-02-29,Manipur,949,6,941,11584,4993,824,8.19,2,3.1,54053,506,53771,161.06,26.58,3.736774193548387,0.94,99.48
2020-03-01,Manipur,256,2,248,3047,3574,859,8.4,6,3.1,54309,508,54019,115.29,27.71,0.9829032258064516,0.94,99.47
2020-03-02,Manipur,1358,15,1358,17491,4706,3345,7.76,0,3.1,55667,523,55377,151.81,107.9,5.642258064516129,0.94,99.48
2020-03-03,Manipur,1553,6,1550,19295,1597,187,8.05,0,3.1,57220,529,56927,51.52,6.03,6.224193548387097,0.92,99.49
2020-03-04,Manipur,776,11,772,9518,3800,728,8.15,0,3.1,57996,540,57699,122.58,23.48,3.0703225806451613,0.93,99.49
2020-03-05,Manipur,1523,6,1519,19266,127,110,7.91,0,3.1,59519,546,59218,4.1,3.55,6.214838709677419,0.92,99.49
2020-03-06,Manipur,697,3,697,8798,4779,3357,7.92,0,3.1,60216,549,59915,154.16,108.29,2.838064516129032,0.91,99.5
2020-03-07,Manipur,461,6,459,5940,2811,531,7.76,0,3.1,60677,555,60374,90.68,17.13,1.9161290322580644,0.91,99.5
2020-03-08,Manipur,1000,9,1000,12404,1764,1198,8.06,0,3.1,61677,564,61374,56.9,38.65,4.001290322580645,0.91,99.51
2020-03-09,Manipur,1245,12,1241,15381,117,4,8.09,0,3.1,62922,576,62615,3.77,0.13,4.961612903225807,0.92,99.51
2020-03-10,Manipur,1066,11,1065,13507,481,86,7.89,0,3.1,63988,587,63680,15.52,2.77,4.357096774193549,0.92,99.52
2020-03-11,Manipur,81,0,72,619,4315,255,13.09,9,3.1,64069,587,63752,139.19,8.23,0.1996774193548387,0.92,99.51
2020-03-12,Manipur,89,0,81,851,2739,1046,10.46,8,3.1,64158,587,63833,88.35,33.74,0.2745161290322581,0.91,99.49
2020-03-13,Manipur,168,1,164,1857,4448,4404,9.05,3,3.1,64326,588,63997,143.48,142.06,0.5990322580645161,0.91,99.49
2020-03-14,Manipur,645,9,644,8079,37,26,7.98,0,3.1,64971,597,64641,1.19,0.84,2.6061290322580644,0.92,99.49
2020-03-15,Manipur,1055,13,1049,12957,3791,2973,8.14,0,3.1,66026,610,65690,122.29,95.9,4.179677419354839,0.92,99.49
2020-03-16,Manipur,265,3,257,3636,3378,480,7.29,5,3.1,66291,613,65947,108.97,15.48,1.1729032258064516,0.92,99.48
2020-03-17,Manipur,1335,15,1330,16753,271,186,7.97,0,3.1,67626,628,67277,8.74,6.0,5.404193548387097,0.93,99.48
2020-03-18,Manipur,1293,16,1287,16087,112,103,8.04,0,3.1,68919,644,68564,3.61,3.32,5.1893548387096775,0.93,99.48
2020-03-19,Manipur,546,1,545,7191,1434,197,7.59,0,3.1,69465,645,69109,46.26,6.35,2.319677419354839,0.93,99.49
2020-03-20,Manipur,1288,13,1282,16190,2295,2279,7.96,0,3.1,70753,658,70391,74.03,73.52,5.22258064516129,0.93,99.49
2020-03-21,Manipur,322,3,319,3769,2787,2192,8.54,0,3.1,71075,661,70710,89.9,70.71,1.2158064516129032,0.93,99.49
2020-03-22,Manipur,340,2,340,4301,2432,16,7.91,0,3.1,71415,663,71050,78.45,0.52,1.3874193548387097,0.93,99.49
2020-03-23,Manipur,604,7,600,7335,2665,1675,8.23,0,3.1,72019,670,71650,85.97,54.03,2.3661290322580646,0.93,99.49
2020-03-24,Manipur,1284,4,1280,16215,3706,2887,7.92,0,3.1,73303,674,72930,119.55,93.13,5.230645161290322,0.92,99.49
2020-03-25,Manipur,374,4,371,4327,1320,631,8.64,0,3.1,73677,678,73301,42.58,20.35,1.3958064516129032,0.92,99.49
2020-03-26,Manipur,222,2,214,2666,4337,448,8.33,6,3.1,73899,680,73515,139.9,14.45,0.86,0.92,99.48
2020-03-27,Manipur,859,5,853,10413,4389,2899,8.25,1,3.1,74758,685,74368,141.58,93.52,3.359032258064516,0.92,99.48
2020-03-28,Manipur,31,0,26,558,3009,1409,5.56,5,3.1,74789,685,74394,97.06,45.45,0.18,0.92,99.47
2020-03-29,Manipur,94,0,87,1122,405,302,8.38,7,3.1,74883,685,74481,13.06,9.74,0.36193548387096774,0.91,99.46
2020-03-30,Manipur,64,0,59,814,1841,1272,7.86,5,3.1,74947,685,74540,59.39,41.03,0.2625806451612903,0.91,99.46
2020-03-31,Manipur,832,4,825,9848,1177,588,8.45,3,3.1,75779,689,75365,37.97,18.97,3.176774193548387,0.91,99.45
2020-04-01,Manipur,41,0,35,610,1726,308,6.72,6,3.1,75820,689,75400,55.68,9.94,0.1967741935483871,0.91,99.45
2020-04-02,Manipur,654,7,647,8165,2619,562,8.01,0,3.1,76474,696,76047,84.48,18.13,2.6338709677419354,0.91,99.44
2020-04-03,Manipur,251,1,250,3246,1392,610,7.73,0,3.1,76725,697,76297,44.9,19.68,1.0470967741935484,0.91,99.44
2020-04-04,Manipur,283,1,276,3471,1139,803,8.15,6,3.1,77008,698,76573,36.74,25.9,1.1196774193548387,0.91,99.44
2020-04-05,Manipur,824,10,821,10501,3846,1833,7.85,0,3.1,77832,708,77394,124.06,59.13,3.3874193548387095,0.91,99.44
2020-04-06,Manipur,505,1,498,6503,2069,1785,7.77,6,3.1,78337,709,77892,66.74,57.58,2.097741935483871,0.91,99.43
2020-04-07,Manipur,140,0,136,2001,4373,2428,7.0,4,3.1,78477,709,78028,141.06,78.32,0.645483870967742,0.9,99.43
2020-04-08,Manipur,298,1,291,4098,840,219,7.27,6,3.1,78775,710,78319,27.1,7.06,1.3219354838709678,0.9,99.42
2020-04-09,Manipur,1154,7,1146,14658,3921,2554,7.87,1,3.1,79929,717,79465,126.48,82.39,4.728387096774194,0.9,99.42
2020-04-10,Manipur,470,5,464,5698,4510,735,8.25,1,3.1,80399,722,79929,145.48,23.71,1.8380645161290323,0.9,99.42
2020-04-11,Manipur,1260,13,1255,16066,597,439,7.84,0,3.1,81659,735,81184,19.26,14.16,5.18258064516129,0.9,99.42
2020-04-12,Manipur,1003,6,1000,12236,291,94,8.2,0,3.1,82662,741,82184,9.39,3.03,3.9470967741935485,0.9,99.42
2020-04-13,Manipur,584,8,577,7339,1918,1072,7.96,0,3.1,83246,749,82761,61.87,34.58,2.3674193548387095,0.9,99.42
2020-04-14,Manipur,460,2,459,6360,4100,3357,7.23,0,3.1,83706,751,83220,132.26,108.29,2.0516129032258066,0.9,99.42
2020-04-15,Manipur,861,12,855,10730,4653,217,8.02,0,3.1,84567,763,84075,150.1,7.0,3.4612903225806453,0.9,99.42
2020-04-16,Manipur,1294,11,1291,16034,2090,1541,8.07,0,3.1,85861,774,85366,67.42,49.71,5.172258064516129,0.9,99.42
2020-04-17,Manipur,1076,10,1076,13344,2067,1341,8.06,0,3.1,86937,784,86442,66.68,43.26,4.304516129032258,0.9,99.43
2020-04-18,Manipur,371,4,366,4883,2737,2055,7.6,1,3.1,87308,788,86808,88.29,66.29,1.5751612903225807,0.9,99.43
2020-04-19,Manipur,879,4,879,10959,3464,1809,8.02,0,3.1,88187,792,87687,111.74,58.35,3.5351612903225806,0.9,99.43
2020-04-20,Manipur,309,4,304,3782,4622,1883,8.17,1,3.1,88496,796,87991,149.1,60.74,1.22,0.9,99.43
2020-04-21,Manipur,522,4,517,6664,2896,1577,7.83,1,3.1,89018,800,88508,93.42,50.87,2.149677419354839,0.9,99.43
2020-04-22,Manipur,619,7,619,7812,1206,255,7.92,0,3.1,89637,807,89127,38.9,8.23,2.52,0.9,99.43
2020-04-23,Manipur,302,1,302,3992,1952,1920,7.57,0,3.1,89939,808,89429,62.97,61.94,1.287741935483871,0.9,99.43
2020-04-24,Manipur,565,3,559,7115,474,293,7.94,3,3.1,90504,811,89988,15.29,9.45,2.2951612903225804,0.9,99.43
2020-04-25,Manipur,287,0,286,3516,70,11,8.16,1,3.1,90791,811,90274,2.26,0.35,1.1341935483870969,0.89,99.43
2020-04-26,Manipur,441,4,437,5526,3480,489,7.98,0,3.1,91232,815,90711,112.26,15.77,1.7825806451612902,0.89,99.43
2020-04-27,Manipur,1358,8,1357,16988,3697,1972,7.99,0,3.1,92590,823,92068,119.26,63.61,5.48,0.89,99.44
2020-04-28,Manipur,1095,12,1095,13431,1967,1284,8.15,0,3.1,93685,835,93163,63.45,41.42,4.332580645161291,0.89,99.44
2020-04-29,Manipur,736,9,736,9252,2628,1634,7.96,0,3.1,94421,844,93899,84.77,52.71,2.984516129032258,0.89,99.45
2020-04-30,Manipur,778,7,771,9658,954,777,8.06,0,3.1,95199,851,94670,30.77,25.06,3.115483870967742,0.89,99.44
2020-05-01,Manipur,1245,9,1241,15332,1562,191,8.12,0,3.1,96444,860,95911,50.39,6.16,4.945806451612904,0.89,99.45
2020-05-02,Manipur,347,3,343,3867,1750,1372,8.97,1,3.1,96791,863,96254,56.45,44.26,1.2474193548387096,0.89,99.45
2020-05-03,Manipur,1032,9,1023,12778,4041,3567,8.08,0,3.1,97823,872,97277,130.35,115.06,4.121935483870968,0.89,99.44
2020-05-04,Manipur,1412,16,1405,17967,477,139,7.86,0,3.1,99235,888,98682,15.39,4.48,5.795806451612903,0.89,99.44
2020-05-05,Manipur,913,11,906,11430,349,242,7.99,0,3.1,100148,899,99588,11.26,7.81,3.6870967741935483,0.9,99.44
2020-05-06,Manipur,970,13,964,12070,4910,4835,8.04,0,3.1,101118,912,100552,158.39,155.97,3.893548387096774,0.9,99.44
2020-05-07,Manipur,404,2,400,4686,4719,1026,8.62,2,3.1,101522,914,100952,152.23,33.1,1.5116129032258065,0.9,99.44
2020-05-08,Manipur,412,5,408,5000,3410,2645,8.24,0,3.1,101934,919,101360,110.0,85.32,1.6129032258064515,0.9,99.44
2020-05-09,Manipur,1283,6,1281,16418,2908,600,7.81,0,3.1,103217,925,102641,93.81,19.35,5.296129032258064,0.9,99.44
2020-05-10,Manipur,1226,17,1219,15251,3915,588,8.04,0,3.1,104443,942,103860,126.29,18.97,4.919677419354839,0.9,99.44
2020-05-11,Manipur,1479,16,1473,18535,4990,2778,7.98,0,3.1,105922,958,105333,160.97,89.61,5.9790322580645165,0.9,99.44
2020-05-12,Manipur,159,1,155,2190,1526,967,7.26,3,3.1,106081,959,105488,49.23,31.19,0.7064516129032258,0.9,99.44
2020-05-13,Manipur,523,7,517,6417,328,309,8.15,0,3.1,106604,966,106005,10.58,9.97,2.07,0.91,99.44
2020-05-14,Manipur,432,3,426,5492,2817,357,7.87,3,3.1,107036,969,106431,90.87,11.52,1.7716129032258066,0.91,99.43
2020-05-15,Manipur,631,6,626,7977,4416,3361,7.91,0,3.1,107667,975,107057,142.45,108.42,2.573225806451613,0.91,99.43
2020-05-16,Manipur,228,1,223,2911,88,50,7.83,4,3.1,107895,976,107280,2.84,1.61,0.9390322580645162,0.9,99.43
2020-05-17,Manipur,474,3,473,5937,724,21,7.98,0,3.1,108369,979,107753,23.35,0.68,1.9151612903225808,0.9,99.43
2020-05-18,Manipur,938,13,937,11683,1967,1219,8.03,0,3.1,109307,992,108690,63.45,39.32,3.7687096774193547,0.91,99.44
2020-05-19,Manipur,1302,6,1298,16765,1073,830,7.77,0,3.1,110609,998,109988,34.61,26.77,5.408064516129032,0.9,99.44
2020-05-20,Manipur,1521,15,1515,18977,3624,1085,8.01,0,3.1,112130,1013,111503,116.9,35.0,6.121612903225807,0.9,99.44
2020-05-21,Manipur,1258,14,1249,15594,2156,1708,8.07,0,3.1,113388,1027,112752,69.55,55.1,5.030322580645161,0.91,99.44
2020-05-22,Manipur,682,9,678,8540,2631,677,7.99,0,3.1,114070,1036,113430,84.87,21.84,2.7548387096774194,0.91,99.44
2020-05-23,Manipur,1383,8,1381,17143,3764,3135,8.07,0,3.1,115453,1044,114811,121.42,101.13,5.53,0.9,99.44
2020-05-24,Manipur,1213,12,1209,15031,2738,1248,8.07,0,3.1,116666,1056,116020,88.32,40.26,4.848709677419355,0.91,99.45
2020-05-25,Manipur,86,0,79,799,1481,1113,10.76,7,3.1,116752,1056,116099,47.77,35.9,0.257741935483871,0.9,99.44
2020-05-26,Manipur,1198,7,1196,15152,3772,1673,7.91,0,3.1,117950,1063,117295,121.68,53.97,4.887741935483871,0.9,99.44
2020-05-27,Manipur,1062,6,1054,13385,2384,1186,7.93,2,3.1,119012,1069,118349,76.9,38.26,4.317741935483871,0.9,99.44
2020-05-28,Manipur,1394,5,1386,16928,1694,889,8.23,3,3.1,120406,1074,119735,54.65,28.68,5.460645161290323,0.89,99.44
2020-05-29,Manipur,150,1,142,1932,2336,81,7.76,7,3.1,120556,1075,119877,75.35,2.61,0.6232258064516129,0.89,99.44
2020-05-30,Manipur,1397,17,1392,17499,1733,1448,7.98,0,3.1,121953,1092,121269,55.9,46.71,5.644838709677419,0.9,99.44
2020-05-31,Manipur,1498,6,1490,18805,4954,3238,7.97,2,3.1,123451,1098,122759,159.81,104.45,6.066129032258065,0.89,99.44
2020-06-01,Manipur,501,3,498,5953,1681,327,8.42,0,3.1,123952,1101,123257,54.23,10.55,1.9203225806451614,0.89,99.44
2020-06-02,Manipur,1573,10,1569,19706,2496,620,7.98,0,3.1,125525,1111,124826,80.52,20.0,6.356774193548387,0.89,99.44
2020-06-03,Manipur,262,1,253,3512,1013,1006,7.46,8,3.1,125787,1112,125079,32.68,32.45,1.1329032258064515,0.88,99.44
2020-06-04,Manipur,160,0,153,1916,2433,2051,8.35,7,3.1,125947,1112,125232,78.48,66.16,0.6180645161290322,0.88,99.43
2020-06-05,Manipur,1464,20,1460,18170,4443,3168,8.06,0,3.1,127411,1132,126692,143.32,102.19,5.861290322580645,0.89,99.44
2020-06-06,Manipur,187,2,182,2242,1076,940,8.34,3,3.1,127598,1134,126874,34.71,30.32,0.7232258064516129,0.89,99.43
2020-06-07,Manipur,1394,18,1389,17547,4033,1938,7.94,0,3.1,128992,1152,128263,130.1,62.52,5.660322580645161,0.89,99.43
2020-06-08,Manipur,451,1,443,5634,3335,232,8.0,7,3.1,129443,1153,128706,107.58,7.48,1.8174193548387096,0.89,99.43
2020-06-09,Manipur,822,5,822,10493,4970,1241,7.83,0,3.1,130265,1158,129528,160.32,40.03,3.3848387096774193,0.89,99.43
2020-06-10,Manipur,1578,6,1573,19849,2334,1906,7.95,0,3.1,131843,1164,131101,75.29,61.48,6.402903225806452,0.88,99.44
2020-06-11,Manipur,1483,13,1483,18392,170,106,8.06,0,3.1,133326,1177,132584,5.48,3.42,5.932903225806451,0.88,99.44
2020-06-12,Manipur,1225,8,1220,15080,4639,3919,8.12,0,3.1,134551,1185,133804,149.65,126.42,4.864516129032258,0.88,99.44
2020-06-13,Manipur,1345,13,1337,16633,3821,2232,8.09,0,3.1,135896,1198,135141,123.26,72.0,5.365483870967742,0.88,99.44
2020-06-14,Manipur,206,1,198,2671,632,619,7.71,7,3.1,136102,1199,135339,20.39,19.97,0.8616129032258064,0.88,99.44
2020-06-15,Manipur,751,3,749,9570,540,393,7.85,0,3.1,136853,1202,136088,17.42,12.68,3.087096774193548,0.88,99.44
2020-06-16,Manipur,1110,10,1104,14213,4522,4301,7.81,0,3.1,137963,1212,137192,145.87,138.74,4.5848387096774195,0.88,99.44
2020-06-17,Manipur,1070,10,1066,13216,1449,871,8.1,0,3.1,139033,1222,138258,46.74,28.1,4.263225806451613,0.88,99.44
2020-06-18,Manipur,799,10,795,9996,3795,572,7.99,0,3.1,139832,1232,139053,122.42,18.45,3.224516129032258,0.88,99.44
2020-06-19,Manipur,980,10,974,12227,2631,2103,8.02,0,3.1,140812,1242,140027,84.87,67.84,3.944193548387097,0.88,99.44
2020-06-20,Manipur,699,7,692,8559,4113,737,8.17,0,3.1,141511,1249,140719,132.68,23.77,2.7609677419354837,0.88,99.44
2020-06-21,Manipur,1596,16,1588,19520,3039,231,8.18,0,3.1,143107,1265,142307,98.03,7.45,6.296774193548387,0.88,99.44
2020-06-22,Manipur,145,0,141,1788,3941,3778,8.11,4,3.1,143252,1265,142448,127.13,121.87,0.5767741935483871,0.88,99.44
2020-06-23,Manipur,1193,6,1184,14674,3328,1322,8.13,3,3.1,144445,1271,143632,107.35,42.65,4.733548387096774,0.88,99.44
2020-06-24,Manipur,1302,14,1299,15798,2555,1059,8.24,0,3.1,145747,1285,144931,82.42,34.16,5.096129032258064,0.88,99.44
2020-06-25,Manipur,399,2,391,5294,3415,401,7.54,6,3.1,146146,1287,145322,110.16,12.94,1.707741935483871,0.88,99.44
2020-06-26,Manipur,231,1,224,3006,29,6,7.68,6,3.1,146377,1288,145546,0.94,0.19,0.9696774193548388,0.88,99.43
2020-06-27,Manipur,545,3,537,6877,1937,1687,7.92,5,3.1,146922,1291,146083,62.48,54.42,2.2183870967741934,0.88,99.43
2020-06-28,Manipur,927,5,927,11626,475,253,7.97,0,3.1,147849,1296,147010,15.32,8.16,3.7503225806451614,0.88,99.43
2020-06-29,Manipur,637,4,636,8246,2019,510,7.72,0,3.1,148486,1300,147646,65.13,16.45,2.66,0.88,99.43
2020-06-30,Manipur,1272,16,1272,15865,4620,3950,8.02,0,3.1,149758,1316,148918,149.03,127.42,5.117741935483871,0.88,99.44
2020-07-01,Manipur,121,0,118,1810,355,287,6.69,3,3.1,149879,1316,149036,11.45,9.26,0.5838709677419355,0.88,99.44
2020-07-02,Manipur,1389,13,1382,16963,4612,1298,8.19,0,3.1,151268,1329,150418,148.77,41.87,5.4719354838709675,0.88,99.44
2020-07-03,Manipur,1375,5,1373,17145,949,195,8.02,0,3.1,152643,1334,151791,30.61,6.29,5.530645161290322,0.87,99.44
2020-07-04,Manipur,1096,4,1095,13778,577,212,7.95,0,3.1,153739,1338,152886,18.61,6.84,4.444516129032258,0.87,99.45
2020-07-05,Manipur,466,3,466,5725,3924,1276,8.14,0,3.1,154205,1341,153352,126.58,41.16,1.846774193548387,0.87,99.45
2020-07-06,Manipur,506,7,497,6382,3898,1220,7.93,2,3.1,154711,1348,153849,125.74,39.35,2.0587096774193547,0.87,99.44
2020-07-07,Manipur,1570,10,1562,19558,2320,1500,8.03,0,3.1,156281,1358,155411,74.84,48.39,6.309032258064516,0.87,99.44
2020-07-08,Manipur,1221,17,1214,15052,34,0,8.11,0,3.1,157502,1375,156625,1.1,0.0,4.855483870967742,0.87,99.44
2020-07-09,Manipur,199,2,198,2480,1187,485,8.02,0,3.1,157701,1377,156823,38.29,15.65,0.8,0.87,99.44
2020-07-10,Manipur,255,2,255,2860,3338,2118,8.92,0,3.1,157956,1379,157078,107.68,68.32,0.9225806451612903,0.87,99.44
2020-07-11,Manipur,1150,13,1144,13893,4552,3584,8.28,0,3.1,159106,1392,158222,146.84,115.61,4.481612903225806,0.87,99.44
2020-07-12,Manipur,696,3,688,8703,4728,946,8.0,5,3.1,159802,1395,158910,152.52,30.52,2.80741935483871,0.87,99.44
2020-07-13,Manipur,1463,15,1455,17897,2845,2450,8.17,0,3.1,161265,1410,160365,91.77,79.03,5.773225806451613,0.87,99.44
2020-07-14,Manipur,1315,11,1312,16671,3304,3235,7.89,0,3.1,162580,1421,161677,106.58,104.35,5.377741935483871,0.87,99.44
2020-07-15,Manipur,1432,13,1429,17837,1409,1036,8.03,0,3.1,164012,1434,163106,45.45,33.42,5.7538709677419355,0.87,99.45
2020-07-16,Manipur,466,1,464,5818,3942,3216,8.01,1,3.1,164478,1435,163570,127.16,103.74,1.876774193548387,0.87,99.45
2020-07-17,Manipur,603,2,596,7390,4151,2578,8.16,5,3.1,165081,1437,164166,133.9,83.16,2.3838709677419354,0.87,99.45
2020-07-18,Manipur,1043,11,1042,12550,2863,731,8.31,0,3.1,166124,1448,165208,92.35,23.58,4.048387096774194,0.87,99.45
2020-07-19,Manipur,986,12,984,12920,3782,1644,7.63,0,3.1,167110,1460,166192,122.0,53.03,4.167741935483871,0.87,99.45
2020-07-20,Manipur,428,6,423,6162,2069,454,6.95,0,3.1,167538,1466,166615,66.74,14.65,1.987741935483871,0.88,99.45
2020-07-21,Manipur,512,7,506,6273,2549,1633,8.16,0,3.1,168050,1473,167121,82.23,52.68,2.023548387096774,0.88,99.45
2020-07-22,Manipur,643,7,642,8148,3492,1783,7.89,0,3.1,168693,1480,167763,112.65,57.52,2.6283870967741936,0.88,99.45
2020-07-23,Manipur,1269,16,1261,15555,3747,1848,8.16,0,3.1,169962,1496,169024,120.87,59.61,5.017741935483871,0.88,99.45
2020-07-24,Manipur,795,4,795,9924,3738,2380,8.01,0,3.1,170757,1500,169819,120.58,76.77,3.201290322580645,0.88,99.45
2020-07-25,Manipur,1525,12,1523,18906,3237,2598,8.07,0,3.1,172282,1512,171342,104.42,83.81,6.098709677419355,0.88,99.45
2020-07-26,Manipur,357,4,357,4408,2969,1533,8.1,0,3.1,172639,1516,171699,95.77,49.45,1.4219354838709677,0.88,99.46
2020-07-27,Manipur,351,5,347,4327,355,53,8.11,0,3.1,172990,1521,172046,11.45,1.71,1.3958064516129032,0.88,99.45
2020-07-28,Manipur,186,0,181,2698,3319,2347,6.89,5,3.1,173176,1521,172227,107.06,75.71,0.8703225806451613,0.88,99.45
2020-07-29,Manipur,575,7,572,6928,4664,3204,8.3,0,3.1,173751,1528,172799,150.45,103.35,2.2348387096774194,0.88,99.45
2020-07-30,Manipur,1213,17,1213,14883,3074,6,8.15,0,3.1,174964,1545,174012,99.16,0.19,4.800967741935484,0.88,99.46
2020-07-31,Manipur,849,6,842,10722,2379,895,7.92,1,3.1,175813,1551,174854,76.74,28.87,3.4587096774193546,0.88,99.45
2020-08-01,Manipur,1371,11,1363,17097,4658,3482,8.02,0,3.1,177184,1562,176217,150.26,112.32,5.515161290322581,0.88,99.45
2020-08-02,Manipur,1354,5,1350,16581,596,513,8.17,0,3.1,178538,1567,177567,19.23,16.55,5.348709677419355,0.88,99.46
2020-08-03,Manipur,1280,13,1273,16289,4693,926,7.86,0,3.1,179818,1580,178840,151.39,29.87,5.254516129032258,0.88,99.46
2020-08-04,Manipur,1339,13,1338,17214,1643,1138,7.78,0,3.1,181157,1593,180178,53.0,36.71,5.5529032258064515,0.88,99.46
2020-08-05,Manipur,344,2,344,4087,2660,334,8.42,0,3.1,181501,1595,180522,85.81,10.77,1.3183870967741935,0.88,99.46
2020-08-06,Manipur,230,1,222,2401,4502,4272,9.58,7,3.1,181731,1596,180744,145.23,137.81,0.7745161290322581,0.88,99.46
2020-08-07,Manipur,1336,9,1332,16463,3518,7,8.12,0,3.1,183067,1605,182076,113.48,0.23,5.3106451612903225,0.88,99.46
2020-08-08,Manipur,434,4,426,5817,3553,2835,7.46,4,3.1,183501,1609,182502,114.61,91.45,1.8764516129032258,0.88,99.46
2020-08-09,Manipur,840,4,833,10419,682,74,8.06,3,3.1,184341,1613,183335,22.0,2.39,3.3609677419354838,0.88,99.45
2020-08-10,Manipur,958,6,950,12020,2712,1946,7.97,2,3.1,185299,1619,184285,87.48,62.77,3.8774193548387097,0.87,99.45
2020-08-11,Manipur,1448,11,1441,17972,3410,254,8.06,0,3.1,186747,1630,185726,110.0,8.19,5.79741935483871,0.87,99.45
2020-08-12,Manipur,1380,14,1373,17063,406,202,8.09,0,3.1,188127,1644,187099,13.1,6.52,5.5041935483870965,0.87,99.45
2020-08-13,Manipur,1117,12,1111,14311,4454,3289,7.81,0,3.1,189244,1656,188210,143.68,106.1,4.616451612903226,0.88,99.45
2020-08-14,Manipur,1039,6,1032,13021,2811,2270,7.98,1,3.1,190283,1662,189242,90.68,73.23,4.200322580645161,0.87,99.45
2020-08-15,Manipur,729,4,725,9029,1235,235,8.07,0,3.1,191012,1666,189967,39.84,7.58,2.9125806451612903,0.87,99.45
2020-08-16,Manipur,898,2,894,11408,1361,313,7.87,2,3.1,191910,1668,190861,43.9,10.1,3.68,0.87,99.45
2020-08-17,Manipur,1402,5,1398,17500,1707,1558,8.01,0,3.1,193312,1673,192259,55.06,50.26,5.645161290322581,0.87,99.46
2020-08-18,Manipur,379,4,372,4391,1429,839,8.63,3,3.1,193691,1677,192631,46.1,27.06,1.4164516129032259,0.87,99.45
2020-08-19,Manipur,741,6,741,9344,1656,84,7.93,0,3.1,194432,1683,193372,53.42,2.71,3.0141935483870967,0.87,99.45
2020-08-20,Manipur,1583,17,1576,19750,2232,2047,8.02,0,3.1,196015,1700,194948,72.0,66.03,6.370967741935484,0.87,99.46
2020-08-21,Manipur,1215,13,1211,14960,2599,1010,8.12,0,3.1,197230,1713,196159,83.84,32.58,4.825806451612904,0.87,99.46
2020-08-22,Manipur,983,9,977,12327,338,190,7.97,0,3.1,198213,1722,197136,10.9,6.13,3.976451612903226,0.87,99.46
2020-08-23,Manipur,450,6,447,5402,3387,2907,8.33,0,3.1,198663,1728,197583,109.26,93.77,1.7425806451612904,0.87,99.46
2020-08-24,Manipur,907,10,898,11405,4440,2375,7.95,0,3.1,199570,1738,198481,143.23,76.61,3.6790322580645163,0.87,99.45
2020-08-25,Manipur,1472,10,1464,18150,1841,986,8.11,0,3.1,201042,1748,199945,59.39,31.81,5.854838709677419,0.87,99.45
2020-08-26,Manipur,1187,12,1183,15020,3371,927,7.9,0,3.1,202229,1760,201128,108.74,29.9,4.84516129032258,0.87,99.46
2020-08-27,Manipur,1452,16,1452,18195,260,95,7.98,0,3.1,203681,1776,202580,8.39,3.06,5.869354838709677,0.87,99.46
2020-08-28,Manipur,115,1,108,1596,2109,1061,7.21,6,3.1,203796,1777,202688,68.03,34.23,0.5148387096774194,0.87,99.46
2020-08-29,Manipur,1412,17,1406,17719,4527,3496,7.97,0,3.1,205208,1794,204094,146.03,112.77,5.715806451612903,0.87,99.46
2020-08-30,Manipur,808,5,806,9900,4972,3247,8.16,0,3.1,206016,1799,204900,160.39,104.74,3.193548387096774,0.87,99.46
2020-08-31,Manipur,27,0,21,556,3538,2379,4.86,6,3.1,206043,1799,204921,114.13,76.74,0.17935483870967742,0.87,99.46
2020-09-01,Manipur,685,5,685,9294,258,195,7.37,0,3.1,206728,1804,205606,8.32,6.29,2.9980645161290322,0.87,99.46
2020-09-02,Manipur,115,1,110,1646,2235,2211,6.99,4,3.1,206843,1805,205716,72.1,71.32,0.5309677419354839,0.87,99.46
2020-09-03,Manipur,795,6,786,10351,2982,1525,7.68,3,3.1,207638,1811,206502,96.19,49.19,3.339032258064516,0.87,99.45
2020-09-04,Manipur,210,1,207,2466,4935,3551,8.52,2,3.1,207848,1812,206709,159.19,114.55,0.795483870967742,0.87,99.45
2020-09-05,Manipur,121,1,114,1311,2114,2025,9.23,6,3.1,207969,1813,206823,68.19,65.32,0.4229032258064516,0.87,99.45
2020-09-06,Manipur,172,1,171,2096,3794,1080,8.21,0,3.1,208141,1814,206994,122.39,34.84,0.6761290322580645,0.87,99.45
2020-09-07,Manipur,906,11,903,11368,1231,85,7.97,0,3.1,209047,1825,207897,39.71,2.74,3.6670967741935483,0.87,99.45
2020-09-08,Manipur,304,2,302,3858,2133,221,7.88,0,3.1,209351,1827,208199,68.81,7.13,1.2445161290322582,0.87,99.45
2020-09-09,Manipur,722,5,714,8906,1043,543,8.11,3,3.1,210073,1832,208913,33.65,17.52,2.8729032258064517,0.87,99.45
2020-09-10,Manipur,1329,10,1320,16576,3337,2547,8.02,0,3.1,211402,1842,210233,107.65,82.16,5.347096774193548,0.87,99.45
2020-09-11,Manipur,1147,7,1142,14494,610,14,7.91,0,3.1,212549,1849,211375,19.68,0.45,4.675483870967742,0.87,99.45
2020-09-12,Manipur,574,3,573,7129,2444,395,8.05,0,3.1,213123,1852,211948,78.84,12.74,2.299677419354839,0.87,99.45
2020-09-13,Manipur,807,6,801,10211,193,36,7.9,0,3.1,213930,1858,212749,6.23,1.16,3.2938709677419356,0.87,99.45
2020-09-14,Manipur,1292,10,1291,15894,1355,682,8.13,0,3.1,215222,1868,214040,43.71,22.0,5.127096774193548,0.87,99.45
2020-09-15,Manipur,1356,10,1356,16829,2239,2121,8.06,0,3.1,216578,1878,215396,72.23,68.42,5.428709677419355,0.87,99.45
2020-09-16,Manipur,1261,11,1260,15590,548,154,8.09,0,3.1,217839,1889,216656,17.68,4.97,5.029032258064516,0.87,99.46
2020-09-17,Manipur,151,2,147,1772,4301,971,8.52,2,3.1,217990,1891,216803,138.74,31.32,0.5716129032258065,0.87,99.46
2020-09-18,Manipur,450,3,446,5731,2614,2574,7.85,1,3.1,218440,1894,217249,84.32,83.03,1.8487096774193548,0.87,99.45
2020-09-19,Manipur,1479,22,1472,18345,1627,445,8.06,0,3.1,219919,1916,218721,52.48,14.35,5.917741935483871,0.87,99.46
2020-09-20,Manipur,664,6,663,8445,4105,3890,7.86,0,3.1,220583,1922,219384,132.42,125.48,2.7241935483870967,0.87,99.46
2020-09-21,Manipur,232,3,224,3028,3872,930,7.66,5,3.1,220815,1925,219608,124.9,30.0,0.9767741935483871,0.87,99.45
2020-09-22,Manipur,967,5,961,12374,2510,1017,7.81,1,3.1,221782,1930,220569,80.97,32.81,3.9916129032258065,0.87,99.45
2020-09-23,Manipur,209,1,206,2466,812,35,8.48,2,3.1,221991,1931,220775,26.19,1.13,0.795483870967742,0.87,99.45
2020-09-24,Manipur,596,3,594,7950,15,11,7.5,0,3.1,222587,1934,221369,0.48,0.35,2.564516129032258,0.87,99.45
2020-09-25,Manipur,359,1,358,4625,4862,997,7.76,0,3.1,222946,1935,221727,156.84,32.16,1.4919354838709677,0.87,99.45
2020-09-26,Manipur,837,4,833,10341,716,589,8.09,0,3.1,223783,1939,222560,23.1,19.0,3.3358064516129033,0.87,99.45
2020-09-27,Manipur,793,2,791,10189,4312,1383,7.78,0,3.1,224576,1941,223351,139.1,44.61,3.286774193548387,0.86,99.45
2020-09-28,Manipur,95,1,92,1143,2667,1134,8.31,2,3.1,224671,1942,223443,86.03,36.58,0.36870967741935484,0.86,99.45
2020-09-29,Manipur,1335,8,1326,16741,3921,1363,7.97,1,3.1,226006,1950,224769,126.48,43.97,5.400322580645161,0.86,99.45
2020-09-30,Manipur,1407,19,1402,17650,4082,3165,7.97,0,3.1,227413,1969,226171,131.68,102.1,5.693548387096774,0.87,99.45
2020-10-01,Manipur,162,2,155,1750,573,37,9.26,5,3.1,227575,1971,226326,18.48,1.19,0.5645161290322581,0.87,99.45
2020-10-02,Manipur,426,2,418,5285,1439,1181,8.06,6,3.1,228001,1973,226744,46.42,38.1,1.7048387096774194,0.87,99.45
2020-10-03,Manipur,1575,9,1568,19791,4452,164,7.96,0,3.1,229576,1982,228312,143.61,5.29,6.384193548387096,0.86,99.45
2020-10-04,Manipur,53,0,53,1128,308,172,4.7,0,3.1,229629,1982,228365,9.94,5.55,0.3638709677419355,0.86,99.45
2020-10-05,Manipur,193,1,193,2423,3233,897,7.97,0,3.1,229822,1983,228558,104.29,28.94,0.7816129032258065,0.86,99.45
2020-10-06,Manipur,88,0,86,1202,1907,369,7.32,2,3.1,229910,1983,228644,61.52,11.9,0.387741935483871,0.86,99.45
2020-10-07,Manipur,532,4,525,6727,4003,2644,7.91,3,3.1,230442,1987,229169,129.13,85.29,2.17,0.86,99.45
2020-10-08,Manipur,295,3,291,3839,4176,1678,7.68,1,3.1,230737,1990,229460,134.71,54.13,1.2383870967741935,0.86,99.45
2020-10-09,Manipur,1530,15,1523,19212,3789,271,7.96,0,3.1,232267,2005,230983,122.23,8.74,6.1974193548387095,0.86,99.45
2020-10-10,Manipur,426,4,423,4806,3123,523,8.86,0,3.1,232693,2009,231406,100.74,16.87,1.5503225806451613,0.86,99.45
2020-10-11,Manipur,155,1,152,1760,1996,676,8.81,2,3.1,232848,2010,231558,64.39,21.81,0.567741935483871,0.86,99.45
2020-10-12,Manipur,375,2,368,4562,1549,1341,8.22,5,3.1,233223,2012,231926,49.97,43.26,1.4716129032258065,0.86,99.44
2020-10-13,Manipur,1222,11,1219,15511,3088,1091,7.88,0,3.1,234445,2023,233145,99.61,35.19,5.0035483870967745,0.86,99.45
2020-10-14,Manipur,302,3,295,4041,2800,584,7.47,4,3.1,234747,2026,233440,90.32,18.84,1.3035483870967741,0.86,99.44
2020-10-15,Manipur,1515,6,1513,18897,4951,4180,8.02,0,3.1,236262,2032,234953,159.71,134.84,6.095806451612903,0.86,99.45
2020-10-16,Manipur,98,0,89,1447,2621,723,6.77,9,3.1,236360,2032,235042,84.55,23.32,0.4667741935483871,0.86,99.44
2020-10-17,Manipur,848,6,843,10478,4382,2320,8.09,0,3.1,237208,2038,235885,141.35,74.84,3.38,0.86,99.44
2020-10-18,Manipur,643,7,637,7837,4224,1074,8.2,0,3.1,237851,2045,236522,136.26,34.65,2.528064516129032,0.86,99.44
2020-10-19,Manipur,1077,5,1074,13273,4148,871,8.11,0,3.1,238928,2050,237596,133.81,28.1,4.281612903225806,0.86,99.44
2020-10-20,Manipur,1206,5,1201,15186,178,4,7.94,0,3.1,240134,2055,238797,5.74,0.13,4.898709677419355,0.86,99.44
2020-10-21,Manipur,315,3,314,3901,884,798,8.07,0,3.1,240449,2058,239111,28.52,25.74,1.2583870967741935,0.86,99.44
2020-10-22,Manipur,1002,12,998,12504,897,639,8.01,0,3.1,241451,2070,240109,28.94,20.61,4.033548387096774,0.86,99.44
2020-10-23,Manipur,322,4,317,4379,4265,1012,7.35,1,3.1,241773,2074,240426,137.58,32.65,1.4125806451612903,0.86,99.44
2020-10-24,Manipur,1168,7,1167,14764,4313,3751,7.91,0,3.1,242941,2081,241593,139.13,121.0,4.76258064516129,0.86,99.45
2020-10-25,Manipur,1285,11,1282,16084,1827,974,7.99,0,3.1,244226,2092,242875,58.94,31.42,5.188387096774194,0.86,99.45
2020-10-26,Manipur,102,1,94,1233,3485,1618,8.27,7,3.1,244328,2093,242969,112.42,52.19,0.397741935483871,0.86,99.44
2020-10-27,Manipur,684,2,677,8736,4563,3433,7.83,5,3.1,245012,2095,243646,147.19,110.74,2.818064516129032,0.86,99.44
2020-10-28,Manipur,1238,8,1233,15393,954,271,8.04,0,3.1,246250,2103,244879,30.77,8.74,4.965483870967742,0.85,99.44
2020-10-29,Manipur,733,6,726,9020,4462,3171,8.13,1,3.1,246983,2109,245605,143.94,102.29,2.9096774193548387,0.85,99.44
2020-10-30,Manipur,1346,6,1345,16619,3135,172,8.1,0,3.1,248329,2115,246950,101.13,5.55,5.360967741935484,0.85,99.44
2020-10-31,Manipur,946,6,938,11700,3093,2240,8.09,2,3.1,249275,2121,247888,99.77,72.26,3.774193548387097,0.85,99.44
2020-11-01,Manipur,67,0,59,821,2144,128,8.16,8,3.1,249342,2121,247947,69.16,4.13,0.26483870967741935,0.85,99.44
2020-11-02,Manipur,572,3,567,6845,4406,3005,8.36,2,3.1,249914,2124,248514,142.13,96.94,2.208064516129032,0.85,99.44
2020-11-03,Manipur,1088,13,1084,13487,4940,569,8.07,0,3.1,251002,2137,249598,159.35,18.35,4.3506451612903225,0.85,99.44
2020-11-04,Manipur,849,11,847,10442,3257,2138,8.13,0,3.1,251851,2148,250445,105.06,68.97,3.3683870967741933,0.85,99.44
2020-11-05,Manipur,191,2,185,2510,4589,4069,7.61,4,3.1,252042,2150,250630,148.03,131.26,0.8096774193548387,0.85,99.44
2020-11-06,Manipur,893,3,892,10936,1486,1219,8.17,0,3.1,252935,2153,251522,47.94,39.32,3.527741935483871,0.85,99.44
2020-11-07,Manipur,478,4,478,5766,2806,820,8.29,0,3.1,253413,2157,252000,90.52,26.45,1.86,0.85,99.44
2020-11-08,Manipur,1347,14,1344,16915,1485,447,7.96,0,3.1,254760,2171,253344,47.9,14.42,5.4564516129032254,0.85,99.44
2020-11-09,Manipur,662,5,658,8226,383,129,8.05,0,3.1,255422,2176,254002,12.35,4.16,2.653548387096774,0.85,99.44
2020-11-10,Manipur,255,3,249,3285,3039,1870,7.76,3,3.1,255677,2179,254251,98.03,60.32,1.0596774193548386,0.85,99.44
2020-11-11,Manipur,281,2,280,3621,2770,1153,7.76,0,3.1,255958,2181,254531,89.35,37.19,1.1680645161290322,0.85,99.44
2020-11-12,Manipur,1508,19,1507,18683,4860,1302,8.07,0,3.1,257466,2200,256038,156.77,42.0,6.026774193548387,0.85,99.45
2020-11-13,Manipur,1229,13,1229,14971,4877,1854,8.21,0,3.1,258695,2213,257267,157.32,59.81,4.829354838709677,0.86,99.45
2020-11-14,Manipur,133,1,126,1558,4428,1448,8.54,6,3.1,258828,2214,257393,142.84,46.71,0.5025806451612903,0.86,99.45
2020-11-15,Manipur,1062,8,1055,13815,3832,1210,7.69,0,3.1,259890,2222,258448,123.61,39.03,4.4564516129032254,0.85,99.45
2020-11-16,Manipur,1201,4,1194,15389,2790,521,7.8,3,3.1,261091,2226,259642,90.0,16.81,4.9641935483870965,0.85,99.45
2020-11-17,Manipur,1226,15,1222,15276,4697,3549,8.03,0,3.1,262317,2241,260864,151.52,114.48,4.927741935483871,0.85,99.45
2020-11-18,Manipur,402,3,397,5574,4315,3377,7.21,2,3.1,262719,2244,261261,139.19,108.94,1.7980645161290323,0.85,99.45
2020-11-19,Manipur,1056,14,1047,13081,1741,178,8.07,0,3.1,263775,2258,262308,56.16,5.74,4.219677419354839,0.86,99.44
2020-11-20,Manipur,1005,6,1004,12723,4451,3993,7.9,0,3.1,264780,2264,263312,143.58,128.81,4.104193548387097,0.86,99.45
2020-11-21,Manipur,752,2,747,9372,1058,853,8.02,3,3.1,265532,2266,264059,34.13,27.52,3.023225806451613,0.85,99.45
2020-11-22,Manipur,800,4,794,9831,651,34,8.14,2,3.1,266332,2270,264853,21.0,1.1,3.1712903225806452,0.85,99.44
2020-11-23,Manipur,374,3,370,4910,3904,269,7.62,1,3.1,266706,2273,265223,125.94,8.68,1.5838709677419356,0.85,99.44
2020-11-24,Manipur,472,2,472,6158,3048,3006,7.66,0,3.1,267178,2275,265695,98.32,96.97,1.986451612903226,0.85,99.44
2020-11-25,Manipur,1160,5,1152,14197,4877,915,8.17,3,3.1,268338,2280,266847,157.32,29.52,4.579677419354839,0.85,99.44
2020-11-26,Manipur,1119,10,1118,13386,4821,373,8.36,0,3.1,269457,2290,267965,155.52,12.03,4.3180645161290325,0.85,99.45
2020-11-27,Manipur,146,1,140,2002,2264,117,7.29,5,3.1,269603,2291,268105,73.03,3.77,0.6458064516129032,0.85,99.44
2020-11-28,Manipur,1557,21,1554,19869,4438,1897,7.84,0,3.1,271160,2312,269659,143.16,61.19,6.409354838709677,0.85,99.45
2020-11-29,Manipur,85,0,79,701,2566,1281,12.13,6,3.1,271245,2312,269738,82.77,41.32,0.22612903225806452,0.85,99.44
2020-11-30,Manipur,934,12,927,11852,24,2,7.88,0,3.1,272179,2324,270665,0.77,0.06,3.823225806451613,0.85,99.44
2020-12-01,Manipur,951,4,948,11825,3343,1066,8.04,0,3.1,273130,2328,271613,107.84,34.39,3.814516129032258,0.85,99.44
2020-12-02,Manipur,108,0,103,1190,3999,3315,9.08,5,3.1,273238,2328,271716,129.0,106.94,0.38387096774193546,0.85,99.44
2020-12-03,Manipur,1320,13,1314,16592,3917,2488,7.96,0,3.1,274558,2341,273030,126.35,80.26,5.352258064516129,0.85,99.44
2020-12-04,Manipur,967,14,958,12680,4747,4144,7.63,0,3.1,275525,2355,273988,153.13,133.68,4.090322580645161,0.85,99.44
2020-12-05,Manipur,771,6,765,9528,483,371,8.09,0,3.1,276296,2361,274753,15.58,11.97,3.0735483870967744,0.85,99.44
2020-12-06,Manipur,1416,13,1408,18039,4898,1266,7.85,0,3.1,277712,2374,276161,158.0,40.84,5.819032258064516,0.85,99.44
2020-12-07,Manipur,903,9,896,11352,2929,1262,7.95,0,3.1,278615,2383,277057,94.48,40.71,3.661935483870968,0.86,99.44
2020-12-08,Manipur,584,5,579,7150,938,569,8.17,0,3.1,279199,2388,277636,30.26,18.35,2.306451612903226,0.86,99.44
2020-12-09,Manipur,994,10,992,12468,1641,1127,7.97,0,3.1,280193,2398,278628,52.94,36.35,4.021935483870967,0.86,99.44
2020-12-10,Manipur,1219,5,1218,15228,3418,2656,8.0,0,3.1,281412,2403,279846,110.26,85.68,4.912258064516129,0.85,99.44
2020-12-11,Manipur,1056,10,1053,13284,4345,3903,7.95,0,3.1,282468,2413,280899,140.16,125.9,4.285161290322581,0.85,99.44
2020-12-12,Manipur,14,0,9,621,3503,891,2.25,5,3.1,282482,2413,280908,113.0,28.74,0.20032258064516129,0.85,99.44
2020-12-13,Manipur,1058,10,1053,13205,4420,2041,8.01,0,3.1,283540,2423,281961,142.58,65.84,4.259677419354839,0.85,99.44
2020-12-14,Manipur,422,4,415,5497,1083,288,7.68,3,3.1,283962,2427,282376,34.94,9.29,1.7732258064516129,0.85,99.44
2020-12-15,Manipur,1348,19,1340,16243,3951,3452,8.3,0,3.1,285310,2446,283716,127.45,111.35,5.239677419354838,0.86,99.44
2020-12-16,Manipur,183,1,183,2418,1590,621,7.57,0,3.1,285493,2447,283899,51.29,20.03,0.78,0.86,99.44
2020-12-17,Manipur,377,1,377,4893,2200,938,7.7,0,3.1,285870,2448,284276,70.97,30.26,1.5783870967741935,0.86,99.44
2020-12-18,Manipur,694,4,694,8385,2848,1336,8.28,0,3.1,286564,2452,284970,91.87,43.1,2.7048387096774196,0.86,99.44
2020-12-19,Manipur,339,2,337,4737,1465,7,7.16,0,3.1,286903,2454,285307,47.26,0.23,1.5280645161290323,0.86,99.44
2020-12-20,Manipur,655,1,650,8310,1580,1466,7.88,4,3.1,287558,2455,285957,50.97,47.29,2.6806451612903226,0.85,99.44
2020-12-21,Manipur,954,13,950,11828,1400,133,8.07,0,3.1,288512,2468,286907,45.16,4.29,3.815483870967742,0.86,99.44
2020-12-22,Manipur,475,6,474,5581,477,35,8.51,0,3.1,288987,2474,287381,15.39,1.13,1.8003225806451613,0.86,99.44
2020-12-23,Manipur,863,3,860,10479,2438,568,8.24,0,3.1,289850,2477,288241,78.65,18.32,3.3803225806451613,0.85,99.44
2020-12-24,Manipur,673,4,670,8356,371,28,8.05,0,3.1,290523,2481,288911,11.97,0.9,2.695483870967742,0.85,99.45
2020-12-25,Manipur,1445,9,1441,18228,4839,2772,7.93,0,3.1,291968,2490,290352,156.1,89.42,5.88,0.85,99.45
2020-12-26,Manipur,1304,14,1300,16142,491,293,8.08,0,3.1,293272,2504,291652,15.84,9.45,5.207096774193548,0.85,99.45
2020-12-27,Manipur,361,2,356,4854,2659,1847,7.44,3,3.1,293633,2506,292008,85.77,59.58,1.5658064516129033,0.85,99.45
2020-12-28,Manipur,1419,12,1416,17894,345,45,7.93,0,3.1,295052,2518,293424,11.13,1.45,5.772258064516129,0.85,99.45
2020-12-29,Manipur,453,2,446,5456,3791,3166,8.3,5,3.1,295505,2520,293870,122.29,102.13,1.76,0.85,99.45
2020-12-30,Manipur,317,3,308,3721,2824,2279,8.52,6,3.1,295822,2523,294178,91.1,73.52,1.2003225806451614,0.85,99.44
2020-12-31,Manipur,341,2,335,4575,4291,486,7.45,4,3.1,296163,2525,294513,138.42,15.68,1.4758064516129032,0.85,99.44
2021-01-01,Manipur,942,12,940,12276,449,366,7.67,0,3.1,297105,2537,295453,14.48,11.81,3.96,0.85,99.44
2021-01-02,Manipur,1546,5,1546,19043,1411,1345,8.12,0,3.1,298651,2542,296999,45.52,43.39,6.142903225806451,0.85,99.45
2021-01-03,Manipur,228,2,219,3148,4508,2143,7.24,7,3.1,298879,2544,297218,145.42,69.13,1.0154838709677418,0.85,99.44
2021-01-04,Manipur,414,1,410,5313,1867,628,7.79,3,3.1,299293,2545,297628,60.23,20.26,1.7138709677419355,0.85,99.44
2021-01-05,Manipur,496,5,496,6144,4738,3617,8.07,0,3.1,299789,2550,298124,152.84,116.68,1.9819354838709677,0.85,99.44
2021-01-06,Manipur,190,2,183,2537,2763,341,7.49,5,3.1,299979,2552,298307,89.13,11.0,0.8183870967741935,0.85,99.44
2021-01-07,Manipur,1575,18,1573,19614,4694,1337,8.03,0,3.1,301554,2570,299880,151.42,43.13,6.327096774193548,0.85,99.44
2021-01-08,Manipur,667,8,663,8531,1542,48,7.82,0,3.1,302221,2578,300543,49.74,1.55,2.7519354838709678,0.85,99.44
2021-01-09,Manipur,1478,22,1476,18451,1490,361,8.01,0,3.1,303699,2600,302019,48.06,11.65,5.951935483870968,0.86,99.45
2021-01-10,Manipur,1543,10,1536,19466,3377,911,7.93,0,3.1,305242,2610,303555,108.94,29.39,6.279354838709677,0.86,99.45
2021-01-11,Manipur,694,2,685,8872,2416,1850,7.82,7,3.1,305936,2612,304240,77.94,59.68,2.8619354838709676,0.85,99.45
2021-01-12,Manipur,1551,12,1547,19277,839,71,8.05,0,3.1,307487,2624,305787,27.06,2.29,6.218387096774194,0.85,99.45
2021-01-13,Manipur,1497,7,1490,18982,2923,668,7.89,0,3.1,308984,2631,307277,94.29,21.55,6.123225806451613,0.85,99.45
2021-01-14,Manipur,248,2,242,2860,4557,706,8.67,4,3.1,309232,2633,307519,147.0,22.77,0.9225806451612903,0.85,99.45
2021-01-15,Manipur,912,9,906,11492,3415,413,7.94,0,3.1,310144,2642,308425,110.16,13.32,3.7070967741935483,0.85,99.45
2021-01-16,Manipur,946,6,938,11895,1674,1499,7.95,2,3.1,311090,2648,309363,54.0,48.35,3.837096774193548,0.85,99.44
2021-01-17,Manipur,1303,11,1296,16541,3806,37,7.88,0,3.1,312393,2659,310659,122.77,1.19,5.335806451612903,0.85,99.44
2021-01-18,Manipur,1111,8,1105,13659,3594,2837,8.13,0,3.1,313504,2667,311764,115.94,91.52,4.406129032258065,0.85,99.44
2021-01-19,Manipur,1252,18,1250,15090,4101,1991,8.3,0,3.1,314756,2685,313014,132.29,64.23,4.867741935483871,0.85,99.45
2021-01-20,Manipur,271,2,262,3494,1649,1160,7.76,7,3.1,315027,2687,313276,53.19,37.42,1.1270967741935485,0.85,99.44
2021-01-21,Manipur,277,1,274,3076,3980,2620,9.01,2,3.1,315304,2688,313550,128.39,84.52,0.9922580645161291,0.85,99.44
2021-01-22,Manipur,623,7,619,8046,4535,292,7.74,0,3.1,315927,2695,314169,146.29,9.42,2.595483870967742,0.85,99.44
2021-01-23,Manipur,1009,4,1008,12410,3610,1530,8.13,0,3.1,316936,2699,315177,116.45,49.35,4.003225806451613,0.85,99.44
2021-01-24,Manipur,528,7,524,6683,1467,558,7.9,0,3.1,317464,2706,315701,47.32,18.0,2.155806451612903,0.85,99.44
2021-01-25,Manipur,1167,15,1166,14350,1757,1332,8.13,0,3.1,318631,2721,316867,56.68,42.97,4.629032258064516,0.85,99.45
2021-01-26,Manipur,1250,13,1241,15688,1970,1827,7.97,0,3.1,319881,2734,318108,63.55,58.94,5.0606451612903225,0.85,99.45
2021-01-27,Manipur,946,13,942,12028,1354,1030,7.86,0,3.1,320827,2747,319050,43.68,33.23,3.88,0.86,99.45
2021-01-28,Manipur,1145,7,1139,14732,4541,1010,7.77,0,3.1,321972,2754,320189,146.48,32.58,4.752258064516129,0.86,99.45
2021-01-29,Manipur,1507,14,1505,18721,1475,1313,8.05,0,3.1,323479,2768,321694,47.58,42.35,6.039032258064516,0.86,99.45
2021-01-30,Manipur,1036,9,1028,12353,2696,147,8.39,0,3.1,324515,2777,322722,86.97,4.74,3.9848387096774194,0.86,99.45
2021-01-31,Manipur,1436,20,1430,17878,2539,1493,8.03,0,3.1,325951,2797,324152,81.9,48.16,5.767096774193549,0.86,99.45
2021-02-01,Manipur,1280,13,1277,16199,423,418,7.9,0,3.1,327231,2810,325429,13.65,13.48,5.225483870967742,0.86,99.45
2021-02-02,Manipur,916,4,912,11404,2092,710,8.03,0,3.1,328147,2814,326341,67.48,22.9,3.678709677419355,0.86,99.45
2021-02-03,Manipur,1233,4,1233,15736,3097,269,7.84,0,3.1,329380,2818,327574,99.9,8.68,5.0761290322580646,0.86,99.45
2021-02-04,Manipur,223,3,217,2797,41,30,7.97,3,3.1,329603,2821,327791,1.32,0.97,0.902258064516129,0.86,99.45
2021-02-05,Manipur,177,0,169,2143,1976,1308,8.26,8,3.1,329780,2821,327960,63.74,42.19,0.6912903225806452,0.86,99.45
2021-02-06,Manipur,410,4,404,5010,1477,381,8.18,2,3.1,330190,2825,328364,47.65,12.29,1.6161290322580646,0.86,99.45
2021-02-07,Manipur,0,0,0,547,263,3,0.0,0,3.1,330190,2825,328364,8.48,0.1,0.1764516129032258,0.86,99.45
2021-02-08,Manipur,120,0,111,1827,3901,3128,6.57,9,3.1,330310,2825,328475,125.84,100.9,0.5893548387096774,0.86,99.44
2021-02-09,Manipur,879,5,870,11230,1164,461,7.83,4,3.1,331189,2830,329345,37.55,14.87,3.6225806451612903,0.85,99.44
2021-02-10,Manipur,1209,8,1208,15376,2583,2043,7.86,0,3.1,332398,2838,330553,83.32,65.9,4.96,0.85,99.44
2021-02-11,Manipur,1553,11,1544,19460,2517,46,7.98,0,3.1,333951,2849,332097,81.19,1.48,6.27741935483871,0.85,99.44
2021-02-12,Manipur,1352,19,1350,16808,4360,711,8.04,0,3.1,335303,2868,333447,140.65,22.94,5.421935483870968,0.86,99.45
2021-02-13,Manipur,1448,15,1442,18346,1135,231,7.89,0,3.1,336751,2883,334889,36.61,7.45,5.918064516129032,0.86,99.45
2021-02-14,Manipur,808,4,804,9991,4995,2080,8.09,0,3.1,337559,2887,335693,161.13,67.1,3.222903225806452,0.86,99.45
2021-02-15,Manipur,851,8,847,10701,547,520,7.95,0,3.1,338410,2895,336540,17.65,16.77,3.451935483870968,0.86,99.45
2021-02-16,Manipur,618,6,615,7830,3312,2598,7.89,0,3.1,339028,2901,337155,106.84,83.81,2.5258064516129033,0.86,99.45
2021-02-17,Manipur,79,0,78,1155,4887,2385,6.84,1,3.1,339107,2901,337233,157.65,76.94,0.3725806451612903,0.86,99.45
2021-02-18,Manipur,242,0,238,3078,4981,3092,7.86,4,3.1,339349,2901,337471,160.68,99.74,0.9929032258064516,0.85,99.45
2021-02-19,Manipur,68,0,63,692,4684,3798,9.83,5,3.1,339417,2901,337534,151.1,122.52,0.2232258064516129,0.85,99.45
2021-02-20,Manipur,73,0,65,1133,3564,2146,6.44,8,3.1,339490,2901,337599,114.97,69.23,0.36548387096774193,0.85,99.44
2021-02-21,Manipur,1389,11,1386,17369,1502,214,8.0,0,3.1,340879,2912,338985,48.45,6.9,5.602903225806451,0.85,99.44
2021-02-22,Manipur,966,14,961,11851,2741,884,8.15,0,3.1,341845,2926,339946,88.42,28.52,3.8229032258064515,0.86,99.44
2021-02-23,Manipur,1039,10,1039,13273,3628,3173,7.83,0,3.1,342884,2936,340985,117.03,102.35,4.281612903225806,0.86,99.45
2021-02-24,Manipur,1081,3,1079,13594,1939,931,7.95,0,3.1,343965,2939,342064,62.55,30.03,4.38516129032258,0.85,99.45
2021-02-25,Manipur,1284,11,1278,16066,862,313,7.99,0,3.1,345249,2950,343342,27.81,10.1,5.18258064516129,0.85,99.45
2021-02-26,Manipur,1097,15,1097,14121,4401,1047,7.77,0,3.1,346346,2965,344439,141.97,33.77,4.55516129032258,0.86,99.45
2021-02-27,Manipur,603,8,602,7740,3779,1347,7.79,0,3.1,346949,2973,345041,121.9,43.45,2.496774193548387,0.86,99.45
2021-02-28,Manipur,1024,11,1022,13281,4997,2926,7.71,0,3.1,347973,2984,346063,161.19,94.39,4.284193548387097,0.86,99.45
2021-03-01,Manipur,791,7,783,10073,2953,2051,7.85,1,3.1,348764,2991,346846,95.26,66.16,3.2493548387096776,0.86,99.45
2021-03-02,Manipur,694,2,693,9034,3185,1599,7.68,0,3.1,349458,2993,347539,102.74,51.58,2.9141935483870967,0.86,99.45
2021-03-03,Manipur,170,2,165,2177,4814,3689,7.81,3,3.1,349628,2995,347704,155.29,119.0,0.702258064516129,0.86,99.45
2021-03-04,Manipur,741,4,737,9334,902,625,7.94,0,3.1,350369,2999,348441,29.1,20.16,3.0109677419354837,0.86,99.45
2021-03-05,Manipur,1197,13,1191,14954,2375,2208,8.0,0,3.1,351566,3012,349632,76.61,71.23,4.823870967741936,0.86,99.45
2021-03-06,Manipur,466,4,459,5556,372,43,8.39,3,3.1,352032,3016,350091,12.0,1.39,1.792258064516129,0.86,99.45
2021-03-07,Manipur,380,2,380,4805,623,95,7.91,0,3.1,352412,3018,350471,20.1,3.06,1.55,0.86,99.45
2021-03-08,Manipur,1509,17,1506,19054,2280,62,7.92,0,3.1,353921,3035,351977,73.55,2.0,6.146451612903226,0.86,99.45
2021-03-09,Manipur,581,2,579,7266,4202,2780,8.0,0,3.1,354502,3037,352556,135.55,89.68,2.3438709677419354,0.86,99.45
2021-03-10,Manipur,1130,13,1121,14010,743,118,8.07,0,3.1,355632,3050,353677,23.97,3.81,4.519354838709678,0.86,99.45
2021-03-11,Manipur,513,2,511,6228,4954,286,8.24,0,3.1,356145,3052,354188,159.81,9.23,2.009032258064516,0.86,99.45
2021-03-12,Manipur,711,8,702,8732,3115,1618,8.14,1,3.1,356856,3060,354890,100.48,52.19,2.816774193548387,0.86,99.45
2021-03-13,Manipur,1264,8,1263,16087,2470,2287,7.86,0,3.1,358120,3068,356153,79.68,73.77,5.1893548387096775,0.86,99.45
2021-03-14,Manipur,795,7,787,9833,3288,195,8.09,1,3.1,358915,3075,356940,106.06,6.29,3.1719354838709677,0.86,99.45
2021-03-15,Manipur,1220,11,1212,14874,1412,132,8.2,0,3.1,360135,3086,358152,45.55,4.26,4.798064516129032,0.86,99.45
2021-03-16,Manipur,1263,4,1259,15391,2024,1600,8.21,0,3.1,361398,3090,359411,65.29,51.61,4.964838709677419,0.86,99.45
2021-03-17,Manipur,1317,10,1308,16366,4990,4752,8.05,0,3.1,362715,3100,360719,160.97,153.29,5.279354838709677,0.85,99.45
2021-03-18,Manipur,125,1,125,1514,4580,1545,8.26,0,3.1,362840,3101,360844,147.74,49.84,0.48838709677419356,0.85,99.45
2021-03-19,Manipur,1596,13,1596,19598,515,261,8.14,0,3.1,364436,3114,362440,16.61,8.42,6.321935483870968,0.85,99.45
2021-03-20,Manipur,377,3,372,4402,310,302,8.56,2,3.1,364813,3117,362812,10.0,9.74,1.42,0.85,99.45
2021-03-21,Manipur,1203,9,1199,15128,845,229,7.95,0,3.1,366016,3126,364011,27.26,7.39,4.88,0.85,99.45
2021-03-22,Manipur,378,5,372,4509,1409,875,8.38,1,3.1,366394,3131,364383,45.45,28.23,1.4545161290322581,0.85,99.45
2021-03-23,Manipur,263,2,256,3512,3212,1122,7.49,5,3.1,366657,3133,364639,103.61,36.19,1.1329032258064515,0.85,99.45
2021-03-24,Manipur,442,4,441,5485,2959,2790,8.06,0,3.1,367099,3137,365080,95.45,90.0,1.7693548387096774,0.85,99.45
2021-03-25,Manipur,904,11,901,11502,897,453,7.86,0,3.1,368003,3148,365981,28.94,14.61,3.7103225806451614,0.86,99.45
2021-03-26,Manipur,423,1,419,5505,4951,4437,7.68,3,3.1,368426,3149,366400,159.71,143.13,1.7758064516129033,0.85,99.45
2021-03-27,Manipur,205,2,202,2305,773,574,8.89,1,3.1,368631,3151,366602,24.94,18.52,0.7435483870967742,0.85,99.45
2021-03-28,Manipur,316,1,308,3897,990,90,8.11,7,3.1,368947,3152,366910,31.94,2.9,1.2570967741935484,0.85,99.45
2021-03-29,Manipur,1326,8,1324,16661,1422,1278,7.96,0,3.1,370273,3160,368234,45.87,41.23,5.3745161290322585,0.85,99.45
2021-03-30,Manipur,1524,14,1518,19028,2495,1753,8.01,0,3.1,371797,3174,369752,80.48,56.55,6.138064516129032,0.85,99.45
2021-03-31,Manipur,174,0,166,2066,4324,3115,8.42,8,3.1,371971,3174,369918,139.48,100.48,0.6664516129032259,0.85,99.45
2021-04-01,Manipur,1078,12,1073,13373,4895,3115,8.06,0,3.1,373049,3186,370991,157.9,100.48,4.313870967741935,0.85,99.45
2021-04-02,Manipur,1017,12,1015,13412,3573,668,7.58,0,3.1,374066,3198,372006,115.26,21.55,4.3264516129032256,0.85,99.45
2021-04-03,Manipur,186,1,184,2247,1136,586,8.28,1,3.1,374252,3199,372190,36.65,18.9,0.7248387096774194,0.85,99.45
2021-04-04,Manipur,1364,11,1357,17013,4674,2026,8.02,0,3.1,375616,3210,373547,150.77,65.35,5.4880645161290325,0.85,99.45
2021-04-05,Manipur,1232,15,1231,15499,4902,1441,7.95,0,3.1,376848,3225,374778,158.13,46.48,4.999677419354839,0.86,99.45
2021-04-06,Manipur,449,1,448,5769,584,409,7.78,0,3.1,377297,3226,375226,18.84,13.19,1.860967741935484,0.86,99.45
2021-04-07,Manipur,903,9,902,10925,4893,1729,8.27,0,3.1,378200,3235,376128,157.84,55.77,3.524193548387097,0.86,99.45
2021-04-08,Manipur,657,5,651,8392,4399,257,7.83,1,3.1,378857,3240,376779,141.9,8.29,2.7070967741935483,0.86,99.45
2021-04-09,Manipur,1215,17,1209,15181,4172,2892,8.0,0,3.1,380072,3257,377988,134.58,93.29,4.897096774193549,0.86,99.45
2021-04-10,Manipur,82,0,73,1169,4820,1108,7.01,9,3.1,380154,3257,378061,155.48,35.74,0.37709677419354837,0.86,99.45
2021-04-11,Manipur,997,14,990,12332,1843,291,8.08,0,3.1,381151,3271,379051,59.45,9.39,3.9780645161290322,0.86,99.45
2021-04-12,Manipur,50,0,46,1001,4649,1081,5.0,4,3.1,381201,3271,379097,149.97,34.87,0.3229032258064516,0.86,99.45
2021-04-13,Manipur,998,2,991,12398,2204,1809,8.05,5,3.1,382199,3273,380088,71.1,58.35,3.9993548387096776,0.86,99.45
2021-04-14,Manipur,1357,4,1349,16609,4987,2758,8.17,4,3.1,383556,3277,381437,160.87,88.97,5.357741935483871,0.85,99.45
2021-04-15,Manipur,1019,9,1013,12072,3142,2404,8.44,0,3.1,384575,3286,382450,101.35,77.55,3.8941935483870966,0.85,99.45
2021-04-16,Manipur,616,3,615,7419,1317,978,8.3,0,3.1,385191,3289,383065,42.48,31.55,2.3932258064516128,0.85,99.45
2021-04-17,Manipur,213,0,210,2931,1972,1671,7.27,3,3.1,385404,3289,383275,63.61,53.9,0.9454838709677419,0.85,99.45
2021-04-18,Manipur,647,7,639,8119,2635,280,7.97,1,3.1,386051,3296,383914,85.0,9.03,2.6190322580645162,0.85,99.45
2021-04-19,Manipur,644,7,641,8187,4879,1438,7.87,0,3.1,386695,3303,384555,157.39,46.39,2.640967741935484,0.85,99.45
2021-04-20,Manipur,1464,16,1460,18086,4421,2452,8.09,0,3.1,388159,3319,386015,142.61,79.1,5.834193548387097,0.86,99.45
2021-04-21,Manipur,1599,15,1595,19631,4421,152,8.15,0,3.1,389758,3334,387610,142.61,4.9,6.332580645161291,0.86,99.45
2021-04-22,Manipur,419,4,414,5107,4564,1496,8.2,1,3.1,390177,3338,388024,147.23,48.26,1.6474193548387097,0.86,99.45
2021-04-23,Manipur,953,5,952,12019,3384,1341,7.93,0,3.1,391130,3343,388976,109.16,43.26,3.8770967741935483,0.85,99.45
2021-04-24,Manipur,363,1,362,4650,4857,422,7.81,0,3.1,391493,3344,389338,156.68,13.61,1.5,0.85,99.45
2021-04-25,Manipur,202,2,202,2873,4403,3947,7.03,0,3.1,391695,3346,389540,142.03,127.32,0.9267741935483871,0.85,99.45
2021-04-26,Manipur,573,7,565,7198,1734,1677,7.96,1,3.1,392268,3353,390105,55.94,54.1,2.3219354838709676,0.85,99.45
2021-04-27,Manipur,1413,4,1404,17436,2033,1753,8.1,5,3.1,393681,3357,391509,65.58,56.55,5.6245161290322585,0.85,99.45
2021-04-28,Manipur,964,7,958,12395,2224,477,7.78,0,3.1,394645,3364,392467,71.74,15.39,3.9983870967741937,0.85,99.45
2021-04-29,Manipur,1433,6,1433,17640,4002,3571,8.12,0,3.1,396078,3370,393900,129.1,115.19,5.690322580645161,0.85,99.45
2021-04-30,Manipur,842,6,835,10308,2388,1788,8.17,1,3.1,396920,3376,394735,77.03,57.68,3.3251612903225807,0.85,99.45
2021-05-01,Manipur,1015,7,1015,12778,845,194,7.94,0,3.1,397935,3383,395750,27.26,6.26,4.121935483870968,0.85,99.45
2021-05-02,Manipur,432,4,431,5151,2473,2279,8.39,0,3.1,398367,3387,396181,79.77,73.52,1.6616129032258065,0.85,99.45
2021-05-03,Manipur,863,8,860,11184,1909,1165,7.72,0,3.1,399230,3395,397041,61.58,37.58,3.607741935483871,0.85,99.45
2021-05-04,Manipur,1016,14,1012,12957,1197,894,7.84,0,3.1,400246,3409,398053,38.61,28.84,4.179677419354839,0.85,99.45
2021-05-05,Manipur,1576,5,1572,19647,2360,992,8.02,0,3.1,401822,3414,399625,76.13,32.0,6.337741935483871,0.85,99.45
2021-05-06,Manipur,614,6,614,7689,3344,1047,7.99,0,3.1,402436,3420,400239,107.87,33.77,2.4803225806451614,0.85,99.45
2021-05-07,Manipur,1101,13,1096,13899,1205,433,7.92,0,3.1,403537,3433,401335,38.87,13.97,4.483548387096774,0.85,99.45
2021-05-08,Manipur,965,5,960,12046,2164,847,8.01,0,3.1,404502,3438,402295,69.81,27.32,3.885806451612903,0.85,99.45
2021-05-09,Manipur,689,9,683,8617,2822,1802,8.0,0,3.1,405191,3447,402978,91.03,58.13,2.779677419354839,0.85,99.45
2021-05-10,Manipur,1346,9,1340,16857,458,67,7.98,0,3.1,406537,3456,404318,14.77,2.16,5.437741935483871,0.85,99.45
2021-05-11,Manipur,889,4,883,10916,3089,214,8.14,2,3.1,407426,3460,405201,99.65,6.9,3.5212903225806453,0.85,99.45
2021-05-12,Manipur,736,7,733,9109,3327,582,8.08,0,3.1,408162,3467,405934,107.32,18.77,2.9383870967741936,0.85,99.45
2021-05-13,Manipur,946,5,942,12089,4664,2420,7.83,0,3.1,409108,3472,406876,150.45,78.06,3.899677419354839,0.85,99.45
2021-05-14,Manipur,1471,10,1468,18732,3803,3272,7.85,0,3.1,410579,3482,408344,122.68,105.55,6.042580645161291,0.85,99.46
2021-05-15,Manipur,1421,10,1420,18574,4618,2427,7.65,0,3.1,412000,3492,409764,148.97,78.29,5.991612903225806,0.85,99.46
2021-05-16,Manipur,1554,13,1553,19701,728,121,7.89,0,3.1,413554,3505,411317,23.48,3.9,6.355161290322581,0.85,99.46
2021-05-17,Manipur,47,0,39,627,2428,704,7.5,8,3.1,413601,3505,411356,78.32,22.71,0.20225806451612904,0.85,99.46
2021-05-18,Manipur,123,1,122,1274,2125,2028,9.65,0,3.1,413724,3506,411478,68.55,65.42,0.41096774193548385,0.85,99.46
2021-05-19,Manipur,1103,4,1096,13922,476,329,7.92,3,3.1,414827,3510,412574,15.35,10.61,4.490967741935484,0.85,99.46
2021-05-20,Manipur,1384,17,1380,17043,4455,3519,8.12,0,3.1,416211,3527,413954,143.71,113.52,5.497741935483871,0.85,99.46
2021-05-21,Manipur,412,5,410,4833,1263,184,8.52,0,3.1,416623,3532,414364,40.74,5.94,1.5590322580645162,0.85,99.46
2021-05-22,Manipur,384,4,378,4999,3176,1338,7.68,2,3.1,417007,3536,414742,102.45,43.16,1.6125806451612903,0.85,99.46
2021-05-23,Manipur,1270,7,1267,15689,2277,1265,8.09,0,3.1,418277,3543,416009,73.45,40.81,5.0609677419354835,0.85,99.46
2021-05-24,Manipur,530,3,526,6566,3072,2771,8.07,1,3.1,418807,3546,416535,99.1,89.39,2.1180645161290323,0.85,99.46
2021-05-25,Manipur,435,3,431,5287,1882,1263,8.23,1,3.1,419242,3549,416966,60.71,40.74,1.705483870967742,0.85,99.46
2021-05-26,Manipur,1085,9,1078,13437,2625,1600,8.07,0,3.1,420327,3558,418044,84.68,51.61,4.3345161290322585,0.85,99.46
2021-05-27,Manipur,48,0,46,917,1259,495,5.23,2,3.1,420375,3558,418090,40.61,15.97,0.2958064516129032,0.85,99.46
2021-05-28,Manipur,1260,9,1255,15993,4011,967,7.88,0,3.1,421635,3567,419345,129.39,31.19,5.159032258064516,0.85,99.46
2021-05-29,Manipur,137,1,134,1887,4877,3816,7.26,2,3.1,421772,3568,419479,157.32,123.1,0.6087096774193549,0.85,99.46
2021-05-30,Manipur,1118,8,1109,13793,2199,668,8.11,1,3.1,422890,3576,420588,70.94,21.55,4.449354838709677,0.85,99.46
2021-05-31,Manipur,448,4,446,5509,4668,4160,8.13,0,3.1,423338,3580,421034,150.58,134.19,1.7770967741935484,0.85,99.46
2021-06-01,Manipur,1328,5,1319,16455,2797,12,8.07,4,3.1,424666,3585,422353,90.23,0.39,5.308064516129032,0.84,99.46
2021-06-02,Manipur,1491,18,1484,18705,3007,2327,7.97,0,3.1,426157,3603,423837,97.0,75.06,6.033870967741936,0.85,99.46
2021-06-03,Manipur,1372,17,1366,17302,2142,748,7.93,0,3.1,427529,3620,425203,69.1,24.13,5.581290322580645,0.85,99.46
2021-06-04,Manipur,1529,20,1527,19127,3175,15,7.99,0,3.1,429058,3640,426730,102.42,0.48,6.17,0.85,99.46
2021-06-05,Manipur,1077,6,1071,13432,2424,1049,8.02,0,3.1,430135,3646,427801,78.19,33.84,4.332903225806452,0.85,99.46
2021-06-06,Manipur,604,5,595,7531,2737,210,8.02,4,3.1,430739,3651,428396,88.29,6.77,2.4293548387096773,0.85,99.46
2021-06-07,Manipur,653,8,648,8163,1683,309,8.0,0,3.1,431392,3659,429044,54.29,9.97,2.633225806451613,0.85,99.46
2021-06-08,Manipur,1380,9,1374,17484,3109,2830,7.89,0,3.1,432772,3668,430418,100.29,91.29,5.64,0.85,99.46
2021-06-09,Manipur,314,1,305,4112,172,144,7.64,8,3.1,433086,3669,430723,5.55,4.65,1.3264516129032258,0.85,99.45
2021-06-10,Manipur,1388,16,1379,17141,2392,861,8.1,0,3.1,434474,3685,432102,77.16,27.77,5.529354838709677,0.85,99.45
2021-06-11,Manipur,189,2,180,2358,1435,952,8.02,7,3.1,434663,3687,432282,46.29,30.71,0.7606451612903226,0.85,99.45
2021-06-12,Manipur,1018,8,1014,12829,1218,6,7.94,0,3.1,435681,3695,433296,39.29,0.19,4.138387096774194,0.85,99.45
2021-06-13,Manipur,271,3,269,3707,176,147,7.31,0,3.1,435952,3698,433565,5.68,4.74,1.1958064516129032,0.85,99.45
2021-06-14,Manipur,739,2,738,9529,2231,686,7.76,0,3.1,436691,3700,434303,71.97,22.13,3.0738709677419354,0.85,99.45
2021-06-15,Manipur,1208,4,1204,15106,3010,1403,8.0,0,3.1,437899,3704,435507,97.1,45.26,4.872903225806452,0.85,99.45
2021-06-16,Manipur,1179,5,1178,14879,4038,752,7.92,0,3.1,439078,3709,436685,130.26,24.26,4.799677419354839,0.84,99.45
2021-06-17,Manipur,1043,7,1040,13098,3936,849,7.96,0,3.1,440121,3716,437725,126.97,27.39,4.225161290322581,0.84,99.46
2021-06-18,Manipur,1310,17,1309,16469,177,168,7.95,0,3.1,441431,3733,439034,5.71,5.42,5.31258064516129,0.85,99.46
2021-06-19,Manipur,79,0,78,1389,1370,456,5.69,1,3.1,441510,3733,439112,44.19,14.71,0.44806451612903225,0.85,99.46
2021-06-20,Manipur,485,3,480,6292,4677,970,7.71,2,3.1,441995,3736,439592,150.87,31.29,2.029677419354839,0.85,99.46
2021-06-21,Manipur,285,1,285,3259,4886,183,8.75,0,3.1,442280,3737,439877,157.61,5.9,1.0512903225806451,0.84,99.46
2021-06-22,Manipur,1009,4,1009,12321,676,631,8.19,0,3.1,443289,3741,440886,21.81,20.35,3.974516129032258,0.84,99.46
2021-06-23,Manipur,1556,21,1555,19534,3698,2996,7.97,0,3.1,444845,3762,442441,119.29,96.65,6.301290322580646,0.85,99.46
2021-06-24,Manipur,105,0,96,1227,4179,3192,8.56,9,3.1,444950,3762,442537,134.81,102.97,0.39580645161290323,0.85,99.46
2021-06-25,Manipur,942,13,937,11810,311,273,7.98,0,3.1,445892,3775,443474,10.03,8.81,3.8096774193548386,0.85,99.46
2021-06-26,Manipur,1543,12,1535,19103,4367,72,8.08,0,3.1,447435,3787,445009,140.87,2.32,6.162258064516129,0.85,99.46
2021-06-27,Manipur,51,0,43,585,1939,743,8.72,8,3.1,447486,3787,445052,62.55,23.97,0.18870967741935485,0.85,99.46
2021-06-28,Manipur,129,0,120,1471,1796,1510,8.77,9,3.1,447615,3787,445172,57.94,48.71,0.47451612903225804,0.85,99.45
2021-06-29,Manipur,1363,5,1360,17399,2830,305,7.83,0,3.1,448978,3792,446532,91.29,9.84,5.61258064516129,0.84,99.46
2021-06-30,Manipur,887,6,880,11116,344,21,7.98,1,3.1,449865,3798,447412,11.1,0.68,3.5858064516129033,0.84,99.45
2021-07-01,Manipur,1055,11,1048,13107,2280,1036,8.05,0,3.1,450920,3809,448460,73.55,33.42,4.228064516129033,0.84,99.45
2021-07-02,Manipur,82,1,80,1053,3176,743,7.79,1,3.1,451002,3810,448540,102.45,23.97,0.3396774193548387,0.84,99.45
2021-07-03,Manipur,764,9,758,9170,1216,848,8.33,0,3.1,451766,3819,449298,39.23,27.35,2.958064516129032,0.85,99.45
2021-07-04,Manipur,1018,4,1013,12747,634,555,7.99,1,3.1,452784,3823,450311,20.45,17.9,4.111935483870968,0.84,99.45
2021-07-05,Manipur,1140,9,1139,14437,4036,3710,7.9,0,3.1,453924,3832,451450,130.19,119.68,4.6570967741935485,0.84,99.45
2021-07-06,Manipur,122,1,117,1414,4179,3612,8.63,4,3.1,454046,3833,451567,134.81,116.52,0.4561290322580645,0.84,99.45
2021-07-07,Manipur,956,3,951,11824,636,245,8.09,2,3.1,455002,3836,452518,20.52,7.9,3.8141935483870966,0.84,99.45
2021-07-08,Manipur,218,1,215,2746,4036,3410,7.94,2,3.1,455220,3837,452733,130.19,110.0,0.8858064516129033,0.84,99.45
2021-07-09,Manipur,1507,10,1502,19364,4565,3221,7.78,0,3.1,456727,3847,454235,147.26,103.9,6.2464516129032255,0.84,99.45
2021-07-10,Manipur,1203,8,1202,15178,1233,587,7.93,0,3.1,457930,3855,455437,39.77,18.94,4.896129032258065,0.84,99.46
2021-07-11,Manipur,1207,11,1200,15232,3828,156,7.92,0,3.1,459137,3866,456637,123.48,5.03,4.913548387096774,0.84,99.46
2021-07-12,Manipur,441,2,437,5745,3176,1604,7.68,2,3.1,459578,3868,457074,102.45,51.74,1.853225806451613,0.84,99.46
2021-07-13,Manipur,872,4,871,11327,2178,141,7.7,0,3.1,460450,3872,457945,70.26,4.55,3.6538709677419354,0.84,99.46
2021-07-14,Manipur,1183,7,1183,14608,4289,476,8.1,0,3.1,461633,3879,459128,138.35,15.35,4.712258064516129,0.84,99.46
2021-07-15,Manipur,177,2,175,1803,4571,3041,9.82,0,3.1,461810,3881,459303,147.45,98.1,0.5816129032258065,0.84,99.46
2021-07-16,Manipur,278,1,274,3293,4461,2345,8.44,3,3.1,462088,3882,459577,143.9,75.65,1.062258064516129,0.84,99.46
2021-07-17,Manipur,907,9,904,11371,4313,2189,7.98,0,3.1,462995,3891,460481,139.13,70.61,3.668064516129032,0.84,99.46
2021-07-18,Manipur,1446,15,1440,17630,173,158,8.2,0,3.1,464441,3906,461921,5.58,5.1,5.687096774193549,0.84,99.46
2021-07-19,Manipur,1197,9,1197,15217,3865,1967,7.87,0,3.1,465638,3915,463118,124.68,63.45,4.908709677419355,0.84,99.46
2021-07-20,Manipur,1175,16,1170,14841,1541,1394,7.92,0,3.1,466813,3931,464288,49.71,44.97,4.787419354838709,0.84,99.46
2021-07-21,Manipur,938,13,935,11577,4987,3699,8.1,0,3.1,467751,3944,465223,160.87,119.32,3.734516129032258,0.84,99.46
2021-07-22,Manipur,161,1,153,1898,4418,1170,8.48,7,3.1,467912,3945,465376,142.52,37.74,0.6122580645161291,0.84,99.46
2021-07-23,Manipur,1066,12,1060,13514,872,348,7.89,0,3.1,468978,3957,466436,28.13,11.23,4.359354838709677,0.84,99.46
2021-07-24,Manipur,1371,12,1367,17140,2230,1888,8.0,0,3.1,470349,3969,467803,71.94,60.9,5.529032258064516,0.84,99.46
2021-07-25,Manipur,938,3,931,11902,3902,2914,7.88,4,3.1,471287,3972,468734,125.87,94.0,3.8393548387096774,0.84,99.46
2021-07-26,Manipur,1149,10,1142,14123,673,172,8.14,0,3.1,472436,3982,469876,21.71,5.55,4.555806451612903,0.84,99.46
2021-07-27,Manipur,7,0,6,536,669,198,1.31,1,3.1,472443,3982,469882,21.58,6.39,0.17290322580645162,0.84,99.46
2021-07-28,Manipur,502,2,501,6487,3858,3540,7.74,0,3.1,472945,3984,470383,124.45,114.19,2.0925806451612905,0.84,99.46
2021-07-29,Manipur,368,5,364,4927,4276,2441,7.47,0,3.1,473313,3989,470747,137.94,78.74,1.5893548387096774,0.84,99.46
2021-07-30,Manipur,458,5,452,5568,2720,2538,8.23,1,3.1,473771,3994,471199,87.74,81.87,1.7961290322580645,0.84,99.46
2021-07-31,Manipur,1267,4,1262,15712,4520,2041,8.06,1,3.1,475038,3998,472461,145.81,65.84,5.0683870967741935,0.84,99.46
2021-08-01,Manipur,189,2,187,2974,3141,2747,6.36,0,3.1,475227,4000,472648,101.32,88.61,0.9593548387096774,0.84,99.46
2021-08-02,Manipur,587,4,583,7270,2138,95,8.07,0,3.1,475814,4004,473231,68.97,3.06,2.3451612903225807,0.84,99.46
2021-08-03,Manipur,1555,18,1554,19825,4827,945,7.84,0,3.1,477369,4022,474785,155.71,30.48,6.395161290322581,0.84,99.46
2021-08-04,Manipur,791,3,787,10496,1011,911,7.54,1,3.1,478160,4025,475572,32.61,29.39,3.385806451612903,0.84,99.46
2021-08-05,Manipur,69,0,62,1116,4963,1395,6.18,7,3.1,478229,4025,475634,160.1,45.0,0.36,0.84,99.46
2021-08-06,Manipur,1542,14,1540,19685,3405,3143,7.83,0,3.1,479771,4039,477174,109.84,101.39,6.35,0.84,99.46
2021-08-07,Manipur,1094,10,1093,13505,3196,1798,8.1,0,3.1,480865,4049,478267,103.1,58.0,4.356451612903226,0.84,99.46
2021-08-08,Manipur,1370,16,1362,17317,1891,1519,7.91,0,3.1,482235,4065,479629,61.0,49.0,5.586129032258064,0.84,99.46
2021-08-09,Manipur,1014,12,1007,12269,3543,3082,8.26,0,3.1,483249,4077,480636,114.29,99.42,3.9577419354838708,0.84,99.46
2021-08-10,Manipur,1224,13,1216,15146,1712,612,8.08,0,3.1,484473,4090,481852,55.23,19.74,4.885806451612903,0.84,99.46
2021-08-11,Manipur,746,7,743,8871,4230,1772,8.41,0,3.1,485219,4097,482595,136.45,57.16,2.8616129032258066,0.84,99.46
2021-08-12,Manipur,800,11,791,10009,2464,1029,7.99,0,3.1,486019,4108,483386,79.48,33.19,3.2287096774193547,0.85,99.46
2021-08-13,Manipur,1087,7,1084,13721,4103,283,7.92,0,3.1,487106,4115,484470,132.35,9.13,4.426129032258064,0.84,99.46
2021-08-14,Manipur,817,6,816,9656,1854,417,8.46,0,3.1,487923,4121,485286,59.81,13.45,3.1148387096774193,0.84,99.46
2021-08-15,Manipur,81,1,81,1301,2253,413,6.23,0,3.1,488004,4122,485367,72.68,13.32,0.4196774193548387,0.84,99.46
2021-08-16,Manipur,157,2,157,2440,2782,34,6.43,0,3.1,488161,4124,485524,89.74,1.1,0.7870967741935484,0.84,99.46
2021-08-17,Manipur,1207,13,1205,14878,3841,139,8.11,0,3.1,489368,4137,486729,123.9,4.48,4.799354838709678,0.85,99.46
2021-08-18,Manipur,668,9,665,8464,4289,914,7.89,0,3.1,490036,4146,487394,138.35,29.48,2.7303225806451614,0.85,99.46
2021-08-19,Manipur,326,3,324,4290,3663,1753,7.6,0,3.1,490362,4149,487718,118.16,56.55,1.3838709677419354,0.85,99.46
2021-08-20,Manipur,1436,7,1435,17776,2515,1384,8.08,0,3.1,491798,4156,489153,81.13,44.65,5.734193548387097,0.85,99.46
2021-08-21,Manipur,258,1,253,3464,4512,4473,7.45,4,3.1,492056,4157,489406,145.55,144.29,1.1174193548387097,0.84,99.46
2021-08-22,Manipur,773,6,768,9586,2687,1574,8.06,0,3.1,492829,4163,490174,86.68,50.77,3.092258064516129,0.84,99.46
2021-08-23,Manipur,622,8,615,7331,4127,2550,8.48,0,3.1,493451,4171,490789,133.13,82.26,2.3648387096774193,0.85,99.46
2021-08-24,Manipur,58,0,49,1158,2546,84,5.01,9,3.1,493509,4171,490838,82.13,2.71,0.3735483870967742,0.85,99.46
2021-08-25,Manipur,919,12,912,11473,3261,2771,8.01,0,3.1,494428,4183,491750,105.19,89.39,3.700967741935484,0.85,99.46
2021-08-26,Manipur,339,1,330,4451,4011,2999,7.62,8,3.1,494767,4184,492080,129.39,96.74,1.4358064516129032,0.85,99.46
2021-08-27,Manipur,967,11,961,11824,4268,2188,8.18,0,3.1,495734,4195,493041,137.68,70.58,3.8141935483870966,0.85,99.46
2021-08-28,Manipur,1467,4,1460,18015,2580,291,8.14,3,3.1,497201,4199,494501,83.23,9.39,5.811290322580645,0.84,99.46
2021-08-29,Manipur,1341,19,1333,16774,2088,1106,7.99,0,3.1,498542,4218,495834,67.35,35.68,5.410967741935484,0.85,99.46
2021-08-30,Manipur,755,8,751,9519,3926,1846,7.93,0,3.1,499297,4226,496585,126.65,59.55,3.0706451612903227,0.85,99.46
2021-08-31,Manipur,358,3,358,4555,577,528,7.86,0,3.1,499655,4229,496943,18.61,17.03,1.4693548387096773,0.85,99.46
2021-09-01,Manipur,105,0,100,1501,1219,899,7.0,5,3.1,499760,4229,497043,39.32,29.0,0.4841935483870968,0.85,99.46
2021-09-02,Manipur,578,7,577,7263,2593,2233,7.96,0,3.1,500338,4236,497620,83.65,72.03,2.3429032258064515,0.85,99.46
2021-09-03,Manipur,1564,23,1558,19277,1065,499,8.11,0,3.1,501902,4259,499178,34.35,16.1,6.218387096774194,0.85,99.46
2021-09-04,Manipur,1424,18,1415,17854,2021,1273,7.98,0,3.1,503326,4277,500593,65.19,41.06,5.759354838709678,0.85,99.46
2021-09-05,Manipur,1037,5,1036,13154,362,183,7.88,0,3.1,504363,4282,501629,11.68,5.9,4.243225806451613,0.85,99.46
2021-09-06,Manipur,65,0,59,795,4440,1487,8.18,6,3.1,504428,4282,501688,143.23,47.97,0.2564516129032258,0.85,99.46
2021-09-07,Manipur,298,1,289,4029,1763,1330,7.4,8,3.1,504726,4283,501977,56.87,42.9,1.2996774193548386,0.85,99.46
2021-09-08,Manipur,1053,3,1052,13531,2703,2211,7.78,0,3.1,505779,4286,503029,87.19,71.32,4.36483870967742,0.85,99.46
2021-09-09,Manipur,700,6,693,8349,523,432,8.38,1,3.1,506479,4292,503722,16.87,13.94,2.693225806451613,0.85,99.46
2021-09-10,Manipur,603,8,602,7453,197,168,8.09,0,3.1,507082,4300,504324,6.35,5.42,2.404193548387097,0.85,99.46
2021-09-11,Manipur,764,4,760,9175,1098,457,8.33,0,3.1,507846,4304,505084,35.42,14.74,2.9596774193548385,0.85,99.46
2021-09-12,Manipur,875,12,870,11081,3885,405,7.9,0,3.1,508721,4316,505954,125.32,13.06,3.5745161290322582,0.85,99.46
2021-09-13,Manipur,616,7,610,7880,3877,2502,7.82,0,3.1,509337,4323,506564,125.06,80.71,2.541935483870968,0.85,99.46
2021-09-14,Manipur,1594,15,1588,19886,4814,4477,8.02,0,3.1,510931,4338,508152,155.29,144.42,6.4148387096774195,0.85,99.46
2021-09-15,Manipur,1298,9,1291,16383,193,12,7.92,0,3.1,512229,4347,509443,6.23,0.39,5.28483870967742,0.85,99.46
2021-09-16,Manipur,619,5,614,7603,779,614,8.14,0,3.1,512848,4352,510057,25.13,19.81,2.4525806451612904,0.85,99.46
2021-09-17,Manipur,969,8,967,12511,3278,2200,7.75,0,3.1,513817,4360,511024,105.74,70.97,4.0358064516129035,0.85,99.46
2021-09-18,Manipur,1626,17,1618,19898,382,131,8.17,0,3.1,515443,4377,512642,12.32,4.23,6.418709677419355,0.85,99.46
2021-09-19,Manipur,142,0,135,1940,2443,2019,7.32,7,3.1,515585,4377,512777,78.81,65.13,0.6258064516129033,0.85,99.46
2021-09-20,Manipur,806,10,798,9823,3601,1871,8.21,0,3.1,516391,4387,513575,116.16,60.35,3.168709677419355,0.85,99.45
2021-09-21,Manipur,772,11,764,10038,3103,2129,7.69,0,3.1,517163,4398,514339,100.1,68.68,3.2380645161290325,0.85,99.45
2021-09-22,Manipur,139,1,137,1673,3141,107,8.31,1,3.1,517302,4399,514476,101.32,3.45,0.5396774193548387,0.85,99.45
2021-09-23,Manipur,291,2,282,3540,2415,2386,8.22,7,3.1,517593,4401,514758,77.9,76.97,1.1419354838709677,0.85,99.45
2021-09-24,Manipur,791,6,785,10137,3230,1913,7.8,0,3.1,518384,4407,515543,104.19,61.71,3.27,0.85,99.45
2021-09-25,Manipur,904,9,903,11494,1140,956,7.86,0,3.1,519288,4416,516446,36.77,30.84,3.7077419354838708,0.85,99.45
2021-09-26,Manipur,1114,9,1113,14378,200,200,7.75,0,3.1,520402,4425,517559,6.45,6.45,4.638064516129032,0.85,99.45
2021-09-27,Manipur,716,9,716,9433,2234,1215,7.59,0,3.1,521118,4434,518275,72.06,39.19,3.0429032258064517,0.85,99.45
2021-09-28,Manipur,1514,8,1506,19427,4123,3914,7.79,0,3.1,522632,4442,519781,133.0,126.26,6.266774193548387,0.85,99.45
2021-09-29,Manipur,1034,8,1026,12770,332,140,8.1,0,3.1,523666,4450,520807,10.71,4.52,4.119354838709677,0.85,99.45
2021-09-30,Manipur,269,1,267,3019,4533,972,8.91,1,3.1,523935,4451,521074,146.23,31.35,0.9738709677419355,0.85,99.45
2021-10-01,Manipur,149,0,146,1785,2933,1648,8.35,3,3.1,524084,4451,521220,94.61,53.16,0.5758064516129032,0.85,99.45
2021-10-02,Manipur,1542,18,1540,19155,3017,2849,8.05,0,3.1,525626,4469,522760,97.32,91.9,6.179032258064516,0.85,99.45
2021-10-03,Manipur,743,7,740,9032,3759,3215,8.23,0,3.1,526369,4476,523500,121.26,103.71,2.913548387096774,0.85,99.45
2021-10-04,Manipur,141,1,134,1605,3933,3005,8.79,6,3.1,526510,4477,523634,126.87,96.94,0.5177419354838709,0.85,99.45
2021-10-05,Manipur,1533,21,1526,19221,2630,1600,7.98,0,3.1,528043,4498,525160,84.84,51.61,6.200322580645161,0.85,99.45
2021-10-06,Manipur,381,1,374,4808,1357,906,7.92,6,3.1,528424,4499,525534,43.77,29.23,1.550967741935484,0.85,99.45
2021-10-07,Manipur,1501,20,1495,18556,4189,271,8.09,0,3.1,529925,4519,527029,135.13,8.74,5.985806451612903,0.85,99.45
2021-10-08,Manipur,86,0,77,1288,1671,1249,6.68,9,3.1,530011,4519,527106,53.9,40.29,0.4154838709677419,0.85,99.45
2021-10-09,Manipur,241,2,232,3151,1594,114,7.65,7,3.1,530252,4521,527338,51.42,3.68,1.0164516129032257,0.85,99.45
2021-10-10,Manipur,700,3,693,8619,3189,1652,8.12,4,3.1,530952,4524,528031,102.87,53.29,2.7803225806451612,0.85,99.45
2021-10-11,Manipur,682,6,673,8577,1107,416,7.95,3,3.1,531634,4530,528704,35.71,13.42,2.766774193548387,0.85,99.45
2021-10-12,Manipur,839,11,832,10503,1924,727,7.99,0,3.1,532473,4541,529536,62.06,23.45,3.3880645161290324,0.85,99.45
2021-10-13,Manipur,1497,19,1488,18748,607,179,7.98,0,3.1,533970,4560,531024,19.58,5.77,6.047741935483871,0.85,99.45
2021-10-14,Manipur,1381,9,1381,17858,2936,1054,7.73,0,3.1,535351,4569,532405,94.71,34.0,5.760645161290323,0.85,99.45
2021-10-15,Manipur,1613,15,1611,19989,4849,4791,8.07,0,3.1,536964,4584,534016,156.42,154.55,6.448064516129032,0.85,99.45
2021-10-16,Manipur,346,5,345,4084,4664,1069,8.47,0,3.1,537310,4589,534361,150.45,34.48,1.3174193548387096,0.85,99.45
2021-10-17,Manipur,431,3,424,5081,2488,2107,8.48,4,3.1,537741,4592,534785,80.26,67.97,1.639032258064516,0.85,99.45
2021-10-18,Manipur,1073,9,1068,13063,2135,2074,8.21,0,3.1,538814,4601,535853,68.87,66.9,4.2138709677419355,0.85,99.45
2021-10-19,Manipur,643,9,634,8127,4644,3805,7.91,0,3.1,539457,4610,536487,149.81,122.74,2.6216129032258064,0.85,99.45
2021-10-20,Manipur,963,9,954,11926,1626,328,8.07,0,3.1,540420,4619,537441,52.45,10.58,3.8470967741935485,0.85,99.45
2021-10-21,Manipur,248,3,239,3049,4181,1323,8.13,6,3.1,540668,4622,537680,134.87,42.68,0.9835483870967742,0.85,99.45
2021-10-22,Manipur,171,2,164,2492,3274,2877,6.86,5,3.1,540839,4624,537844,105.61,92.81,0.8038709677419354,0.85,99.45
2021-10-23,Manipur,1468,12,1462,18077,4186,38,8.12,0,3.1,542307,4636,539306,135.03,1.23,5.831290322580645,0.85,99.45
2021-10-24,Manipur,429,1,428,5698,4537,1775,7.53,0,3.1,542736,4637,539734,146.35,57.26,1.8380645161290323,0.85,99.45
2021-10-25,Manipur,679,7,672,8887,3013,1827,7.64,0,3.1,543415,4644,540406,97.19,58.94,2.866774193548387,0.85,99.45
2021-10-26,Manipur,349,4,346,4382,1914,939,7.96,0,3.1,543764,4648,540752,61.74,30.29,1.4135483870967742,0.85,99.45
2021-10-27,Manipur,64,0,62,824,4490,2713,7.77,2,3.1,543828,4648,540814,144.84,87.52,0.2658064516129032,0.85,99.45
2021-10-28,Manipur,820,7,813,10420,2565,1329,7.87,0,3.1,544648,4655,541627,82.74,42.87,3.361290322580645,0.85,99.45
2021-10-29,Manipur,1172,10,1163,15002,83,48,7.81,0,3.1,545820,4665,542790,2.68,1.55,4.839354838709677,0.85,99.44
2021-10-30,Manipur,271,1,271,3280,3505,412,8.26,0,3.1,546091,4666,543061,113.06,13.29,1.0580645161290323,0.85,99.45
2021-10-31,Manipur,1563,15,1563,19626,4462,4270,7.96,0,3.1,547654,4681,544624,143.94,137.74,6.330967741935484,0.85,99.45
2021-11-01,Manipur,1402,17,1395,17521,1701,1340,8.0,0,3.1,549056,4698,546019,54.87,43.23,5.651935483870968,0.86,99.45
2021-11-02,Manipur,698,7,690,8644,3726,187,8.07,1,3.1,549754,4705,546709,120.19,6.03,2.7883870967741937,0.86,99.45
2021-11-03,Manipur,1588,22,1585,19339,2362,365,8.21,0,3.1,551342,4727,548294,76.19,11.77,6.2383870967741935,0.86,99.45
2021-11-04,Manipur,1554,6,1548,19763,2535,2299,7.86,0,3.1,552896,4733,549842,81.77,74.16,6.3751612903225805,0.86,99.45
2021-11-05,Manipur,1536,9,1529,19277,316,244,7.97,0,3.1,554432,4742,551371,10.19,7.87,6.218387096774194,0.86,99.45
2021-11-06,Manipur,695,3,687,8666,1951,1784,8.02,5,3.1,555127,4745,552058,62.94,57.55,2.795483870967742,0.85,99.45
2021-11-07,Manipur,1081,4,1079,13844,3705,2946,7.81,0,3.1,556208,4749,553137,119.52,95.03,4.465806451612903,0.85,99.45
2021-11-08,Manipur,1507,22,1499,18762,2383,906,8.03,0,3.1,557715,4771,554636,76.87,29.23,6.0522580645161295,0.86,99.45
2021-11-09,Manipur,1085,15,1084,13859,2503,1303,7.83,0,3.1,558800,4786,555720,80.74,42.03,4.470645161290323,0.86,99.45
2021-11-10,Manipur,818,9,810,10337,1452,462,7.91,0,3.1,559618,4795,556530,46.84,14.9,3.334516129032258,0.86,99.45
2021-11-11,Manipur,910,5,901,11670,1924,1156,7.8,4,3.1,560528,4800,557431,62.06,37.29,3.764516129032258,0.86,99.45
2021-11-12,Manipur,1133,9,1126,14318,3609,130,7.91,0,3.1,561661,4809,558557,116.42,4.19,4.618709677419355,0.86,99.45
2021-11-13,Manipur,1392,6,1385,17248,219,143,8.07,1,3.1,563053,4815,559942,7.06,4.61,5.563870967741935,0.86,99.45
2021-11-14,Manipur,1316,19,1309,16483,3922,1790,7.98,0,3.1,564369,4834,561251,126.52,57.74,5.317096774193549,0.86,99.45
2021-11-15,Manipur,503,1,494,6241,2628,1556,8.06,8,3.1,564872,4835,561745,84.77,50.19,2.013225806451613,0.86,99.45
2021-11-16,Manipur,978,11,971,11570,4851,4539,8.45,0,3.1,565850,4846,562716,156.48,146.42,3.732258064516129,0.86,99.45
2021-11-17,Manipur,898,3,896,11520,2297,1045,7.8,0,3.1,566748,4849,563612,74.1,33.71,3.7161290322580647,0.86,99.45
2021-11-18,Manipur,667,5,664,8272,3741,680,8.06,0,3.1,567415,4854,564276,120.68,21.94,2.6683870967741936,0.86,99.45
2021-11-19,Manipur,669,5,664,8265,4835,1034,8.09,0,3.1,568084,4859,564940,155.97,33.35,2.6661290322580644,0.86,99.45
2021-11-20,Manipur,737,9,730,9168,4573,468,8.04,0,3.1,568821,4868,565670,147.52,15.1,2.9574193548387098,0.86,99.45
2021-11-21,Manipur,1129,14,1128,13880,3424,2679,8.13,0,3.1,569950,4882,566798,110.45,86.42,4.47741935483871,0.86,99.45
2021-11-22,Manipur,1281,5,1281,16273,1937,1237,7.87,0,3.1,571231,4887,568079,62.48,39.9,5.249354838709677,0.86,99.45
2021-11-23,Manipur,859,9,857,10736,776,182,8.0,0,3.1,572090,4896,568936,25.03,5.87,3.463225806451613,0.86,99.45
2021-11-24,Manipur,1272,11,1265,15662,1969,1068,8.12,0,3.1,573362,4907,570201,63.52,34.45,5.0522580645161295,0.86,99.45
2021-11-25,Manipur,1167,17,1161,14604,2714,1850,7.99,0,3.1,574529,4924,571362,87.55,59.68,4.710967741935484,0.86,99.45
2021-11-26,Manipur,1382,13,1380,16876,4502,1891,8.19,0,3.1,575911,4937,572742,145.23,61.0,5.443870967741936,0.86,99.45
2021-11-27,Manipur,148,1,143,2054,3162,169,7.21,4,3.1,576059,4938,572885,102.0,5.45,0.6625806451612903,0.86,99.45
2021-11-28,Manipur,510,1,506,6680,4884,130,7.63,3,3.1,576569,4939,573391,157.55,4.19,2.1548387096774193,0.86,99.45
2021-11-29,Manipur,947,12,941,12120,1186,178,7.81,0,3.1,577516,4951,574332,38.26,5.74,3.9096774193548387,0.86,99.45
2021-11-30,Manipur,1518,4,1511,19309,1928,901,7.86,3,3.1,579034,4955,575843,62.19,29.06,6.228709677419355,0.86,99.45
2021-12-01,Manipur,1459,15,1457,17931,1934,715,8.14,0,3.1,580493,4970,577300,62.39,23.06,5.784193548387097,0.86,99.45
2021-12-02,Manipur,1384,11,1382,16955,4489,1444,8.16,0,3.1,581877,4981,578682,144.81,46.58,5.469354838709678,0.86,99.45
2021-12-03,Manipur,1020,4,1020,12965,3883,831,7.87,0,3.1,582897,4985,579702,125.26,26.81,4.182258064516129,0.86,99.45
2021-12-04,Manipur,342,4,337,4395,1036,233,7.78,1,3.1,583239,4989,580039,33.42,7.52,1.417741935483871,0.86,99.45
2021-12-05,Manipur,1546,16,1538,19377,4817,510,7.98,0,3.1,584785,5005,581577,155.39,16.45,6.250645161290323,0.86,99.45
2021-12-06,Manipur,142,0,133,1413,1827,451,10.05,9,3.1,584927,5005,581710,58.94,14.55,0.45580645161290323,0.86,99.45
2021-12-07,Manipur,759,9,756,9445,4384,3569,8.04,0,3.1,585686,5014,582466,141.42,115.13,3.046774193548387,0.86,99.45
2021-12-08,Manipur,493,4,491,6460,4770,2089,7.63,0,3.1,586179,5018,582957,153.87,67.39,2.0838709677419356,0.86,99.45
2021-12-09,Manipur,1060,9,1057,13068,421,82,8.11,0,3.1,587239,5027,584014,13.58,2.65,4.215483870967742,0.86,99.45
2021-12-10,Manipur,413,4,410,4984,4288,2549,8.29,0,3.1,587652,5031,584424,138.32,82.23,1.607741935483871,0.86,99.45
2021-12-11,Manipur,619,4,610,7591,2220,2096,8.15,5,3.1,588271,5035,585034,71.61,67.61,2.448709677419355,0.86,99.45
2021-12-12,Manipur,1239,15,1237,15595,2101,145,7.94,0,3.1,589510,5050,586271,67.77,4.68,5.030645161290322,0.86,99.45
2021-12-13,Manipur,613,5,606,7719,2062,896,7.94,2,3.1,590123,5055,586877,66.52,28.9,2.49,0.86,99.45
2021-12-14,Manipur,822,10,813,10178,4671,178,8.08,0,3.1,590945,5065,587690,150.68,5.74,3.283225806451613,0.86,99.45
2021-12-15,Manipur,793,5,788,9912,4705,1318,8.0,0,3.1,591738,5070,588478,151.77,42.52,3.1974193548387095,0.86,99.45
2021-12-16,Manipur,505,3,503,6381,772,185,7.91,0,3.1,592243,5073,588981,24.9,5.97,2.0583870967741937,0.86,99.45
2021-12-17,Manipur,1019,3,1017,12674,4043,83,8.04,0,3.1,593262,5076,589998,130.42,2.68,4.088387096774194,0.86,99.45
2021-12-18,Manipur,1190,16,1184,14668,3457,2109,8.11,0,3.1,594452,5092,591182,111.52,68.03,4.731612903225806,0.86,99.45
2021-12-19,Manipur,1029,13,1021,13182,296,39,7.81,0,3.1,595481,5105,592203,9.55,1.26,4.252258064516129,0.86,99.45
2021-12-20,Manipur,1474,17,1468,18470,3944,448,7.98,0,3.1,596955,5122,593671,127.23,14.45,5.958064516129032,0.86,99.45
2021-12-21,Manipur,926,9,919,11801,1740,298,7.85,0,3.1,597881,5131,594590,56.13,9.61,3.806774193548387,0.86,99.45
2021-12-22,Manipur,1280,7,1280,16113,4111,3414,7.94,0,3.1,599161,5138,595870,132.61,110.13,5.1977419354838705,0.86,99.45
2021-12-23,Manipur,454,6,447,5409,2530,953,8.39,1,3.1,599615,5144,596317,81.61,30.74,1.7448387096774194,0.86,99.45
2021-12-24,Manipur,1511,15,1507,19012,1521,468,7.95,0,3.1,601126,5159,597824,49.06,15.1,6.1329032258064515,0.86,99.45
2021-12-25,Manipur,509,4,501,6703,517,59,7.59,4,3.1,601635,5163,598325,16.68,1.9,2.162258064516129,0.86,99.45
2021-12-26,Manipur,261,3,255,3484,4706,157,7.49,3,3.1,601896,5166,598580,151.81,5.06,1.1238709677419354,0.86,99.45
2021-12-27,Manipur,739,2,738,9382,468,182,7.88,0,3.1,602635,5168,599318,15.1,5.87,3.0264516129032257,0.86,99.45
2021-12-28,Manipur,1423,16,1421,17674,753,396,8.05,0,3.1,604058,5184,600739,24.29,12.77,5.701290322580645,0.86,99.45
2021-12-29,Manipur,203,2,200,2639,2811,2637,7.69,1,3.1,604261,5186,600939,90.68,85.06,0.8512903225806452,0.86,99.45
2021-12-30,Manipur,1553,13,1549,19404,4967,1300,8.0,0,3.1,605814,5199,602488,160.23,41.94,6.259354838709678,0.86,99.45
2021-12-31,Manipur,707,5,707,8832,3293,1985,8.0,0,3.1,606521,5204,603195,106.23,64.03,2.849032258064516,0.86,99.45
2022-01-01,Manipur,1533,19,1528,19282,952,872,7.95,0,3.1,608054,5223,604723,30.71,28.13,6.22,0.86,99.45
2022-01-02,Manipur,1222,7,1222,14884,3142,2141,8.21,0,3.1,609276,5230,605945,101.35,69.06,4.801290322580646,0.86,99.45
2022-01-03,Manipur,145,0,141,1962,974,767,7.39,4,3.1,609421,5230,606086,31.42,24.74,0.6329032258064516,0.86,99.45
2022-01-04,Manipur,404,3,399,4785,3933,3075,8.44,2,3.1,609825,5233,606485,126.87,99.19,1.543548387096774,0.86,99.45
2022-01-05,Manipur,1007,10,1006,12575,234,127,8.01,0,3.1,610832,5243,607491,7.55,4.1,4.056451612903226,0.86,99.45
2022-01-06,Manipur,1363,11,1355,16907,1094,96,8.06,0,3.1,612195,5254,608846,35.29,3.1,5.453870967741936,0.86,99.45
2022-01-07,Manipur,1028,10,1025,13217,2990,2659,7.78,0,3.1,613223,5264,609871,96.45,85.77,4.263548387096774,0.86,99.45
2022-01-08,Manipur,431,4,427,4893,3578,898,8.81,0,3.1,613654,5268,610298,115.42,28.97,1.5783870967741935,0.86,99.45
2022-01-09,Manipur,508,5,505,6066,1760,658,8.37,0,3.1,614162,5273,610803,56.77,21.23,1.956774193548387,0.86,99.45
2022-01-10,Manipur,507,2,504,6509,4049,3413,7.79,1,3.1,614669,5275,611307,130.61,110.1,2.0996774193548386,0.86,99.45
2022-01-11,Manipur,590,2,583,7410,2567,210,7.96,5,3.1,615259,5277,611890,82.81,6.77,2.390322580645161,0.86,99.45
2022-01-12,Manipur,712,7,710,8474,409,241,8.4,0,3.1,615971,5284,612600,13.19,7.77,2.733548387096774,0.86,99.45
2022-01-13,Manipur,688,3,688,8643,486,353,7.96,0,3.1,616659,5287,613288,15.68,11.39,2.7880645161290323,0.86,99.45
2022-01-14,Manipur,1431,21,1429,17496,2084,95,8.18,0,3.1,618090,5308,614717,67.23,3.06,5.643870967741935,0.86,99.45
2022-01-15,Manipur,199,2,190,2514,1078,785,7.92,7,3.1,618289,5310,614907,34.77,25.32,0.8109677419354838,0.86,99.45
2022-01-16,Manipur,129,1,123,1104,155,104,11.68,5,3.1,618418,5311,615030,5.0,3.35,0.3561290322580645,0.86,99.45
2022-01-17,Manipur,923,3,921,11082,2090,895,8.33,0,3.1,619341,5314,615951,67.42,28.87,3.5748387096774192,0.86,99.45
2022-01-18,Manipur,1459,16,1457,18231,4803,2617,8.0,0,3.1,620800,5330,617408,154.94,84.42,5.880967741935484,0.86,99.45
2022-01-19,Manipur,244,2,243,2765,1318,1076,8.82,0,3.1,621044,5332,617651,42.52,34.71,0.8919354838709678,0.86,99.45
2022-01-20,Manipur,289,3,289,3243,3862,287,8.91,0,3.1,621333,5335,617940,124.58,9.26,1.0461290322580645,0.86,99.45
2022-01-21,Manipur,1134,7,1125,14180,1455,319,8.0,2,3.1,622467,5342,619065,46.94,10.29,4.574193548387097,0.86,99.45
2022-01-22,Manipur,1030,12,1025,13014,3340,2029,7.91,0,3.1,623497,5354,620090,107.74,65.45,4.198064516129032,0.86,99.45
2022-01-23,Manipur,667,8,658,8421,3900,745,7.92,1,3.1,624164,5362,620748,125.81,24.03,2.7164516129032257,0.86,99.45
2022-01-24,Manipur,1116,11,1116,14145,3925,2669,7.89,0,3.1,625280,5373,621864,126.61,86.1,4.562903225806451,0.86,99.45
2022-01-25,Manipur,816,3,812,10311,3318,2661,7.91,1,3.1,626096,5376,622676,107.03,85.84,3.3261290322580646,0.86,99.45
2022-01-26,Manipur,1044,13,1039,13437,1546,1360,7.77,0,3.1,627140,5389,623715,49.87,43.87,4.3345161290322585,0.86,99.45
2022-01-27,Manipur,946,6,939,11747,1068,424,8.05,1,3.1,628086,5395,624654,34.45,13.68,3.7893548387096776,0.86,99.45
2022-01-28,Manipur,515,4,509,6307,1274,677,8.17,2,3.1,628601,5399,625163,41.1,21.84,2.034516129032258,0.86,99.45
2022-01-29,Manipur,1211,11,1202,14848,467,314,8.16,0,3.1,629812,5410,626365,15.06,10.13,4.789677419354839,0.86,99.45
2022-01-30,Manipur,681,5,676,8453,4262,1734,8.06,0,3.1,630493,5415,627041,137.48,55.94,2.726774193548387,0.86,99.45
2022-01-31,Manipur,1020,3,1012,12861,1429,817,7.93,5,3.1,631513,5418,628053,46.1,26.35,4.148709677419355,0.86,99.45
2022-02-01,Manipur,1137,7,1137,14205,125,17,8.0,0,3.1,632650,5425,629190,4.03,0.55,4.582258064516129,0.86,99.45
2022-02-02,Manipur,175,2,169,2221,928,44,7.88,4,3.1,632825,5427,629359,29.94,1.42,0.7164516129032258,0.86,99.45
2022-02-03,Manipur,648,7,642,8288,1485,1136,7.82,0,3.1,633473,5434,630001,47.9,36.65,2.673548387096774,0.86,99.45
2022-02-04,Manipur,241,2,234,3034,3941,2241,7.94,5,3.1,633714,5436,630235,127.13,72.29,0.9787096774193549,0.86,99.45
2022-02-05,Manipur,1242,14,1239,15620,4952,1767,7.95,0,3.1,634956,5450,631474,159.74,57.0,5.038709677419355,0.86,99.45
2022-02-06,Manipur,115,0,111,1432,2826,525,8.03,4,3.1,635071,5450,631585,91.16,16.94,0.4619354838709677,0.86,99.45
2022-02-07,Manipur,67,0,63,664,1708,1269,10.09,4,3.1,635138,5450,631648,55.1,40.94,0.21419354838709678,0.86,99.45
2022-02-08,Manipur,525,5,525,7359,4486,1774,7.13,0,3.1,635663,5455,632173,144.71,57.23,2.3738709677419356,0.86,99.45
2022-02-09,Manipur,437,5,433,5152,4025,1517,8.48,0,3.1,636100,5460,632606,129.84,48.94,1.6619354838709677,0.86,99.45
2022-02-10,Manipur,47,0,46,740,464,26,6.35,1,3.1,636147,5460,632652,14.97,0.84,0.23870967741935484,0.86,99.45
2022-02-11,Manipur,612,8,610,7667,2034,398,7.98,0,3.1,636759,5468,633262,65.61,12.84,2.473225806451613,0.86,99.45
2022-02-12,Manipur,944,11,936,11941,3426,1432,7.91,0,3.1,637703,5479,634198,110.52,46.19,3.851935483870968,0.86,99.45
2022-02-13,Manipur,1113,14,1104,13862,4620,748,8.03,0,3.1,638816,5493,635302,149.03,24.13,4.4716129032258065,0.86,99.45
2022-02-14,Manipur,987,6,985,12873,4366,884,7.67,0,3.1,639803,5499,636287,140.84,28.52,4.15258064516129,0.86,99.45
2022-02-15,Manipur,1351,5,1345,16646,2616,1604,8.12,1,3.1,641154,5504,637632,84.39,51.74,5.369677419354839,0.86,99.45
2022-02-16,Manipur,931,12,931,11872,4693,3403,7.84,0,3.1,642085,5516,638563,151.39,109.77,3.8296774193548386,0.86,99.45
2022-02-17,Manipur,193,1,186,2657,3073,1533,7.26,6,3.1,642278,5517,638749,99.13,49.45,0.8570967741935483,0.86,99.45
2022-02-18,Manipur,1181,8,1172,14911,4410,1831,7.92,1,3.1,643459,5525,639921,142.26,59.06,4.81,0.86,99.45
2022-02-19,Manipur,401,4,397,5439,3743,1873,7.37,0,3.1,643860,5529,640318,120.74,60.42,1.754516129032258,0.86,99.45
2022-02-20,Manipur,42,0,35,669,1297,1115,6.28,7,3.1,643902,5529,640353,41.84,35.97,0.21580645161290324,0.86,99.45
2022-02-21,Manipur,371,1,365,4692,2537,1672,7.91,5,3.1,644273,5530,640718,81.84,53.94,1.513548387096774,0.86,99.45
2022-02-22,Manipur,722,2,718,9391,765,536,7.69,2,3.1,644995,5532,641436,24.68,17.29,3.0293548387096774,0.86,99.45
2022-02-23,Manipur,1011,10,1003,12911,2641,405,7.83,0,3.1,646006,5542,642439,85.19,13.06,4.1648387096774195,0.86,99.45
2022-02-24,Manipur,625,2,625,7692,4803,3806,8.13,0,3.1,646631,5544,643064,154.94,122.77,2.4812903225806453,0.86,99.45
2022-02-25,Manipur,1030,10,1029,13002,3974,1391,7.92,0,3.1,647661,5554,644093,128.19,44.87,4.194193548387097,0.86,99.45
2022-02-26,Manipur,660,9,653,8206,835,51,8.04,0,3.1,648321,5563,644746,26.94,1.65,2.6470967741935483,0.86,99.45
2022-02-27,Manipur,1584,12,1577,19431,3177,2217,8.15,0,3.1,649905,5575,646323,102.48,71.52,6.268064516129032,0.86,99.45
2022-02-28,Manipur,188,2,184,2296,4145,1711,8.19,2,3.1,650093,5577,646507,133.71,55.19,0.7406451612903225,0.86,99.45
2022-03-01,Manipur,395,2,392,4975,3825,2889,7.94,1,3.1,650488,5579,646899,123.39,93.19,1.6048387096774193,0.86,99.45
2022-03-02,Manipur,979,10,977,12302,715,633,7.96,0,3.1,651467,5589,647876,23.06,20.42,3.9683870967741934,0.86,99.45
2022-03-03,Manipur,1187,13,1183,14631,2475,287,8.11,0,3.1,652654,5602,649059,79.84,9.26,4.719677419354839,0.86,99.45
2022-03-04,Manipur,471,4,463,6029,2137,365,7.81,4,3.1,653125,5606,649522,68.94,11.77,1.9448387096774193,0.86,99.45
2022-03-05,Manipur,861,12,860,11196,1790,732,7.69,0,3.1,653986,5618,650382,57.74,23.61,3.6116129032258066,0.86,99.45
2022-03-06,Manipur,1374,15,1371,17394,1048,559,7.9,0,3.1,655360,5633,651753,33.81,18.03,5.610967741935484,0.86,99.45
2022-03-07,Manipur,332,2,330,4256,4307,3037,7.8,0,3.1,655692,5635,652083,138.94,97.97,1.3729032258064515,0.86,99.45
2022-03-08,Manipur,926,13,918,11580,2846,2294,8.0,0,3.1,656618,5648,653001,91.81,74.0,3.735483870967742,0.86,99.45
2022-03-09,Manipur,491,7,487,6248,4484,3626,7.86,0,3.1,657109,5655,653488,144.65,116.97,2.015483870967742,0.86,99.45
2022-03-10,Manipur,988,14,980,12272,3503,3194,8.05,0,3.1,658097,5669,654468,113.0,103.03,3.9587096774193546,0.86,99.45
2022-03-11,Manipur,1079,15,1077,13746,4538,4407,7.85,0,3.1,659176,5684,655545,146.39,142.16,4.434193548387097,0.86,99.45
2022-03-12,Manipur,1587,12,1578,19877,1227,130,7.98,0,3.1,660763,5696,657123,39.58,4.19,6.411935483870968,0.86,99.45
2022-03-13,Manipur,997,12,988,12549,2860,1236,7.94,0,3.1,661760,5708,658111,92.26,39.87,4.048064516129032,0.86,99.45
2022-03-14,Manipur,744,7,735,9242,4359,3356,8.05,2,3.1,662504,5715,658846,140.61,108.26,2.9812903225806453,0.86,99.45
2022-03-15,Manipur,705,4,704,9045,361,325,7.79,0,3.1,663209,5719,659550,11.65,10.48,2.917741935483871,0.86,99.45
2022-03-16,Manipur,140,1,138,1450,872,722,9.66,1,3.1,663349,5720,659688,28.13,23.29,0.46774193548387094,0.86,99.45
2022-03-17,Manipur,110,0,105,1109,1004,9,9.92,5,3.1,663459,5720,659793,32.39,0.29,0.35774193548387095,0.86,99.45
2022-03-18,Manipur,185,0,184,1825,2892,1021,10.14,1,3.1,663644,5720,659977,93.29,32.94,0.5887096774193549,0.86,99.45
2022-03-19,Manipur,1192,5,1183,14633,4254,4089,8.15,4,3.1,664836,5725,661160,137.23,131.9,4.720322580645162,0.86,99.45
2022-03-20,Manipur,436,3,429,5628,2081,889,7.75,4,3.1,665272,5728,661589,67.13,28.68,1.8154838709677419,0.86,99.45
2022-03-21,Manipur,345,4,340,4155,2166,465,8.3,1,3.1,665617,5732,661929,69.87,15.0,1.3403225806451613,0.86,99.45
2022-03-22,Manipur,1360,15,1354,16931,4153,3602,8.03,0,3.1,666977,5747,663283,133.97,116.19,5.461612903225807,0.86,99.45
2022-03-23,Manipur,1288,13,1279,16171,2818,2351,7.96,0,3.1,668265,5760,664562,90.9,75.84,5.216451612903226,0.86,99.45
2022-03-24,Manipur,130,0,128,1673,2523,725,7.77,2,3.1,668395,5760,664690,81.39,23.39,0.5396774193548387,0.86,99.45
2022-03-25,Manipur,1029,8,1020,13153,3910,3529,7.82,1,3.1,669424,5768,665710,126.13,113.84,4.242903225806452,0.86,99.45
2022-03-26,Manipur,1173,11,1167,14785,3133,585,7.93,0,3.1,670597,5779,666877,101.06,18.87,4.769354838709678,0.86,99.45
2022-03-27,Manipur,1509,19,1500,18893,2280,150,7.99,0,3.1,672106,5798,668377,73.55,4.84,6.094516129032258,0.86,99.45
2022-03-28,Manipur,896,11,896,11326,3741,43,7.91,0,3.1,673002,5809,669273,120.68,1.39,3.653548387096774,0.86,99.45
2022-03-29,Manipur,507,3,502,6350,2609,35,7.98,2,3.1,673509,5812,669775,84.16,1.13,2.0483870967741935,0.86,99.45
2022-03-30,Manipur,746,11,738,9201,3459,368,8.11,0,3.1,674255,5823,670513,111.58,11.87,2.9680645161290324,0.86,99.45
2022-03-31,Manipur,1301,8,1299,16369,2054,1851,7.95,0,3.1,675556,5831,671812,66.26,59.71,5.280322580645161,0.86,99.45
2022-04-01,Manipur,284,2,279,3750,2451,1959,7.57,3,3.1,675840,5833,672091,79.06,63.19,1.2096774193548387,0.86,99.45
2022-04-02,Manipur,261,3,254,3502,3500,2813,7.45,4,3.1,676101,5836,672345,112.9,90.74,1.1296774193548387,0.86,99.44
2022-04-03,Manipur,501,1,501,6058,1767,1150,8.27,0,3.1,676602,5837,672846,57.0,37.1,1.9541935483870967,0.86,99.44
2022-04-04,Manipur,880,9,875,11174,3652,616,7.88,0,3.1,677482,5846,673721,117.81,19.87,3.604516129032258,0.86,99.44
2022-04-05,Manipur,891,9,891,11131,679,643,8.0,0,3.1,678373,5855,674612,21.9,20.74,3.5906451612903227,0.86,99.45
2022-04-06,Manipur,1417,19,1412,17533,1548,454,8.08,0,3.1,679790,5874,676024,49.94,14.65,5.655806451612904,0.86,99.45
2022-04-07,Manipur,782,10,781,9527,3778,3509,8.21,0,3.1,680572,5884,676805,121.87,113.19,3.073225806451613,0.86,99.45
2022-04-08,Manipur,1082,14,1080,12867,162,39,8.41,0,3.1,681654,5898,677885,5.23,1.26,4.150645161290322,0.87,99.45
2022-04-09,Manipur,957,8,954,12039,3197,2877,7.95,0,3.1,682611,5906,678839,103.13,92.81,3.8835483870967744,0.87,99.45
2022-04-10,Manipur,152,1,150,1980,4862,154,7.68,1,3.1,682763,5907,678989,156.84,4.97,0.6387096774193548,0.87,99.45
2022-04-11,Manipur,1524,12,1524,19334,2181,1143,7.88,0,3.1,684287,5919,680513,70.35,36.87,6.236774193548387,0.86,99.45
2022-04-12,Manipur,346,2,342,4382,3946,23,7.9,2,3.1,684633,5921,680855,127.29,0.74,1.4135483870967742,0.86,99.45
2022-04-13,Manipur,1511,19,1505,19049,4672,1505,7.93,0,3.1,686144,5940,682360,150.71,48.55,6.144838709677419,0.87,99.45
2022-04-14,Manipur,177,2,174,2412,2001,1135,7.34,1,3.1,686321,5942,682534,64.55,36.61,0.7780645161290323,0.87,99.45
2022-04-15,Manipur,669,7,662,8837,4184,4176,7.57,0,3.1,686990,5949,683196,134.97,134.71,2.8506451612903225,0.87,99.45
2022-04-16,Manipur,1340,16,1338,16804,3227,714,7.97,0,3.1,688330,5965,684534,104.1,23.03,5.420645161290323,0.87,99.45
2022-04-17,Manipur,988,10,985,12700,3832,633,7.78,0,3.1,689318,5975,685519,123.61,20.42,4.096774193548387,0.87,99.45
2022-04-18,Manipur,359,5,351,4530,2160,1563,7.92,3,3.1,689677,5980,685870,69.68,50.42,1.461290322580645,0.87,99.45
2022-04-19,Manipur,1177,8,1170,14775,1788,1632,7.97,0,3.1,690854,5988,687040,57.68,52.65,4.766129032258065,0.87,99.45
2022-04-20,Manipur,644,3,637,7892,3931,514,8.16,4,3.1,691498,5991,687677,126.81,16.58,2.5458064516129033,0.87,99.45
2022-04-21,Manipur,563,6,556,6885,1277,384,8.18,1,3.1,692061,5997,688233,41.19,12.39,2.220967741935484,0.87,99.45
2022-04-22,Manipur,1530,22,1522,19284,3045,1247,7.93,0,3.1,693591,6019,689755,98.23,40.23,6.220645161290323,0.87,99.45
2022-04-23,Manipur,908,12,899,10855,2963,2729,8.36,0,3.1,694499,6031,690654,95.58,88.03,3.5016129032258063,0.87,99.45
2022-04-24,Manipur,1571,19,1563,19233,1857,220,8.17,0,3.1,696070,6050,692217,59.9,7.1,6.204193548387097,0.87,99.45
2022-04-25,Manipur,380,2,377,4475,2250,300,8.49,1,3.1,696450,6052,692594,72.58,9.68,1.4435483870967742,0.87,99.45
2022-04-26,Manipur,1434,15,1432,18026,810,472,7.96,0,3.1,697884,6067,694026,26.13,15.23,5.814838709677419,0.87,99.45
2022-04-27,Manipur,59,0,59,842,2517,2193,7.01,0,3.1,697943,6067,694085,81.19,70.74,0.27161290322580645,0.87,99.45
2022-04-28,Manipur,286,2,285,3646,1921,517,7.84,0,3.1,698229,6069,694370,61.97,16.68,1.1761290322580644,0.87,99.45
2022-04-29,Manipur,1467,9,1467,18355,4984,2719,7.99,0,3.1,699696,6078,695837,160.77,87.71,5.920967741935484,0.87,99.45
2022-04-30,Manipur,1236,11,1235,15555,3844,3651,7.95,0,3.1,700932,6089,697072,124.0,117.77,5.017741935483871,0.87,99.45
2022-05-01,Manipur,1578,15,1572,19746,1760,1660,7.99,0,3.1,702510,6104,698644,56.77,53.55,6.369677419354839,0.87,99.45
2022-05-02,Manipur,1258,14,1252,15710,4634,669,8.01,0,3.1,703768,6118,699896,149.48,21.58,5.067741935483871,0.87,99.45
2022-05-03,Manipur,1495,14,1494,18806,461,373,7.95,0,3.1,705263,6132,701390,14.87,12.03,6.066451612903226,0.87,99.45
2022-05-04,Manipur,972,11,967,12491,3776,2817,7.78,0,3.1,706235,6143,702357,121.81,90.87,4.029354838709677,0.87,99.45
2022-05-05,Manipur,433,3,429,5363,347,174,8.07,1,3.1,706668,6146,702786,11.19,5.61,1.73,0.87,99.45
2022-05-06,Manipur,1174,15,1174,14410,3807,3282,8.15,0,3.1,707842,6161,703960,122.81,105.87,4.648387096774194,0.87,99.45
2022-05-07,Manipur,668,2,659,8280,3921,2841,8.07,7,3.1,708510,6163,704619,126.48,91.65,2.670967741935484,0.87,99.45
2022-05-08,Manipur,882,12,877,10721,3487,2096,8.23,0,3.1,709392,6175,705496,112.48,67.61,3.4583870967741936,0.87,99.45
2022-05-09,Manipur,361,1,361,4282,2367,948,8.43,0,3.1,709753,6176,705857,76.35,30.58,1.3812903225806452,0.87,99.45
2022-05-10,Manipur,641,8,637,8195,4827,2718,7.82,0,3.1,710394,6184,706494,155.71,87.68,2.643548387096774,0.87,99.45
2022-05-11,Manipur,560,6,551,7208,1148,450,7.77,3,3.1,710954,6190,707045,37.03,14.52,2.3251612903225807,0.87,99.45
2022-05-12,Manipur,1168,13,1168,15044,1443,460,7.76,0,3.1,712122,6203,708213,46.55,14.84,4.852903225806451,0.87,99.45
2022-05-13,Manipur,921,2,919,11288,1002,49,8.16,0,3.1,713043,6205,709132,32.32,1.58,3.641290322580645,0.87,99.45
2022-05-14,Manipur,1198,9,1195,14524,2368,713,8.25,0,3.1,714241,6214,710327,76.39,23.0,4.685161290322581,0.87,99.45
2022-05-15,Manipur,1089,12,1085,13994,1340,712,7.78,0,3.1,715330,6226,711412,43.23,22.97,4.514193548387097,0.87,99.45
2022-05-16,Manipur,479,4,475,6221,3815,949,7.7,0,3.1,715809,6230,711887,123.06,30.61,2.006774193548387,0.87,99.45
2022-05-17,Manipur,1217,9,1212,15418,2519,1153,7.89,0,3.1,717026,6239,713099,81.26,37.19,4.973548387096774,0.87,99.45
2022-05-18,Manipur,482,3,479,5941,1874,47,8.11,0,3.1,717508,6242,713578,60.45,1.52,1.9164516129032259,0.87,99.45
2022-05-19,Manipur,1233,17,1227,15526,4523,745,7.94,0,3.1,718741,6259,714805,145.9,24.03,5.008387096774194,0.87,99.45
2022-05-20,Manipur,1393,11,1389,17658,3635,2717,7.89,0,3.1,720134,6270,716194,117.26,87.65,5.696129032258065,0.87,99.45
2022-05-21,Manipur,1562,15,1560,18943,2916,1537,8.25,0,3.1,721696,6285,717754,94.06,49.58,6.110645161290322,0.87,99.45
2022-05-22,Manipur,1127,10,1124,13994,1956,1725,8.05,0,3.1,722823,6295,718878,63.1,55.65,4.514193548387097,0.87,99.45
2022-05-23,Manipur,352,1,345,4774,3572,191,7.37,6,3.1,723175,6296,719223,115.23,6.16,1.54,0.87,99.45
2022-05-24,Manipur,182,0,174,1900,942,230,9.58,8,3.1,723357,6296,719397,30.39,7.42,0.6129032258064516,0.87,99.45
2022-05-25,Manipur,1362,9,1353,17212,117,114,7.91,0,3.1,724719,6305,720750,3.77,3.68,5.5522580645161295,0.87,99.45
2022-05-26,Manipur,351,4,345,3915,2710,2692,8.97,2,3.1,725070,6309,721095,87.42,86.84,1.2629032258064516,0.87,99.45
2022-05-27,Manipur,324,3,322,4290,4648,3853,7.55,0,3.1,725394,6312,721417,149.94,124.29,1.3838709677419354,0.87,99.45
2022-05-28,Manipur,912,13,912,11494,1417,870,7.93,0,3.1,726306,6325,722329,45.71,28.06,3.7077419354838708,0.87,99.45
2022-05-29,Manipur,683,3,676,8531,4954,1590,8.01,4,3.1,726989,6328,723005,159.81,51.29,2.7519354838709678,0.87,99.45
2022-05-30,Manipur,659,8,651,8336,4438,4220,7.91,0,3.1,727648,6336,723656,143.16,136.13,2.689032258064516,0.87,99.45
2022-05-31,Manipur,540,7,537,7041,1049,983,7.67,0,3.1,728188,6343,724193,33.84,31.71,2.2712903225806453,0.87,99.45
2022-06-01,Manipur,840,11,839,10433,1590,1107,8.05,0,3.1,729028,6354,725032,51.29,35.71,3.365483870967742,0.87,99.45
2022-06-02,Manipur,11,0,4,696,3545,2321,1.58,7,3.1,729039,6354,725036,114.35,74.87,0.22451612903225807,0.87,99.45
2022-06-03,Manipur,1470,9,1462,17840,3191,958,8.24,0,3.1,730509,6363,726498,102.94,30.9,5.754838709677419,0.87,99.45
2022-06-04,Manipur,896,8,889,11217,4365,755,7.99,0,3.1,731405,6371,727387,140.81,24.35,3.6183870967741933,0.87,99.45
2022-06-05,Manipur,140,1,140,1967,1935,1241,7.12,0,3.1,731545,6372,727527,62.42,40.03,0.6345161290322581,0.87,99.45
2022-06-06,Manipur,1332,11,1327,16442,3749,2664,8.1,0,3.1,732877,6383,728854,120.94,85.94,5.303870967741935,0.87,99.45
2022-06-07,Manipur,1447,21,1442,18244,3642,2234,7.93,0,3.1,734324,6404,730296,117.48,72.06,5.88516129032258,0.87,99.45
2022-06-08,Manipur,916,7,908,11620,2857,1339,7.88,1,3.1,735240,6411,731204,92.16,43.19,3.7483870967741937,0.87,99.45
2022-06-09,Manipur,135,1,135,1951,2638,1106,6.92,0,3.1,735375,6412,731339,85.1,35.68,0.6293548387096775,0.87,99.45
2022-06-10,Manipur,682,8,675,8401,2809,129,8.12,0,3.1,736057,6420,732014,90.61,4.16,2.71,0.87,99.45
2022-06-11,Manipur,571,4,568,7238,3081,2814,7.89,0,3.1,736628,6424,732582,99.39,90.77,2.3348387096774195,0.87,99.45
2022-06-12,Manipur,321,2,321,4081,4574,1773,7.87,0,3.1,736949,6426,732903,147.55,57.19,1.3164516129032258,0.87,99.45
2022-06-13,Manipur,535,7,530,6687,4888,873,8.0,0,3.1,737484,6433,733433,157.68,28.16,2.1570967741935485,0.87,99.45
2022-06-14,Manipur,973,6,967,12335,1790,999,7.89,0,3.1,738457,6439,734400,57.74,32.23,3.979032258064516,0.87,99.45
2022-06-15,Manipur,1110,11,1110,14239,3624,404,7.8,0,3.1,739567,6450,735510,116.9,13.03,4.5932258064516125,0.87,99.45
2022-06-16,Manipur,1398,16,1394,17358,1112,999,8.05,0,3.1,740965,6466,736904,35.87,32.23,5.599354838709678,0.87,99.45
2022-06-17,Manipur,396,4,391,5013,2693,2624,7.9,1,3.1,741361,6470,737295,86.87,84.65,1.6170967741935485,0.87,99.45
2022-06-18,Manipur,185,1,183,2609,38,6,7.09,1,3.1,741546,6471,737478,1.23,0.19,0.8416129032258064,0.87,99.45
2022-06-19,Manipur,1344,17,1344,16759,4054,1273,8.02,0,3.1,742890,6488,738822,130.77,41.06,5.406129032258065,0.87,99.45
2022-06-20,Manipur,642,6,637,7510,3226,322,8.55,0,3.1,743532,6494,739459,104.06,10.39,2.42258064516129,0.87,99.45
2022-06-21,Manipur,957,8,949,11656,4532,500,8.21,0,3.1,744489,6502,740408,146.19,16.13,3.76,0.87,99.45
2022-06-22,Manipur,1468,6,1462,18448,4876,2627,7.96,0,3.1,745957,6508,741870,157.29,84.74,5.950967741935484,0.87,99.45
2022-06-23,Manipur,471,6,462,5844,2902,1954,8.06,3,3.1,746428,6514,742332,93.61,63.03,1.8851612903225807,0.87,99.45
2022-06-24,Manipur,538,3,538,6173,4918,2970,8.72,0,3.1,746966,6517,742870,158.65,95.81,1.991290322580645,0.87,99.45
2022-06-25,Manipur,1231,12,1225,15265,1694,395,8.06,0,3.1,748197,6529,744095,54.65,12.74,4.924193548387096,0.87,99.45
2022-06-26,Manipur,386,2,385,5293,4057,2724,7.29,0,3.1,748583,6531,744480,130.87,87.87,1.7074193548387098,0.87,99.45
2022-06-27,Manipur,38,0,35,549,1091,27,6.92,3,3.1,748621,6531,744515,35.19,0.87,0.17709677419354838,0.87,99.45
2022-06-28,Manipur,703,9,701,9023,970,630,7.79,0,3.1,749324,6540,745216,31.29,20.32,2.9106451612903226,0.87,99.45
2022-06-29,Manipur,205,2,202,2384,1208,180,8.6,1,3.1,749529,6542,745418,38.97,5.81,0.7690322580645161,0.87,99.45
2022-06-30,Manipur,382,1,373,4736,3445,3085,8.07,8,3.1,749911,6543,745791,111.13,99.52,1.527741935483871,0.87,99.45
2022-07-01,Manipur,1376,7,1373,17232,4743,712,7.99,0,3.1,751287,6550,747164,153.0,22.97,5.558709677419355,0.87,99.45
2022-07-02,Manipur,382,2,378,4468,1674,144,8.55,2,3.1,751669,6552,747542,54.0,4.65,1.4412903225806453,0.87,99.45
2022-07-03,Manipur,683,4,675,8609,4571,755,7.93,4,3.1,752352,6556,748217,147.45,24.35,2.777096774193548,0.87,99.45
2022-07-04,Manipur,244,1,239,3383,4034,3660,7.21,4,3.1,752596,6557,748456,130.13,118.06,1.0912903225806452,0.87,99.45
2022-07-05,Manipur,1259,4,1258,15974,925,444,7.88,0,3.1,753855,6561,749714,29.84,14.32,5.152903225806452,0.87,99.45
2022-07-06,Manipur,374,2,365,4799,405,351,7.79,7,3.1,754229,6563,750079,13.06,11.32,1.5480645161290323,0.87,99.45
2022-07-07,Manipur,30,0,28,801,1274,33,3.75,2,3.1,754259,6563,750107,41.1,1.06,0.2583870967741935,0.87,99.45
2022-07-08,Manipur,169,0,168,1903,4160,2883,8.88,1,3.1,754428,6563,750275,134.19,93.0,0.6138709677419355,0.87,99.45
2022-07-09,Manipur,1087,10,1087,13589,4438,623,8.0,0,3.1,755515,6573,751362,143.16,20.1,4.383548387096774,0.87,99.45
2022-07-10,Manipur,1342,19,1340,16100,724,24,8.34,0,3.1,756857,6592,752702,23.35,0.77,5.193548387096774,0.87,99.45
2022-07-11,Manipur,454,3,448,5940,4843,1459,7.64,3,3.1,757311,6595,753150,156.23,47.06,1.9161290322580644,0.87,99.45
2022-07-12,Manipur,446,3,439,5462,2558,2485,8.17,4,3.1,757757,6598,753589,82.52,80.16,1.7619354838709678,0.87,99.45
2022-07-13,Manipur,1257,18,1253,15695,1241,1120,8.01,0,3.1,759014,6616,754842,40.03,36.13,5.062903225806451,0.87,99.45
2022-07-14,Manipur,727,6,726,8980,889,553,8.1,0,3.1,759741,6622,755568,28.68,17.84,2.8967741935483873,0.87,99.45
2022-07-15,Manipur,927,12,924,11170,1119,487,8.3,0,3.1,760668,6634,756492,36.1,15.71,3.6032258064516127,0.87,99.45
2022-07-16,Manipur,1221,7,1212,15369,4884,4535,7.94,2,3.1,761889,6641,757704,157.55,146.29,4.957741935483871,0.87,99.45
2022-07-17,Manipur,624,3,621,8200,847,691,7.61,0,3.1,762513,6644,758325,27.32,22.29,2.6451612903225805,0.87,99.45
2022-07-18,Manipur,460,3,457,5588,3413,1336,8.23,0,3.1,762973,6647,758782,110.1,43.1,1.8025806451612902,0.87,99.45
2022-07-19,Manipur,1026,9,1017,13126,1671,119,7.82,0,3.1,763999,6656,759799,53.9,3.84,4.234193548387097,0.87,99.45
2022-07-20,Manipur,1012,4,1007,12596,4407,3857,8.03,1,3.1,765011,6660,760806,142.16,124.42,4.063225806451613,0.87,99.45
2022-07-21,Manipur,663,4,654,7983,1707,1177,8.31,5,3.1,765674,6664,761460,55.06,37.97,2.5751612903225807,0.87,99.45
2022-07-22,Manipur,1343,11,1338,17103,2266,1570,7.85,0,3.1,767017,6675,762798,73.1,50.65,5.517096774193549,0.87,99.45
2022-07-23,Manipur,1413,9,1412,17636,4323,3589,8.01,0,3.1,768430,6684,764210,139.45,115.77,5.6890322580645165,0.87,99.45
2022-07-24,Manipur,1227,10,1227,15155,392,305,8.1,0,3.1,769657,6694,765437,12.65,9.84,4.888709677419355,0.87,99.45
2022-07-25,Manipur,580,5,579,7629,2032,842,7.6,0,3.1,770237,6699,766016,65.55,27.16,2.460967741935484,0.87,99.45
2022-07-26,Manipur,1181,16,1178,15309,786,144,7.71,0,3.1,771418,6715,767194,25.35,4.65,4.938387096774194,0.87,99.45
2022-07-27,Manipur,109,0,100,1152,4063,1325,9.46,9,3.1,771527,6715,767294,131.06,42.74,0.3716129032258065,0.87,99.45
2022-07-28,Manipur,720,9,718,9094,3134,1440,7.92,0,3.1,772247,6724,768012,101.1,46.45,2.9335483870967742,0.87,99.45
2022-07-29,Manipur,525,6,519,6384,2210,1455,8.22,0,3.1,772772,6730,768531,71.29,46.94,2.0593548387096776,0.87,99.45
2022-07-30,Manipur,570,5,569,7049,213,20,8.09,0,3.1,773342,6735,769100,6.87,0.65,2.2738709677419355,0.87,99.45
2022-07-31,Manipur,1023,7,1018,12736,4971,347,8.03,0,3.1,774365,6742,770118,160.35,11.19,4.108387096774194,0.87,99.45
2022-08-01,Manipur,335,4,335,3980,894,540,8.42,0,3.1,774700,6746,770453,28.84,17.42,1.2838709677419355,0.87,99.45
2022-08-02,Manipur,1497,10,1488,19084,3080,2778,7.84,0,3.1,776197,6756,771941,99.35,89.61,6.156129032258065,0.87,99.45
2022-08-03,Manipur,511,5,511,6278,4705,2754,8.14,0,3.1,776708,6761,772452,151.77,88.84,2.025161290322581,0.87,99.45
2022-08-04,Manipur,1208,8,1207,15177,4714,1566,7.96,0,3.1,777916,6769,773659,152.06,50.52,4.895806451612903,0.87,99.45
2022-08-05,Manipur,598,8,592,7643,2083,1663,7.82,0,3.1,778514,6777,774251,67.19,53.65,2.465483870967742,0.87,99.45
2022-08-06,Manipur,803,8,796,10059,4170,2969,7.98,0,3.1,779317,6785,775047,134.52,95.77,3.244838709677419,0.87,99.45
2022-08-07,Manipur,1172,15,1170,14859,3465,3431,7.89,0,3.1,780489,6800,776217,111.77,110.68,4.793225806451613,0.87,99.45
2022-08-08,Manipur,114,1,113,1272,1887,808,8.96,0,3.1,780603,6801,776330,60.87,26.06,0.4103225806451613,0.87,99.45
2022-08-09,Manipur,556,7,550,6688,451,228,8.31,0,3.1,781159,6808,776880,14.55,7.35,2.1574193548387095,0.87,99.45
2022-08-10,Manipur,260,0,260,3359,3290,561,7.74,0,3.1,781419,6808,777140,106.13,18.1,1.0835483870967741,0.87,99.45
2022-08-11,Manipur,251,3,243,2883,4706,1931,8.71,5,3.1,781670,6811,777383,151.81,62.29,0.93,0.87,99.45
2022-08-12,Manipur,459,4,452,5516,4509,1235,8.32,3,3.1,782129,6815,777835,145.45,39.84,1.7793548387096774,0.87,99.45
2022-08-13,Manipur,1448,12,1448,17931,3773,1461,8.08,0,3.1,783577,6827,779283,121.71,47.13,5.784193548387097,0.87,99.45
2022-08-14,Manipur,288,1,286,2974,1189,359,9.68,1,3.1,783865,6828,779569,38.35,11.58,0.9593548387096774,0.87,99.45
2022-08-15,Manipur,1452,18,1447,18233,3943,3410,7.96,0,3.1,785317,6846,781016,127.19,110.0,5.881612903225807,0.87,99.45
2022-08-16,Manipur,372,5,363,4645,1767,699,8.01,4,3.1,785689,6851,781379,57.0,22.55,1.4983870967741935,0.87,99.45
2022-08-17,Manipur,863,4,855,10416,2163,1601,8.29,4,3.1,786552,6855,782234,69.77,51.65,3.36,0.87,99.45
2022-08-18,Manipur,440,4,437,5325,1124,286,8.26,0,3.1,786992,6859,782671,36.26,9.23,1.717741935483871,0.87,99.45
2022-08-19,Manipur,1541,7,1539,19164,1569,1179,8.04,0,3.1,788533,6866,784210,50.61,38.03,6.1819354838709675,0.87,99.45
2022-08-20,Manipur,608,7,602,7934,3021,615,7.66,0,3.1,789141,6873,784812,97.45,19.84,2.5593548387096776,0.87,99.45
2022-08-21,Manipur,847,5,840,10563,773,583,8.02,2,3.1,789988,6878,785652,24.94,18.81,3.4074193548387095,0.87,99.45
2022-08-22,Manipur,366,2,360,4363,3227,2559,8.39,4,3.1,790354,6880,786012,104.1,82.55,1.4074193548387097,0.87,99.45
2022-08-23,Manipur,240,2,235,3088,1911,1455,7.77,3,3.1,790594,6882,786247,61.65,46.94,0.9961290322580645,0.87,99.45
2022-08-24,Manipur,672,2,672,8691,1715,940,7.73,0,3.1,791266,6884,786919,55.32,30.32,2.8035483870967743,0.87,99.45
2022-08-25,Manipur,1372,9,1369,17374,2605,2074,7.9,0,3.1,792638,6893,788288,84.03,66.9,5.604516129032258,0.87,99.45
2022-08-26,Manipur,61,0,56,727,1004,862,8.39,5,3.1,792699,6893,788344,32.39,27.81,0.23451612903225807,0.87,99.45
2022-08-27,Manipur,962,4,962,12377,3366,2733,7.77,0,3.1,793661,6897,789306,108.58,88.16,3.9925806451612904,0.87,99.45
2022-08-28,Manipur,435,3,426,5350,1954,1448,8.13,6,3.1,794096,6900,789732,63.03,46.71,1.7258064516129032,0.87,99.45
2022-08-29,Manipur,690,7,688,8405,3458,3301,8.21,0,3.1,794786,6907,790420,111.55,106.48,2.7112903225806453,0.87,99.45
2022-08-30,Manipur,988,9,981,12485,797,395,7.91,0,3.1,795774,6916,791401,25.71,12.74,4.02741935483871,0.87,99.45
2022-08-31,Manipur,1563,19,1556,19319,3433,114,8.09,0,3.1,797337,6935,792957,110.74,3.68,6.231935483870968,0.87,99.45
2022-09-01,Manipur,1323,15,1315,16893,2633,1974,7.83,0,3.1,798660,6950,794272,84.94,63.68,5.449354838709677,0.87,99.45
2022-09-02,Manipur,821,6,820,9854,3550,2367,8.33,0,3.1,799481,6956,795092,114.52,76.35,3.178709677419355,0.87,99.45
2022-09-03,Manipur,1370,14,1363,16754,981,892,8.18,0,3.1,800851,6970,796455,31.65,28.77,5.404516129032258,0.87,99.45
2022-09-04,Manipur,511,2,507,6496,436,405,7.87,2,3.1,801362,6972,796962,14.06,13.06,2.095483870967742,0.87,99.45
2022-09-05,Manipur,297,2,293,3544,4619,4372,8.38,2,3.1,801659,6974,797255,149.0,141.03,1.143225806451613,0.87,99.45
2022-09-06,Manipur,1571,13,1568,19606,4691,3554,8.01,0,3.1,803230,6987,798823,151.32,114.65,6.324516129032258,0.87,99.45
2022-09-07,Manipur,343,2,337,4227,508,66,8.11,4,3.1,803573,6989,799160,16.39,2.13,1.3635483870967742,0.87,99.45
2022-09-08,Manipur,1138,5,1138,14058,3905,2410,8.1,0,3.1,804711,6994,800298,125.97,77.74,4.53483870967742,0.87,99.45
2022-09-09,Manipur,1187,10,1180,14574,3010,63,8.14,0,3.1,805898,7004,801478,97.1,2.03,4.701290322580645,0.87,99.45
2022-09-10,Manipur,1024,6,1023,12691,4849,732,8.07,0,3.1,806922,7010,802501,156.42,23.61,4.093870967741935,0.87,99.45
2022-09-11,Manipur,124,1,120,1331,2923,1497,9.32,3,3.1,807046,7011,802621,94.29,48.29,0.42935483870967744,0.87,99.45
2022-09-12,Manipur,403,1,400,5433,591,191,7.42,2,3.1,807449,7012,803021,19.06,6.16,1.7525806451612904,0.87,99.45
2022-09-13,Manipur,609,8,603,7346,228,207,8.29,0,3.1,808058,7020,803624,7.35,6.68,2.3696774193548387,0.87,99.45
2022-09-14,Manipur,964,12,961,12108,523,166,7.96,0,3.1,809022,7032,804585,16.87,5.35,3.905806451612903,0.87,99.45
2022-09-15,Manipur,712,6,711,9430,4643,1088,7.55,0,3.1,809734,7038,805296,149.77,35.1,3.041935483870968,0.87,99.45
2022-09-16,Manipur,484,4,482,5708,1438,314,8.48,0,3.1,810218,7042,805778,46.39,10.13,1.8412903225806452,0.87,99.45
2022-09-17,Manipur,1401,14,1396,17538,350,170,7.99,0,3.1,811619,7056,807174,11.29,5.48,5.6574193548387095,0.87,99.45
2022-09-18,Manipur,118,1,118,1425,2356,638,8.28,0,3.1,811737,7057,807292,76.0,20.58,0.4596774193548387,0.87,99.45
2022-09-19,Manipur,990,9,988,12957,953,473,7.64,0,3.1,812727,7066,808280,30.74,15.26,4.179677419354839,0.87,99.45
2022-09-20,Manipur,445,6,442,5283,768,415,8.42,0,3.1,813172,7072,808722,24.77,13.39,1.7041935483870967,0.87,99.45
2022-09-21,Manipur,947,10,945,11638,3579,3419,8.14,0,3.1,814119,7082,809667,115.45,110.29,3.754193548387097,0.87,99.45
2022-09-22,Manipur,1413,19,1409,17650,3578,851,8.01,0,3.1,815532,7101,811076,115.42,27.45,5.693548387096774,0.87,99.45
2022-09-23,Manipur,400,3,391,4968,4213,1407,8.05,6,3.1,815932,7104,811467,135.9,45.39,1.6025806451612903,0.87,99.45
2022-09-24,Manipur,1135,3,1129,14149,3368,1390,8.02,3,3.1,817067,7107,812596,108.65,44.84,4.564193548387097,0.87,99.45
2022-09-25,Manipur,250,1,245,2970,3941,1818,8.42,4,3.1,817317,7108,812841,127.13,58.65,0.9580645161290322,0.87,99.45
2022-09-26,Manipur,785,8,782,9695,2461,735,8.1,0,3.1,818102,7116,813623,79.39,23.71,3.1274193548387097,0.87,99.45
2022-09-27,Manipur,1225,14,1216,15392,4929,231,7.96,0,3.1,819327,7130,814839,159.0,7.45,4.96516129032258,0.87,99.45
2022-09-28,Manipur,800,6,794,9631,1189,117,8.31,0,3.1,820127,7136,815633,38.35,3.77,3.1067741935483872,0.87,99.45
2022-09-29,Manipur,502,5,496,5947,3890,1758,8.44,1,3.1,820629,7141,816129,125.48,56.71,1.9183870967741936,0.87,99.45
2022-09-30,Manipur,1040,12,1039,12866,1369,174,8.08,0,3.1,821669,7153,817168,44.16,5.61,4.150322580645161,0.87,99.45
2022-10-01,Manipur,535,2,533,7063,3448,2392,7.57,0,3.1,822204,7155,817701,111.23,77.16,2.2783870967741935,0.87,99.45
2022-10-02,Manipur,115,0,107,928,1545,76,12.39,8,3.1,822319,7155,817808,49.84,2.45,0.29935483870967744,0.87,99.45
2022-10-03,Manipur,92,1,92,1249,1416,654,7.37,0,3.1,822411,7156,817900,45.68,21.1,0.4029032258064516,0.87,99.45
2022-10-04,Manipur,1374,4,1366,17246,1143,729,7.97,4,3.1,823785,7160,819266,36.87,23.52,5.563225806451613,0.87,99.45
2022-10-05,Manipur,735,8,728,9294,1304,853,7.91,0,3.1,824520,7168,819994,42.06,27.52,2.9980645161290322,0.87,99.45
2022-10-06,Manipur,423,4,423,4995,465,357,8.47,0,3.1,824943,7172,820417,15.0,11.52,1.6112903225806452,0.87,99.45
2022-10-07,Manipur,1067,10,1061,12919,3583,2946,8.26,0,3.1,826010,7182,821478,115.58,95.03,4.167419354838709,0.87,99.45
2022-10-08,Manipur,70,0,61,844,4992,3544,8.29,9,3.1,826080,7182,821539,161.03,114.32,0.27225806451612905,0.87,99.45
2022-10-09,Manipur,1039,7,1037,13264,4605,1574,7.83,0,3.1,827119,7189,822576,148.55,50.77,4.2787096774193545,0.87,99.45
2022-10-10,Manipur,1276,15,1272,16376,2815,1055,7.79,0,3.1,828395,7204,823848,90.81,34.03,5.28258064516129,0.87,99.45
2022-10-11,Manipur,1385,19,1382,17398,3054,2830,7.96,0,3.1,829780,7223,825230,98.52,91.29,5.612258064516129,0.87,99.45
2022-10-12,Manipur,455,1,453,6041,1339,284,7.53,1,3.1,830235,7224,825683,43.19,9.16,1.9487096774193549,0.87,99.45
2022-10-13,Manipur,1066,12,1063,13565,3290,2351,7.86,0,3.1,831301,7236,826746,106.13,75.84,4.375806451612903,0.87,99.45
2022-10-14,Manipur,1379,12,1375,17635,2248,1475,7.82,0,3.1,832680,7248,828121,72.52,47.58,5.688709677419355,0.87,99.45
2022-10-15,Manipur,1519,5,1516,18742,4993,330,8.1,0,3.1,834199,7253,829637,161.06,10.65,6.045806451612903,0.87,99.45
2022-10-16,Manipur,547,1,546,7051,4683,405,7.76,0,3.1,834746,7254,830183,151.06,13.06,2.274516129032258,0.87,99.45
2022-10-17,Manipur,771,4,769,9803,722,576,7.86,0,3.1,835517,7258,830952,23.29,18.58,3.162258064516129,0.87,99.45
2022-10-18,Manipur,1557,18,1556,19419,442,69,8.02,0,3.1,837074,7276,832508,14.26,2.23,6.264193548387097,0.87,99.45
2022-10-19,Manipur,118,1,112,1594,3050,2256,7.4,5,3.1,837192,7277,832620,98.39,72.77,0.5141935483870967,0.87,99.45
2022-10-20,Manipur,656,4,647,8006,1699,693,8.19,5,3.1,837848,7281,833267,54.81,22.35,2.5825806451612903,0.87,99.45
2022-10-21,Manipur,752,8,743,9107,327,202,8.26,1,3.1,838600,7289,834010,10.55,6.52,2.9377419354838707,0.87,99.45
2022-10-22,Manipur,582,2,580,7154,1522,522,8.14,0,3.1,839182,7291,834590,49.1,16.84,2.307741935483871,0.87,99.45
2022-10-23,Manipur,1350,10,1341,17017,1717,339,7.93,0,3.1,840532,7301,835931,55.39,10.94,5.489354838709677,0.87,99.45
2022-10-24,Manipur,306,3,301,3626,3089,1544,8.44,2,3.1,840838,7304,836232,99.65,49.81,1.1696774193548387,0.87,99.45
2022-10-25,Manipur,368,3,368,4082,4553,1357,9.02,0,3.1,841206,7307,836600,146.87,43.77,1.3167741935483872,0.87,99.45
2022-10-26,Manipur,1493,10,1489,18963,3110,1675,7.87,0,3.1,842699,7317,838089,100.32,54.03,6.1170967741935485,0.87,99.45
2022-10-27,Manipur,346,3,341,4649,2749,1864,7.44,2,3.1,843045,7320,838430,88.68,60.13,1.4996774193548388,0.87,99.45
2022-10-28,Manipur,806,4,798,9539,4074,3271,8.45,4,3.1,843851,7324,839228,131.42,105.52,3.0770967741935484,0.87,99.45
2022-10-29,Manipur,545,4,537,6839,4670,276,7.97,4,3.1,844396,7328,839765,150.65,8.9,2.2061290322580644,0.87,99.45
2022-10-30,Manipur,609,6,601,7656,2891,2827,7.95,2,3.1,845005,7334,840366,93.26,91.19,2.4696774193548388,0.87,99.45
2022-10-31,Manipur,821,11,819,10331,26,13,7.95,0,3.1,845826,7345,841185,0.84,0.42,3.3325806451612903,0.87,99.45
2022-11-01,Manipur,363,5,357,4182,2354,172,8.68,1,3.1,846189,7350,841542,75.94,5.55,1.3490322580645162,0.87,99.45
2022-11-02,Manipur,457,3,456,5530,874,503,8.26,0,3.1,846646,7353,841998,28.19,16.23,1.7838709677419355,0.87,99.45
2022-11-03,Manipur,1387,5,1387,17102,367,45,8.11,0,3.1,848033,7358,843385,11.84,1.45,5.516774193548387,0.87,99.45
2022-11-04,Manipur,870,9,866,10678,1514,1343,8.15,0,3.1,848903,7367,844251,48.84,43.32,3.444516129032258,0.87,99.45
2022-11-05,Manipur,929,13,926,11254,1932,1036,8.25,0,3.1,849832,7380,845177,62.32,33.42,3.6303225806451613,0.87,99.45
2022-11-06,Manipur,62,0,57,783,2085,1051,7.92,5,3.1,849894,7380,845234,67.26,33.9,0.2525806451612903,0.87,99.45
2022-11-07,Manipur,551,5,548,6633,224,179,8.31,0,3.1,850445,7385,845782,7.23,5.77,2.1396774193548387,0.87,99.45
2022-11-08,Manipur,392,4,388,4636,4933,2301,8.46,0,3.1,850837,7389,846170,159.13,74.23,1.495483870967742,0.87,99.45
2022-11-09,Manipur,1140,5,1132,13974,1997,296,8.16,3,3.1,851977,7394,847302,64.42,9.55,4.507741935483871,0.87,99.45
2022-11-10,Manipur,513,6,512,6090,429,37,8.42,0,3.1,852490,7400,847814,13.84,1.19,1.9645161290322581,0.87,99.45
2022-11-11,Manipur,461,3,457,5804,1846,1150,7.94,1,3.1,852951,7403,848271,59.55,37.1,1.872258064516129,0.87,99.45
2022-11-12,Manipur,668,4,662,8666,2530,1478,7.71,2,3.1,853619,7407,848933,81.61,47.68,2.795483870967742,0.87,99.45
2022-11-13,Manipur,1388,13,1388,17518,213,176,7.92,0,3.1,855007,7420,850321,6.87,5.68,5.650967741935484,0.87,99.45
2022-11-14,Manipur,1509,6,1505,19305,3129,471,7.82,0,3.1,856516,7426,851826,100.94,15.19,6.22741935483871,0.87,99.45
2022-11-15,Manipur,906,5,906,11202,3996,712,8.09,0,3.1,857422,7431,852732,128.9,22.97,3.6135483870967744,0.87,99.45
2022-11-16,Manipur,1232,5,1226,15754,4492,3550,7.82,1,3.1,858654,7436,853958,144.9,114.52,5.081935483870968,0.87,99.45
2022-11-17,Manipur,1274,14,1270,15497,3901,2761,8.22,0,3.1,859928,7450,855228,125.84,89.06,4.999032258064516,0.87,99.45
2022-11-18,Manipur,419,1,418,5558,1544,1370,7.54,0,3.1,860347,7451,855646,49.81,44.19,1.7929032258064517,0.87,99.45
2022-11-19,Manipur,1092,12,1090,13375,3735,489,8.16,0,3.1,861439,7463,856736,120.48,15.77,4.314516129032258,0.87,99.45
2022-11-20,Manipur,143,0,137,1609,4299,3860,8.89,6,3.1,861582,7463,856873,138.68,124.52,0.5190322580645161,0.87,99.45
2022-11-21,Manipur,1360,17,1359,17048,2481,2,7.98,0,3.1,862942,7480,858232,80.03,0.06,5.499354838709677,0.87,99.45
2022-11-22,Manipur,1446,17,1437,18178,420,25,7.95,0,3.1,864388,7497,859669,13.55,0.81,5.863870967741936,0.87,99.45
2022-11-23,Manipur,612,6,607,7630,1161,386,8.02,0,3.1,865000,7503,860276,37.45,12.45,2.4612903225806453,0.87,99.45
2022-11-24,Manipur,695,7,693,8879,2465,865,7.83,0,3.1,865695,7510,860969,79.52,27.9,2.864193548387097,0.87,99.45
2022-11-25,Manipur,391,4,388,4618,4169,752,8.47,0,3.1,866086,7514,861357,134.48,24.26,1.4896774193548388,0.87,99.45
2022-11-26,Manipur,948,10,944,11939,3606,1494,7.94,0,3.1,867034,7524,862301,116.32,48.19,3.851290322580645,0.87,99.45
2022-11-27,Manipur,1508,17,1499,19112,2337,457,7.89,0,3.1,868542,7541,863800,75.39,14.74,6.1651612903225805,0.87,99.45
2022-11-28,Manipur,383,2,375,5132,4349,3340,7.46,6,3.1,868925,7543,864175,140.29,107.74,1.655483870967742,0.87,99.45
2022-11-29,Manipur,301,2,293,3842,1557,1230,7.83,6,3.1,869226,7545,864468,50.23,39.68,1.2393548387096773,0.87,99.45
2022-11-30,Manipur,871,3,868,10817,109,65,8.05,0,3.1,870097,7548,865336,3.52,2.1,3.4893548387096773,0.87,99.45
2022-12-01,Manipur,653,8,646,8247,659,136,7.92,0,3.1,870750,7556,865982,21.26,4.39,2.660322580645161,0.87,99.45
2022-12-02,Manipur,1156,11,1156,14568,1613,1437,7.94,0,3.1,871906,7567,867138,52.03,46.35,4.699354838709677,0.87,99.45
2022-12-03,Manipur,288,3,286,3541,2548,2418,8.13,0,3.1,872194,7570,867424,82.19,78.0,1.142258064516129,0.87,99.45
2022-12-04,Manipur,1473,19,1471,18291,1532,1115,8.05,0,3.1,873667,7589,868895,49.42,35.97,5.900322580645161,0.87,99.45
2022-12-05,Manipur,745,2,744,9590,1149,863,7.77,0,3.1,874412,7591,869639,37.06,27.84,3.0935483870967744,0.87,99.45
2022-12-06,Manipur,478,3,470,5698,4901,1815,8.39,5,3.1,874890,7594,870109,158.1,58.55,1.8380645161290323,0.87,99.45
2022-12-07,Manipur,1241,18,1237,15580,373,322,7.97,0,3.1,876131,7612,871346,12.03,10.39,5.025806451612903,0.87,99.45
2022-12-08,Manipur,982,3,977,11958,3147,1512,8.21,2,3.1,877113,7615,872323,101.52,48.77,3.8574193548387097,0.87,99.45
2022-12-09,Manipur,1216,14,1207,15014,4455,2014,8.1,0,3.1,878329,7629,873530,143.71,64.97,4.8432258064516125,0.87,99.45
2022-12-10,Manipur,1461,5,1453,18409,2231,1479,7.94,3,3.1,879790,7634,874983,71.97,47.71,5.938387096774194,0.87,99.45
2022-12-11,Manipur,219,1,215,2725,4618,2541,8.04,3,3.1,880009,7635,875198,148.97,81.97,0.8790322580645161,0.87,99.45
2022-12-12,Manipur,213,1,211,3334,2264,2050,6.39,1,3.1,880222,7636,875409,73.03,66.13,1.075483870967742,0.87,99.45
2022-12-13,Manipur,857,7,855,10678,2712,2316,8.03,0,3.1,881079,7643,876264,87.48,74.71,3.444516129032258,0.87,99.45
2022-12-14,Manipur,1514,20,1511,19166,4596,250,7.9,0,3.1,882593,7663,877775,148.26,8.06,6.18258064516129,0.87,99.45
2022-12-15,Manipur,318,2,310,3715,1151,473,8.56,6,3.1,882911,7665,878085,37.13,15.26,1.1983870967741936,0.87,99.45
2022-12-16,Manipur,1060,7,1057,13674,2354,710,7.75,0,3.1,883971,7672,879142,75.94,22.9,4.410967741935484,0.87,99.45
2022-12-17,Manipur,1189,17,1189,14856,3763,1268,8.0,0,3.1,885160,7689,880331,121.39,40.9,4.792258064516129,0.87,99.45
2022-12-18,Manipur,336,1,330,4232,3528,3475,7.94,5,3.1,885496,7690,880661,113.81,112.1,1.3651612903225807,0.87,99.45
2022-12-19,Manipur,1235,15,1234,15639,4906,2267,7.9,0,3.1,886731,7705,881895,158.26,73.13,5.044838709677419,0.87,99.45
2022-12-20,Manipur,405,1,400,5239,3811,218,7.73,4,3.1,887136,7706,882295,122.94,7.03,1.69,0.87,99.45
2022-12-21,Manipur,498,6,489,6072,3577,1884,8.2,3,3.1,887634,7712,882784,115.39,60.77,1.9587096774193549,0.87,99.45
2022-12-22,Manipur,385,1,376,5178,3078,1768,7.44,8,3.1,888019,7713,883160,99.29,57.03,1.6703225806451614,0.87,99.45
2022-12-23,Manipur,1311,10,1310,16375,982,514,8.01,0,3.1,889330,7723,884470,31.68,16.58,5.282258064516129,0.87,99.45
2022-12-24,Manipur,1630,19,1624,19804,563,221,8.23,0,3.1,890960,7742,886094,18.16,7.13,6.388387096774194,0.87,99.45
2022-12-25,Manipur,134,0,125,2165,609,471,6.19,9,3.1,891094,7742,886219,19.65,15.19,0.6983870967741935,0.87,99.45
2022-12-26,Manipur,250,0,243,3049,385,47,8.2,7,3.1,891344,7742,886462,12.42,1.52,0.9835483870967742,0.87,99.45
2022-12-27,Manipur,1103,9,1103,13873,2701,322,7.95,0,3.1,892447,7751,887565,87.13,10.39,4.475161290322581,0.87,99.45
2022-12-28,Manipur,1298,3,1296,16135,1664,1190,8.04,0,3.1,893745,7754,888861,53.68,38.39,5.20483870967742,0.87,99.45
2022-12-29,Manipur,1036,13,1027,13014,617,385,7.96,0,3.1,894781,7767,889888,19.9,12.42,4.198064516129032,0.87,99.45
2022-12-30,Manipur,1391,11,1386,17638,498,154,7.89,0,3.1,896172,7778,891274,16.06,4.97,5.6896774193548385,0.87,99.45
2022-12-31,Manipur,80,0,78,918,1838,1793,8.71,2,3.1,896252,7778,891352,59.29,57.84,0.29612903225806453,0.87,99.45
2020-01-01,Meghalaya,165,1,162,2278,2931,1367,7.24,2,3.6,165,1,162,81.42,37.97,0.6327777777777778,0.61,98.18
2020-01-02,Meghalaya,1303,6,1303,16393,762,642,7.95,0,3.6,1468,7,1465,21.17,17.83,4.5536111111111115,0.48,99.8
2020-01-03,Meghalaya,736,6,736,9219,4373,489,7.98,0,3.6,2204,13,2201,121.47,13.58,2.5608333333333335,0.59,99.86
2020-01-04,Meghalaya,1268,6,1260,15779,3516,511,8.04,2,3.6,3472,19,3461,97.67,14.19,4.383055555555556,0.55,99.68
2020-01-05,Meghalaya,688,9,687,8100,3825,2159,8.49,0,3.6,4160,28,4148,106.25,59.97,2.25,0.67,99.71
2020-01-06,Meghalaya,347,3,346,4284,612,319,8.1,0,3.6,4507,31,4494,17.0,8.86,1.19,0.69,99.71
2020-01-07,Meghalaya,900,4,893,11238,4974,1508,8.01,3,3.6,5407,35,5387,138.17,41.89,3.1216666666666666,0.65,99.63
2020-01-08,Meghalaya,900,7,900,11412,4719,519,7.89,0,3.6,6307,42,6287,131.08,14.42,3.17,0.67,99.68
2020-01-09,Meghalaya,1168,9,1168,14659,4154,3510,7.97,0,3.6,7475,51,7455,115.39,97.5,4.071944444444444,0.68,99.73
2020-01-10,Meghalaya,263,1,262,3284,2460,1948,8.01,0,3.6,7738,52,7717,68.33,54.11,0.9122222222222223,0.67,99.73
2020-01-11,Meghalaya,251,3,249,3169,1508,608,7.92,0,3.6,7989,55,7966,41.89,16.89,0.8802777777777778,0.69,99.71
2020-01-12,Meghalaya,528,2,526,6355,1573,1091,8.31,0,3.6,8517,57,8492,43.69,30.31,1.7652777777777777,0.67,99.71
2020-01-13,Meghalaya,1369,6,1361,16952,158,22,8.08,2,3.6,9886,63,9853,4.39,0.61,4.708888888888889,0.64,99.67
2020-01-14,Meghalaya,609,5,602,7560,600,448,8.06,2,3.6,10495,68,10455,16.67,12.44,2.1,0.65,99.62
2020-01-15,Meghalaya,1150,8,1145,14080,608,131,8.17,0,3.6,11645,76,11600,16.89,3.64,3.911111111111111,0.65,99.61
2020-01-16,Meghalaya,641,6,635,7915,3707,581,8.1,0,3.6,12286,82,12235,102.97,16.14,2.198611111111111,0.67,99.58
2020-01-17,Meghalaya,1225,8,1221,14791,3350,2702,8.28,0,3.6,13511,90,13456,93.06,75.06,4.108611111111111,0.67,99.59
2020-01-18,Meghalaya,856,3,856,10419,1113,814,8.22,0,3.6,14367,93,14312,30.92,22.61,2.8941666666666666,0.65,99.62
2020-01-19,Meghalaya,1211,17,1208,14710,3490,926,8.23,0,3.6,15578,110,15520,96.94,25.72,4.086111111111111,0.71,99.63
2020-01-20,Meghalaya,1506,20,1504,19264,3095,779,7.82,0,3.6,17084,130,17024,85.97,21.64,5.351111111111111,0.76,99.65
2020-01-21,Meghalaya,46,0,45,740,2093,287,6.22,1,3.6,17130,130,17069,58.14,7.97,0.20555555555555555,0.76,99.64
2020-01-22,Meghalaya,1175,16,1170,14923,290,112,7.87,0,3.6,18305,146,18239,8.06,3.11,4.145277777777777,0.8,99.64
2020-01-23,Meghalaya,680,3,679,8586,476,413,7.92,0,3.6,18985,149,18918,13.22,11.47,2.385,0.78,99.65
2020-01-24,Meghalaya,499,5,491,6463,3434,1374,7.72,3,3.6,19484,154,19409,95.39,38.17,1.7952777777777778,0.79,99.62
2020-01-25,Meghalaya,1419,15,1413,17083,113,45,8.31,0,3.6,20903,169,20822,3.14,1.25,4.745277777777778,0.81,99.61
2020-01-26,Meghalaya,448,3,442,5406,675,298,8.29,3,3.6,21351,172,21264,18.75,8.28,1.5016666666666667,0.81,99.59
2020-01-27,Meghalaya,919,5,911,11400,353,260,8.06,3,3.6,22270,177,22175,9.81,7.22,3.1666666666666665,0.79,99.57
2020-01-28,Meghalaya,821,11,812,10302,448,401,7.97,0,3.6,23091,188,22987,12.44,11.14,2.861666666666667,0.81,99.55
2020-01-29,Meghalaya,1020,5,1019,12800,1761,1530,7.97,0,3.6,24111,193,24006,48.92,42.5,3.5555555555555554,0.8,99.56
2020-01-30,Meghalaya,128,1,121,1403,4209,127,9.12,6,3.6,24239,194,24127,116.92,3.53,0.38972222222222225,0.8,99.54
2020-01-31,Meghalaya,979,13,971,12392,3102,2973,7.9,0,3.6,25218,207,25098,86.17,82.58,3.442222222222222,0.82,99.52
2020-02-01,Meghalaya,1371,18,1370,16977,2697,326,8.08,0,3.6,26589,225,26468,74.92,9.06,4.715833333333333,0.85,99.54
2020-02-02,Meghalaya,974,13,967,12464,2657,2107,7.81,0,3.6,27563,238,27435,73.81,58.53,3.462222222222222,0.86,99.54
2020-02-03,Meghalaya,1273,4,1265,15719,3690,2143,8.1,4,3.6,28836,242,28700,102.5,59.53,4.366388888888889,0.84,99.53
2020-02-04,Meghalaya,255,3,253,3099,278,155,8.23,0,3.6,29091,245,28953,7.72,4.31,0.8608333333333333,0.84,99.53
2020-02-05,Meghalaya,623,3,614,7771,565,138,8.02,6,3.6,29714,248,29567,15.69,3.83,2.158611111111111,0.83,99.51
2020-02-06,Meghalaya,395,1,389,5125,650,305,7.71,5,3.6,30109,249,29956,18.06,8.47,1.4236111111111112,0.83,99.49
2020-02-07,Meghalaya,53,0,50,1094,455,59,4.84,3,3.6,30162,249,30006,12.64,1.64,0.3038888888888889,0.83,99.48
2020-02-08,Meghalaya,1278,10,1275,15833,1823,843,8.07,0,3.6,31440,259,31281,50.64,23.42,4.398055555555556,0.82,99.49
2020-02-09,Meghalaya,1624,9,1622,19929,4370,3963,8.15,0,3.6,33064,268,32903,121.39,110.08,5.535833333333334,0.81,99.51
2020-02-10,Meghalaya,1001,8,994,12218,2776,1601,8.19,0,3.6,34065,276,33897,77.11,44.47,3.3938888888888887,0.81,99.51
2020-02-11,Meghalaya,907,8,902,11501,1958,1646,7.89,0,3.6,34972,284,34799,54.39,45.72,3.194722222222222,0.81,99.51
2020-02-12,Meghalaya,1413,6,1411,17598,4860,1783,8.03,0,3.6,36385,290,36210,135.0,49.53,4.888333333333334,0.8,99.52
2020-02-13,Meghalaya,954,7,954,12078,4599,3651,7.9,0,3.6,37339,297,37164,127.75,101.42,3.355,0.8,99.53
2020-02-14,Meghalaya,966,9,961,12045,1599,1054,8.02,0,3.6,38305,306,38125,44.42,29.28,3.345833333333333,0.8,99.53
2020-02-15,Meghalaya,47,0,38,729,719,138,6.45,9,3.6,38352,306,38163,19.97,3.83,0.2025,0.8,99.51
2020-02-16,Meghalaya,1409,10,1408,17533,1506,530,8.04,0,3.6,39761,316,39571,41.83,14.72,4.870277777777778,0.79,99.52
2020-02-17,Meghalaya,753,2,751,9400,4408,1337,8.01,0,3.6,40514,318,40322,122.44,37.14,2.611111111111111,0.78,99.53
2020-02-18,Meghalaya,82,1,81,1049,1612,727,7.82,0,3.6,40596,319,40403,44.78,20.19,0.29138888888888886,0.79,99.52
2020-02-19,Meghalaya,1500,14,1495,18129,1175,656,8.27,0,3.6,42096,333,41898,32.64,18.22,5.035833333333334,0.79,99.53
2020-02-20,Meghalaya,1571,22,1568,19360,4145,2034,8.11,0,3.6,43667,355,43466,115.14,56.5,5.377777777777778,0.81,99.54
2020-02-21,Meghalaya,624,2,615,7229,2195,1092,8.63,7,3.6,44291,357,44081,60.97,30.33,2.0080555555555555,0.81,99.53
2020-02-22,Meghalaya,238,3,232,3169,4799,1244,7.51,3,3.6,44529,360,44313,133.31,34.56,0.8802777777777778,0.81,99.51
2020-02-23,Meghalaya,1343,16,1336,17139,1924,220,7.84,0,3.6,45872,376,45649,53.44,6.11,4.760833333333333,0.82,99.51
2020-02-24,Meghalaya,1244,8,1240,15421,762,259,8.07,0,3.6,47116,384,46889,21.17,7.19,4.283611111111111,0.82,99.52
2020-02-25,Meghalaya,162,2,154,2113,469,297,7.67,6,3.6,47278,386,47043,13.03,8.25,0.5869444444444445,0.82,99.5
2020-02-26,Meghalaya,156,2,151,1582,4778,2846,9.86,3,3.6,47434,388,47194,132.72,79.06,0.43944444444444447,0.82,99.49
2020-02-27,Meghalaya,478,6,475,5716,24,16,8.36,0,3.6,47912,394,47669,0.67,0.44,1.5877777777777777,0.82,99.49
2020-02-28,Meghalaya,1446,12,1438,17990,3389,2380,8.04,0,3.6,49358,406,49107,94.14,66.11,4.997222222222222,0.82,99.49
2020-02-29,Meghalaya,1462,21,1459,18067,3136,2803,8.09,0,3.6,50820,427,50566,87.11,77.86,5.018611111111111,0.84,99.5
2020-03-01,Meghalaya,695,3,692,8661,528,113,8.02,0,3.6,51515,430,51258,14.67,3.14,2.4058333333333333,0.83,99.5
2020-03-02,Meghalaya,1303,14,1300,16322,1415,241,7.98,0,3.6,52818,444,52558,39.31,6.69,4.533888888888889,0.84,99.51
2020-03-03,Meghalaya,724,8,718,9043,204,94,8.01,0,3.6,53542,452,53276,5.67,2.61,2.5119444444444445,0.84,99.5
2020-03-04,Meghalaya,1522,5,1516,19324,1117,497,7.88,1,3.6,55064,457,54792,31.03,13.81,5.3677777777777775,0.83,99.51
2020-03-05,Meghalaya,625,8,616,7562,1929,480,8.27,1,3.6,55689,465,55408,53.58,13.33,2.1005555555555557,0.83,99.5
2020-03-06,Meghalaya,584,4,581,7108,2745,1190,8.22,0,3.6,56273,469,55989,76.25,33.06,1.9744444444444444,0.83,99.5
2020-03-07,Meghalaya,347,3,339,4071,2708,1155,8.52,5,3.6,56620,472,56328,75.22,32.08,1.1308333333333334,0.83,99.48
2020-03-08,Meghalaya,92,0,90,1167,1204,737,7.88,2,3.6,56712,472,56418,33.44,20.47,0.32416666666666666,0.83,99.48
2020-03-09,Meghalaya,576,7,571,7455,1016,523,7.73,0,3.6,57288,479,56989,28.22,14.53,2.0708333333333333,0.84,99.48
2020-03-10,Meghalaya,428,2,423,4941,2251,1367,8.66,3,3.6,57716,481,57412,62.53,37.97,1.3725,0.83,99.47
2020-03-11,Meghalaya,1193,11,1184,14330,2058,1741,8.33,0,3.6,58909,492,58596,57.17,48.36,3.9805555555555556,0.84,99.47
2020-03-12,Meghalaya,502,1,500,6045,1571,1378,8.3,1,3.6,59411,493,59096,43.64,38.28,1.6791666666666667,0.83,99.47
2020-03-13,Meghalaya,964,10,955,11873,3895,2455,8.12,0,3.6,60375,503,60051,108.19,68.19,3.2980555555555555,0.83,99.46
2020-03-14,Meghalaya,588,2,583,7722,13,6,7.61,3,3.6,60963,505,60634,0.36,0.17,2.145,0.83,99.46
2020-03-15,Meghalaya,1279,7,1274,15870,511,0,8.06,0,3.6,62242,512,61908,14.19,0.0,4.408333333333333,0.82,99.46
2020-03-16,Meghalaya,638,4,630,8238,1906,605,7.74,4,3.6,62880,516,62538,52.94,16.81,2.2883333333333336,0.82,99.46
2020-03-17,Meghalaya,277,1,273,3721,4581,396,7.44,3,3.6,63157,517,62811,127.25,11.0,1.033611111111111,0.82,99.45
2020-03-18,Meghalaya,1357,9,1353,17071,744,743,7.95,0,3.6,64514,526,64164,20.67,20.64,4.741944444444444,0.82,99.46
2020-03-19,Meghalaya,1024,14,1024,12801,3730,140,8.0,0,3.6,65538,540,65188,103.61,3.89,3.555833333333333,0.82,99.47
2020-03-20,Meghalaya,1237,7,1229,15566,3237,2709,7.95,1,3.6,66775,547,66417,89.92,75.25,4.323888888888889,0.82,99.46
2020-03-21,Meghalaya,513,1,504,6386,1396,208,8.03,8,3.6,67288,548,66921,38.78,5.78,1.7738888888888888,0.81,99.45
2020-03-22,Meghalaya,313,3,310,4011,1421,1085,7.8,0,3.6,67601,551,67231,39.47,30.14,1.1141666666666667,0.82,99.45
2020-03-23,Meghalaya,1329,19,1321,16580,194,189,8.02,0,3.6,68930,570,68552,5.39,5.25,4.605555555555555,0.83,99.45
2020-03-24,Meghalaya,1505,5,1496,18801,2391,913,8.0,4,3.6,70435,575,70048,66.42,25.36,5.2225,0.82,99.45
2020-03-25,Meghalaya,69,0,67,869,4830,3383,7.94,2,3.6,70504,575,70115,134.17,93.97,0.24138888888888888,0.82,99.45
2020-03-26,Meghalaya,447,5,442,5299,4842,4452,8.44,0,3.6,70951,580,70557,134.5,123.67,1.4719444444444445,0.82,99.44
2020-03-27,Meghalaya,231,1,225,2795,4500,3913,8.26,5,3.6,71182,581,70782,125.0,108.69,0.7763888888888889,0.82,99.44
2020-03-28,Meghalaya,221,2,218,3238,3032,2251,6.83,1,3.6,71403,583,71000,84.22,62.53,0.8994444444444445,0.82,99.44
2020-03-29,Meghalaya,1394,9,1394,17617,1292,587,7.91,0,3.6,72797,592,72394,35.89,16.31,4.893611111111111,0.81,99.45
2020-03-30,Meghalaya,616,2,608,7764,3808,1321,7.93,6,3.6,73413,594,73002,105.78,36.69,2.1566666666666667,0.81,99.44
2020-03-31,Meghalaya,286,0,282,3644,2059,1903,7.85,4,3.6,73699,594,73284,57.19,52.86,1.0122222222222221,0.81,99.44
2020-04-01,Meghalaya,1550,11,1548,19349,1370,983,8.01,0,3.6,75249,605,74832,38.06,27.31,5.374722222222222,0.8,99.45
2020-04-02,Meghalaya,1263,10,1255,15735,2437,38,8.03,0,3.6,76512,615,76087,67.69,1.06,4.370833333333334,0.8,99.44
2020-04-03,Meghalaya,1319,6,1315,16036,3442,1815,8.23,0,3.6,77831,621,77402,95.61,50.42,4.454444444444444,0.8,99.45
2020-04-04,Meghalaya,1526,8,1523,19022,692,199,8.02,0,3.6,79357,629,78925,19.22,5.53,5.283888888888889,0.79,99.46
2020-04-05,Meghalaya,521,2,515,6469,4172,1401,8.05,4,3.6,79878,631,79440,115.89,38.92,1.7969444444444445,0.79,99.45
2020-04-06,Meghalaya,1380,17,1374,17001,3368,3286,8.12,0,3.6,81258,648,80814,93.56,91.28,4.7225,0.8,99.45
2020-04-07,Meghalaya,1553,13,1553,19385,1599,356,8.01,0,3.6,82811,661,82367,44.42,9.89,5.384722222222222,0.8,99.46
2020-04-08,Meghalaya,326,4,319,3923,2604,41,8.31,3,3.6,83137,665,82686,72.33,1.14,1.0897222222222223,0.8,99.46
2020-04-09,Meghalaya,1037,13,1029,12715,417,51,8.16,0,3.6,84174,678,83715,11.58,1.42,3.5319444444444446,0.81,99.45
2020-04-10,Meghalaya,1205,11,1201,14546,3129,3028,8.28,0,3.6,85379,689,84916,86.92,84.11,4.040555555555556,0.81,99.46
2020-04-11,Meghalaya,1154,8,1154,14427,1331,424,8.0,0,3.6,86533,697,86070,36.97,11.78,4.0075,0.81,99.46
2020-04-12,Meghalaya,975,13,967,12095,4085,623,8.06,0,3.6,87508,710,87037,113.47,17.31,3.359722222222222,0.81,99.46
2020-04-13,Meghalaya,306,3,305,3738,4805,2500,8.19,0,3.6,87814,713,87342,133.47,69.44,1.0383333333333333,0.81,99.46
2020-04-14,Meghalaya,252,2,246,3148,2464,2196,8.01,4,3.6,88066,715,87588,68.44,61.0,0.8744444444444445,0.81,99.46
2020-04-15,Meghalaya,1440,16,1434,18195,3893,1774,7.91,0,3.6,89506,731,89022,108.14,49.28,5.054166666666666,0.82,99.46
2020-04-16,Meghalaya,704,9,696,8907,1625,1167,7.9,0,3.6,90210,740,89718,45.14,32.42,2.4741666666666666,0.82,99.45
2020-04-17,Meghalaya,788,4,779,9679,1276,1126,8.14,5,3.6,90998,744,90497,35.44,31.28,2.6886111111111113,0.82,99.45
2020-04-18,Meghalaya,786,7,780,9747,6,0,8.06,0,3.6,91784,751,91277,0.17,0.0,2.7075,0.82,99.45
2020-04-19,Meghalaya,1321,11,1321,16514,1484,1214,8.0,0,3.6,93105,762,92598,41.22,33.72,4.5872222222222225,0.82,99.46
2020-04-20,Meghalaya,702,6,693,8725,1130,512,8.05,3,3.6,93807,768,93291,31.39,14.22,2.423611111111111,0.82,99.45
2020-04-21,Meghalaya,1609,20,1600,19982,3888,1644,8.05,0,3.6,95416,788,94891,108.0,45.67,5.5505555555555555,0.83,99.45
2020-04-22,Meghalaya,534,2,530,6473,3666,2045,8.25,2,3.6,95950,790,95421,101.83,56.81,1.7980555555555555,0.82,99.45
2020-04-23,Meghalaya,907,12,904,11655,3317,2121,7.78,0,3.6,96857,802,96325,92.14,58.92,3.2375,0.83,99.45
2020-04-24,Meghalaya,1450,20,1449,17997,488,190,8.06,0,3.6,98307,822,97774,13.56,5.28,4.9991666666666665,0.84,99.46
2020-04-25,Meghalaya,696,4,694,8698,2490,1029,8.0,0,3.6,99003,826,98468,69.17,28.58,2.4161111111111113,0.83,99.46
2020-04-26,Meghalaya,458,4,456,5519,2202,1464,8.3,0,3.6,99461,830,98924,61.17,40.67,1.5330555555555556,0.83,99.46
2020-04-27,Meghalaya,129,0,127,1519,2881,1507,8.49,2,3.6,99590,830,99051,80.03,41.86,0.42194444444444446,0.83,99.46
2020-04-28,Meghalaya,1152,3,1150,14213,2184,1993,8.11,0,3.6,100742,833,100201,60.67,55.36,3.9480555555555554,0.83,99.46
2020-04-29,Meghalaya,834,3,827,10692,1324,808,7.8,4,3.6,101576,836,101028,36.78,22.44,2.97,0.82,99.46
2020-04-30,Meghalaya,84,0,78,1076,1336,701,7.81,6,3.6,101660,836,101106,37.11,19.47,0.29888888888888887,0.82,99.46
2020-05-01,Meghalaya,503,4,495,6137,2576,2306,8.2,4,3.6,102163,840,101601,71.56,64.06,1.7047222222222222,0.82,99.45
2020-05-02,Meghalaya,574,6,572,7207,555,404,7.96,0,3.6,102737,846,102173,15.42,11.22,2.0019444444444443,0.82,99.45
2020-05-03,Meghalaya,1389,17,1381,17396,2612,2246,7.98,0,3.6,104126,863,103554,72.56,62.39,4.832222222222223,0.83,99.45
2020-05-04,Meghalaya,724,2,715,9229,2918,448,7.84,7,3.6,104850,865,104269,81.06,12.44,2.5636111111111113,0.82,99.45
2020-05-05,Meghalaya,343,1,336,3988,2734,1019,8.6,6,3.6,105193,866,104605,75.94,28.31,1.1077777777777778,0.82,99.44
2020-05-06,Meghalaya,661,8,652,8268,583,301,7.99,1,3.6,105854,874,105257,16.19,8.36,2.296666666666667,0.83,99.44
2020-05-07,Meghalaya,742,4,737,9372,1873,1726,7.92,1,3.6,106596,878,105994,52.03,47.94,2.6033333333333335,0.82,99.44
2020-05-08,Meghalaya,1279,9,1279,15754,257,221,8.12,0,3.6,107875,887,107273,7.14,6.14,4.376111111111111,0.82,99.44
2020-05-09,Meghalaya,391,1,385,5043,3618,888,7.75,5,3.6,108266,888,107658,100.5,24.67,1.4008333333333334,0.82,99.44
2020-05-10,Meghalaya,368,4,359,4473,3751,3668,8.23,5,3.6,108634,892,108017,104.19,101.89,1.2425,0.82,99.43
2020-05-11,Meghalaya,734,7,732,9096,4506,932,8.07,0,3.6,109368,899,108749,125.17,25.89,2.526666666666667,0.82,99.43
2020-05-12,Meghalaya,239,2,233,2856,4466,1254,8.37,4,3.6,109607,901,108982,124.06,34.83,0.7933333333333333,0.82,99.43
2020-05-13,Meghalaya,1173,3,1164,14497,672,53,8.09,6,3.6,110780,904,110146,18.67,1.47,4.026944444444444,0.82,99.43
2020-05-14,Meghalaya,285,3,282,3638,3468,899,7.83,0,3.6,111065,907,110428,96.33,24.97,1.0105555555555557,0.82,99.43
2020-05-15,Meghalaya,1214,16,1214,15482,2877,2098,7.84,0,3.6,112279,923,111642,79.92,58.28,4.3005555555555555,0.82,99.43
2020-05-16,Meghalaya,1611,14,1605,19984,3451,2073,8.06,0,3.6,113890,937,113247,95.86,57.58,5.551111111111111,0.82,99.44
2020-05-17,Meghalaya,778,11,771,9585,3812,3254,8.12,0,3.6,114668,948,114018,105.89,90.39,2.6625,0.83,99.43
2020-05-18,Meghalaya,949,7,941,11789,996,785,8.05,1,3.6,115617,955,114959,27.67,21.81,3.274722222222222,0.83,99.43
2020-05-19,Meghalaya,701,6,698,9018,4854,709,7.77,0,3.6,116318,961,115657,134.83,19.69,2.505,0.83,99.43
2020-05-20,Meghalaya,1553,10,1552,19693,125,76,7.89,0,3.6,117871,971,117209,3.47,2.11,5.470277777777778,0.82,99.44
2020-05-21,Meghalaya,1428,8,1419,17650,614,483,8.09,1,3.6,119299,979,118628,17.06,13.42,4.902777777777778,0.82,99.44
2020-05-22,Meghalaya,1198,14,1198,14915,911,428,8.03,0,3.6,120497,993,119826,25.31,11.89,4.143055555555556,0.82,99.44
2020-05-23,Meghalaya,1271,18,1271,15627,4348,4289,8.13,0,3.6,121768,1011,121097,120.78,119.14,4.340833333333333,0.83,99.45
2020-05-24,Meghalaya,1090,9,1085,13637,3942,681,7.99,0,3.6,122858,1020,122182,109.5,18.92,3.7880555555555557,0.83,99.45
2020-05-25,Meghalaya,231,1,224,3011,2874,789,7.67,6,3.6,123089,1021,122406,79.83,21.92,0.8363888888888888,0.83,99.45
2020-05-26,Meghalaya,986,11,986,12180,4124,3776,8.1,0,3.6,124075,1032,123392,114.56,104.89,3.3833333333333333,0.83,99.45
2020-05-27,Meghalaya,1071,15,1063,13507,564,453,7.93,0,3.6,125146,1047,124455,15.67,12.58,3.7519444444444443,0.84,99.45
2020-05-28,Meghalaya,669,6,669,8123,3537,1932,8.24,0,3.6,125815,1053,125124,98.25,53.67,2.256388888888889,0.84,99.45
2020-05-29,Meghalaya,425,2,419,5570,2972,413,7.63,4,3.6,126240,1055,125543,82.56,11.47,1.5472222222222223,0.84,99.45
2020-05-30,Meghalaya,346,2,338,4146,2045,83,8.35,6,3.6,126586,1057,125881,56.81,2.31,1.1516666666666666,0.84,99.44
2020-05-31,Meghalaya,1369,18,1360,17044,1369,1115,8.03,0,3.6,127955,1075,127241,38.03,30.97,4.734444444444445,0.84,99.44
2020-06-01,Meghalaya,1210,13,1202,14951,4476,1815,8.09,0,3.6,129165,1088,128443,124.33,50.42,4.1530555555555555,0.84,99.44
2020-06-02,Meghalaya,307,2,303,3816,4489,1046,8.05,2,3.6,129472,1090,128746,124.69,29.06,1.06,0.84,99.44
2020-06-03,Meghalaya,329,4,325,4251,4424,3291,7.74,0,3.6,129801,1094,129071,122.89,91.42,1.1808333333333334,0.84,99.44
2020-06-04,Meghalaya,384,1,384,5344,4535,3871,7.19,0,3.6,130185,1095,129455,125.97,107.53,1.4844444444444445,0.84,99.44
2020-06-05,Meghalaya,1255,4,1246,15878,2777,1696,7.9,5,3.6,131440,1099,130701,77.14,47.11,4.410555555555556,0.84,99.44
2020-06-06,Meghalaya,1315,14,1309,16636,1521,1405,7.9,0,3.6,132755,1113,132010,42.25,39.03,4.621111111111111,0.84,99.44
2020-06-07,Meghalaya,484,3,476,6018,3510,1900,8.04,5,3.6,133239,1116,132486,97.5,52.78,1.6716666666666666,0.84,99.43
2020-06-08,Meghalaya,942,7,938,11676,4810,4655,8.07,0,3.6,134181,1123,133424,133.61,129.31,3.243333333333333,0.84,99.44
2020-06-09,Meghalaya,1116,7,1108,14444,4464,3603,7.73,1,3.6,135297,1130,134532,124.0,100.08,4.012222222222222,0.84,99.43
2020-06-10,Meghalaya,392,4,387,4922,979,9,7.96,1,3.6,135689,1134,134919,27.19,0.25,1.3672222222222221,0.84,99.43
2020-06-11,Meghalaya,1446,18,1440,17921,4023,1075,8.07,0,3.6,137135,1152,136359,111.75,29.86,4.978055555555556,0.84,99.43
2020-06-12,Meghalaya,48,0,46,557,866,833,8.62,2,3.6,137183,1152,136405,24.06,23.14,0.15472222222222223,0.84,99.43
2020-06-13,Meghalaya,1436,15,1433,17974,4615,758,7.99,0,3.6,138619,1167,137838,128.19,21.06,4.9927777777777775,0.84,99.44
2020-06-14,Meghalaya,386,3,383,5078,3316,770,7.6,0,3.6,139005,1170,138221,92.11,21.39,1.4105555555555556,0.84,99.44
2020-06-15,Meghalaya,1042,3,1038,12954,2711,648,8.04,1,3.6,140047,1173,139259,75.31,18.0,3.598333333333333,0.84,99.44
2020-06-16,Meghalaya,307,3,304,4081,723,164,7.52,0,3.6,140354,1176,139563,20.08,4.56,1.1336111111111111,0.84,99.44
2020-06-17,Meghalaya,1378,5,1372,17059,914,553,8.08,1,3.6,141732,1181,140935,25.39,15.36,4.738611111111111,0.83,99.44
2020-06-18,Meghalaya,1414,6,1413,17567,1900,1723,8.05,0,3.6,143146,1187,142348,52.78,47.86,4.879722222222222,0.83,99.44
2020-06-19,Meghalaya,1336,13,1334,16650,2484,543,8.02,0,3.6,144482,1200,143682,69.0,15.08,4.625,0.83,99.45
2020-06-20,Meghalaya,1395,17,1386,17467,4471,4020,7.99,0,3.6,145877,1217,145068,124.19,111.67,4.851944444444444,0.83,99.45
2020-06-21,Meghalaya,1365,11,1357,16966,1539,342,8.05,0,3.6,147242,1228,146425,42.75,9.5,4.712777777777778,0.83,99.45
2020-06-22,Meghalaya,1090,14,1083,13360,3504,2652,8.16,0,3.6,148332,1242,147508,97.33,73.67,3.7111111111111112,0.84,99.44
2020-06-23,Meghalaya,1150,13,1146,14104,2600,1194,8.15,0,3.6,149482,1255,148654,72.22,33.17,3.917777777777778,0.84,99.45
2020-06-24,Meghalaya,181,2,178,2477,4273,3274,7.31,1,3.6,149663,1257,148832,118.69,90.94,0.6880555555555555,0.84,99.44
2020-06-25,Meghalaya,855,7,848,10832,776,275,7.89,0,3.6,150518,1264,149680,21.56,7.64,3.008888888888889,0.84,99.44
2020-06-26,Meghalaya,845,4,843,10720,2333,990,7.88,0,3.6,151363,1268,150523,64.81,27.5,2.977777777777778,0.84,99.45
2020-06-27,Meghalaya,72,0,66,1294,4683,3669,5.56,6,3.6,151435,1268,150589,130.08,101.92,0.35944444444444446,0.84,99.44
2020-06-28,Meghalaya,632,6,629,8087,1300,852,7.82,0,3.6,152067,1274,151218,36.11,23.67,2.2463888888888888,0.84,99.44
2020-06-29,Meghalaya,1291,13,1287,15944,2190,1117,8.1,0,3.6,153358,1287,152505,60.83,31.03,4.428888888888889,0.84,99.44
2020-06-30,Meghalaya,168,2,161,1704,884,865,9.86,5,3.6,153526,1289,152666,24.56,24.03,0.47333333333333333,0.84,99.44
2020-07-01,Meghalaya,438,4,438,5155,853,325,8.5,0,3.6,153964,1293,153104,23.69,9.03,1.4319444444444445,0.84,99.44
2020-07-02,Meghalaya,989,3,986,11889,1623,1194,8.32,0,3.6,154953,1296,154090,45.08,33.17,3.3025,0.84,99.44
2020-07-03,Meghalaya,423,4,422,5137,3168,2601,8.23,0,3.6,155376,1300,154512,88.0,72.25,1.4269444444444443,0.84,99.44
2020-07-04,Meghalaya,940,6,937,11775,2257,931,7.98,0,3.6,156316,1306,155449,62.69,25.86,3.2708333333333335,0.84,99.45
2020-07-05,Meghalaya,937,10,937,11683,618,224,8.02,0,3.6,157253,1316,156386,17.17,6.22,3.245277777777778,0.84,99.45
2020-07-06,Meghalaya,1559,17,1558,19608,2090,1446,7.95,0,3.6,158812,1333,157944,58.06,40.17,5.446666666666666,0.84,99.45
2020-07-07,Meghalaya,1008,3,1002,12335,3891,686,8.17,3,3.6,159820,1336,158946,108.08,19.06,3.426388888888889,0.84,99.45
2020-07-08,Meghalaya,563,5,563,7463,2836,2217,7.54,0,3.6,160383,1341,159509,78.78,61.58,2.0730555555555554,0.84,99.46
2020-07-09,Meghalaya,1406,14,1399,17605,2880,775,7.99,0,3.6,161789,1355,160908,80.0,21.53,4.8902777777777775,0.84,99.46
2020-07-10,Meghalaya,961,9,960,12051,1133,10,7.97,0,3.6,162750,1364,161868,31.47,0.28,3.3475,0.84,99.46
2020-07-11,Meghalaya,317,3,316,3923,3974,2650,8.08,0,3.6,163067,1367,162184,110.39,73.61,1.0897222222222223,0.84,99.46
2020-07-12,Meghalaya,244,3,242,2889,4870,3649,8.45,0,3.6,163311,1370,162426,135.28,101.36,0.8025,0.84,99.46
2020-07-13,Meghalaya,971,12,966,12300,3141,1333,7.89,0,3.6,164282,1382,163392,87.25,37.03,3.4166666666666665,0.84,99.46
2020-07-14,Meghalaya,775,9,766,9509,659,625,8.15,0,3.6,165057,1391,164158,18.31,17.36,2.641388888888889,0.84,99.46
2020-07-15,Meghalaya,1500,18,1495,18378,4565,2403,8.16,0,3.6,166557,1409,165653,126.81,66.75,5.105,0.85,99.46
2020-07-16,Meghalaya,593,1,590,7633,310,19,7.77,2,3.6,167150,1410,166243,8.61,0.53,2.120277777777778,0.84,99.46
2020-07-17,Meghalaya,266,2,258,3157,3432,2070,8.43,6,3.6,167416,1412,166501,95.33,57.5,0.8769444444444444,0.84,99.45
2020-07-18,Meghalaya,714,7,705,8778,3998,139,8.13,2,3.6,168130,1419,167206,111.06,3.86,2.4383333333333335,0.84,99.45
2020-07-19,Meghalaya,1235,13,1232,15032,1827,1117,8.22,0,3.6,169365,1432,168438,50.75,31.03,4.1755555555555555,0.85,99.45
2020-07-20,Meghalaya,964,6,962,12456,759,197,7.74,0,3.6,170329,1438,169400,21.08,5.47,3.46,0.84,99.45
2020-07-21,Meghalaya,1313,8,1308,16579,3087,1170,7.92,0,3.6,171642,1446,170708,85.75,32.5,4.605277777777777,0.84,99.46
2020-07-22,Meghalaya,720,2,711,9287,4031,2085,7.75,7,3.6,172362,1448,171419,111.97,57.92,2.5797222222222222,0.84,99.45
2020-07-23,Meghalaya,1029,3,1027,12944,2548,542,7.95,0,3.6,173391,1451,172446,70.78,15.06,3.5955555555555554,0.84,99.45
2020-07-24,Meghalaya,889,10,882,11003,1258,1146,8.08,0,3.6,174280,1461,173328,34.94,31.83,3.056388888888889,0.84,99.45
2020-07-25,Meghalaya,1528,19,1522,19282,2239,1553,7.92,0,3.6,175808,1480,174850,62.19,43.14,5.356111111111111,0.84,99.46
2020-07-26,Meghalaya,1303,14,1294,16166,2672,1197,8.06,0,3.6,177111,1494,176144,74.22,33.25,4.490555555555556,0.84,99.45
2020-07-27,Meghalaya,469,2,469,6171,1717,698,7.6,0,3.6,177580,1496,176613,47.69,19.39,1.7141666666666666,0.84,99.46
2020-07-28,Meghalaya,616,3,609,7570,1262,376,8.14,4,3.6,178196,1499,177222,35.06,10.44,2.102777777777778,0.84,99.45
2020-07-29,Meghalaya,530,7,521,6491,524,136,8.17,2,3.6,178726,1506,177743,14.56,3.78,1.8030555555555556,0.84,99.45
2020-07-30,Meghalaya,1401,11,1401,17724,4480,464,7.9,0,3.6,180127,1517,179144,124.44,12.89,4.923333333333333,0.84,99.45
2020-07-31,Meghalaya,1320,10,1313,16382,3738,2857,8.06,0,3.6,181447,1527,180457,103.83,79.36,4.5505555555555555,0.84,99.45
2020-08-01,Meghalaya,780,3,779,9693,831,50,8.05,0,3.6,182227,1530,181236,23.08,1.39,2.6925,0.84,99.46
2020-08-02,Meghalaya,772,3,770,9804,1367,1332,7.87,0,3.6,182999,1533,182006,37.97,37.0,2.723333333333333,0.84,99.46
2020-08-03,Meghalaya,928,3,924,11496,2403,171,8.07,1,3.6,183927,1536,182930,66.75,4.75,3.1933333333333334,0.84,99.46
2020-08-04,Meghalaya,506,1,506,6407,815,753,7.9,0,3.6,184433,1537,183436,22.64,20.92,1.7797222222222222,0.83,99.46
2020-08-05,Meghalaya,1383,14,1383,17237,2129,1524,8.02,0,3.6,185816,1551,184819,59.14,42.33,4.788055555555555,0.83,99.46
2020-08-06,Meghalaya,1266,9,1263,15582,3072,2743,8.12,0,3.6,187082,1560,186082,85.33,76.19,4.328333333333333,0.83,99.47
2020-08-07,Meghalaya,1318,15,1312,16481,102,17,8.0,0,3.6,188400,1575,187394,2.83,0.47,4.578055555555555,0.84,99.47
2020-08-08,Meghalaya,1413,6,1409,17620,3892,2460,8.02,0,3.6,189813,1581,188803,108.11,68.33,4.894444444444445,0.83,99.47
2020-08-09,Meghalaya,1058,5,1049,13449,1271,409,7.87,4,3.6,190871,1586,189852,35.31,11.36,3.7358333333333333,0.83,99.47
2020-08-10,Meghalaya,1538,6,1537,19045,2039,247,8.08,0,3.6,192409,1592,191389,56.64,6.86,5.290277777777778,0.83,99.47
2020-08-11,Meghalaya,1121,10,1121,14367,284,87,7.8,0,3.6,193530,1602,192510,7.89,2.42,3.9908333333333332,0.83,99.47
2020-08-12,Meghalaya,886,11,886,11313,4032,1693,7.83,0,3.6,194416,1613,193396,112.0,47.03,3.1425,0.83,99.48
2020-08-13,Meghalaya,734,2,731,9064,1298,878,8.1,1,3.6,195150,1615,194127,36.06,24.39,2.517777777777778,0.83,99.48
2020-08-14,Meghalaya,511,1,506,6541,690,406,7.81,4,3.6,195661,1616,194633,19.17,11.28,1.8169444444444445,0.83,99.47
2020-08-15,Meghalaya,1415,8,1412,18209,1031,122,7.77,0,3.6,197076,1624,196045,28.64,3.39,5.058055555555556,0.82,99.48
2020-08-16,Meghalaya,1145,14,1140,14291,4586,2452,8.01,0,3.6,198221,1638,197185,127.39,68.11,3.9697222222222224,0.83,99.48
2020-08-17,Meghalaya,1072,15,1072,13719,2701,1501,7.81,0,3.6,199293,1653,198257,75.03,41.69,3.8108333333333335,0.83,99.48
2020-08-18,Meghalaya,134,0,127,1363,4833,3419,9.83,7,3.6,199427,1653,198384,134.25,94.97,0.3786111111111111,0.83,99.48
2020-08-19,Meghalaya,477,5,469,6517,1788,547,7.32,3,3.6,199904,1658,198853,49.67,15.19,1.8102777777777779,0.83,99.47
2020-08-20,Meghalaya,1121,5,1118,14148,552,166,7.92,0,3.6,201025,1663,199971,15.33,4.61,3.93,0.83,99.48
2020-08-21,Meghalaya,1126,4,1119,13633,4667,2227,8.26,3,3.6,202151,1667,201090,129.64,61.86,3.7869444444444444,0.82,99.48
2020-08-22,Meghalaya,570,4,567,6885,1548,894,8.28,0,3.6,202721,1671,201657,43.0,24.83,1.9125,0.82,99.48
2020-08-23,Meghalaya,1477,10,1477,18506,1883,1755,7.98,0,3.6,204198,1681,203134,52.31,48.75,5.140555555555555,0.82,99.48
2020-08-24,Meghalaya,410,4,409,5176,3668,1386,7.92,0,3.6,204608,1685,203543,101.89,38.5,1.4377777777777778,0.82,99.48
2020-08-25,Meghalaya,678,4,673,8241,4963,884,8.23,1,3.6,205286,1689,204216,137.86,24.56,2.2891666666666666,0.82,99.48
2020-08-26,Meghalaya,1523,8,1520,19246,985,347,7.91,0,3.6,206809,1697,205736,27.36,9.64,5.346111111111111,0.82,99.48
2020-08-27,Meghalaya,380,5,374,4597,3486,1275,8.27,1,3.6,207189,1702,206110,96.83,35.42,1.2769444444444444,0.82,99.48
2020-08-28,Meghalaya,1445,11,1444,18152,4310,2694,7.96,0,3.6,208634,1713,207554,119.72,74.83,5.042222222222223,0.82,99.48
2020-08-29,Meghalaya,1011,12,1007,12780,1835,788,7.91,0,3.6,209645,1725,208561,50.97,21.89,3.55,0.82,99.48
2020-08-30,Meghalaya,1540,5,1538,19424,2253,829,7.93,0,3.6,211185,1730,210099,62.58,23.03,5.395555555555555,0.82,99.49
2020-08-31,Meghalaya,1477,14,1472,17948,2752,2064,8.23,0,3.6,212662,1744,211571,76.44,57.33,4.985555555555556,0.82,99.49
2020-09-01,Meghalaya,1352,16,1343,16446,2094,317,8.22,0,3.6,214014,1760,212914,58.17,8.81,4.568333333333333,0.82,99.49
2020-09-02,Meghalaya,789,9,789,9173,4019,1910,8.6,0,3.6,214803,1769,213703,111.64,53.06,2.5480555555555555,0.82,99.49
2020-09-03,Meghalaya,737,8,737,8851,3309,2444,8.33,0,3.6,215540,1777,214440,91.92,67.89,2.4586111111111113,0.82,99.49
2020-09-04,Meghalaya,378,1,374,4677,3235,1479,8.08,3,3.6,215918,1778,214814,89.86,41.08,1.2991666666666666,0.82,99.49
2020-09-05,Meghalaya,259,1,257,3309,4672,921,7.83,1,3.6,216177,1779,215071,129.78,25.58,0.9191666666666667,0.82,99.49
2020-09-06,Meghalaya,732,3,726,8981,77,24,8.15,3,3.6,216909,1782,215797,2.14,0.67,2.4947222222222223,0.82,99.49
2020-09-07,Meghalaya,1237,17,1236,15476,628,17,7.99,0,3.6,218146,1799,217033,17.44,0.47,4.2988888888888885,0.82,99.49
2020-09-08,Meghalaya,522,5,518,6524,2033,24,8.0,0,3.6,218668,1804,217551,56.47,0.67,1.8122222222222222,0.82,99.49
2020-09-09,Meghalaya,133,1,130,1719,1560,1428,7.74,2,3.6,218801,1805,217681,43.33,39.67,0.4775,0.82,99.49
2020-09-10,Meghalaya,1432,9,1430,17692,300,154,8.09,0,3.6,220233,1814,219111,8.33,4.28,4.914444444444444,0.82,99.49
2020-09-11,Meghalaya,786,6,786,9826,3473,515,8.0,0,3.6,221019,1820,219897,96.47,14.31,2.7294444444444443,0.82,99.49
2020-09-12,Meghalaya,413,5,409,5153,3483,3280,8.01,0,3.6,221432,1825,220306,96.75,91.11,1.4313888888888888,0.82,99.49
2020-09-13,Meghalaya,170,1,161,2376,2032,137,7.15,8,3.6,221602,1826,220467,56.44,3.81,0.66,0.82,99.49
2020-09-14,Meghalaya,1172,16,1165,14805,2499,1298,7.92,0,3.6,222774,1842,221632,69.42,36.06,4.1125,0.83,99.49
2020-09-15,Meghalaya,672,2,664,8234,3946,601,8.16,6,3.6,223446,1844,222296,109.61,16.69,2.2872222222222223,0.83,99.49
2020-09-16,Meghalaya,829,9,826,10193,4561,314,8.13,0,3.6,224275,1853,223122,126.69,8.72,2.8313888888888887,0.83,99.49
2020-09-17,Meghalaya,651,9,645,8133,1242,199,8.0,0,3.6,224926,1862,223767,34.5,5.53,2.2591666666666668,0.83,99.48
2020-09-18,Meghalaya,954,14,948,11994,1886,1348,7.95,0,3.6,225880,1876,224715,52.39,37.44,3.3316666666666666,0.83,99.48
2020-09-19,Meghalaya,1422,11,1418,17618,1545,1108,8.07,0,3.6,227302,1887,226133,42.92,30.78,4.893888888888889,0.83,99.49
2020-09-20,Meghalaya,512,2,506,6083,3551,249,8.42,4,3.6,227814,1889,226639,98.64,6.92,1.6897222222222221,0.83,99.48
2020-09-21,Meghalaya,450,1,446,5589,2268,565,8.05,3,3.6,228264,1890,227085,63.0,15.69,1.5525,0.83,99.48
2020-09-22,Meghalaya,484,3,480,6261,4919,3000,7.73,1,3.6,228748,1893,227565,136.64,83.33,1.7391666666666667,0.83,99.48
2020-09-23,Meghalaya,1311,6,1310,16307,3844,840,8.04,0,3.6,230059,1899,228875,106.78,23.33,4.529722222222222,0.83,99.49
2020-09-24,Meghalaya,1424,10,1421,18392,3851,740,7.74,0,3.6,231483,1909,230296,106.97,20.56,5.108888888888889,0.82,99.49
2020-09-25,Meghalaya,567,6,564,7245,4690,821,7.83,0,3.6,232050,1915,230860,130.28,22.81,2.0125,0.83,99.49
2020-09-26,Meghalaya,539,4,532,6882,1633,844,7.83,3,3.6,232589,1919,231392,45.36,23.44,1.9116666666666666,0.83,99.49
2020-09-27,Meghalaya,322,1,317,3949,998,982,8.15,4,3.6,232911,1920,231709,27.72,27.28,1.0969444444444445,0.82,99.48
2020-09-28,Meghalaya,287,2,284,3429,4013,693,8.37,1,3.6,233198,1922,231993,111.47,19.25,0.9525,0.82,99.48
2020-09-29,Meghalaya,987,4,979,12285,2370,1619,8.03,4,3.6,234185,1926,232972,65.83,44.97,3.4125,0.82,99.48
2020-09-30,Meghalaya,967,11,965,12131,3084,2830,7.97,0,3.6,235152,1937,233937,85.67,78.61,3.3697222222222223,0.82,99.48
2020-10-01,Meghalaya,764,8,763,9508,2372,394,8.04,0,3.6,235916,1945,234700,65.89,10.94,2.641111111111111,0.82,99.48
2020-10-02,Meghalaya,497,3,492,6668,4584,4545,7.45,2,3.6,236413,1948,235192,127.33,126.25,1.8522222222222222,0.82,99.48
2020-10-03,Meghalaya,597,5,594,7350,4208,938,8.12,0,3.6,237010,1953,235786,116.89,26.06,2.0416666666666665,0.82,99.48
2020-10-04,Meghalaya,50,0,46,725,1043,90,6.9,4,3.6,237060,1953,235832,28.97,2.5,0.2013888888888889,0.82,99.48
2020-10-05,Meghalaya,184,1,181,2442,2180,298,7.53,2,3.6,237244,1954,236013,60.56,8.28,0.6783333333333333,0.82,99.48
2020-10-06,Meghalaya,280,1,276,3181,179,5,8.8,3,3.6,237524,1955,236289,4.97,0.14,0.8836111111111111,0.82,99.48
2020-10-07,Meghalaya,395,5,394,5137,4403,4267,7.69,0,3.6,237919,1960,236683,122.31,118.53,1.4269444444444443,0.82,99.48
2020-10-08,Meghalaya,435,1,428,5236,3068,1723,8.31,6,3.6,238354,1961,237111,85.22,47.86,1.4544444444444444,0.82,99.48
2020-10-09,Meghalaya,1469,11,1469,18117,936,217,8.11,0,3.6,239823,1972,238580,26.0,6.03,5.0325,0.82,99.48
2020-10-10,Meghalaya,722,10,714,8904,730,414,8.11,0,3.6,240545,1982,239294,20.28,11.5,2.473333333333333,0.82,99.48
2020-10-11,Meghalaya,1033,9,1025,12739,331,317,8.11,0,3.6,241578,1991,240319,9.19,8.81,3.538611111111111,0.82,99.48
2020-10-12,Meghalaya,764,4,763,10167,4713,3282,7.51,0,3.6,242342,1995,241082,130.92,91.17,2.8241666666666667,0.82,99.48
2020-10-13,Meghalaya,98,1,97,1372,4566,1944,7.14,0,3.6,242440,1996,241179,126.83,54.0,0.3811111111111111,0.82,99.48
2020-10-14,Meghalaya,1490,6,1483,18566,2885,2402,8.03,1,3.6,243930,2002,242662,80.14,66.72,5.157222222222222,0.82,99.48
2020-10-15,Meghalaya,781,10,776,10119,2317,1369,7.72,0,3.6,244711,2012,243438,64.36,38.03,2.8108333333333335,0.82,99.48
2020-10-16,Meghalaya,46,0,37,719,1781,1331,6.4,9,3.6,244757,2012,243475,49.47,36.97,0.19972222222222222,0.82,99.48
2020-10-17,Meghalaya,1326,11,1322,16081,1871,1385,8.25,0,3.6,246083,2023,244797,51.97,38.47,4.466944444444445,0.82,99.48
2020-10-18,Meghalaya,794,10,787,9813,2993,324,8.09,0,3.6,246877,2033,245584,83.14,9.0,2.7258333333333336,0.82,99.48
2020-10-19,Meghalaya,369,2,361,4496,3318,1969,8.21,6,3.6,247246,2035,245945,92.17,54.69,1.248888888888889,0.82,99.47
2020-10-20,Meghalaya,479,4,472,6147,366,80,7.79,3,3.6,247725,2039,246417,10.17,2.22,1.7075,0.82,99.47
2020-10-21,Meghalaya,819,11,810,10054,2489,1755,8.15,0,3.6,248544,2050,247227,69.14,48.75,2.792777777777778,0.82,99.47
2020-10-22,Meghalaya,993,11,984,11917,4845,352,8.33,0,3.6,249537,2061,248211,134.58,9.78,3.310277777777778,0.83,99.47
2020-10-23,Meghalaya,38,0,33,589,3812,46,6.45,5,3.6,249575,2061,248244,105.89,1.28,0.16361111111111112,0.83,99.47
2020-10-24,Meghalaya,1125,14,1118,13902,38,38,8.09,0,3.6,250700,2075,249362,1.06,1.06,3.861666666666667,0.83,99.47
2020-10-25,Meghalaya,1018,10,1015,12837,1096,147,7.93,0,3.6,251718,2085,250377,30.44,4.08,3.5658333333333334,0.83,99.47
2020-10-26,Meghalaya,1254,10,1249,15625,4027,2962,8.03,0,3.6,252972,2095,251626,111.86,82.28,4.340277777777778,0.83,99.47
2020-10-27,Meghalaya,850,5,848,10873,1166,166,7.82,0,3.6,253822,2100,252474,32.39,4.61,3.020277777777778,0.83,99.47
2020-10-28,Meghalaya,1043,15,1039,12652,1067,574,8.24,0,3.6,254865,2115,253513,29.64,15.94,3.5144444444444445,0.83,99.47
2020-10-29,Meghalaya,1541,6,1537,19587,189,95,7.87,0,3.6,256406,2121,255050,5.25,2.64,5.440833333333333,0.83,99.47
2020-10-30,Meghalaya,717,10,715,9672,3894,3757,7.41,0,3.6,257123,2131,255765,108.17,104.36,2.6866666666666665,0.83,99.47
2020-10-31,Meghalaya,1098,8,1094,14138,19,2,7.77,0,3.6,258221,2139,256859,0.53,0.06,3.9272222222222224,0.83,99.47
2020-11-01,Meghalaya,1311,18,1305,16256,1367,1121,8.06,0,3.6,259532,2157,258164,37.97,31.14,4.515555555555555,0.83,99.47
2020-11-02,Meghalaya,658,3,655,8573,1965,161,7.68,0,3.6,260190,2160,258819,54.58,4.47,2.381388888888889,0.83,99.47
2020-11-03,Meghalaya,1125,10,1121,13894,4987,2944,8.1,0,3.6,261315,2170,259940,138.53,81.78,3.8594444444444442,0.83,99.47
2020-11-04,Meghalaya,428,3,420,5681,3256,3054,7.53,5,3.6,261743,2173,260360,90.44,84.83,1.5780555555555555,0.83,99.47
2020-11-05,Meghalaya,1132,7,1130,14218,140,83,7.96,0,3.6,262875,2180,261490,3.89,2.31,3.9494444444444445,0.83,99.47
2020-11-06,Meghalaya,393,2,388,4636,1699,203,8.48,3,3.6,263268,2182,261878,47.19,5.64,1.2877777777777777,0.83,99.47
2020-11-07,Meghalaya,544,7,544,7060,526,373,7.71,0,3.6,263812,2189,262422,14.61,10.36,1.961111111111111,0.83,99.47
2020-11-08,Meghalaya,578,3,573,7018,4455,2434,8.24,2,3.6,264390,2192,262995,123.75,67.61,1.9494444444444445,0.83,99.47
2020-11-09,Meghalaya,1367,15,1360,16775,136,101,8.15,0,3.6,265757,2207,264355,3.78,2.81,4.659722222222222,0.83,99.47
2020-11-10,Meghalaya,404,2,398,4983,4730,2734,8.11,4,3.6,266161,2209,264753,131.39,75.94,1.3841666666666668,0.83,99.47
2020-11-11,Meghalaya,188,1,180,2687,3295,1241,7.0,7,3.6,266349,2210,264933,91.53,34.47,0.7463888888888889,0.83,99.47
2020-11-12,Meghalaya,1457,14,1452,18172,3860,410,8.02,0,3.6,267806,2224,266385,107.22,11.39,5.047777777777778,0.83,99.47
2020-11-13,Meghalaya,542,6,541,6765,4749,1338,8.01,0,3.6,268348,2230,266926,131.92,37.17,1.8791666666666667,0.83,99.47
2020-11-14,Meghalaya,1242,7,1236,15534,3173,1602,8.0,0,3.6,269590,2237,268162,88.14,44.5,4.315,0.83,99.47
2020-11-15,Meghalaya,703,5,701,8610,3453,71,8.16,0,3.6,270293,2242,268863,95.92,1.97,2.3916666666666666,0.83,99.47
2020-11-16,Meghalaya,57,0,56,1379,3116,2696,4.13,1,3.6,270350,2242,268919,86.56,74.89,0.38305555555555554,0.83,99.47
2020-11-17,Meghalaya,976,3,973,12172,1861,407,8.02,0,3.6,271326,2245,269892,51.69,11.31,3.381111111111111,0.83,99.47
2020-11-18,Meghalaya,787,5,787,9861,3,1,7.98,0,3.6,272113,2250,270679,0.08,0.03,2.7391666666666667,0.83,99.47
2020-11-19,Meghalaya,507,2,506,6336,4791,4580,8.0,0,3.6,272620,2252,271185,133.08,127.22,1.76,0.83,99.47
2020-11-20,Meghalaya,611,5,607,7661,1117,415,7.98,0,3.6,273231,2257,271792,31.03,11.53,2.1280555555555556,0.83,99.47
2020-11-21,Meghalaya,743,10,743,9385,3974,3822,7.92,0,3.6,273974,2267,272535,110.39,106.17,2.6069444444444443,0.83,99.47
2020-11-22,Meghalaya,1063,15,1057,13153,4921,611,8.08,0,3.6,275037,2282,273592,136.69,16.97,3.653611111111111,0.83,99.47
2020-11-23,Meghalaya,286,1,286,3816,1732,1371,7.49,0,3.6,275323,2283,273878,48.11,38.08,1.06,0.83,99.48
2020-11-24,Meghalaya,619,4,614,8226,2163,1281,7.52,1,3.6,275942,2287,274492,60.08,35.58,2.285,0.83,99.47
2020-11-25,Meghalaya,177,2,175,2641,3635,2851,6.7,0,3.6,276119,2289,274667,100.97,79.19,0.7336111111111111,0.83,99.47
2020-11-26,Meghalaya,1509,9,1500,18817,549,477,8.02,0,3.6,277628,2298,276167,15.25,13.25,5.226944444444444,0.83,99.47
2020-11-27,Meghalaya,69,0,68,835,2549,130,8.26,1,3.6,277697,2298,276235,70.81,3.61,0.23194444444444445,0.83,99.47
2020-11-28,Meghalaya,1006,4,1003,12380,1834,13,8.13,0,3.6,278703,2302,277238,50.94,0.36,3.438888888888889,0.83,99.47
2020-11-29,Meghalaya,152,1,144,2372,1454,1400,6.41,7,3.6,278855,2303,277382,40.39,38.89,0.6588888888888889,0.83,99.47
2020-11-30,Meghalaya,136,1,133,1311,1287,811,10.37,2,3.6,278991,2304,277515,35.75,22.53,0.3641666666666667,0.83,99.47
2020-12-01,Meghalaya,1189,13,1186,15120,340,66,7.86,0,3.6,280180,2317,278701,9.44,1.83,4.2,0.83,99.47
2020-12-02,Meghalaya,779,2,777,9972,1944,909,7.81,0,3.6,280959,2319,279478,54.0,25.25,2.77,0.83,99.47
2020-12-03,Meghalaya,1265,16,1263,15868,3470,928,7.97,0,3.6,282224,2335,280741,96.39,25.78,4.407777777777778,0.83,99.47
2020-12-04,Meghalaya,834,6,828,10622,1786,313,7.85,0,3.6,283058,2341,281569,49.61,8.69,2.9505555555555554,0.83,99.47
2020-12-05,Meghalaya,703,2,701,8947,3244,347,7.86,0,3.6,283761,2343,282270,90.11,9.64,2.4852777777777777,0.83,99.47
2020-12-06,Meghalaya,905,9,904,11456,3082,2819,7.9,0,3.6,284666,2352,283174,85.61,78.31,3.1822222222222223,0.83,99.48
2020-12-07,Meghalaya,932,7,923,11754,4281,3267,7.93,2,3.6,285598,2359,284097,118.92,90.75,3.265,0.83,99.47
2020-12-08,Meghalaya,674,4,674,8594,3517,3124,7.84,0,3.6,286272,2363,284771,97.69,86.78,2.3872222222222224,0.83,99.48
2020-12-09,Meghalaya,1536,14,1528,19320,3578,1926,7.95,0,3.6,287808,2377,286299,99.39,53.5,5.366666666666666,0.83,99.48
2020-12-10,Meghalaya,862,12,860,10456,4775,1312,8.24,0,3.6,288670,2389,287159,132.64,36.44,2.9044444444444446,0.83,99.48
2020-12-11,Meghalaya,227,1,226,2482,206,36,9.15,0,3.6,288897,2390,287385,5.72,1.0,0.6894444444444444,0.83,99.48
2020-12-12,Meghalaya,994,9,985,12557,2127,1526,7.92,0,3.6,289891,2399,288370,59.08,42.39,3.4880555555555555,0.83,99.48
2020-12-13,Meghalaya,914,5,910,11081,1988,1792,8.25,0,3.6,290805,2404,289280,55.22,49.78,3.0780555555555558,0.83,99.48
2020-12-14,Meghalaya,994,4,989,12288,4162,2264,8.09,1,3.6,291799,2408,290269,115.61,62.89,3.4133333333333336,0.83,99.48
2020-12-15,Meghalaya,1207,10,1201,15140,4100,2157,7.97,0,3.6,293006,2418,291470,113.89,59.92,4.205555555555556,0.83,99.48
2020-12-16,Meghalaya,711,2,709,8988,1090,272,7.91,0,3.6,293717,2420,292179,30.28,7.56,2.4966666666666666,0.82,99.48
2020-12-17,Meghalaya,308,4,306,3803,4581,2399,8.1,0,3.6,294025,2424,292485,127.25,66.64,1.0563888888888888,0.82,99.48
2020-12-18,Meghalaya,1467,15,1460,18281,1397,167,8.02,0,3.6,295492,2439,293945,38.81,4.64,5.078055555555555,0.83,99.48
2020-12-19,Meghalaya,1562,22,1560,19463,1080,637,8.03,0,3.6,297054,2461,295505,30.0,17.69,5.4063888888888885,0.83,99.48
2020-12-20,Meghalaya,872,5,866,11301,3531,3367,7.72,1,3.6,297926,2466,296371,98.08,93.53,3.1391666666666667,0.83,99.48
2020-12-21,Meghalaya,681,6,679,9046,1675,1209,7.53,0,3.6,298607,2472,297050,46.53,33.58,2.512777777777778,0.83,99.48
2020-12-22,Meghalaya,1277,7,1276,16134,2763,387,7.91,0,3.6,299884,2479,298326,76.75,10.75,4.4816666666666665,0.83,99.48
2020-12-23,Meghalaya,1118,6,1118,14070,187,122,7.95,0,3.6,301002,2485,299444,5.19,3.39,3.908333333333333,0.83,99.48
2020-12-24,Meghalaya,374,1,374,4879,2439,252,7.67,0,3.6,301376,2486,299818,67.75,7.0,1.3552777777777778,0.82,99.48
2020-12-25,Meghalaya,1294,3,1285,16381,2105,936,7.9,6,3.6,302670,2489,301103,58.47,26.0,4.550277777777778,0.82,99.48
2020-12-26,Meghalaya,1267,10,1265,15779,4354,2254,8.03,0,3.6,303937,2499,302368,120.94,62.61,4.383055555555556,0.82,99.48
2020-12-27,Meghalaya,1272,18,1270,15790,1699,221,8.06,0,3.6,305209,2517,303638,47.19,6.14,4.386111111111111,0.82,99.49
2020-12-28,Meghalaya,1215,15,1206,14725,2437,2243,8.25,0,3.6,306424,2532,304844,67.69,62.31,4.090277777777778,0.83,99.48
2020-12-29,Meghalaya,970,6,962,12353,1338,1117,7.85,2,3.6,307394,2538,305806,37.17,31.03,3.431388888888889,0.83,99.48
2020-12-30,Meghalaya,646,8,641,7829,4969,2489,8.25,0,3.6,308040,2546,306447,138.03,69.14,2.174722222222222,0.83,99.48
2020-12-31,Meghalaya,264,2,255,3121,1435,1344,8.46,7,3.6,308304,2548,306702,39.86,37.33,0.8669444444444444,0.83,99.48
2021-01-01,Meghalaya,248,1,243,3025,2578,1597,8.2,4,3.6,308552,2549,306945,71.61,44.36,0.8402777777777778,0.83,99.48
2021-01-02,Meghalaya,1459,8,1459,18346,1744,814,7.95,0,3.6,310011,2557,308404,48.44,22.61,5.096111111111111,0.82,99.48
2021-01-03,Meghalaya,1592,8,1589,19906,3424,2436,8.0,0,3.6,311603,2565,309993,95.11,67.67,5.529444444444445,0.82,99.48
2021-01-04,Meghalaya,1554,8,1547,19613,2593,43,7.92,0,3.6,313157,2573,311540,72.03,1.19,5.448055555555555,0.82,99.48
2021-01-05,Meghalaya,1152,11,1148,14500,4044,3936,7.94,0,3.6,314309,2584,312688,112.33,109.33,4.027777777777778,0.82,99.48
2021-01-06,Meghalaya,1113,9,1113,13941,55,18,7.98,0,3.6,315422,2593,313801,1.53,0.5,3.8725,0.82,99.49
2021-01-07,Meghalaya,174,0,165,2348,3575,1569,7.41,9,3.6,315596,2593,313966,99.31,43.58,0.6522222222222223,0.82,99.48
2021-01-08,Meghalaya,1288,11,1288,15563,2061,1195,8.28,0,3.6,316884,2604,315254,57.25,33.19,4.323055555555555,0.82,99.49
2021-01-09,Meghalaya,1232,15,1226,15240,1511,1304,8.08,0,3.6,318116,2619,316480,41.97,36.22,4.233333333333333,0.82,99.49
2021-01-10,Meghalaya,950,12,950,12049,4363,609,7.88,0,3.6,319066,2631,317430,121.19,16.92,3.3469444444444445,0.82,99.49
2021-01-11,Meghalaya,49,0,41,800,2151,1576,6.12,8,3.6,319115,2631,317471,59.75,43.78,0.2222222222222222,0.82,99.48
2021-01-12,Meghalaya,1501,7,1495,18541,1,0,8.1,0,3.6,320616,2638,318966,0.03,0.0,5.150277777777778,0.82,99.49
2021-01-13,Meghalaya,1427,13,1422,17848,1250,121,8.0,0,3.6,322043,2651,320388,34.72,3.36,4.957777777777777,0.82,99.49
2021-01-14,Meghalaya,138,0,132,2000,2862,1033,6.9,6,3.6,322181,2651,320520,79.5,28.69,0.5555555555555556,0.82,99.48
2021-01-15,Meghalaya,1276,6,1276,15664,2554,647,8.15,0,3.6,323457,2657,321796,70.94,17.97,4.351111111111111,0.82,99.49
2021-01-16,Meghalaya,442,1,441,5419,4820,2240,8.16,0,3.6,323899,2658,322237,133.89,62.22,1.5052777777777777,0.82,99.49
2021-01-17,Meghalaya,65,0,59,1256,2144,494,5.18,6,3.6,323964,2658,322296,59.56,13.72,0.3488888888888889,0.82,99.49
2021-01-18,Meghalaya,1063,14,1063,13009,4258,553,8.17,0,3.6,325027,2672,323359,118.28,15.36,3.613611111111111,0.82,99.49
2021-01-19,Meghalaya,698,6,695,8743,2821,1098,7.98,0,3.6,325725,2678,324054,78.36,30.5,2.428611111111111,0.82,99.49
2021-01-20,Meghalaya,78,1,72,1023,2463,1785,7.62,5,3.6,325803,2679,324126,68.42,49.58,0.2841666666666667,0.82,99.49
2021-01-21,Meghalaya,281,3,273,3578,1682,689,7.85,5,3.6,326084,2682,324399,46.72,19.14,0.9938888888888889,0.82,99.48
2021-01-22,Meghalaya,928,9,923,11876,1520,951,7.81,0,3.6,327012,2691,325322,42.22,26.42,3.298888888888889,0.82,99.48
2021-01-23,Meghalaya,548,6,548,7008,3495,982,7.82,0,3.6,327560,2697,325870,97.08,27.28,1.9466666666666668,0.82,99.48
2021-01-24,Meghalaya,966,13,957,12359,1860,1482,7.82,0,3.6,328526,2710,326827,51.67,41.17,3.4330555555555557,0.82,99.48
2021-01-25,Meghalaya,1359,8,1352,16895,1488,650,8.04,0,3.6,329885,2718,328179,41.33,18.06,4.6930555555555555,0.82,99.48
2021-01-26,Meghalaya,846,7,839,10566,3075,1893,8.01,0,3.6,330731,2725,329018,85.42,52.58,2.935,0.82,99.48
2021-01-27,Meghalaya,1188,4,1179,14801,4891,2379,8.03,5,3.6,331919,2729,330197,135.86,66.08,4.1113888888888885,0.82,99.48
2021-01-28,Meghalaya,263,2,260,3097,155,63,8.49,1,3.6,332182,2731,330457,4.31,1.75,0.8602777777777778,0.82,99.48
2021-01-29,Meghalaya,264,3,259,3209,4980,4737,8.23,2,3.6,332446,2734,330716,138.33,131.58,0.8913888888888889,0.82,99.48
2021-01-30,Meghalaya,1495,13,1493,18579,4235,871,8.05,0,3.6,333941,2747,332209,117.64,24.19,5.160833333333334,0.82,99.48
2021-01-31,Meghalaya,95,1,88,1377,2564,460,6.9,6,3.6,334036,2748,332297,71.22,12.78,0.3825,0.82,99.48
2021-02-01,Meghalaya,267,2,261,3307,2666,909,8.07,4,3.6,334303,2750,332558,74.06,25.25,0.9186111111111112,0.82,99.48
2021-02-02,Meghalaya,891,12,888,11135,2295,11,8.0,0,3.6,335194,2762,333446,63.75,0.31,3.0930555555555554,0.82,99.48
2021-02-03,Meghalaya,1456,9,1452,18059,3120,385,8.06,0,3.6,336650,2771,334898,86.67,10.69,5.016388888888889,0.82,99.48
2021-02-04,Meghalaya,136,1,136,1816,1007,740,7.49,0,3.6,336786,2772,335034,27.97,20.56,0.5044444444444445,0.82,99.48
2021-02-05,Meghalaya,1257,17,1249,15585,2938,2227,8.07,0,3.6,338043,2789,336283,81.61,61.86,4.329166666666667,0.83,99.48
2021-02-06,Meghalaya,1443,16,1441,18248,4665,1089,7.91,0,3.6,339486,2805,337724,129.58,30.25,5.068888888888889,0.83,99.48
2021-02-07,Meghalaya,1252,13,1244,15401,72,55,8.13,0,3.6,340738,2818,338968,2.0,1.53,4.2780555555555555,0.83,99.48
2021-02-08,Meghalaya,477,3,473,6146,4899,1976,7.76,1,3.6,341215,2821,339441,136.08,54.89,1.7072222222222222,0.83,99.48
2021-02-09,Meghalaya,385,1,385,5046,1423,742,7.63,0,3.6,341600,2822,339826,39.53,20.61,1.4016666666666666,0.83,99.48
2021-02-10,Meghalaya,1455,14,1453,17888,483,355,8.13,0,3.6,343055,2836,341279,13.42,9.86,4.9688888888888885,0.83,99.48
2021-02-11,Meghalaya,1328,19,1325,16760,4507,175,7.92,0,3.6,344383,2855,342604,125.19,4.86,4.655555555555556,0.83,99.48
2021-02-12,Meghalaya,1572,21,1565,19983,1243,9,7.87,0,3.6,345955,2876,344169,34.53,0.25,5.550833333333333,0.83,99.48
2021-02-13,Meghalaya,890,6,882,10648,2801,304,8.36,2,3.6,346845,2882,345051,77.81,8.44,2.957777777777778,0.83,99.48
2021-02-14,Meghalaya,980,12,971,11943,1358,103,8.21,0,3.6,347825,2894,346022,37.72,2.86,3.3175,0.83,99.48
2021-02-15,Meghalaya,1184,10,1177,14364,459,186,8.24,0,3.6,349009,2904,347199,12.75,5.17,3.99,0.83,99.48
2021-02-16,Meghalaya,1557,13,1548,19482,36,26,7.99,0,3.6,350566,2917,348747,1.0,0.72,5.411666666666667,0.83,99.48
2021-02-17,Meghalaya,585,5,580,7232,564,440,8.09,0,3.6,351151,2922,349327,15.67,12.22,2.008888888888889,0.83,99.48
2021-02-18,Meghalaya,983,4,979,12466,4039,3497,7.89,0,3.6,352134,2926,350306,112.19,97.14,3.4627777777777777,0.83,99.48
2021-02-19,Meghalaya,1590,12,1585,19694,2876,1959,8.07,0,3.6,353724,2938,351891,79.89,54.42,5.470555555555555,0.83,99.48
2021-02-20,Meghalaya,1113,7,1113,13541,3461,3279,8.22,0,3.6,354837,2945,353004,96.14,91.08,3.761388888888889,0.83,99.48
2021-02-21,Meghalaya,252,2,243,2846,312,86,8.85,7,3.6,355089,2947,353247,8.67,2.39,0.7905555555555556,0.83,99.48
2021-02-22,Meghalaya,981,9,975,12277,2316,1473,7.99,0,3.6,356070,2956,354222,64.33,40.92,3.410277777777778,0.83,99.48
2021-02-23,Meghalaya,1360,4,1356,17283,4655,3869,7.87,0,3.6,357430,2960,355578,129.31,107.47,4.800833333333333,0.83,99.48
2021-02-24,Meghalaya,1145,12,1137,14887,754,157,7.69,0,3.6,358575,2972,356715,20.94,4.36,4.135277777777778,0.83,99.48
2021-02-25,Meghalaya,1283,12,1278,15793,3760,172,8.12,0,3.6,359858,2984,357993,104.44,4.78,4.3869444444444445,0.83,99.48
2021-02-26,Meghalaya,648,5,639,7753,4844,928,8.36,4,3.6,360506,2989,358632,134.56,25.78,2.153611111111111,0.83,99.48
2021-02-27,Meghalaya,1413,13,1405,17916,1051,160,7.89,0,3.6,361919,3002,360037,29.19,4.44,4.976666666666667,0.83,99.48
2021-02-28,Meghalaya,1187,9,1187,14763,91,27,8.04,0,3.6,363106,3011,361224,2.53,0.75,4.100833333333333,0.83,99.48
2021-03-01,Meghalaya,1496,9,1492,18637,1795,789,8.03,0,3.6,364602,3020,362716,49.86,21.92,5.176944444444445,0.83,99.48
2021-03-02,Meghalaya,625,3,624,7522,3984,766,8.31,0,3.6,365227,3023,363340,110.67,21.28,2.0894444444444447,0.83,99.48
2021-03-03,Meghalaya,1555,4,1548,19737,520,446,7.88,3,3.6,366782,3027,364888,14.44,12.39,5.4825,0.83,99.48
2021-03-04,Meghalaya,454,4,448,5634,4779,3469,8.06,2,3.6,367236,3031,365336,132.75,96.36,1.565,0.83,99.48
2021-03-05,Meghalaya,564,6,558,6849,1882,264,8.23,0,3.6,367800,3037,365894,52.28,7.33,1.9025,0.83,99.48
2021-03-06,Meghalaya,728,8,726,9225,313,82,7.89,0,3.6,368528,3045,366620,8.69,2.28,2.5625,0.83,99.48
2021-03-07,Meghalaya,143,1,138,2151,4497,4140,6.65,4,3.6,368671,3046,366758,124.92,115.0,0.5975,0.83,99.48
2021-03-08,Meghalaya,1021,10,1021,13050,1586,160,7.82,0,3.6,369692,3056,367779,44.06,4.44,3.625,0.83,99.48
2021-03-09,Meghalaya,1379,16,1375,17268,2723,342,7.99,0,3.6,371071,3072,369154,75.64,9.5,4.796666666666667,0.83,99.48
2021-03-10,Meghalaya,1268,3,1260,15869,3043,2718,7.99,5,3.6,372339,3075,370414,84.53,75.5,4.408055555555555,0.83,99.48
2021-03-11,Meghalaya,169,1,164,2085,3520,2165,8.11,4,3.6,372508,3076,370578,97.78,60.14,0.5791666666666667,0.83,99.48
2021-03-12,Meghalaya,1298,6,1296,16106,4628,2341,8.06,0,3.6,373806,3082,371874,128.56,65.03,4.473888888888889,0.82,99.48
2021-03-13,Meghalaya,1161,10,1157,14602,1964,1480,7.95,0,3.6,374967,3092,373031,54.56,41.11,4.056111111111111,0.82,99.48
2021-03-14,Meghalaya,50,0,43,540,153,97,9.26,7,3.6,375017,3092,373074,4.25,2.69,0.15,0.82,99.48
2021-03-15,Meghalaya,1447,16,1443,18090,3782,1370,8.0,0,3.6,376464,3108,374517,105.06,38.06,5.025,0.83,99.48
2021-03-16,Meghalaya,651,8,651,8409,3243,1525,7.74,0,3.6,377115,3116,375168,90.08,42.36,2.3358333333333334,0.83,99.48
2021-03-17,Meghalaya,307,1,299,4233,4112,331,7.25,7,3.6,377422,3117,375467,114.22,9.19,1.1758333333333333,0.83,99.48
2021-03-18,Meghalaya,80,0,79,932,4550,641,8.58,1,3.6,377502,3117,375546,126.39,17.81,0.2588888888888889,0.83,99.48
2021-03-19,Meghalaya,676,6,675,8351,2784,2528,8.09,0,3.6,378178,3123,376221,77.33,70.22,2.319722222222222,0.83,99.48
2021-03-20,Meghalaya,153,2,144,1753,0,0,8.73,7,3.6,378331,3125,376365,0.0,0.0,0.48694444444444446,0.83,99.48
2021-03-21,Meghalaya,521,3,519,6599,816,254,7.9,0,3.6,378852,3128,376884,22.67,7.06,1.8330555555555557,0.83,99.48
2021-03-22,Meghalaya,476,5,470,5593,2710,1296,8.51,1,3.6,379328,3133,377354,75.28,36.0,1.553611111111111,0.83,99.48
2021-03-23,Meghalaya,1303,17,1303,16318,455,334,7.99,0,3.6,380631,3150,378657,12.64,9.28,4.532777777777778,0.83,99.48
2021-03-24,Meghalaya,521,2,512,6402,178,106,8.14,7,3.6,381152,3152,379169,4.94,2.94,1.7783333333333333,0.83,99.48
2021-03-25,Meghalaya,198,2,197,2659,842,466,7.45,0,3.6,381350,3154,379366,23.39,12.94,0.7386111111111111,0.83,99.48
2021-03-26,Meghalaya,537,7,534,7141,3071,1944,7.52,0,3.6,381887,3161,379900,85.31,54.0,1.9836111111111112,0.83,99.48
2021-03-27,Meghalaya,975,13,966,11953,301,298,8.16,0,3.6,382862,3174,380866,8.36,8.28,3.3202777777777777,0.83,99.48
2021-03-28,Meghalaya,380,2,374,4651,4310,1890,8.17,4,3.6,383242,3176,381240,119.72,52.5,1.2919444444444443,0.83,99.48
2021-03-29,Meghalaya,542,4,542,7090,3275,2252,7.64,0,3.6,383784,3180,381782,90.97,62.56,1.9694444444444446,0.83,99.48
2021-03-30,Meghalaya,730,9,724,9393,153,34,7.77,0,3.6,384514,3189,382506,4.25,0.94,2.609166666666667,0.83,99.48
2021-03-31,Meghalaya,1027,14,1021,13036,1256,167,7.88,0,3.6,385541,3203,383527,34.89,4.64,3.621111111111111,0.83,99.48
2021-04-01,Meghalaya,324,1,318,4123,3797,3090,7.86,5,3.6,385865,3204,383845,105.47,85.83,1.1452777777777778,0.83,99.48
2021-04-02,Meghalaya,1343,5,1339,16585,2036,79,8.1,0,3.6,387208,3209,385184,56.56,2.19,4.606944444444444,0.83,99.48
2021-04-03,Meghalaya,1348,14,1344,16993,4175,1757,7.93,0,3.6,388556,3223,386528,115.97,48.81,4.720277777777778,0.83,99.48
2021-04-04,Meghalaya,753,9,745,9358,4266,3919,8.05,0,3.6,389309,3232,387273,118.5,108.86,2.5994444444444444,0.83,99.48
2021-04-05,Meghalaya,1163,11,1160,14877,3049,1897,7.82,0,3.6,390472,3243,388433,84.69,52.69,4.1325,0.83,99.48
2021-04-06,Meghalaya,1619,8,1613,19987,2298,2284,8.1,0,3.6,392091,3251,390046,63.83,63.44,5.551944444444445,0.83,99.48
2021-04-07,Meghalaya,338,3,336,3960,2390,1463,8.54,0,3.6,392429,3254,390382,66.39,40.64,1.1,0.83,99.48
2021-04-08,Meghalaya,1031,4,1027,12524,4216,2690,8.23,0,3.6,393460,3258,391409,117.11,74.72,3.4788888888888887,0.83,99.48
2021-04-09,Meghalaya,888,6,885,11118,4909,4233,7.99,0,3.6,394348,3264,392294,136.36,117.58,3.0883333333333334,0.83,99.48
2021-04-10,Meghalaya,644,6,644,7945,2331,1115,8.11,0,3.6,394992,3270,392938,64.75,30.97,2.2069444444444444,0.83,99.48
2021-04-11,Meghalaya,1091,13,1084,13581,1913,438,8.03,0,3.6,396083,3283,394022,53.14,12.17,3.7725,0.83,99.48
2021-04-12,Meghalaya,204,1,203,2711,1043,643,7.52,0,3.6,396287,3284,394225,28.97,17.86,0.7530555555555556,0.83,99.48
2021-04-13,Meghalaya,1027,3,1026,12427,883,522,8.26,0,3.6,397314,3287,395251,24.53,14.5,3.4519444444444445,0.83,99.48
2021-04-14,Meghalaya,866,5,865,11231,2490,1499,7.71,0,3.6,398180,3292,396116,69.17,41.64,3.1197222222222223,0.83,99.48
2021-04-15,Meghalaya,415,4,408,5497,4653,191,7.55,3,3.6,398595,3296,396524,129.25,5.31,1.5269444444444444,0.83,99.48
2021-04-16,Meghalaya,1145,14,1144,14200,4646,4127,8.06,0,3.6,399740,3310,397668,129.06,114.64,3.9444444444444446,0.83,99.48
2021-04-17,Meghalaya,701,5,693,8548,1430,1224,8.2,3,3.6,400441,3315,398361,39.72,34.0,2.3744444444444444,0.83,99.48
2021-04-18,Meghalaya,337,1,331,4609,4958,4746,7.31,5,3.6,400778,3316,398692,137.72,131.83,1.2802777777777778,0.83,99.48
2021-04-19,Meghalaya,936,2,936,11209,72,64,8.35,0,3.6,401714,3318,399628,2.0,1.78,3.113611111111111,0.83,99.48
2021-04-20,Meghalaya,1232,12,1227,15583,2677,874,7.91,0,3.6,402946,3330,400855,74.36,24.28,4.328611111111111,0.83,99.48
2021-04-21,Meghalaya,751,6,742,8765,1718,1283,8.57,3,3.6,403697,3336,401597,47.72,35.64,2.4347222222222222,0.83,99.48
2021-04-22,Meghalaya,862,10,859,10397,3477,1432,8.29,0,3.6,404559,3346,402456,96.58,39.78,2.8880555555555554,0.83,99.48
2021-04-23,Meghalaya,1314,12,1305,16531,4407,1339,7.95,0,3.6,405873,3358,403761,122.42,37.19,4.591944444444445,0.83,99.48
2021-04-24,Meghalaya,1054,5,1046,13932,593,4,7.57,3,3.6,406927,3363,404807,16.47,0.11,3.87,0.83,99.48
2021-04-25,Meghalaya,668,8,662,8682,1612,360,7.69,0,3.6,407595,3371,405469,44.78,10.0,2.4116666666666666,0.83,99.48
2021-04-26,Meghalaya,872,11,864,10990,4837,1057,7.93,0,3.6,408467,3382,406333,134.36,29.36,3.0527777777777776,0.83,99.48
2021-04-27,Meghalaya,826,2,825,10599,2038,254,7.79,0,3.6,409293,3384,407158,56.61,7.06,2.944166666666667,0.83,99.48
2021-04-28,Meghalaya,866,3,859,10655,449,136,8.13,4,3.6,410159,3387,408017,12.47,3.78,2.959722222222222,0.83,99.48
2021-04-29,Meghalaya,554,1,546,6919,2447,665,8.01,7,3.6,410713,3388,408563,67.97,18.47,1.9219444444444445,0.82,99.48
2021-04-30,Meghalaya,1275,14,1270,16247,516,147,7.85,0,3.6,411988,3402,409833,14.33,4.08,4.513055555555556,0.83,99.48
2021-05-01,Meghalaya,1197,15,1188,15025,4465,3340,7.97,0,3.6,413185,3417,411021,124.03,92.78,4.173611111111111,0.83,99.48
2021-05-02,Meghalaya,357,3,348,4397,540,60,8.12,6,3.6,413542,3420,411369,15.0,1.67,1.2213888888888889,0.83,99.47
2021-05-03,Meghalaya,1282,15,1277,16474,1129,1128,7.78,0,3.6,414824,3435,412646,31.36,31.33,4.5761111111111115,0.83,99.47
2021-05-04,Meghalaya,956,6,955,11867,237,77,8.06,0,3.6,415780,3441,413601,6.58,2.14,3.296388888888889,0.83,99.48
2021-05-05,Meghalaya,1268,17,1262,15910,1692,32,7.97,0,3.6,417048,3458,414863,47.0,0.89,4.419444444444444,0.83,99.48
2021-05-06,Meghalaya,506,2,498,6429,805,565,7.87,6,3.6,417554,3460,415361,22.36,15.69,1.7858333333333334,0.83,99.47
2021-05-07,Meghalaya,560,6,559,7101,4392,2998,7.89,0,3.6,418114,3466,415920,122.0,83.28,1.9725,0.83,99.48
2021-05-08,Meghalaya,990,4,984,12711,2135,1409,7.79,2,3.6,419104,3470,416904,59.31,39.14,3.5308333333333333,0.83,99.48
2021-05-09,Meghalaya,275,3,267,3296,898,480,8.34,5,3.6,419379,3473,417171,24.94,13.33,0.9155555555555556,0.83,99.47
2021-05-10,Meghalaya,920,4,919,11809,692,103,7.79,0,3.6,420299,3477,418090,19.22,2.86,3.2802777777777776,0.83,99.47
2021-05-11,Meghalaya,258,2,258,3033,4920,905,8.51,0,3.6,420557,3479,418348,136.67,25.14,0.8425,0.83,99.47
2021-05-12,Meghalaya,560,3,551,7343,4494,304,7.63,6,3.6,421117,3482,418899,124.83,8.44,2.039722222222222,0.83,99.47
2021-05-13,Meghalaya,1081,6,1077,13268,2968,1139,8.15,0,3.6,422198,3488,419976,82.44,31.64,3.6855555555555557,0.83,99.47
2021-05-14,Meghalaya,312,3,311,3744,911,676,8.33,0,3.6,422510,3491,420287,25.31,18.78,1.04,0.83,99.47
2021-05-15,Meghalaya,288,2,288,3083,366,154,9.34,0,3.6,422798,3493,420575,10.17,4.28,0.8563888888888889,0.83,99.47
2021-05-16,Meghalaya,817,6,810,10089,3358,3293,8.1,1,3.6,423615,3499,421385,93.28,91.47,2.8025,0.83,99.47
2021-05-17,Meghalaya,1575,23,1567,19668,1639,623,8.01,0,3.6,425190,3522,422952,45.53,17.31,5.463333333333333,0.83,99.47
2021-05-18,Meghalaya,651,8,650,7812,3671,2252,8.33,0,3.6,425841,3530,423602,101.97,62.56,2.17,0.83,99.47
2021-05-19,Meghalaya,1506,7,1497,19064,4286,884,7.9,2,3.6,427347,3537,425099,119.06,24.56,5.295555555555556,0.83,99.47
2021-05-20,Meghalaya,905,5,904,11045,2384,1002,8.19,0,3.6,428252,3542,426003,66.22,27.83,3.0680555555555555,0.83,99.47
2021-05-21,Meghalaya,1230,5,1223,15335,3997,980,8.02,2,3.6,429482,3547,427226,111.03,27.22,4.259722222222222,0.83,99.47
2021-05-22,Meghalaya,143,0,142,1519,4979,4759,9.41,1,3.6,429625,3547,427368,138.31,132.19,0.42194444444444446,0.83,99.47
2021-05-23,Meghalaya,372,4,371,4984,3599,1661,7.46,0,3.6,429997,3551,427739,99.97,46.14,1.3844444444444444,0.83,99.47
2021-05-24,Meghalaya,199,1,196,2513,3691,543,7.92,2,3.6,430196,3552,427935,102.53,15.08,0.6980555555555555,0.83,99.47
2021-05-25,Meghalaya,560,6,556,7006,3974,1347,7.99,0,3.6,430756,3558,428491,110.39,37.42,1.9461111111111111,0.83,99.47
2021-05-26,Meghalaya,1540,15,1538,19033,4948,3044,8.09,0,3.6,432296,3573,430029,137.44,84.56,5.286944444444444,0.83,99.48
2021-05-27,Meghalaya,1255,11,1254,16078,4285,2292,7.81,0,3.6,433551,3584,431283,119.03,63.67,4.466111111111111,0.83,99.48
2021-05-28,Meghalaya,1149,14,1143,14602,4678,3845,7.87,0,3.6,434700,3598,432426,129.94,106.81,4.056111111111111,0.83,99.48
2021-05-29,Meghalaya,1268,18,1268,15626,2795,1822,8.11,0,3.6,435968,3616,433694,77.64,50.61,4.3405555555555555,0.83,99.48
2021-05-30,Meghalaya,665,7,659,8631,3682,3276,7.7,0,3.6,436633,3623,434353,102.28,91.0,2.3975,0.83,99.48
2021-05-31,Meghalaya,1026,10,1018,12726,230,207,8.06,0,3.6,437659,3633,435371,6.39,5.75,3.535,0.83,99.48
2021-06-01,Meghalaya,486,3,486,5881,760,220,8.26,0,3.6,438145,3636,435857,21.11,6.11,1.6336111111111111,0.83,99.48
2021-06-02,Meghalaya,282,3,276,3572,2465,2286,7.89,3,3.6,438427,3639,436133,68.47,63.5,0.9922222222222222,0.83,99.48
2021-06-03,Meghalaya,1523,22,1521,19288,3067,2512,7.9,0,3.6,439950,3661,437654,85.19,69.78,5.357777777777778,0.83,99.48
2021-06-04,Meghalaya,728,8,721,9034,2573,246,8.06,0,3.6,440678,3669,438375,71.47,6.83,2.5094444444444446,0.83,99.48
2021-06-05,Meghalaya,474,7,469,5616,2188,489,8.44,0,3.6,441152,3676,438844,60.78,13.58,1.56,0.83,99.48
2021-06-06,Meghalaya,1601,11,1597,19975,1107,99,8.02,0,3.6,442753,3687,440441,30.75,2.75,5.548611111111111,0.83,99.48
2021-06-07,Meghalaya,1586,14,1578,19442,4880,710,8.16,0,3.6,444339,3701,442019,135.56,19.72,5.400555555555556,0.83,99.48
2021-06-08,Meghalaya,726,5,725,8942,2943,1351,8.12,0,3.6,445065,3706,442744,81.75,37.53,2.483888888888889,0.83,99.48
2021-06-09,Meghalaya,809,7,804,10041,186,175,8.06,0,3.6,445874,3713,443548,5.17,4.86,2.7891666666666666,0.83,99.48
2021-06-10,Meghalaya,813,9,806,10408,2024,1693,7.81,0,3.6,446687,3722,444354,56.22,47.03,2.891111111111111,0.83,99.48
2021-06-11,Meghalaya,680,5,677,8874,871,308,7.66,0,3.6,447367,3727,445031,24.19,8.56,2.465,0.83,99.48
2021-06-12,Meghalaya,334,3,332,4437,468,118,7.53,0,3.6,447701,3730,445363,13.0,3.28,1.2325,0.83,99.48
2021-06-13,Meghalaya,596,6,588,7452,2941,2698,8.0,2,3.6,448297,3736,445951,81.69,74.94,2.07,0.83,99.48
2021-06-14,Meghalaya,522,7,514,6470,533,82,8.07,1,3.6,448819,3743,446465,14.81,2.28,1.7972222222222223,0.83,99.48
2021-06-15,Meghalaya,710,9,701,9109,4701,4387,7.79,0,3.6,449529,3752,447166,130.58,121.86,2.5302777777777776,0.83,99.47
2021-06-16,Meghalaya,1535,5,1526,18912,3228,2539,8.12,4,3.6,451064,3757,448692,89.67,70.53,5.253333333333333,0.83,99.47
2021-06-17,Meghalaya,999,9,999,12542,1694,933,7.97,0,3.6,452063,3766,449691,47.06,25.92,3.483888888888889,0.83,99.48
2021-06-18,Meghalaya,1554,17,1550,19496,2838,1843,7.97,0,3.6,453617,3783,451241,78.83,51.19,5.415555555555556,0.83,99.48
2021-06-19,Meghalaya,1011,9,1011,12381,966,648,8.17,0,3.6,454628,3792,452252,26.83,18.0,3.4391666666666665,0.83,99.48
2021-06-20,Meghalaya,1156,11,1150,14820,826,408,7.8,0,3.6,455784,3803,453402,22.94,11.33,4.116666666666666,0.83,99.48
2021-06-21,Meghalaya,1459,11,1454,18103,3168,1012,8.06,0,3.6,457243,3814,454856,88.0,28.11,5.028611111111111,0.83,99.48
2021-06-22,Meghalaya,1421,11,1415,17844,2461,1476,7.96,0,3.6,458664,3825,456271,68.36,41.0,4.956666666666667,0.83,99.48
2021-06-23,Meghalaya,332,1,324,4514,3096,2049,7.35,7,3.6,458996,3826,456595,86.0,56.92,1.2538888888888888,0.83,99.48
2021-06-24,Meghalaya,139,0,137,1819,763,521,7.64,2,3.6,459135,3826,456732,21.19,14.47,0.5052777777777778,0.83,99.48
2021-06-25,Meghalaya,519,4,518,6243,2660,1911,8.31,0,3.6,459654,3830,457250,73.89,53.08,1.7341666666666666,0.83,99.48
2021-06-26,Meghalaya,248,2,245,3289,1485,726,7.54,1,3.6,459902,3832,457495,41.25,20.17,0.9136111111111112,0.83,99.48
2021-06-27,Meghalaya,1244,15,1244,15446,3051,2376,8.05,0,3.6,461146,3847,458739,84.75,66.0,4.290555555555556,0.83,99.48
2021-06-28,Meghalaya,700,7,697,9047,3695,1369,7.74,0,3.6,461846,3854,459436,102.64,38.03,2.5130555555555554,0.83,99.48
2021-06-29,Meghalaya,1180,17,1180,14935,1629,673,7.9,0,3.6,463026,3871,460616,45.25,18.69,4.148611111111111,0.84,99.48
2021-06-30,Meghalaya,110,0,107,1367,3943,529,8.05,3,3.6,463136,3871,460723,109.53,14.69,0.37972222222222224,0.84,99.48
2021-07-01,Meghalaya,939,9,937,11736,241,239,8.0,0,3.6,464075,3880,461660,6.69,6.64,3.26,0.84,99.48
2021-07-02,Meghalaya,1278,13,1269,16254,1096,61,7.86,0,3.6,465353,3893,462929,30.44,1.69,4.515,0.84,99.48
2021-07-03,Meghalaya,777,8,770,9964,2428,1275,7.8,0,3.6,466130,3901,463699,67.44,35.42,2.767777777777778,0.84,99.48
2021-07-04,Meghalaya,338,2,333,4365,4283,881,7.74,3,3.6,466468,3903,464032,118.97,24.47,1.2125,0.84,99.48
2021-07-05,Meghalaya,488,2,483,6114,3261,2264,7.98,3,3.6,466956,3905,464515,90.58,62.89,1.6983333333333333,0.84,99.48
2021-07-06,Meghalaya,450,2,446,5339,2340,428,8.43,2,3.6,467406,3907,464961,65.0,11.89,1.4830555555555556,0.84,99.48
2021-07-07,Meghalaya,741,3,737,8905,4156,3045,8.32,1,3.6,468147,3910,465698,115.44,84.58,2.473611111111111,0.84,99.48
2021-07-08,Meghalaya,124,0,115,1474,2461,51,8.41,9,3.6,468271,3910,465813,68.36,1.42,0.40944444444444444,0.83,99.48
2021-07-09,Meghalaya,222,0,221,2487,1764,25,8.93,1,3.6,468493,3910,466034,49.0,0.69,0.6908333333333333,0.83,99.48
2021-07-10,Meghalaya,214,1,211,2540,4437,1527,8.43,2,3.6,468707,3911,466245,123.25,42.42,0.7055555555555556,0.83,99.47
2021-07-11,Meghalaya,381,3,381,4685,3766,1197,8.13,0,3.6,469088,3914,466626,104.61,33.25,1.301388888888889,0.83,99.48
2021-07-12,Meghalaya,1088,11,1079,13608,2090,1612,8.0,0,3.6,470176,3925,467705,58.06,44.78,3.78,0.83,99.47
2021-07-13,Meghalaya,765,5,763,9107,262,146,8.4,0,3.6,470941,3930,468468,7.28,4.06,2.5297222222222224,0.83,99.47
2021-07-14,Meghalaya,1576,8,1571,19638,4602,4542,8.03,0,3.6,472517,3938,470039,127.83,126.17,5.455,0.83,99.48
2021-07-15,Meghalaya,1019,14,1017,12737,2136,235,8.0,0,3.6,473536,3952,471056,59.33,6.53,3.5380555555555557,0.83,99.48
2021-07-16,Meghalaya,1239,14,1237,15555,1303,1149,7.97,0,3.6,474775,3966,472293,36.19,31.92,4.320833333333334,0.84,99.48
2021-07-17,Meghalaya,557,7,557,7137,2974,2027,7.8,0,3.6,475332,3973,472850,82.61,56.31,1.9825,0.84,99.48
2021-07-18,Meghalaya,994,12,987,12723,3923,3034,7.81,0,3.6,476326,3985,473837,108.97,84.28,3.5341666666666667,0.84,99.48
2021-07-19,Meghalaya,1362,4,1355,17318,477,288,7.86,3,3.6,477688,3989,475192,13.25,8.0,4.810555555555555,0.84,99.48
2021-07-20,Meghalaya,1605,17,1604,19888,3847,2191,8.07,0,3.6,479293,4006,476796,106.86,60.86,5.524444444444445,0.84,99.48
2021-07-21,Meghalaya,1263,13,1255,15325,2511,172,8.24,0,3.6,480556,4019,478051,69.75,4.78,4.256944444444445,0.84,99.48
2021-07-22,Meghalaya,914,8,906,11355,1589,1578,8.05,0,3.6,481470,4027,478957,44.14,43.83,3.154166666666667,0.84,99.48
2021-07-23,Meghalaya,1269,7,1265,15679,4716,1213,8.09,0,3.6,482739,4034,480222,131.0,33.69,4.355277777777777,0.84,99.48
2021-07-24,Meghalaya,1112,7,1105,13863,4504,811,8.02,0,3.6,483851,4041,481327,125.11,22.53,3.8508333333333336,0.84,99.48
2021-07-25,Meghalaya,1590,19,1586,19530,2985,793,8.14,0,3.6,485441,4060,482913,82.92,22.03,5.425,0.84,99.48
2021-07-26,Meghalaya,776,2,774,9681,110,101,8.02,0,3.6,486217,4062,483687,3.06,2.81,2.6891666666666665,0.84,99.48
2021-07-27,Meghalaya,1372,10,1363,17377,305,140,7.9,0,3.6,487589,4072,485050,8.47,3.89,4.826944444444444,0.84,99.48
2021-07-28,Meghalaya,85,0,76,539,14,3,15.77,9,3.6,487674,4072,485126,0.39,0.08,0.14972222222222223,0.83,99.48
2021-07-29,Meghalaya,1338,18,1336,16886,2339,341,7.92,0,3.6,489012,4090,486462,64.97,9.47,4.690555555555555,0.84,99.48
2021-07-30,Meghalaya,1342,14,1342,16739,3510,484,8.02,0,3.6,490354,4104,487804,97.5,13.44,4.6497222222222225,0.84,99.48
2021-07-31,Meghalaya,1478,13,1476,18522,4946,721,7.98,0,3.6,491832,4117,489280,137.39,20.03,5.145,0.84,99.48
2021-08-01,Meghalaya,821,9,817,10296,396,95,7.97,0,3.6,492653,4126,490097,11.0,2.64,2.86,0.84,99.48
2021-08-02,Meghalaya,1284,18,1280,16021,2160,789,8.01,0,3.6,493937,4144,491377,60.0,21.92,4.450277777777778,0.84,99.48
2021-08-03,Meghalaya,1588,21,1583,19684,2300,428,8.07,0,3.6,495525,4165,492960,63.89,11.89,5.467777777777778,0.84,99.48
2021-08-04,Meghalaya,149,0,140,1911,4762,3392,7.8,9,3.6,495674,4165,493100,132.28,94.22,0.5308333333333334,0.84,99.48
2021-08-05,Meghalaya,832,8,825,10353,49,17,8.04,0,3.6,496506,4173,493925,1.36,0.47,2.8758333333333335,0.84,99.48
2021-08-06,Meghalaya,345,2,342,4508,3103,1891,7.65,1,3.6,496851,4175,494267,86.19,52.53,1.2522222222222221,0.84,99.48
2021-08-07,Meghalaya,1015,13,1014,12333,2980,905,8.23,0,3.6,497866,4188,495281,82.78,25.14,3.4258333333333333,0.84,99.48
2021-08-08,Meghalaya,1096,4,1089,13681,166,106,8.01,3,3.6,498962,4192,496370,4.61,2.94,3.8002777777777776,0.84,99.48
2021-08-09,Meghalaya,314,3,311,4005,2710,1697,7.84,0,3.6,499276,4195,496681,75.28,47.14,1.1125,0.84,99.48
2021-08-10,Meghalaya,581,4,580,7034,3832,2178,8.26,0,3.6,499857,4199,497261,106.44,60.5,1.9538888888888888,0.84,99.48
2021-08-11,Meghalaya,1377,20,1368,17266,1455,166,7.98,0,3.6,501234,4219,498629,40.42,4.61,4.796111111111111,0.84,99.48
2021-08-12,Meghalaya,506,3,501,6345,4247,3343,7.97,2,3.6,501740,4222,499130,117.97,92.86,1.7625,0.84,99.48
2021-08-13,Meghalaya,759,6,754,9110,3234,687,8.33,0,3.6,502499,4228,499884,89.83,19.08,2.5305555555555554,0.84,99.48
2021-08-14,Meghalaya,382,4,376,4802,4851,3522,7.96,2,3.6,502881,4232,500260,134.75,97.83,1.333888888888889,0.84,99.48
2021-08-15,Meghalaya,171,1,165,1720,2332,1359,9.94,5,3.6,503052,4233,500425,64.78,37.75,0.4777777777777778,0.84,99.48
2021-08-16,Meghalaya,1315,14,1314,16326,1938,1349,8.05,0,3.6,504367,4247,501739,53.83,37.47,4.535,0.84,99.48
2021-08-17,Meghalaya,1482,19,1482,18459,1673,568,8.03,0,3.6,505849,4266,503221,46.47,15.78,5.1275,0.84,99.48
2021-08-18,Meghalaya,1447,12,1445,18602,1635,490,7.78,0,3.6,507296,4278,504666,45.42,13.61,5.167222222222223,0.84,99.48
2021-08-19,Meghalaya,918,13,915,11219,3602,270,8.18,0,3.6,508214,4291,505581,100.06,7.5,3.116388888888889,0.84,99.48
2021-08-20,Meghalaya,1427,5,1426,17897,1760,28,7.97,0,3.6,509641,4296,507007,48.89,0.78,4.971388888888889,0.84,99.48
2021-08-21,Meghalaya,348,2,341,4217,4742,4470,8.25,5,3.6,509989,4298,507348,131.72,124.17,1.1713888888888888,0.84,99.48
2021-08-22,Meghalaya,453,3,449,5677,932,252,7.98,1,3.6,510442,4301,507797,25.89,7.0,1.5769444444444445,0.84,99.48
2021-08-23,Meghalaya,1168,9,1168,14397,3730,1164,8.11,0,3.6,511610,4310,508965,103.61,32.33,3.9991666666666665,0.84,99.48
2021-08-24,Meghalaya,1426,9,1426,18131,2470,1398,7.86,0,3.6,513036,4319,510391,68.61,38.83,5.036388888888889,0.84,99.48
2021-08-25,Meghalaya,1558,16,1556,19624,3554,2443,7.94,0,3.6,514594,4335,511947,98.72,67.86,5.4511111111111115,0.84,99.49
2021-08-26,Meghalaya,174,1,172,2309,3419,2490,7.54,1,3.6,514768,4336,512119,94.97,69.17,0.6413888888888889,0.84,99.49
2021-08-27,Meghalaya,457,5,450,6218,4059,2278,7.35,2,3.6,515225,4341,512569,112.75,63.28,1.7272222222222222,0.84,99.48
2021-08-28,Meghalaya,1180,14,1172,14869,3161,2967,7.94,0,3.6,516405,4355,513741,87.81,82.42,4.130277777777778,0.84,99.48
2021-08-29,Meghalaya,1412,11,1406,17580,835,275,8.03,0,3.6,517817,4366,515147,23.19,7.64,4.883333333333334,0.84,99.48
2021-08-30,Meghalaya,1260,3,1256,16137,3804,52,7.81,1,3.6,519077,4369,516403,105.67,1.44,4.4825,0.84,99.48
2021-08-31,Meghalaya,252,1,249,3001,2125,188,8.4,2,3.6,519329,4370,516652,59.03,5.22,0.8336111111111111,0.84,99.48
2021-09-01,Meghalaya,666,8,660,8015,817,639,8.31,0,3.6,519995,4378,517312,22.69,17.75,2.2263888888888888,0.84,99.48
2021-09-02,Meghalaya,1377,5,1368,17043,2031,1610,8.08,4,3.6,521372,4383,518680,56.42,44.72,4.734166666666667,0.84,99.48
2021-09-03,Meghalaya,87,0,84,810,539,353,10.74,3,3.6,521459,4383,518764,14.97,9.81,0.225,0.84,99.48
2021-09-04,Meghalaya,913,3,908,11882,3858,3168,7.68,2,3.6,522372,4386,519672,107.17,88.0,3.3005555555555555,0.84,99.48
2021-09-05,Meghalaya,1422,12,1414,17717,3513,2742,8.03,0,3.6,523794,4398,521086,97.58,76.17,4.921388888888889,0.84,99.48
2021-09-06,Meghalaya,1372,16,1365,17015,659,472,8.06,0,3.6,525166,4414,522451,18.31,13.11,4.726388888888889,0.84,99.48
2021-09-07,Meghalaya,1237,10,1232,15517,1383,854,7.97,0,3.6,526403,4424,523683,38.42,23.72,4.310277777777777,0.84,99.48
2021-09-08,Meghalaya,399,1,399,5206,4731,2069,7.66,0,3.6,526802,4425,524082,131.42,57.47,1.4461111111111111,0.84,99.48
2021-09-09,Meghalaya,621,7,612,8181,19,12,7.59,2,3.6,527423,4432,524694,0.53,0.33,2.2725,0.84,99.48
2021-09-10,Meghalaya,1525,6,1519,18826,2419,1241,8.1,0,3.6,528948,4438,526213,67.19,34.47,5.229444444444445,0.84,99.48
2021-09-11,Meghalaya,529,3,522,6593,2272,1034,8.02,4,3.6,529477,4441,526735,63.11,28.72,1.831388888888889,0.84,99.48
2021-09-12,Meghalaya,982,5,974,12172,1252,230,8.07,3,3.6,530459,4446,527709,34.78,6.39,3.381111111111111,0.84,99.48
2021-09-13,Meghalaya,1138,13,1138,13990,3249,1523,8.13,0,3.6,531597,4459,528847,90.25,42.31,3.886111111111111,0.84,99.48
2021-09-14,Meghalaya,1476,14,1471,18529,1904,1846,7.97,0,3.6,533073,4473,530318,52.89,51.28,5.146944444444444,0.84,99.48
2021-09-15,Meghalaya,332,3,329,4354,1990,621,7.63,0,3.6,533405,4476,530647,55.28,17.25,1.2094444444444445,0.84,99.48
2021-09-16,Meghalaya,310,2,310,3582,2244,1930,8.65,0,3.6,533715,4478,530957,62.33,53.61,0.995,0.84,99.48
2021-09-17,Meghalaya,830,9,828,10682,2828,2645,7.77,0,3.6,534545,4487,531785,78.56,73.47,2.9672222222222224,0.84,99.48
2021-09-18,Meghalaya,973,13,967,12173,640,214,7.99,0,3.6,535518,4500,532752,17.78,5.94,3.381388888888889,0.84,99.48
2021-09-19,Meghalaya,1256,15,1252,15802,2177,106,7.95,0,3.6,536774,4515,534004,60.47,2.94,4.389444444444444,0.84,99.48
2021-09-20,Meghalaya,219,2,218,2620,176,14,8.36,0,3.6,536993,4517,534222,4.89,0.39,0.7277777777777777,0.84,99.48
2021-09-21,Meghalaya,597,6,597,7297,1910,1056,8.18,0,3.6,537590,4523,534819,53.06,29.33,2.0269444444444447,0.84,99.48
2021-09-22,Meghalaya,342,4,334,4359,3815,2896,7.85,4,3.6,537932,4527,535153,105.97,80.44,1.2108333333333334,0.84,99.48
2021-09-23,Meghalaya,1037,11,1037,12943,4278,4142,8.01,0,3.6,538969,4538,536190,118.83,115.06,3.5952777777777776,0.84,99.48
2021-09-24,Meghalaya,1166,12,1160,14752,503,115,7.9,0,3.6,540135,4550,537350,13.97,3.19,4.097777777777778,0.84,99.48
2021-09-25,Meghalaya,303,3,298,4120,4906,1231,7.35,2,3.6,540438,4553,537648,136.28,34.19,1.1444444444444444,0.84,99.48
2021-09-26,Meghalaya,1150,6,1147,14454,4721,4386,7.96,0,3.6,541588,4559,538795,131.14,121.83,4.015,0.84,99.48
2021-09-27,Meghalaya,1200,6,1193,14883,3434,2149,8.06,1,3.6,542788,4565,539988,95.39,59.69,4.134166666666666,0.84,99.48
2021-09-28,Meghalaya,753,2,747,9500,2417,2205,7.93,4,3.6,543541,4567,540735,67.14,61.25,2.638888888888889,0.84,99.48
2021-09-29,Meghalaya,710,3,703,8930,4869,1674,7.95,4,3.6,544251,4570,541438,135.25,46.5,2.4805555555555556,0.84,99.48
2021-09-30,Meghalaya,928,7,927,11670,135,53,7.95,0,3.6,545179,4577,542365,3.75,1.47,3.2416666666666667,0.84,99.48
2021-10-01,Meghalaya,1425,20,1425,17741,3181,259,8.03,0,3.6,546604,4597,543790,88.36,7.19,4.928055555555556,0.84,99.49
2021-10-02,Meghalaya,52,0,47,576,266,222,9.03,5,3.6,546656,4597,543837,7.39,6.17,0.16,0.84,99.48
2021-10-03,Meghalaya,979,11,976,11940,343,103,8.2,0,3.6,547635,4608,544813,9.53,2.86,3.316666666666667,0.84,99.48
2021-10-04,Meghalaya,104,0,96,1430,3703,1868,7.27,8,3.6,547739,4608,544909,102.86,51.89,0.3972222222222222,0.84,99.48
2021-10-05,Meghalaya,1006,5,1006,12687,1645,233,7.93,0,3.6,548745,4613,545915,45.69,6.47,3.5241666666666664,0.84,99.48
2021-10-06,Meghalaya,161,1,161,2218,3796,2344,7.26,0,3.6,548906,4614,546076,105.44,65.11,0.6161111111111112,0.84,99.48
2021-10-07,Meghalaya,982,13,980,11871,4530,1807,8.27,0,3.6,549888,4627,547056,125.83,50.19,3.2975,0.84,99.48
2021-10-08,Meghalaya,1311,10,1304,16026,674,151,8.18,0,3.6,551199,4637,548360,18.72,4.19,4.451666666666667,0.84,99.48
2021-10-09,Meghalaya,956,3,947,12040,1590,840,7.94,6,3.6,552155,4640,549307,44.17,23.33,3.3444444444444446,0.84,99.48
2021-10-10,Meghalaya,601,6,595,7670,1057,297,7.84,0,3.6,552756,4646,549902,29.36,8.25,2.1305555555555555,0.84,99.48
2021-10-11,Meghalaya,1240,11,1231,15655,1752,1572,7.92,0,3.6,553996,4657,551133,48.67,43.67,4.348611111111111,0.84,99.48
2021-10-12,Meghalaya,298,2,293,3809,4385,3457,7.82,3,3.6,554294,4659,551426,121.81,96.03,1.0580555555555555,0.84,99.48
2021-10-13,Meghalaya,954,6,954,12026,446,48,7.93,0,3.6,555248,4665,552380,12.39,1.33,3.3405555555555555,0.84,99.48
2021-10-14,Meghalaya,392,2,389,4367,1176,241,8.98,1,3.6,555640,4667,552769,32.67,6.69,1.2130555555555556,0.84,99.48
2021-10-15,Meghalaya,762,11,759,9519,3794,190,8.01,0,3.6,556402,4678,553528,105.39,5.28,2.6441666666666666,0.84,99.48
2021-10-16,Meghalaya,1511,16,1506,19031,1801,441,7.94,0,3.6,557913,4694,555034,50.03,12.25,5.286388888888889,0.84,99.48
2021-10-17,Meghalaya,1091,9,1083,13857,4403,4385,7.87,0,3.6,559004,4703,556117,122.31,121.81,3.8491666666666666,0.84,99.48
2021-10-18,Meghalaya,681,6,681,8254,2492,1501,8.25,0,3.6,559685,4709,556798,69.22,41.69,2.292777777777778,0.84,99.48
2021-10-19,Meghalaya,298,1,292,3692,3228,633,8.07,5,3.6,559983,4710,557090,89.67,17.58,1.0255555555555556,0.84,99.48
2021-10-20,Meghalaya,544,4,543,6454,4558,1546,8.43,0,3.6,560527,4714,557633,126.61,42.94,1.7927777777777778,0.84,99.48
2021-10-21,Meghalaya,1317,14,1315,16715,4782,2984,7.88,0,3.6,561844,4728,558948,132.83,82.89,4.643055555555556,0.84,99.48
2021-10-22,Meghalaya,29,0,27,587,1872,872,4.94,2,3.6,561873,4728,558975,52.0,24.22,0.16305555555555556,0.84,99.48
2021-10-23,Meghalaya,1202,13,1197,14922,1047,392,8.06,0,3.6,563075,4741,560172,29.08,10.89,4.145,0.84,99.48
2021-10-24,Meghalaya,985,10,976,12629,2489,302,7.8,0,3.6,564060,4751,561148,69.14,8.39,3.5080555555555555,0.84,99.48
2021-10-25,Meghalaya,668,4,662,8657,3639,964,7.72,2,3.6,564728,4755,561810,101.08,26.78,2.4047222222222224,0.84,99.48
2021-10-26,Meghalaya,504,6,504,6206,3591,846,8.12,0,3.6,565232,4761,562314,99.75,23.5,1.7238888888888888,0.84,99.48
2021-10-27,Meghalaya,902,9,897,11119,785,135,8.11,0,3.6,566134,4770,563211,21.81,3.75,3.088611111111111,0.84,99.48
2021-10-28,Meghalaya,1025,8,1022,13158,4391,3194,7.79,0,3.6,567159,4778,564233,121.97,88.72,3.655,0.84,99.48
2021-10-29,Meghalaya,835,6,826,10746,4299,4295,7.77,3,3.6,567994,4784,565059,119.42,119.31,2.985,0.84,99.48
2021-10-30,Meghalaya,1416,8,1413,17971,4102,2720,7.88,0,3.6,569410,4792,566472,113.94,75.56,4.991944444444444,0.84,99.48
2021-10-31,Meghalaya,1240,12,1235,15950,4613,1722,7.77,0,3.6,570650,4804,567707,128.14,47.83,4.430555555555555,0.84,99.48
2021-11-01,Meghalaya,966,12,966,12370,4806,300,7.81,0,3.6,571616,4816,568673,133.5,8.33,3.436111111111111,0.84,99.49
2021-11-02,Meghalaya,1392,8,1387,17438,2193,340,7.98,0,3.6,573008,4824,570060,60.92,9.44,4.8438888888888885,0.84,99.49
2021-11-03,Meghalaya,793,4,786,10116,3073,693,7.84,3,3.6,573801,4828,570846,85.36,19.25,2.81,0.84,99.49
2021-11-04,Meghalaya,989,6,980,11758,872,511,8.41,3,3.6,574790,4834,571826,24.22,14.19,3.266111111111111,0.84,99.48
2021-11-05,Meghalaya,707,9,707,8814,3770,209,8.02,0,3.6,575497,4843,572533,104.72,5.81,2.4483333333333333,0.84,99.48
2021-11-06,Meghalaya,1367,10,1365,16961,2920,2809,8.06,0,3.6,576864,4853,573898,81.11,78.03,4.711388888888889,0.84,99.49
2021-11-07,Meghalaya,1411,4,1404,17170,1283,1042,8.22,3,3.6,578275,4857,575302,35.64,28.94,4.769444444444445,0.84,99.49
2021-11-08,Meghalaya,33,0,33,703,2754,15,4.69,0,3.6,578308,4857,575335,76.5,0.42,0.19527777777777777,0.84,99.49
2021-11-09,Meghalaya,1141,7,1132,14246,460,62,8.01,2,3.6,579449,4864,576467,12.78,1.72,3.957222222222222,0.84,99.49
2021-11-10,Meghalaya,1580,16,1580,19725,1450,277,8.01,0,3.6,581029,4880,578047,40.28,7.69,5.479166666666667,0.84,99.49
2021-11-11,Meghalaya,906,6,899,11416,891,454,7.94,1,3.6,581935,4886,578946,24.75,12.61,3.171111111111111,0.84,99.49
2021-11-12,Meghalaya,328,2,320,4312,2778,1608,7.61,6,3.6,582263,4888,579266,77.17,44.67,1.1977777777777778,0.84,99.49
2021-11-13,Meghalaya,825,7,820,10300,650,289,8.01,0,3.6,583088,4895,580086,18.06,8.03,2.861111111111111,0.84,99.49
2021-11-14,Meghalaya,1443,17,1434,18115,2,1,7.97,0,3.6,584531,4912,581520,0.06,0.03,5.031944444444444,0.84,99.48
2021-11-15,Meghalaya,1285,15,1278,16066,2804,214,8.0,0,3.6,585816,4927,582798,77.89,5.94,4.462777777777778,0.84,99.48
2021-11-16,Meghalaya,1150,4,1150,14235,1722,169,8.08,0,3.6,586966,4931,583948,47.83,4.69,3.9541666666666666,0.84,99.49
2021-11-17,Meghalaya,955,11,947,12137,3997,2856,7.87,0,3.6,587921,4942,584895,111.03,79.33,3.3713888888888888,0.84,99.49
2021-11-18,Meghalaya,889,3,887,11187,2864,8,7.95,0,3.6,588810,4945,585782,79.56,0.22,3.1075,0.84,99.49
2021-11-19,Meghalaya,338,4,338,4105,2134,1591,8.23,0,3.6,589148,4949,586120,59.28,44.19,1.1402777777777777,0.84,99.49
2021-11-20,Meghalaya,1042,7,1034,13261,447,12,7.86,1,3.6,590190,4956,587154,12.42,0.33,3.683611111111111,0.84,99.49
2021-11-21,Meghalaya,423,6,414,5591,1580,1575,7.57,3,3.6,590613,4962,587568,43.89,43.75,1.5530555555555556,0.84,99.48
2021-11-22,Meghalaya,585,8,584,7332,3413,555,7.98,0,3.6,591198,4970,588152,94.81,15.42,2.0366666666666666,0.84,99.48
2021-11-23,Meghalaya,1306,3,1303,16217,3738,1307,8.05,0,3.6,592504,4973,589455,103.83,36.31,4.504722222222222,0.84,99.49
2021-11-24,Meghalaya,469,5,469,5386,791,686,8.71,0,3.6,592973,4978,589924,21.97,19.06,1.4961111111111112,0.84,99.49
2021-11-25,Meghalaya,214,2,214,2699,617,364,7.93,0,3.6,593187,4980,590138,17.14,10.11,0.7497222222222222,0.84,99.49
2021-11-26,Meghalaya,94,0,94,1675,2514,342,5.61,0,3.6,593281,4980,590232,69.83,9.5,0.4652777777777778,0.84,99.49
2021-11-27,Meghalaya,1037,4,1032,13086,3625,2393,7.92,1,3.6,594318,4984,591264,100.69,66.47,3.635,0.84,99.49
2021-11-28,Meghalaya,429,5,420,5247,4901,1012,8.18,4,3.6,594747,4989,591684,136.14,28.11,1.4575,0.84,99.48
2021-11-29,Meghalaya,333,1,330,4180,487,51,7.97,2,3.6,595080,4990,592014,13.53,1.42,1.1611111111111112,0.84,99.48
2021-11-30,Meghalaya,1604,15,1603,19770,3847,1486,8.11,0,3.6,596684,5005,593617,106.86,41.28,5.491666666666666,0.84,99.49
2021-12-01,Meghalaya,374,1,368,4338,1100,215,8.62,5,3.6,597058,5006,593985,30.56,5.97,1.205,0.84,99.49
2021-12-02,Meghalaya,1520,16,1517,19069,2936,654,7.97,0,3.6,598578,5022,595502,81.56,18.17,5.296944444444445,0.84,99.49
2021-12-03,Meghalaya,918,12,909,11075,2545,1176,8.29,0,3.6,599496,5034,596411,70.69,32.67,3.076388888888889,0.84,99.49
2021-12-04,Meghalaya,821,4,813,10006,4958,4682,8.21,4,3.6,600317,5038,597224,137.72,130.06,2.7794444444444446,0.84,99.48
2021-12-05,Meghalaya,1361,9,1356,16569,4728,2079,8.21,0,3.6,601678,5047,598580,131.33,57.75,4.6025,0.84,99.49
2021-12-06,Meghalaya,1304,7,1299,16212,3879,1293,8.04,0,3.6,602982,5054,599879,107.75,35.92,4.503333333333333,0.84,99.49
2021-12-07,Meghalaya,476,5,476,5982,3850,3765,7.96,0,3.6,603458,5059,600355,106.94,104.58,1.6616666666666666,0.84,99.49
2021-12-08,Meghalaya,487,6,485,6029,1649,17,8.08,0,3.6,603945,5065,600840,45.81,0.47,1.6747222222222222,0.84,99.49
2021-12-09,Meghalaya,624,6,617,7801,2448,1392,8.0,1,3.6,604569,5071,601457,68.0,38.67,2.1669444444444443,0.84,99.49
2021-12-10,Meghalaya,1273,18,1271,15650,3286,1702,8.13,0,3.6,605842,5089,602728,91.28,47.28,4.347222222222222,0.84,99.49
2021-12-11,Meghalaya,966,9,960,12074,815,586,8.0,0,3.6,606808,5098,603688,22.64,16.28,3.3538888888888887,0.84,99.49
2021-12-12,Meghalaya,240,1,233,3126,2039,404,7.68,6,3.6,607048,5099,603921,56.64,11.22,0.8683333333333333,0.84,99.48
2021-12-13,Meghalaya,465,4,463,5741,4466,1816,8.1,0,3.6,607513,5103,604384,124.06,50.44,1.5947222222222222,0.84,99.48
2021-12-14,Meghalaya,123,1,122,1495,1397,1339,8.23,0,3.6,607636,5104,604506,38.81,37.19,0.4152777777777778,0.84,99.48
2021-12-15,Meghalaya,1331,15,1327,16866,1962,1014,7.89,0,3.6,608967,5119,605833,54.5,28.17,4.685,0.84,99.49
2021-12-16,Meghalaya,138,0,135,2347,3959,1463,5.88,3,3.6,609105,5119,605968,109.97,40.64,0.6519444444444444,0.84,99.48
2021-12-17,Meghalaya,751,2,751,9843,4353,1803,7.63,0,3.6,609856,5121,606719,120.92,50.08,2.734166666666667,0.84,99.49
2021-12-18,Meghalaya,1312,5,1305,16534,1771,1531,7.94,2,3.6,611168,5126,608024,49.19,42.53,4.592777777777778,0.84,99.49
2021-12-19,Meghalaya,883,9,874,11374,4919,4718,7.76,0,3.6,612051,5135,608898,136.64,131.06,3.1594444444444445,0.84,99.48
2021-12-20,Meghalaya,1280,18,1271,16160,4281,2437,7.92,0,3.6,613331,5153,610169,118.92,67.69,4.488888888888889,0.84,99.48
2021-12-21,Meghalaya,871,3,868,10702,1617,1280,8.14,0,3.6,614202,5156,611037,44.92,35.56,2.972777777777778,0.84,99.48
2021-12-22,Meghalaya,1475,15,1471,18364,2578,908,8.03,0,3.6,615677,5171,612508,71.61,25.22,5.101111111111111,0.84,99.49
2021-12-23,Meghalaya,364,1,363,4613,2961,2899,7.89,0,3.6,616041,5172,612871,82.25,80.53,1.281388888888889,0.84,99.49
2021-12-24,Meghalaya,543,3,539,6617,2022,1532,8.21,1,3.6,616584,5175,613410,56.17,42.56,1.8380555555555556,0.84,99.49
2021-12-25,Meghalaya,1089,10,1087,13686,3965,1862,7.96,0,3.6,617673,5185,614497,110.14,51.72,3.8016666666666667,0.84,99.49
2021-12-26,Meghalaya,1297,18,1292,16381,1126,261,7.92,0,3.6,618970,5203,615789,31.28,7.25,4.550277777777778,0.84,99.49
2021-12-27,Meghalaya,1088,12,1083,13756,1358,1150,7.91,0,3.6,620058,5215,616872,37.72,31.94,3.821111111111111,0.84,99.49
2021-12-28,Meghalaya,1194,15,1193,15001,907,665,7.96,0,3.6,621252,5230,618065,25.19,18.47,4.166944444444445,0.84,99.49
2021-12-29,Meghalaya,626,9,619,7766,4267,2815,8.06,0,3.6,621878,5239,618684,118.53,78.19,2.1572222222222224,0.84,99.49
2021-12-30,Meghalaya,1083,6,1081,13455,506,499,8.05,0,3.6,622961,5245,619765,14.06,13.86,3.7375,0.84,99.49
2021-12-31,Meghalaya,354,1,351,4881,2104,338,7.25,2,3.6,623315,5246,620116,58.44,9.39,1.3558333333333332,0.84,99.49
2022-01-01,Meghalaya,1180,15,1180,15081,2789,944,7.82,0,3.6,624495,5261,621296,77.47,26.22,4.189166666666667,0.84,99.49
2022-01-02,Meghalaya,1567,11,1559,19900,271,90,7.87,0,3.6,626062,5272,622855,7.53,2.5,5.527777777777778,0.84,99.49
2022-01-03,Meghalaya,861,3,861,10710,4016,1965,8.04,0,3.6,626923,5275,623716,111.56,54.58,2.975,0.84,99.49
2022-01-04,Meghalaya,1127,10,1119,13671,3247,977,8.24,0,3.6,628050,5285,624835,90.19,27.14,3.7975,0.84,99.49
2022-01-05,Meghalaya,562,2,560,7018,4836,1834,8.01,0,3.6,628612,5287,625395,134.33,50.94,1.9494444444444445,0.84,99.49
2022-01-06,Meghalaya,526,5,526,6330,4963,607,8.31,0,3.6,629138,5292,625921,137.86,16.86,1.7583333333333333,0.84,99.49
2022-01-07,Meghalaya,355,3,355,4378,315,97,8.11,0,3.6,629493,5295,626276,8.75,2.69,1.2161111111111111,0.84,99.49
2022-01-08,Meghalaya,1149,16,1148,14417,197,159,7.97,0,3.6,630642,5311,627424,5.47,4.42,4.004722222222222,0.84,99.49
2022-01-09,Meghalaya,880,11,875,11149,1025,309,7.89,0,3.6,631522,5322,628299,28.47,8.58,3.0969444444444445,0.84,99.49
2022-01-10,Meghalaya,70,0,69,856,3717,1603,8.18,1,3.6,631592,5322,628368,103.25,44.53,0.23777777777777778,0.84,99.49
2022-01-11,Meghalaya,1373,19,1371,16884,3511,2006,8.13,0,3.6,632965,5341,629739,97.53,55.72,4.69,0.84,99.49
2022-01-12,Meghalaya,332,3,330,4292,848,379,7.74,0,3.6,633297,5344,630069,23.56,10.53,1.1922222222222223,0.84,99.49
2022-01-13,Meghalaya,988,14,988,12506,1790,370,7.9,0,3.6,634285,5358,631057,49.72,10.28,3.473888888888889,0.84,99.49
2022-01-14,Meghalaya,591,5,590,7775,3220,1615,7.6,0,3.6,634876,5363,631647,89.44,44.86,2.1597222222222223,0.84,99.49
2022-01-15,Meghalaya,890,7,890,11028,66,46,8.07,0,3.6,635766,5370,632537,1.83,1.28,3.0633333333333335,0.84,99.49
2022-01-16,Meghalaya,613,4,606,7954,4263,407,7.71,3,3.6,636379,5374,633143,118.42,11.31,2.2094444444444443,0.84,99.49
2022-01-17,Meghalaya,1529,6,1522,19439,4859,4338,7.87,1,3.6,637908,5380,634665,134.97,120.5,5.3997222222222225,0.84,99.49
2022-01-18,Meghalaya,389,4,381,5094,2190,939,7.64,4,3.6,638297,5384,635046,60.83,26.08,1.415,0.84,99.49
2022-01-19,Meghalaya,1512,12,1507,18756,3550,2920,8.06,0,3.6,639809,5396,636553,98.61,81.11,5.21,0.84,99.49
2022-01-20,Meghalaya,284,3,276,3510,447,381,8.09,5,3.6,640093,5399,636829,12.42,10.58,0.975,0.84,99.49
2022-01-21,Meghalaya,1172,6,1166,14851,1328,226,7.89,0,3.6,641265,5405,637995,36.89,6.28,4.125277777777778,0.84,99.49
2022-01-22,Meghalaya,1004,11,1003,12314,4256,1932,8.15,0,3.6,642269,5416,638998,118.22,53.67,3.4205555555555556,0.84,99.49
2022-01-23,Meghalaya,1147,8,1139,14495,2809,447,7.91,0,3.6,643416,5424,640137,78.03,12.42,4.026388888888889,0.84,99.49
2022-01-24,Meghalaya,1414,19,1410,17986,2081,1464,7.86,0,3.6,644830,5443,641547,57.81,40.67,4.996111111111111,0.84,99.49
2022-01-25,Meghalaya,533,3,531,7098,2683,272,7.51,0,3.6,645363,5446,642078,74.53,7.56,1.9716666666666667,0.84,99.49
2022-01-26,Meghalaya,677,4,670,8606,4614,1589,7.87,3,3.6,646040,5450,642748,128.17,44.14,2.3905555555555558,0.84,99.49
2022-01-27,Meghalaya,1013,3,1006,12654,498,180,8.01,4,3.6,647053,5453,643754,13.83,5.0,3.515,0.84,99.49
2022-01-28,Meghalaya,897,7,897,11774,1538,1208,7.62,0,3.6,647950,5460,644651,42.72,33.56,3.2705555555555557,0.84,99.49
2022-01-29,Meghalaya,1053,12,1051,12696,1662,389,8.29,0,3.6,649003,5472,645702,46.17,10.81,3.526666666666667,0.84,99.49
2022-01-30,Meghalaya,744,7,738,9227,357,19,8.06,0,3.6,649747,5479,646440,9.92,0.53,2.5630555555555556,0.84,99.49
2022-01-31,Meghalaya,594,7,585,7085,1393,1225,8.38,2,3.6,650341,5486,647025,38.69,34.03,1.9680555555555554,0.84,99.49
2022-02-01,Meghalaya,246,2,241,3270,3894,1147,7.52,3,3.6,650587,5488,647266,108.17,31.86,0.9083333333333333,0.84,99.49
2022-02-02,Meghalaya,675,4,669,7865,4895,2848,8.58,2,3.6,651262,5492,647935,135.97,79.11,2.1847222222222222,0.84,99.49
2022-02-03,Meghalaya,1457,7,1453,18280,236,23,7.97,0,3.6,652719,5499,649388,6.56,0.64,5.0777777777777775,0.84,99.49
2022-02-04,Meghalaya,270,1,267,3307,4622,2999,8.16,2,3.6,652989,5500,649655,128.39,83.31,0.9186111111111112,0.84,99.49
2022-02-05,Meghalaya,1261,9,1260,15703,4968,3144,8.03,0,3.6,654250,5509,650915,138.0,87.33,4.361944444444444,0.84,99.49
2022-02-06,Meghalaya,1475,8,1468,18443,3199,2109,8.0,0,3.6,655725,5517,652383,88.86,58.58,5.123055555555555,0.84,99.49
2022-02-07,Meghalaya,992,14,992,12409,3665,1098,7.99,0,3.6,656717,5531,653375,101.81,30.5,3.4469444444444446,0.84,99.49
2022-02-08,Meghalaya,1378,14,1378,17461,4010,2046,7.89,0,3.6,658095,5545,654753,111.39,56.83,4.8502777777777775,0.84,99.49
2022-02-09,Meghalaya,921,10,919,11465,861,437,8.03,0,3.6,659016,5555,655672,23.92,12.14,3.1847222222222222,0.84,99.49
2022-02-10,Meghalaya,50,0,42,861,61,54,5.81,8,3.6,659066,5555,655714,1.69,1.5,0.23916666666666667,0.84,99.49
2022-02-11,Meghalaya,1141,6,1139,14170,3587,3198,8.05,0,3.6,660207,5561,656853,99.64,88.83,3.936111111111111,0.84,99.49
2022-02-12,Meghalaya,597,1,590,7647,4661,3410,7.81,6,3.6,660804,5562,657443,129.47,94.72,2.1241666666666665,0.84,99.49
2022-02-13,Meghalaya,1373,13,1368,17314,3031,2332,7.93,0,3.6,662177,5575,658811,84.19,64.78,4.809444444444445,0.84,99.49
2022-02-14,Meghalaya,384,4,377,4532,976,927,8.47,3,3.6,662561,5579,659188,27.11,25.75,1.258888888888889,0.84,99.49
2022-02-15,Meghalaya,1644,19,1643,19962,2535,1912,8.24,0,3.6,664205,5598,660831,70.42,53.11,5.545,0.84,99.49
2022-02-16,Meghalaya,1037,5,1031,13003,4853,2573,7.98,1,3.6,665242,5603,661862,134.81,71.47,3.6119444444444446,0.84,99.49
2022-02-17,Meghalaya,1366,10,1358,17144,149,109,7.97,0,3.6,666608,5613,663220,4.14,3.03,4.762222222222222,0.84,99.49
2022-02-18,Meghalaya,675,3,672,8100,1884,1635,8.33,0,3.6,667283,5616,663892,52.33,45.42,2.25,0.84,99.49
2022-02-19,Meghalaya,685,5,685,8552,2688,1992,8.01,0,3.6,667968,5621,664577,74.67,55.33,2.3755555555555556,0.84,99.49
2022-02-20,Meghalaya,143,2,134,2219,4941,3156,6.44,7,3.6,668111,5623,664711,137.25,87.67,0.6163888888888889,0.84,99.49
2022-02-21,Meghalaya,349,2,343,4384,4270,3239,7.96,4,3.6,668460,5625,665054,118.61,89.97,1.2177777777777778,0.84,99.49
2022-02-22,Meghalaya,1398,16,1391,17615,4124,73,7.94,0,3.6,669858,5641,666445,114.56,2.03,4.893055555555556,0.84,99.49
2022-02-23,Meghalaya,1494,12,1488,18395,1405,458,8.12,0,3.6,671352,5653,667933,39.03,12.72,5.1097222222222225,0.84,99.49
2022-02-24,Meghalaya,1139,3,1132,14230,3694,260,8.0,4,3.6,672491,5656,669065,102.61,7.22,3.952777777777778,0.84,99.49
2022-02-25,Meghalaya,1325,16,1318,16287,2959,679,8.14,0,3.6,673816,5672,670383,82.19,18.86,4.524166666666667,0.84,99.49
2022-02-26,Meghalaya,1301,6,1294,16325,861,47,7.97,1,3.6,675117,5678,671677,23.92,1.31,4.534722222222222,0.84,99.49
2022-02-27,Meghalaya,1119,9,1118,14170,426,292,7.9,0,3.6,676236,5687,672795,11.83,8.11,3.936111111111111,0.84,99.49
2022-02-28,Meghalaya,1223,6,1221,14969,1115,142,8.17,0,3.6,677459,5693,674016,30.97,3.94,4.158055555555555,0.84,99.49
2022-03-01,Meghalaya,310,2,304,4254,3571,2944,7.29,4,3.6,677769,5695,674320,99.19,81.78,1.1816666666666666,0.84,99.49
2022-03-02,Meghalaya,1241,7,1237,15886,4082,985,7.81,0,3.6,679010,5702,675557,113.39,27.36,4.4127777777777775,0.84,99.49
2022-03-03,Meghalaya,1015,12,1012,12457,1352,1051,8.15,0,3.6,680025,5714,676569,37.56,29.19,3.460277777777778,0.84,99.49
2022-03-04,Meghalaya,1260,16,1256,15603,1851,396,8.08,0,3.6,681285,5730,677825,51.42,11.0,4.3341666666666665,0.84,99.49
2022-03-05,Meghalaya,1041,6,1039,13259,919,199,7.85,0,3.6,682326,5736,678864,25.53,5.53,3.6830555555555557,0.84,99.49
2022-03-06,Meghalaya,1098,9,1096,13738,2939,2926,7.99,0,3.6,683424,5745,679960,81.64,81.28,3.8161111111111112,0.84,99.49
2022-03-07,Meghalaya,1235,6,1235,15199,3021,1419,8.13,0,3.6,684659,5751,681195,83.92,39.42,4.2219444444444445,0.84,99.49
2022-03-08,Meghalaya,536,7,528,6739,2716,338,7.95,1,3.6,685195,5758,681723,75.44,9.39,1.8719444444444444,0.84,99.49
2022-03-09,Meghalaya,528,2,523,6499,169,149,8.12,3,3.6,685723,5760,682246,4.69,4.14,1.8052777777777778,0.84,99.49
2022-03-10,Meghalaya,978,11,975,12193,4929,1094,8.02,0,3.6,686701,5771,683221,136.92,30.39,3.3869444444444445,0.84,99.49
2022-03-11,Meghalaya,972,3,965,12199,1385,1119,7.97,4,3.6,687673,5774,684186,38.47,31.08,3.388611111111111,0.84,99.49
2022-03-12,Meghalaya,614,7,605,7507,4497,2308,8.18,2,3.6,688287,5781,684791,124.92,64.11,2.085277777777778,0.84,99.49
2022-03-13,Meghalaya,1220,5,1216,15003,4585,3918,8.13,0,3.6,689507,5786,686007,127.36,108.83,4.1675,0.84,99.49
2022-03-14,Meghalaya,1413,14,1412,17716,1104,45,7.98,0,3.6,690920,5800,687419,30.67,1.25,4.921111111111111,0.84,99.49
2022-03-15,Meghalaya,1296,18,1289,16428,2980,1249,7.89,0,3.6,692216,5818,688708,82.78,34.69,4.5633333333333335,0.84,99.49
2022-03-16,Meghalaya,1497,21,1494,18650,1635,1370,8.03,0,3.6,693713,5839,690202,45.42,38.06,5.180555555555555,0.84,99.49
2022-03-17,Meghalaya,984,11,976,12106,2348,234,8.13,0,3.6,694697,5850,691178,65.22,6.5,3.3627777777777776,0.84,99.49
2022-03-18,Meghalaya,589,8,581,7209,139,113,8.17,0,3.6,695286,5858,691759,3.86,3.14,2.0025,0.84,99.49
2022-03-19,Meghalaya,596,5,590,7740,1042,88,7.7,1,3.6,695882,5863,692349,28.94,2.44,2.15,0.84,99.49
2022-03-20,Meghalaya,33,0,33,710,1126,332,4.65,0,3.6,695915,5863,692382,31.28,9.22,0.19722222222222222,0.84,99.49
2022-03-21,Meghalaya,253,2,247,3561,2148,872,7.1,4,3.6,696168,5865,692629,59.67,24.22,0.9891666666666666,0.84,99.49
2022-03-22,Meghalaya,872,11,869,10248,3716,3668,8.51,0,3.6,697040,5876,693498,103.22,101.89,2.8466666666666667,0.84,99.49
2022-03-23,Meghalaya,1044,8,1038,13096,3102,2427,7.97,0,3.6,698084,5884,694536,86.17,67.42,3.637777777777778,0.84,99.49
2022-03-24,Meghalaya,171,1,169,2548,2751,2348,6.71,1,3.6,698255,5885,694705,76.42,65.22,0.7077777777777777,0.84,99.49
2022-03-25,Meghalaya,837,2,831,10178,2588,961,8.22,4,3.6,699092,5887,695536,71.89,26.69,2.8272222222222223,0.84,99.49
2022-03-26,Meghalaya,659,8,656,8495,1345,72,7.76,0,3.6,699751,5895,696192,37.36,2.0,2.359722222222222,0.84,99.49
2022-03-27,Meghalaya,993,13,984,12657,2117,1545,7.85,0,3.6,700744,5908,697176,58.81,42.92,3.515833333333333,0.84,99.49
2022-03-28,Meghalaya,112,1,110,1698,3533,2447,6.6,1,3.6,700856,5909,697286,98.14,67.97,0.4716666666666667,0.84,99.49
2022-03-29,Meghalaya,1409,17,1402,17715,1952,342,7.95,0,3.6,702265,5926,698688,54.22,9.5,4.920833333333333,0.84,99.49
2022-03-30,Meghalaya,245,3,242,2796,887,176,8.76,0,3.6,702510,5929,698930,24.64,4.89,0.7766666666666666,0.84,99.49
2022-03-31,Meghalaya,566,7,561,6855,4327,3822,8.26,0,3.6,703076,5936,699491,120.19,106.17,1.9041666666666666,0.84,99.49
2022-04-01,Meghalaya,1006,4,1005,12451,2138,734,8.08,0,3.6,704082,5940,700496,59.39,20.39,3.4586111111111113,0.84,99.49
2022-04-02,Meghalaya,118,1,114,1390,2986,870,8.49,3,3.6,704200,5941,700610,82.94,24.17,0.3861111111111111,0.84,99.49
2022-04-03,Meghalaya,1098,4,1089,13780,2070,691,7.97,5,3.6,705298,5945,701699,57.5,19.19,3.827777777777778,0.84,99.49
2022-04-04,Meghalaya,537,3,533,6586,1826,1448,8.15,1,3.6,705835,5948,702232,50.72,40.22,1.8294444444444444,0.84,99.49
2022-04-05,Meghalaya,561,8,561,7076,4499,2494,7.93,0,3.6,706396,5956,702793,124.97,69.28,1.9655555555555555,0.84,99.49
2022-04-06,Meghalaya,1564,8,1564,19578,2676,1623,7.99,0,3.6,707960,5964,704357,74.33,45.08,5.4383333333333335,0.84,99.49
2022-04-07,Meghalaya,1193,11,1190,15155,308,97,7.87,0,3.6,709153,5975,705547,8.56,2.69,4.209722222222222,0.84,99.49
2022-04-08,Meghalaya,1042,7,1041,12933,1654,712,8.06,0,3.6,710195,5982,706588,45.94,19.78,3.5925,0.84,99.49
2022-04-09,Meghalaya,1604,18,1600,19929,2235,2119,8.05,0,3.6,711799,6000,708188,62.08,58.86,5.535833333333334,0.84,99.49
2022-04-10,Meghalaya,669,5,663,8279,843,622,8.08,1,3.6,712468,6005,708851,23.42,17.28,2.299722222222222,0.84,99.49
2022-04-11,Meghalaya,865,3,860,10949,573,11,7.9,2,3.6,713333,6008,709711,15.92,0.31,3.0413888888888887,0.84,99.49
2022-04-12,Meghalaya,864,8,860,10281,4897,1044,8.4,0,3.6,714197,6016,710571,136.03,29.0,2.8558333333333334,0.84,99.49
2022-04-13,Meghalaya,767,5,767,9618,2417,1964,7.97,0,3.6,714964,6021,711338,67.14,54.56,2.671666666666667,0.84,99.49
2022-04-14,Meghalaya,395,1,395,5018,4701,1061,7.87,0,3.6,715359,6022,711733,130.58,29.47,1.393888888888889,0.84,99.49
2022-04-15,Meghalaya,1385,20,1377,17103,4443,1202,8.1,0,3.6,716744,6042,713110,123.42,33.39,4.7508333333333335,0.84,99.49
2022-04-16,Meghalaya,233,1,226,2715,4373,2808,8.58,6,3.6,716977,6043,713336,121.47,78.0,0.7541666666666667,0.84,99.49
2022-04-17,Meghalaya,457,6,455,5660,3071,501,8.07,0,3.6,717434,6049,713791,85.31,13.92,1.5722222222222222,0.84,99.49
2022-04-18,Meghalaya,771,9,770,9788,447,364,7.88,0,3.6,718205,6058,714561,12.42,10.11,2.718888888888889,0.84,99.49
2022-04-19,Meghalaya,1207,6,1199,15215,3919,1885,7.93,2,3.6,719412,6064,715760,108.86,52.36,4.226388888888889,0.84,99.49
2022-04-20,Meghalaya,771,3,763,9319,4444,4394,8.27,5,3.6,720183,6067,716523,123.44,122.06,2.588611111111111,0.84,99.49
2022-04-21,Meghalaya,1441,4,1440,17599,1925,463,8.19,0,3.6,721624,6071,717963,53.47,12.86,4.8886111111111115,0.84,99.49
2022-04-22,Meghalaya,182,1,178,2324,3204,2318,7.83,3,3.6,721806,6072,718141,89.0,64.39,0.6455555555555555,0.84,99.49
2022-04-23,Meghalaya,646,3,639,7656,12,1,8.44,4,3.6,722452,6075,718780,0.33,0.03,2.1266666666666665,0.84,99.49
2022-04-24,Meghalaya,1230,6,1228,15488,1968,1271,7.94,0,3.6,723682,6081,720008,54.67,35.31,4.302222222222222,0.84,99.49
2022-04-25,Meghalaya,519,4,512,6739,3201,2696,7.7,3,3.6,724201,6085,720520,88.92,74.89,1.8719444444444444,0.84,99.49
2022-04-26,Meghalaya,983,7,981,12225,3312,2859,8.04,0,3.6,725184,6092,721501,92.0,79.42,3.3958333333333335,0.84,99.49
2022-04-27,Meghalaya,272,3,271,3476,3328,890,7.83,0,3.6,725456,6095,721772,92.44,24.72,0.9655555555555555,0.84,99.49
2022-04-28,Meghalaya,992,6,992,12602,3854,870,7.87,0,3.6,726448,6101,722764,107.06,24.17,3.5005555555555556,0.84,99.49
2022-04-29,Meghalaya,1572,6,1571,19835,3881,3268,7.93,0,3.6,728020,6107,724335,107.81,90.78,5.509722222222222,0.84,99.49
2022-04-30,Meghalaya,470,6,465,5857,4782,1501,8.02,0,3.6,728490,6113,724800,132.83,41.69,1.6269444444444445,0.84,99.49
2022-05-01,Meghalaya,1076,6,1067,13389,458,316,8.04,3,3.6,729566,6119,725867,12.72,8.78,3.7191666666666667,0.84,99.49
2022-05-02,Meghalaya,1578,23,1573,19625,1164,410,8.04,0,3.6,731144,6142,727440,32.33,11.39,5.451388888888889,0.84,99.49
2022-05-03,Meghalaya,1050,9,1050,12852,390,127,8.17,0,3.6,732194,6151,728490,10.83,3.53,3.57,0.84,99.49
2022-05-04,Meghalaya,1089,4,1081,13630,3766,990,7.99,4,3.6,733283,6155,729571,104.61,27.5,3.786111111111111,0.84,99.49
2022-05-05,Meghalaya,1076,6,1075,13666,4735,1057,7.87,0,3.6,734359,6161,730646,131.53,29.36,3.796111111111111,0.84,99.49
2022-05-06,Meghalaya,235,3,228,3047,520,139,7.71,4,3.6,734594,6164,730874,14.44,3.86,0.8463888888888889,0.84,99.49
2022-05-07,Meghalaya,991,10,988,12502,4168,829,7.93,0,3.6,735585,6174,731862,115.78,23.03,3.472777777777778,0.84,99.49
2022-05-08,Meghalaya,1025,3,1020,13147,4394,4359,7.8,2,3.6,736610,6177,732882,122.06,121.08,3.6519444444444447,0.84,99.49
2022-05-09,Meghalaya,1090,7,1085,13674,2541,608,7.97,0,3.6,737700,6184,733967,70.58,16.89,3.7983333333333333,0.84,99.49
2022-05-10,Meghalaya,1492,14,1484,18572,2215,835,8.03,0,3.6,739192,6198,735451,61.53,23.19,5.158888888888889,0.84,99.49
2022-05-11,Meghalaya,1268,17,1263,16098,3255,979,7.88,0,3.6,740460,6215,736714,90.42,27.19,4.471666666666667,0.84,99.49
2022-05-12,Meghalaya,214,1,206,2767,4577,4119,7.73,7,3.6,740674,6216,736920,127.14,114.42,0.7686111111111111,0.84,99.49
2022-05-13,Meghalaya,442,4,434,5644,4535,4242,7.83,4,3.6,741116,6220,737354,125.97,117.83,1.5677777777777777,0.84,99.49
2022-05-14,Meghalaya,520,2,513,6950,1852,763,7.48,5,3.6,741636,6222,737867,51.44,21.19,1.9305555555555556,0.84,99.49
2022-05-15,Meghalaya,1019,9,1013,12663,1452,632,8.05,0,3.6,742655,6231,738880,40.33,17.56,3.5175,0.84,99.49
2022-05-16,Meghalaya,690,9,682,8582,2574,996,8.04,0,3.6,743345,6240,739562,71.5,27.67,2.383888888888889,0.84,99.49
2022-05-17,Meghalaya,517,4,514,6559,954,97,7.88,0,3.6,743862,6244,740076,26.5,2.69,1.8219444444444444,0.84,99.49
2022-05-18,Meghalaya,1550,18,1550,19331,4334,2782,8.02,0,3.6,745412,6262,741626,120.39,77.28,5.369722222222222,0.84,99.49
2022-05-19,Meghalaya,726,5,723,9124,550,368,7.96,0,3.6,746138,6267,742349,15.28,10.22,2.5344444444444445,0.84,99.49
2022-05-20,Meghalaya,179,1,175,2024,984,306,8.84,3,3.6,746317,6268,742524,27.33,8.5,0.5622222222222222,0.84,99.49
2022-05-21,Meghalaya,1461,12,1459,18350,316,18,7.96,0,3.6,747778,6280,743983,8.78,0.5,5.097222222222222,0.84,99.49
2022-05-22,Meghalaya,1211,9,1205,15004,4445,2512,8.07,0,3.6,748989,6289,745188,123.47,69.78,4.167777777777777,0.84,99.49
2022-05-23,Meghalaya,130,1,121,1587,428,360,8.19,8,3.6,749119,6290,745309,11.89,10.0,0.44083333333333335,0.84,99.49
2022-05-24,Meghalaya,207,2,206,2668,341,40,7.76,0,3.6,749326,6292,745515,9.47,1.11,0.7411111111111112,0.84,99.49
2022-05-25,Meghalaya,97,1,90,971,2620,110,9.99,6,3.6,749423,6293,745605,72.78,3.06,0.2697222222222222,0.84,99.49
2022-05-26,Meghalaya,74,0,68,987,2421,164,7.5,6,3.6,749497,6293,745673,67.25,4.56,0.27416666666666667,0.84,99.49
2022-05-27,Meghalaya,1492,5,1489,18611,441,197,8.02,0,3.6,750989,6298,747162,12.25,5.47,5.169722222222222,0.84,99.49
2022-05-28,Meghalaya,1194,10,1187,14645,145,110,8.15,0,3.6,752183,6308,748349,4.03,3.06,4.0680555555555555,0.84,99.49
2022-05-29,Meghalaya,982,11,978,12151,692,480,8.08,0,3.6,753165,6319,749327,19.22,13.33,3.375277777777778,0.84,99.49
2022-05-30,Meghalaya,1318,15,1312,16097,4985,4864,8.19,0,3.6,754483,6334,750639,138.47,135.11,4.471388888888889,0.84,99.49
2022-05-31,Meghalaya,155,1,154,1798,4405,2326,8.62,0,3.6,754638,6335,750793,122.36,64.61,0.49944444444444447,0.84,99.49
2022-06-01,Meghalaya,801,4,797,10166,1471,896,7.88,0,3.6,755439,6339,751590,40.86,24.89,2.823888888888889,0.84,99.49
2022-06-02,Meghalaya,432,5,425,5566,2295,1722,7.76,2,3.6,755871,6344,752015,63.75,47.83,1.5461111111111112,0.84,99.49
2022-06-03,Meghalaya,541,7,532,6099,4184,3034,8.87,2,3.6,756412,6351,752547,116.22,84.28,1.6941666666666666,0.84,99.49
2022-06-04,Meghalaya,1574,16,1574,19623,33,26,8.02,0,3.6,757986,6367,754121,0.92,0.72,5.450833333333334,0.84,99.49
2022-06-05,Meghalaya,1231,9,1227,15388,4525,948,8.0,0,3.6,759217,6376,755348,125.69,26.33,4.274444444444445,0.84,99.49
2022-06-06,Meghalaya,1588,13,1579,19723,3079,2166,8.05,0,3.6,760805,6389,756927,85.53,60.17,5.478611111111111,0.84,99.49
2022-06-07,Meghalaya,1398,18,1397,17699,270,190,7.9,0,3.6,762203,6407,758324,7.5,5.28,4.916388888888889,0.84,99.49
2022-06-08,Meghalaya,936,7,933,11652,2298,2199,8.03,0,3.6,763139,6414,759257,63.83,61.08,3.236666666666667,0.84,99.49
2022-06-09,Meghalaya,1548,22,1542,19400,165,22,7.98,0,3.6,764687,6436,760799,4.58,0.61,5.388888888888889,0.84,99.49
2022-06-10,Meghalaya,713,7,712,8763,3557,3077,8.14,0,3.6,765400,6443,761511,98.81,85.47,2.4341666666666666,0.84,99.49
2022-06-11,Meghalaya,1428,20,1428,17814,2342,192,8.02,0,3.6,766828,6463,762939,65.06,5.33,4.948333333333333,0.84,99.49
2022-06-12,Meghalaya,243,2,240,3021,4958,3363,8.04,1,3.6,767071,6465,763179,137.72,93.42,0.8391666666666666,0.84,99.49
2022-06-13,Meghalaya,1179,9,1177,14755,4512,3835,7.99,0,3.6,768250,6474,764356,125.33,106.53,4.098611111111111,0.84,99.49
2022-06-14,Meghalaya,1362,18,1361,16878,4925,1634,8.07,0,3.6,769612,6492,765717,136.81,45.39,4.6883333333333335,0.84,99.49
2022-06-15,Meghalaya,907,10,904,11497,1940,1698,7.89,0,3.6,770519,6502,766621,53.89,47.17,3.193611111111111,0.84,99.49
2022-06-16,Meghalaya,1106,6,1099,13637,433,51,8.11,1,3.6,771625,6508,767720,12.03,1.42,3.7880555555555557,0.84,99.49
2022-06-17,Meghalaya,699,6,694,9032,4284,2838,7.74,0,3.6,772324,6514,768414,119.0,78.83,2.508888888888889,0.84,99.49
2022-06-18,Meghalaya,676,8,669,7911,3051,2831,8.55,0,3.6,773000,6522,769083,84.75,78.64,2.1975,0.84,99.49
2022-06-19,Meghalaya,381,5,379,4867,3863,2908,7.83,0,3.6,773381,6527,769462,107.31,80.78,1.3519444444444444,0.84,99.49
2022-06-20,Meghalaya,1019,4,1017,12826,4910,2326,7.94,0,3.6,774400,6531,770479,136.39,64.61,3.562777777777778,0.84,99.49
2022-06-21,Meghalaya,182,1,174,2007,1198,1183,9.07,7,3.6,774582,6532,770653,33.28,32.86,0.5575,0.84,99.49
2022-06-22,Meghalaya,941,6,941,11657,72,50,8.07,0,3.6,775523,6538,771594,2.0,1.39,3.2380555555555555,0.84,99.49
2022-06-23,Meghalaya,352,4,347,4584,1097,588,7.68,1,3.6,775875,6542,771941,30.47,16.33,1.2733333333333334,0.84,99.49
2022-06-24,Meghalaya,1323,19,1318,16783,302,184,7.88,0,3.6,777198,6561,773259,8.39,5.11,4.661944444444444,0.84,99.49
2022-06-25,Meghalaya,1490,12,1483,18407,1401,607,8.09,0,3.6,778688,6573,774742,38.92,16.86,5.1130555555555555,0.84,99.49
2022-06-26,Meghalaya,1537,17,1532,19564,2573,1006,7.86,0,3.6,780225,6590,776274,71.47,27.94,5.434444444444445,0.84,99.49
2022-06-27,Meghalaya,690,3,690,8743,3193,768,7.89,0,3.6,780915,6593,776964,88.69,21.33,2.428611111111111,0.84,99.49
2022-06-28,Meghalaya,1245,15,1238,15852,3222,2311,7.85,0,3.6,782160,6608,778202,89.5,64.19,4.403333333333333,0.84,99.49
2022-06-29,Meghalaya,1178,15,1174,14704,986,613,8.01,0,3.6,783338,6623,779376,27.39,17.03,4.084444444444444,0.85,99.49
2022-06-30,Meghalaya,265,0,264,3496,4670,3083,7.58,1,3.6,783603,6623,779640,129.72,85.64,0.9711111111111111,0.85,99.49
2022-07-01,Meghalaya,470,3,463,5653,743,672,8.31,4,3.6,784073,6626,780103,20.64,18.67,1.5702777777777779,0.85,99.49
2022-07-02,Meghalaya,1027,8,1022,12773,1968,718,8.04,0,3.6,785100,6634,781125,54.67,19.94,3.5480555555555555,0.84,99.49
2022-07-03,Meghalaya,91,1,87,1226,2362,661,7.42,3,3.6,785191,6635,781212,65.61,18.36,0.34055555555555556,0.85,99.49
2022-07-04,Meghalaya,904,9,898,11182,1259,1074,8.08,0,3.6,786095,6644,782110,34.97,29.83,3.1061111111111113,0.85,99.49
2022-07-05,Meghalaya,1130,6,1129,14224,2945,570,7.94,0,3.6,787225,6650,783239,81.81,15.83,3.951111111111111,0.84,99.49
2022-07-06,Meghalaya,890,7,887,11239,4227,2689,7.92,0,3.6,788115,6657,784126,117.42,74.69,3.1219444444444444,0.84,99.49
2022-07-07,Meghalaya,1515,18,1508,19084,1001,797,7.94,0,3.6,789630,6675,785634,27.81,22.14,5.301111111111111,0.85,99.49
2022-07-08,Meghalaya,64,0,60,696,3409,567,9.2,4,3.6,789694,6675,785694,94.69,15.75,0.19333333333333333,0.85,99.49
2022-07-09,Meghalaya,74,0,71,829,1131,239,8.93,3,3.6,789768,6675,785765,31.42,6.64,0.23027777777777778,0.85,99.49
2022-07-10,Meghalaya,704,6,697,8907,1546,1487,7.9,1,3.6,790472,6681,786462,42.94,41.31,2.4741666666666666,0.85,99.49
2022-07-11,Meghalaya,534,5,529,6915,3091,1764,7.72,0,3.6,791006,6686,786991,85.86,49.0,1.9208333333333334,0.85,99.49
2022-07-12,Meghalaya,1069,7,1067,13650,3841,1161,7.83,0,3.6,792075,6693,788058,106.69,32.25,3.7916666666666665,0.84,99.49
2022-07-13,Meghalaya,113,1,104,1385,3665,308,8.16,8,3.6,792188,6694,788162,101.81,8.56,0.38472222222222224,0.85,99.49
2022-07-14,Meghalaya,1004,6,999,12719,2372,2035,7.89,0,3.6,793192,6700,789161,65.89,56.53,3.5330555555555554,0.84,99.49
2022-07-15,Meghalaya,1123,4,1116,13320,825,770,8.43,3,3.6,794315,6704,790277,22.92,21.39,3.7,0.84,99.49
2022-07-16,Meghalaya,1396,13,1391,18089,388,171,7.72,0,3.6,795711,6717,791668,10.78,4.75,5.0247222222222225,0.84,99.49
2022-07-17,Meghalaya,602,3,600,7313,4223,145,8.23,0,3.6,796313,6720,792268,117.31,4.03,2.031388888888889,0.84,99.49
2022-07-18,Meghalaya,1530,16,1522,18799,1330,414,8.14,0,3.6,797843,6736,793790,36.94,11.5,5.2219444444444445,0.84,99.49
2022-07-19,Meghalaya,289,3,288,3532,3047,927,8.18,0,3.6,798132,6739,794078,84.64,25.75,0.9811111111111112,0.84,99.49
2022-07-20,Meghalaya,208,1,207,2946,2923,1551,7.06,0,3.6,798340,6740,794285,81.19,43.08,0.8183333333333334,0.84,99.49
2022-07-21,Meghalaya,1147,3,1146,14680,2448,1742,7.81,0,3.6,799487,6743,795431,68.0,48.39,4.0777777777777775,0.84,99.49
2022-07-22,Meghalaya,1219,16,1211,15753,2995,1978,7.74,0,3.6,800706,6759,796642,83.19,54.94,4.3758333333333335,0.84,99.49
2022-07-23,Meghalaya,853,3,844,10616,3595,230,8.04,6,3.6,801559,6762,797486,99.86,6.39,2.948888888888889,0.84,99.49
2022-07-24,Meghalaya,650,8,642,8549,1933,1718,7.6,0,3.6,802209,6770,798128,53.69,47.72,2.374722222222222,0.84,99.49
2022-07-25,Meghalaya,428,5,427,5444,3601,3436,7.86,0,3.6,802637,6775,798555,100.03,95.44,1.5122222222222221,0.84,99.49
2022-07-26,Meghalaya,1585,17,1579,19431,2444,1617,8.16,0,3.6,804222,6792,800134,67.89,44.92,5.3975,0.84,99.49
2022-07-27,Meghalaya,1417,12,1412,17463,2957,1354,8.11,0,3.6,805639,6804,801546,82.14,37.61,4.850833333333333,0.84,99.49
2022-07-28,Meghalaya,1302,9,1297,16173,2995,328,8.05,0,3.6,806941,6813,802843,83.19,9.11,4.4925,0.84,99.49
2022-07-29,Meghalaya,1394,7,1391,17263,4032,997,8.08,0,3.6,808335,6820,804234,112.0,27.69,4.795277777777778,0.84,99.49
2022-07-30,Meghalaya,610,7,605,7516,1883,494,8.12,0,3.6,808945,6827,804839,52.31,13.72,2.0877777777777777,0.84,99.49
2022-07-31,Meghalaya,49,0,45,999,2591,2070,4.9,4,3.6,808994,6827,804884,71.97,57.5,0.2775,0.84,99.49
2022-08-01,Meghalaya,1322,8,1320,16074,3084,1647,8.22,0,3.6,810316,6835,806204,85.67,45.75,4.465,0.84,99.49
2022-08-02,Meghalaya,1050,9,1044,13248,1172,490,7.93,0,3.6,811366,6844,807248,32.56,13.61,3.68,0.84,99.49
2022-08-03,Meghalaya,716,4,712,8888,3363,530,8.06,0,3.6,812082,6848,807960,93.42,14.72,2.468888888888889,0.84,99.49
2022-08-04,Meghalaya,1447,12,1443,18307,3408,811,7.9,0,3.6,813529,6860,809403,94.67,22.53,5.085277777777778,0.84,99.49
2022-08-05,Meghalaya,925,3,917,11133,41,39,8.31,5,3.6,814454,6863,810320,1.14,1.08,3.0925,0.84,99.49
2022-08-06,Meghalaya,1108,6,1102,13852,3377,2724,8.0,0,3.6,815562,6869,811422,93.81,75.67,3.847777777777778,0.84,99.49
2022-08-07,Meghalaya,1061,14,1058,13499,4803,1334,7.86,0,3.6,816623,6883,812480,133.42,37.06,3.749722222222222,0.84,99.49
2022-08-08,Meghalaya,739,6,736,9167,569,517,8.06,0,3.6,817362,6889,813216,15.81,14.36,2.546388888888889,0.84,99.49
2022-08-09,Meghalaya,420,1,418,5040,3408,2613,8.33,1,3.6,817782,6890,813634,94.67,72.58,1.4,0.84,99.49
2022-08-10,Meghalaya,233,2,230,2319,147,31,10.05,1,3.6,818015,6892,813864,4.08,0.86,0.6441666666666667,0.84,99.49
2022-08-11,Meghalaya,1288,5,1280,15876,2374,524,8.11,3,3.6,819303,6897,815144,65.94,14.56,4.41,0.84,99.49
2022-08-12,Meghalaya,621,7,616,7630,2500,2473,8.14,0,3.6,819924,6904,815760,69.44,68.69,2.1194444444444445,0.84,99.49
2022-08-13,Meghalaya,1070,15,1068,13237,3248,442,8.08,0,3.6,820994,6919,816828,90.22,12.28,3.6769444444444446,0.84,99.49
2022-08-14,Meghalaya,372,1,370,4567,3405,548,8.15,1,3.6,821366,6920,817198,94.58,15.22,1.2686111111111111,0.84,99.49
2022-08-15,Meghalaya,1464,10,1458,18627,2226,476,7.86,0,3.6,822830,6930,818656,61.83,13.22,5.174166666666666,0.84,99.49
2022-08-16,Meghalaya,710,2,708,8906,843,630,7.97,0,3.6,823540,6932,819364,23.42,17.5,2.473888888888889,0.84,99.49
2022-08-17,Meghalaya,1525,11,1525,18793,1377,621,8.11,0,3.6,825065,6943,820889,38.25,17.25,5.220277777777778,0.84,99.49
2022-08-18,Meghalaya,933,3,924,12057,2939,1229,7.74,6,3.6,825998,6946,821813,81.64,34.14,3.3491666666666666,0.84,99.49
2022-08-19,Meghalaya,1031,8,1023,12617,37,37,8.17,0,3.6,827029,6954,822836,1.03,1.03,3.504722222222222,0.84,99.49
2022-08-20,Meghalaya,1117,10,1110,14060,115,26,7.94,0,3.6,828146,6964,823946,3.19,0.72,3.9055555555555554,0.84,99.49
2022-08-21,Meghalaya,1535,15,1527,19078,1957,986,8.05,0,3.6,829681,6979,825473,54.36,27.39,5.299444444444444,0.84,99.49
2022-08-22,Meghalaya,1194,3,1189,14958,1555,1300,7.98,2,3.6,830875,6982,826662,43.19,36.11,4.155,0.84,99.49
2022-08-23,Meghalaya,1448,4,1441,17999,853,741,8.04,3,3.6,832323,6986,828103,23.69,20.58,4.999722222222222,0.84,99.49
2022-08-24,Meghalaya,1176,16,1174,14649,4585,569,8.03,0,3.6,833499,7002,829277,127.36,15.81,4.069166666666667,0.84,99.49
2022-08-25,Meghalaya,1459,15,1457,18071,1528,111,8.07,0,3.6,834958,7017,830734,42.44,3.08,5.019722222222223,0.84,99.49
2022-08-26,Meghalaya,1352,13,1348,16743,3753,1036,8.08,0,3.6,836310,7030,832082,104.25,28.78,4.650833333333333,0.84,99.49
2022-08-27,Meghalaya,1353,9,1345,17191,3686,1173,7.87,0,3.6,837663,7039,833427,102.39,32.58,4.775277777777778,0.84,99.49
2022-08-28,Meghalaya,593,6,590,7274,3764,468,8.15,0,3.6,838256,7045,834017,104.56,13.0,2.0205555555555557,0.84,99.49
2022-08-29,Meghalaya,1294,17,1294,16331,51,24,7.92,0,3.6,839550,7062,835311,1.42,0.67,4.536388888888889,0.84,99.5
2022-08-30,Meghalaya,320,3,317,4052,1723,55,7.9,0,3.6,839870,7065,835628,47.86,1.53,1.1255555555555556,0.84,99.49
2022-08-31,Meghalaya,723,6,718,8783,1731,1010,8.23,0,3.6,840593,7071,836346,48.08,28.06,2.439722222222222,0.84,99.49
2022-09-01,Meghalaya,635,7,631,7573,461,281,8.39,0,3.6,841228,7078,836977,12.81,7.81,2.1036111111111113,0.84,99.49
2022-09-02,Meghalaya,1017,10,1011,13191,1580,277,7.71,0,3.6,842245,7088,837988,43.89,7.69,3.6641666666666666,0.84,99.49
2022-09-03,Meghalaya,1164,11,1163,14234,689,359,8.18,0,3.6,843409,7099,839151,19.14,9.97,3.953888888888889,0.84,99.5
2022-09-04,Meghalaya,1371,16,1369,17174,2428,349,7.98,0,3.6,844780,7115,840520,67.44,9.69,4.770555555555555,0.84,99.5
2022-09-05,Meghalaya,698,6,696,9308,2465,759,7.5,0,3.6,845478,7121,841216,68.47,21.08,2.5855555555555556,0.84,99.5
2022-09-06,Meghalaya,417,1,414,4841,3072,2155,8.61,2,3.6,845895,7122,841630,85.33,59.86,1.3447222222222222,0.84,99.5
2022-09-07,Meghalaya,799,3,796,10014,4246,1556,7.98,0,3.6,846694,7125,842426,117.94,43.22,2.7816666666666667,0.84,99.5
2022-09-08,Meghalaya,263,1,255,2908,3298,2229,9.04,7,3.6,846957,7126,842681,91.61,61.92,0.8077777777777778,0.84,99.5
2022-09-09,Meghalaya,946,4,943,12262,4875,3667,7.71,0,3.6,847903,7130,843624,135.42,101.86,3.406111111111111,0.84,99.5
2022-09-10,Meghalaya,675,4,671,8882,3572,1491,7.6,0,3.6,848578,7134,844295,99.22,41.42,2.4672222222222224,0.84,99.5
2022-09-11,Meghalaya,1442,21,1437,18155,3407,1000,7.94,0,3.6,850020,7155,845732,94.64,27.78,5.043055555555555,0.84,99.5
2022-09-12,Meghalaya,628,8,620,7631,3419,1022,8.23,0,3.6,850648,7163,846352,94.97,28.39,2.1197222222222223,0.84,99.49
2022-09-13,Meghalaya,1248,16,1245,15235,3167,1054,8.19,0,3.6,851896,7179,847597,87.97,29.28,4.231944444444444,0.84,99.5
2022-09-14,Meghalaya,922,3,918,11857,4811,3854,7.78,1,3.6,852818,7182,848515,133.64,107.06,3.2936111111111113,0.84,99.5
2022-09-15,Meghalaya,388,1,387,4969,3410,1831,7.81,0,3.6,853206,7183,848902,94.72,50.86,1.3802777777777777,0.84,99.5
2022-09-16,Meghalaya,1568,19,1568,19596,728,97,8.0,0,3.6,854774,7202,850470,20.22,2.69,5.443333333333333,0.84,99.5
2022-09-17,Meghalaya,140,0,140,1634,4407,42,8.57,0,3.6,854914,7202,850610,122.42,1.17,0.4538888888888889,0.84,99.5
2022-09-18,Meghalaya,1290,19,1288,16623,2153,1605,7.76,0,3.6,856204,7221,851898,59.81,44.58,4.6175,0.84,99.5
2022-09-19,Meghalaya,201,2,194,2606,3375,3258,7.71,5,3.6,856405,7223,852092,93.75,90.5,0.7238888888888889,0.84,99.5
2022-09-20,Meghalaya,313,3,307,3475,1204,687,9.01,3,3.6,856718,7226,852399,33.44,19.08,0.9652777777777778,0.84,99.5
2022-09-21,Meghalaya,1429,10,1424,17808,359,293,8.02,0,3.6,858147,7236,853823,9.97,8.14,4.946666666666666,0.84,99.5
2022-09-22,Meghalaya,1401,17,1395,17993,4061,1092,7.79,0,3.6,859548,7253,855218,112.81,30.33,4.998055555555555,0.84,99.5
2022-09-23,Meghalaya,105,0,99,737,164,62,14.25,6,3.6,859653,7253,855317,4.56,1.72,0.20472222222222222,0.84,99.5
2022-09-24,Meghalaya,1464,15,1458,18266,2869,2263,8.01,0,3.6,861117,7268,856775,79.69,62.86,5.073888888888889,0.84,99.5
2022-09-25,Meghalaya,342,3,341,4579,4339,529,7.47,0,3.6,861459,7271,857116,120.53,14.69,1.2719444444444445,0.84,99.5
2022-09-26,Meghalaya,525,7,518,6645,3703,3462,7.9,0,3.6,861984,7278,857634,102.86,96.17,1.8458333333333334,0.84,99.5
2022-09-27,Meghalaya,1030,3,1021,12203,3591,1871,8.44,6,3.6,863014,7281,858655,99.75,51.97,3.3897222222222223,0.84,99.49
2022-09-28,Meghalaya,868,9,863,10637,541,323,8.16,0,3.6,863882,7290,859518,15.03,8.97,2.9547222222222222,0.84,99.49
2022-09-29,Meghalaya,1242,12,1233,15711,1138,263,7.91,0,3.6,865124,7302,860751,31.61,7.31,4.364166666666667,0.84,99.49
2022-09-30,Meghalaya,919,10,911,10993,3471,3152,8.36,0,3.6,866043,7312,861662,96.42,87.56,3.053611111111111,0.84,99.49
2022-10-01,Meghalaya,997,3,997,12529,1811,1346,7.96,0,3.6,867040,7315,862659,50.31,37.39,3.480277777777778,0.84,99.49
2022-10-02,Meghalaya,852,7,852,10670,4981,4110,7.99,0,3.6,867892,7322,863511,138.36,114.17,2.963888888888889,0.84,99.5
2022-10-03,Meghalaya,847,10,839,10465,2952,1107,8.09,0,3.6,868739,7332,864350,82.0,30.75,2.9069444444444446,0.84,99.49
2022-10-04,Meghalaya,341,1,332,4488,1973,665,7.6,8,3.6,869080,7333,864682,54.81,18.47,1.2466666666666666,0.84,99.49
2022-10-05,Meghalaya,1582,14,1575,19370,3436,1840,8.17,0,3.6,870662,7347,866257,95.44,51.11,5.3805555555555555,0.84,99.49
2022-10-06,Meghalaya,160,1,151,2128,2649,124,7.52,8,3.6,870822,7348,866408,73.58,3.44,0.5911111111111111,0.84,99.49
2022-10-07,Meghalaya,1170,8,1163,14381,3774,3157,8.14,0,3.6,871992,7356,867571,104.83,87.69,3.9947222222222223,0.84,99.49
2022-10-08,Meghalaya,449,3,447,5831,3268,1370,7.7,0,3.6,872441,7359,868018,90.78,38.06,1.6197222222222223,0.84,99.49
2022-10-09,Meghalaya,359,1,354,4505,4632,3062,7.97,4,3.6,872800,7360,868372,128.67,85.06,1.2513888888888889,0.84,99.49
2022-10-10,Meghalaya,1091,7,1086,13174,4134,101,8.28,0,3.6,873891,7367,869458,114.83,2.81,3.6594444444444445,0.84,99.49
2022-10-11,Meghalaya,1245,14,1241,15119,4186,2149,8.23,0,3.6,875136,7381,870699,116.28,59.69,4.199722222222222,0.84,99.49
2022-10-12,Meghalaya,1471,5,1470,17888,2254,1205,8.22,0,3.6,876607,7386,872169,62.61,33.47,4.9688888888888885,0.84,99.49
2022-10-13,Meghalaya,231,1,230,3234,4993,1859,7.14,0,3.6,876838,7387,872399,138.69,51.64,0.8983333333333333,0.84,99.49
2022-10-14,Meghalaya,1487,6,1480,18713,2655,579,7.95,1,3.6,878325,7393,873879,73.75,16.08,5.198055555555555,0.84,99.49
2022-10-15,Meghalaya,190,1,188,2263,3636,1861,8.4,1,3.6,878515,7394,874067,101.0,51.69,0.6286111111111111,0.84,99.49
2022-10-16,Meghalaya,863,6,858,11093,4954,3911,7.78,0,3.6,879378,7400,874925,137.61,108.64,3.0813888888888887,0.84,99.49
2022-10-17,Meghalaya,283,1,282,3450,249,39,8.2,0,3.6,879661,7401,875207,6.92,1.08,0.9583333333333334,0.84,99.49
2022-10-18,Meghalaya,439,4,430,5627,1674,792,7.8,5,3.6,880100,7405,875637,46.5,22.0,1.5630555555555556,0.84,99.49
2022-10-19,Meghalaya,1025,9,1025,13100,4731,92,7.82,0,3.6,881125,7414,876662,131.42,2.56,3.638888888888889,0.84,99.49
2022-10-20,Meghalaya,150,0,149,2014,868,800,7.45,1,3.6,881275,7414,876811,24.11,22.22,0.5594444444444444,0.84,99.49
2022-10-21,Meghalaya,620,6,612,7720,1643,337,8.03,2,3.6,881895,7420,877423,45.64,9.36,2.1444444444444444,0.84,99.49
2022-10-22,Meghalaya,1332,14,1326,16589,1427,654,8.03,0,3.6,883227,7434,878749,39.64,18.17,4.608055555555556,0.84,99.49
2022-10-23,Meghalaya,1389,11,1384,17357,2761,2218,8.0,0,3.6,884616,7445,880133,76.69,61.61,4.8213888888888885,0.84,99.49
2022-10-24,Meghalaya,1480,17,1475,18699,1353,536,7.91,0,3.6,886096,7462,881608,37.58,14.89,5.194166666666667,0.84,99.49
2022-10-25,Meghalaya,742,4,740,9292,2061,1689,7.99,0,3.6,886838,7466,882348,57.25,46.92,2.581111111111111,0.84,99.49
2022-10-26,Meghalaya,600,8,598,6967,3283,2349,8.61,0,3.6,887438,7474,882946,91.19,65.25,1.9352777777777779,0.84,99.49
2022-10-27,Meghalaya,1178,17,1177,14750,4344,1572,7.99,0,3.6,888616,7491,884123,120.67,43.67,4.097222222222222,0.84,99.49
2022-10-28,Meghalaya,347,2,338,4102,2570,891,8.46,7,3.6,888963,7493,884461,71.39,24.75,1.1394444444444445,0.84,99.49
2022-10-29,Meghalaya,1251,15,1244,15550,3375,2035,8.05,0,3.6,890214,7508,885705,93.75,56.53,4.319444444444445,0.84,99.49
2022-10-30,Meghalaya,1536,11,1536,19012,1269,756,8.08,0,3.6,891750,7519,887241,35.25,21.0,5.2811111111111115,0.84,99.49
2022-10-31,Meghalaya,438,2,434,5606,4645,48,7.81,2,3.6,892188,7521,887675,129.03,1.33,1.5572222222222223,0.84,99.49
2022-11-01,Meghalaya,670,2,667,8653,472,130,7.74,1,3.6,892858,7523,888342,13.11,3.61,2.403611111111111,0.84,99.49
2022-11-02,Meghalaya,430,3,423,5344,1249,289,8.05,4,3.6,893288,7526,888765,34.69,8.03,1.4844444444444445,0.84,99.49
2022-11-03,Meghalaya,398,4,393,5457,198,74,7.29,1,3.6,893686,7530,889158,5.5,2.06,1.5158333333333334,0.84,99.49
2022-11-04,Meghalaya,680,7,674,8855,2924,1132,7.68,0,3.6,894366,7537,889832,81.22,31.44,2.459722222222222,0.84,99.49
2022-11-05,Meghalaya,452,3,448,5745,456,318,7.87,1,3.6,894818,7540,890280,12.67,8.83,1.5958333333333334,0.84,99.49
2022-11-06,Meghalaya,607,7,600,7233,1915,194,8.39,0,3.6,895425,7547,890880,53.19,5.39,2.0091666666666668,0.84,99.49
2022-11-07,Meghalaya,303,2,300,4239,253,63,7.15,1,3.6,895728,7549,891180,7.03,1.75,1.1775,0.84,99.49
2022-11-08,Meghalaya,1548,16,1545,19403,1849,253,7.98,0,3.6,897276,7565,892725,51.36,7.03,5.389722222222222,0.84,99.49
2022-11-09,Meghalaya,1579,5,1578,19594,658,452,8.06,0,3.6,898855,7570,894303,18.28,12.56,5.442777777777778,0.84,99.49
2022-11-10,Meghalaya,69,0,66,581,2758,2192,11.88,3,3.6,898924,7570,894369,76.61,60.89,0.1613888888888889,0.84,99.49
2022-11-11,Meghalaya,1123,16,1120,14238,3305,1147,7.89,0,3.6,900047,7586,895489,91.81,31.86,3.955,0.84,99.49
2022-11-12,Meghalaya,585,8,581,7548,1308,369,7.75,0,3.6,900632,7594,896070,36.33,10.25,2.0966666666666667,0.84,99.49
2022-11-13,Meghalaya,1405,14,1398,17232,1326,777,8.15,0,3.6,902037,7608,897468,36.83,21.58,4.786666666666667,0.84,99.49
2022-11-14,Meghalaya,317,1,314,4141,43,19,7.66,2,3.6,902354,7609,897782,1.19,0.53,1.1502777777777777,0.84,99.49
2022-11-15,Meghalaya,213,0,210,2404,3291,575,8.86,3,3.6,902567,7609,897992,91.42,15.97,0.6677777777777778,0.84,99.49
2022-11-16,Meghalaya,1094,11,1087,13755,2114,1454,7.95,0,3.6,903661,7620,899079,58.72,40.39,3.8208333333333333,0.84,99.49
2022-11-17,Meghalaya,1253,12,1253,15540,327,149,8.06,0,3.6,904914,7632,900332,9.08,4.14,4.316666666666666,0.84,99.49
2022-11-18,Meghalaya,1373,8,1373,17029,874,87,8.06,0,3.6,906287,7640,901705,24.28,2.42,4.730277777777777,0.84,99.49
2022-11-19,Meghalaya,735,5,732,8973,2144,1827,8.19,0,3.6,907022,7645,902437,59.56,50.75,2.4925,0.84,99.49
2022-11-20,Meghalaya,1461,11,1457,18591,1441,761,7.86,0,3.6,908483,7656,903894,40.03,21.14,5.164166666666667,0.84,99.49
2022-11-21,Meghalaya,278,2,274,3471,4105,3204,8.01,2,3.6,908761,7658,904168,114.03,89.0,0.9641666666666666,0.84,99.49
2022-11-22,Meghalaya,1375,8,1367,16684,3965,3712,8.24,0,3.6,910136,7666,905535,110.14,103.11,4.634444444444444,0.84,99.49
2022-11-23,Meghalaya,173,1,168,2370,3767,1919,7.3,4,3.6,910309,7667,905703,104.64,53.31,0.6583333333333333,0.84,99.49
2022-11-24,Meghalaya,532,3,531,6942,218,32,7.66,0,3.6,910841,7670,906234,6.06,0.89,1.9283333333333332,0.84,99.49
2022-11-25,Meghalaya,480,5,474,6037,4484,1311,7.95,1,3.6,911321,7675,906708,124.56,36.42,1.6769444444444443,0.84,99.49
2022-11-26,Meghalaya,1431,13,1423,18160,1214,117,7.88,0,3.6,912752,7688,908131,33.72,3.25,5.044444444444444,0.84,99.49
2022-11-27,Meghalaya,1452,9,1449,18154,2356,1584,8.0,0,3.6,914204,7697,909580,65.44,44.0,5.042777777777777,0.84,99.49
2022-11-28,Meghalaya,130,0,129,1444,4302,1770,9.0,1,3.6,914334,7697,909709,119.5,49.17,0.4011111111111111,0.84,99.49
2022-11-29,Meghalaya,833,4,824,10578,738,461,7.87,5,3.6,915167,7701,910533,20.5,12.81,2.9383333333333335,0.84,99.49
2022-11-30,Meghalaya,798,5,793,9899,979,825,8.06,0,3.6,915965,7706,911326,27.19,22.92,2.749722222222222,0.84,99.49
2022-12-01,Meghalaya,319,3,317,4139,3349,126,7.71,0,3.6,916284,7709,911643,93.03,3.5,1.1497222222222223,0.84,99.49
2022-12-02,Meghalaya,1056,12,1055,12933,1481,1452,8.17,0,3.6,917340,7721,912698,41.14,40.33,3.5925,0.84,99.49
2022-12-03,Meghalaya,576,5,574,6997,1165,349,8.23,0,3.6,917916,7726,913272,32.36,9.69,1.9436111111111112,0.84,99.49
2022-12-04,Meghalaya,1163,9,1155,14038,2296,435,8.28,0,3.6,919079,7735,914427,63.78,12.08,3.8994444444444443,0.84,99.49
2022-12-05,Meghalaya,1188,11,1188,15115,1943,455,7.86,0,3.6,920267,7746,915615,53.97,12.64,4.198611111111111,0.84,99.49
2022-12-06,Meghalaya,331,2,324,3976,2131,1103,8.32,5,3.6,920598,7748,915939,59.19,30.64,1.1044444444444443,0.84,99.49
2022-12-07,Meghalaya,1391,19,1390,16891,1240,169,8.24,0,3.6,921989,7767,917329,34.44,4.69,4.691944444444444,0.84,99.49
2022-12-08,Meghalaya,1069,3,1064,13465,1143,468,7.94,2,3.6,923058,7770,918393,31.75,13.0,3.7402777777777776,0.84,99.49
2022-12-09,Meghalaya,1033,9,1027,13151,2829,1055,7.85,0,3.6,924091,7779,919420,78.58,29.31,3.6530555555555555,0.84,99.49
2022-12-10,Meghalaya,681,2,672,8393,4272,1200,8.11,7,3.6,924772,7781,920092,118.67,33.33,2.3313888888888887,0.84,99.49
2022-12-11,Meghalaya,1475,13,1466,18688,4023,826,7.89,0,3.6,926247,7794,921558,111.75,22.94,5.191111111111111,0.84,99.49
2022-12-12,Meghalaya,67,0,67,849,1165,541,7.89,0,3.6,926314,7794,921625,32.36,15.03,0.23583333333333334,0.84,99.49
2022-12-13,Meghalaya,980,7,979,11762,804,93,8.33,0,3.6,927294,7801,922604,22.33,2.58,3.2672222222222222,0.84,99.49
2022-12-14,Meghalaya,1332,15,1323,16913,4925,2660,7.88,0,3.6,928626,7816,923927,136.81,73.89,4.698055555555555,0.84,99.49
2022-12-15,Meghalaya,786,6,777,9948,2986,1288,7.9,3,3.6,929412,7822,924704,82.94,35.78,2.763333333333333,0.84,99.49
2022-12-16,Meghalaya,276,2,274,3660,370,55,7.54,0,3.6,929688,7824,924978,10.28,1.53,1.0166666666666666,0.84,99.49
2022-12-17,Meghalaya,834,4,833,10507,3397,1230,7.94,0,3.6,930522,7828,925811,94.36,34.17,2.9186111111111113,0.84,99.49
2022-12-18,Meghalaya,713,3,712,8876,53,33,8.03,0,3.6,931235,7831,926523,1.47,0.92,2.4655555555555555,0.84,99.49
2022-12-19,Meghalaya,575,4,569,7217,229,52,7.97,2,3.6,931810,7835,927092,6.36,1.44,2.004722222222222,0.84,99.49
2022-12-20,Meghalaya,391,3,389,5218,1298,310,7.49,0,3.6,932201,7838,927481,36.06,8.61,1.4494444444444445,0.84,99.49
2022-12-21,Meghalaya,150,1,150,1780,616,471,8.43,0,3.6,932351,7839,927631,17.11,13.08,0.49444444444444446,0.84,99.49
2022-12-22,Meghalaya,1514,19,1507,19315,3554,2257,7.84,0,3.6,933865,7858,929138,98.72,62.69,5.365277777777778,0.84,99.49
2022-12-23,Meghalaya,1546,9,1540,18936,2085,2052,8.16,0,3.6,935411,7867,930678,57.92,57.0,5.26,0.84,99.49
2022-12-24,Meghalaya,822,8,814,10283,3149,191,7.99,0,3.6,936233,7875,931492,87.47,5.31,2.856388888888889,0.84,99.49
2022-12-25,Meghalaya,1409,15,1408,17362,4232,4026,8.12,0,3.6,937642,7890,932900,117.56,111.83,4.822777777777778,0.84,99.49
2022-12-26,Meghalaya,1484,7,1477,18298,1289,1017,8.11,0,3.6,939126,7897,934377,35.81,28.25,5.082777777777777,0.84,99.49
2022-12-27,Meghalaya,1440,8,1435,17675,375,316,8.15,0,3.6,940566,7905,935812,10.42,8.78,4.909722222222222,0.84,99.49
2022-12-28,Meghalaya,270,3,262,3134,708,170,8.62,5,3.6,940836,7908,936074,19.67,4.72,0.8705555555555555,0.84,99.49
2022-12-29,Meghalaya,180,2,175,2086,2746,977,8.63,3,3.6,941016,7910,936249,76.28,27.14,0.5794444444444444,0.84,99.49
2022-12-30,Meghalaya,1088,12,1079,13475,4282,3349,8.07,0,3.6,942104,7922,937328,118.94,93.03,3.7430555555555554,0.84,99.49
2022-12-31,Meghalaya,346,4,339,4658,1809,1571,7.43,3,3.6,942450,7926,937667,50.25,43.64,1.2938888888888889,0.84,99.49
2020-01-01,Mizoram,47,0,47,910,2082,544,5.16,0,1.3,47,0,47,160.15,41.85,0.7,0.0,100.0
2020-01-02,Mizoram,1239,15,1236,15318,1787,369,8.09,0,1.3,1286,15,1283,137.46,28.38,11.783076923076923,1.17,99.77
2020-01-03,Mizoram,915,11,910,11561,844,307,7.91,0,1.3,2201,26,2193,64.92,23.62,8.893076923076922,1.18,99.64
2020-01-04,Mizoram,1239,12,1238,15398,4944,497,8.05,0,1.3,3440,38,3431,380.31,38.23,11.844615384615384,1.1,99.74
2020-01-05,Mizoram,774,9,767,9747,1008,31,7.94,0,1.3,4214,47,4198,77.54,2.38,7.497692307692308,1.12,99.62
2020-01-06,Mizoram,892,9,890,11193,526,180,7.97,0,1.3,5106,56,5088,40.46,13.85,8.61,1.1,99.65
2020-01-07,Mizoram,1360,16,1356,16754,2921,2223,8.12,0,1.3,6466,72,6444,224.69,171.0,12.887692307692308,1.11,99.66
2020-01-08,Mizoram,1430,4,1427,18022,1067,990,7.93,0,1.3,7896,76,7871,82.08,76.15,13.863076923076923,0.96,99.68
2020-01-09,Mizoram,543,7,536,6810,367,165,7.97,0,1.3,8439,83,8407,28.23,12.69,5.2384615384615385,0.98,99.62
2020-01-10,Mizoram,1526,10,1526,19068,1597,698,8.0,0,1.3,9965,93,9933,122.85,53.69,14.667692307692308,0.93,99.68
2020-01-11,Mizoram,293,1,287,3599,4242,489,8.14,5,1.3,10258,94,10220,326.31,37.62,2.7684615384615383,0.92,99.63
2020-01-12,Mizoram,1428,8,1419,17627,441,397,8.1,1,1.3,11686,102,11639,33.92,30.54,13.55923076923077,0.87,99.6
2020-01-13,Mizoram,623,5,623,7787,284,107,8.0,0,1.3,12309,107,12262,21.85,8.23,5.99,0.87,99.62
2020-01-14,Mizoram,1142,14,1140,14446,3974,3702,7.91,0,1.3,13451,121,13402,305.69,284.77,11.112307692307692,0.9,99.64
2020-01-15,Mizoram,107,0,106,1262,2212,424,8.48,1,1.3,13558,121,13508,170.15,32.62,0.9707692307692307,0.89,99.63
2020-01-16,Mizoram,440,6,436,5607,853,226,7.85,0,1.3,13998,127,13944,65.62,17.38,4.313076923076923,0.91,99.61
2020-01-17,Mizoram,578,4,569,6818,1560,1466,8.48,5,1.3,14576,131,14513,120.0,112.77,5.2446153846153845,0.9,99.57
2020-01-18,Mizoram,840,12,838,10683,4882,3126,7.86,0,1.3,15416,143,15351,375.54,240.46,8.217692307692309,0.93,99.58
2020-01-19,Mizoram,443,3,434,5663,3081,2152,7.82,6,1.3,15859,146,15785,237.0,165.54,4.3561538461538465,0.92,99.53
2020-01-20,Mizoram,75,0,73,1026,4397,2733,7.31,2,1.3,15934,146,15858,338.23,210.23,0.7892307692307692,0.92,99.52
2020-01-21,Mizoram,1409,14,1407,17136,3019,2023,8.22,0,1.3,17343,160,17265,232.23,155.62,13.181538461538462,0.92,99.55
2020-01-22,Mizoram,1045,12,1043,13246,1484,1301,7.89,0,1.3,18388,172,18308,114.15,100.08,10.18923076923077,0.94,99.56
2020-01-23,Mizoram,484,2,478,6189,2575,429,7.82,4,1.3,18872,174,18786,198.08,33.0,4.760769230769231,0.92,99.54
2020-01-24,Mizoram,1412,18,1408,17165,819,302,8.23,0,1.3,20284,192,20194,63.0,23.23,13.203846153846154,0.95,99.56
2020-01-25,Mizoram,1359,11,1356,16991,3431,3148,8.0,0,1.3,21643,203,21550,263.92,242.15,13.07,0.94,99.57
2020-01-26,Mizoram,1465,13,1461,18545,1358,639,7.9,0,1.3,23108,216,23011,104.46,49.15,14.265384615384615,0.93,99.58
2020-01-27,Mizoram,1386,8,1377,17325,4228,3950,8.0,1,1.3,24494,224,24388,325.23,303.85,13.326923076923077,0.91,99.57
2020-01-28,Mizoram,1094,15,1091,13759,4779,2868,7.95,0,1.3,25588,239,25479,367.62,220.62,10.583846153846153,0.93,99.57
2020-01-29,Mizoram,1511,22,1502,19315,3814,3598,7.82,0,1.3,27099,261,26981,293.38,276.77,14.857692307692307,0.96,99.56
2020-01-30,Mizoram,1082,15,1078,13429,4732,4306,8.06,0,1.3,28181,276,28059,364.0,331.23,10.33,0.98,99.57
2020-01-31,Mizoram,745,9,738,9075,590,61,8.21,0,1.3,28926,285,28797,45.38,4.69,6.980769230769231,0.99,99.55
2020-02-01,Mizoram,525,1,519,6458,4818,3966,8.13,5,1.3,29451,286,29316,370.62,305.08,4.967692307692308,0.97,99.54
2020-02-02,Mizoram,1145,8,1142,14333,4556,3854,7.99,0,1.3,30596,294,30458,350.46,296.46,11.025384615384615,0.96,99.55
2020-02-03,Mizoram,609,7,603,7362,3755,1189,8.27,0,1.3,31205,301,31061,288.85,91.46,5.663076923076923,0.96,99.54
2020-02-04,Mizoram,347,4,344,4257,1139,330,8.15,0,1.3,31552,305,31405,87.62,25.38,3.2746153846153847,0.97,99.53
2020-02-05,Mizoram,1191,17,1185,14970,560,23,7.96,0,1.3,32743,322,32590,43.08,1.77,11.515384615384615,0.98,99.53
2020-02-06,Mizoram,811,3,804,10447,877,337,7.76,4,1.3,33554,325,33394,67.46,25.92,8.036153846153846,0.97,99.52
2020-02-07,Mizoram,884,9,880,10629,3402,11,8.32,0,1.3,34438,334,34274,261.69,0.85,8.176153846153847,0.97,99.52
2020-02-08,Mizoram,1551,5,1549,19240,1238,484,8.06,0,1.3,35989,339,35823,95.23,37.23,14.8,0.94,99.54
2020-02-09,Mizoram,1397,11,1390,17503,591,379,7.98,0,1.3,37386,350,37213,45.46,29.15,13.463846153846154,0.94,99.54
2020-02-10,Mizoram,1592,22,1591,19617,216,101,8.12,0,1.3,38978,372,38804,16.62,7.77,15.09,0.95,99.55
2020-02-11,Mizoram,709,8,703,9269,3854,2021,7.65,0,1.3,39687,380,39507,296.46,155.46,7.13,0.96,99.55
2020-02-12,Mizoram,777,2,773,9625,3885,2582,8.07,2,1.3,40464,382,40280,298.85,198.62,7.403846153846154,0.94,99.55
2020-02-13,Mizoram,578,5,573,6779,1447,101,8.53,0,1.3,41042,387,40853,111.31,7.77,5.214615384615384,0.94,99.54
2020-02-14,Mizoram,1380,5,1372,17417,2221,1735,7.92,3,1.3,42422,392,42225,170.85,133.46,13.397692307692308,0.92,99.54
2020-02-15,Mizoram,127,0,122,1291,892,609,9.84,5,1.3,42549,392,42347,68.62,46.85,0.9930769230769231,0.92,99.53
2020-02-16,Mizoram,212,1,206,2793,1184,785,7.59,5,1.3,42761,393,42553,91.08,60.38,2.1484615384615386,0.92,99.51
2020-02-17,Mizoram,337,1,334,3917,356,187,8.6,2,1.3,43098,394,42887,27.38,14.38,3.013076923076923,0.91,99.51
2020-02-18,Mizoram,1601,21,1593,19969,1387,528,8.02,0,1.3,44699,415,44480,106.69,40.62,15.36076923076923,0.93,99.51
2020-02-19,Mizoram,1395,4,1393,17163,4921,1030,8.13,0,1.3,46094,419,45873,378.54,79.23,13.202307692307693,0.91,99.52
2020-02-20,Mizoram,1584,21,1577,19926,1966,1302,7.95,0,1.3,47678,440,47450,151.23,100.15,15.327692307692308,0.92,99.52
2020-02-21,Mizoram,329,1,322,3851,1381,272,8.54,6,1.3,48007,441,47772,106.23,20.92,2.962307692307692,0.92,99.51
2020-02-22,Mizoram,1196,7,1195,15068,344,26,7.94,0,1.3,49203,448,48967,26.46,2.0,11.590769230769231,0.91,99.52
2020-02-23,Mizoram,1013,10,1013,12833,27,9,7.89,0,1.3,50216,458,49980,2.08,0.69,9.871538461538462,0.91,99.53
2020-02-24,Mizoram,321,2,319,4291,3914,1204,7.48,0,1.3,50537,460,50299,301.08,92.62,3.3007692307692307,0.91,99.53
2020-02-25,Mizoram,444,3,442,5586,3070,243,7.95,0,1.3,50981,463,50741,236.15,18.69,4.296923076923077,0.91,99.53
2020-02-26,Mizoram,1558,22,1551,19549,1899,1779,7.97,0,1.3,52539,485,52292,146.08,136.85,15.037692307692307,0.92,99.53
2020-02-27,Mizoram,564,5,562,6985,3348,2756,8.07,0,1.3,53103,490,52854,257.54,212.0,5.373076923076923,0.92,99.53
2020-02-28,Mizoram,276,2,274,3530,454,64,7.82,0,1.3,53379,492,53128,34.92,4.92,2.7153846153846155,0.92,99.53
2020-02-29,Mizoram,1106,16,1100,13947,837,418,7.93,0,1.3,54485,508,54228,64.38,32.15,10.728461538461538,0.93,99.53
2020-03-01,Mizoram,1053,15,1049,13008,4183,939,8.1,0,1.3,55538,523,55277,321.77,72.23,10.006153846153847,0.94,99.53
2020-03-02,Mizoram,1075,12,1067,13442,2154,468,8.0,0,1.3,56613,535,56344,165.69,36.0,10.34,0.95,99.52
2020-03-03,Mizoram,95,0,91,1276,3028,169,7.45,4,1.3,56708,535,56435,232.92,13.0,0.9815384615384616,0.94,99.52
2020-03-04,Mizoram,692,7,689,8314,1319,76,8.32,0,1.3,57400,542,57124,101.46,5.85,6.395384615384615,0.94,99.52
2020-03-05,Mizoram,107,0,102,1882,1781,1632,5.69,5,1.3,57507,542,57226,137.0,125.54,1.4476923076923076,0.94,99.51
2020-03-06,Mizoram,531,4,526,6762,54,52,7.85,1,1.3,58038,546,57752,4.15,4.0,5.201538461538462,0.94,99.51
2020-03-07,Mizoram,326,2,319,4192,2886,1513,7.78,5,1.3,58364,548,58071,222.0,116.38,3.2246153846153844,0.94,99.5
2020-03-08,Mizoram,91,0,85,1155,466,232,7.88,6,1.3,58455,548,58156,35.85,17.85,0.8884615384615384,0.94,99.49
2020-03-09,Mizoram,833,8,825,11081,1215,225,7.52,0,1.3,59288,556,58981,93.46,17.31,8.523846153846154,0.94,99.48
2020-03-10,Mizoram,669,8,668,8534,4074,564,7.84,0,1.3,59957,564,59649,313.38,43.38,6.564615384615385,0.94,99.49
2020-03-11,Mizoram,1257,17,1249,15784,4191,182,7.96,0,1.3,61214,581,60898,322.38,14.0,12.141538461538461,0.95,99.48
2020-03-12,Mizoram,55,0,52,584,1273,520,9.42,3,1.3,61269,581,60950,97.92,40.0,0.4492307692307692,0.95,99.48
2020-03-13,Mizoram,1543,10,1542,19013,2893,753,8.12,0,1.3,62812,591,62492,222.54,57.92,14.625384615384615,0.94,99.49
2020-03-14,Mizoram,1161,5,1157,15004,1221,529,7.74,0,1.3,63973,596,63649,93.92,40.69,11.541538461538462,0.93,99.49
2020-03-15,Mizoram,695,8,694,8494,1245,637,8.18,0,1.3,64668,604,64343,95.77,49.0,6.533846153846154,0.93,99.5
2020-03-16,Mizoram,202,1,200,2624,4420,4342,7.7,1,1.3,64870,605,64543,340.0,334.0,2.0184615384615383,0.93,99.5
2020-03-17,Mizoram,190,2,181,2262,4504,2602,8.4,7,1.3,65060,607,64724,346.46,200.15,1.74,0.93,99.48
2020-03-18,Mizoram,603,5,598,7192,3203,1751,8.38,0,1.3,65663,612,65322,246.38,134.69,5.532307692307692,0.93,99.48
2020-03-19,Mizoram,849,2,846,10668,1503,1464,7.96,1,1.3,66512,614,66168,115.62,112.62,8.206153846153846,0.92,99.48
2020-03-20,Mizoram,540,6,533,6667,4376,3241,8.1,1,1.3,67052,620,66701,336.62,249.31,5.128461538461538,0.92,99.48
2020-03-21,Mizoram,1444,20,1436,17958,2201,372,8.04,0,1.3,68496,640,68137,169.31,28.62,13.813846153846153,0.93,99.48
2020-03-22,Mizoram,1427,8,1423,17939,1634,797,7.95,0,1.3,69923,648,69560,125.69,61.31,13.79923076923077,0.93,99.48
2020-03-23,Mizoram,633,6,625,7556,1025,922,8.38,2,1.3,70556,654,70185,78.85,70.92,5.812307692307693,0.93,99.47
2020-03-24,Mizoram,793,4,791,10047,1624,1610,7.89,0,1.3,71349,658,70976,124.92,123.85,7.728461538461539,0.92,99.48
2020-03-25,Mizoram,1208,4,1201,14727,1155,675,8.2,3,1.3,72557,662,72177,88.85,51.92,11.32846153846154,0.91,99.48
2020-03-26,Mizoram,1492,7,1491,18642,1903,1156,8.0,0,1.3,74049,669,73668,146.38,88.92,14.34,0.9,99.49
2020-03-27,Mizoram,182,0,182,2459,3129,180,7.4,0,1.3,74231,669,73850,240.69,13.85,1.8915384615384616,0.9,99.49
2020-03-28,Mizoram,1209,12,1207,15373,1727,889,7.86,0,1.3,75440,681,75057,132.85,68.38,11.825384615384616,0.9,99.49
2020-03-29,Mizoram,106,0,104,762,1026,597,13.91,2,1.3,75546,681,75161,78.92,45.92,0.5861538461538461,0.9,99.49
2020-03-30,Mizoram,874,9,869,11249,2783,13,7.77,0,1.3,76420,690,76030,214.08,1.0,8.653076923076924,0.9,99.49
2020-03-31,Mizoram,710,9,710,8822,2414,654,8.05,0,1.3,77130,699,76740,185.69,50.31,6.786153846153846,0.91,99.49
2020-04-01,Mizoram,821,4,814,9755,958,855,8.42,3,1.3,77951,703,77554,73.69,65.77,7.503846153846154,0.9,99.49
2020-04-02,Mizoram,537,5,531,6350,1404,263,8.46,1,1.3,78488,708,78085,108.0,20.23,4.884615384615385,0.9,99.49
2020-04-03,Mizoram,196,2,194,2099,3669,1814,9.34,0,1.3,78684,710,78279,282.23,139.54,1.6146153846153846,0.9,99.49
2020-04-04,Mizoram,749,7,749,9429,2706,1096,7.94,0,1.3,79433,717,79028,208.15,84.31,7.253076923076923,0.9,99.49
2020-04-05,Mizoram,850,7,845,11076,3775,1728,7.67,0,1.3,80283,724,79873,290.38,132.92,8.52,0.9,99.49
2020-04-06,Mizoram,1498,14,1496,18714,3648,3511,8.0,0,1.3,81781,738,81369,280.62,270.08,14.395384615384616,0.9,99.5
2020-04-07,Mizoram,1163,9,1159,14318,1757,1687,8.12,0,1.3,82944,747,82528,135.15,129.77,11.013846153846155,0.9,99.5
2020-04-08,Mizoram,1013,12,1013,12845,3688,1811,7.89,0,1.3,83957,759,83541,283.69,139.31,9.88076923076923,0.9,99.5
2020-04-09,Mizoram,1210,17,1203,15502,539,379,7.81,0,1.3,85167,776,84744,41.46,29.15,11.924615384615384,0.91,99.5
2020-04-10,Mizoram,486,4,477,5752,3925,957,8.45,5,1.3,85653,780,85221,301.92,73.62,4.424615384615384,0.91,99.5
2020-04-11,Mizoram,87,1,83,779,4790,2203,11.17,3,1.3,85740,781,85304,368.46,169.46,0.5992307692307692,0.91,99.49
2020-04-12,Mizoram,559,6,552,7187,1321,17,7.78,1,1.3,86299,787,85856,101.62,1.31,5.5284615384615385,0.91,99.49
2020-04-13,Mizoram,1303,15,1300,16673,1924,1340,7.82,0,1.3,87602,802,87156,148.0,103.08,12.825384615384616,0.92,99.49
2020-04-14,Mizoram,89,0,86,1073,2279,1323,8.29,3,1.3,87691,802,87242,175.31,101.77,0.8253846153846154,0.91,99.49
2020-04-15,Mizoram,1400,14,1395,17102,4126,2124,8.19,0,1.3,89091,816,88637,317.38,163.38,13.155384615384616,0.92,99.49
2020-04-16,Mizoram,554,6,554,7151,3294,2268,7.75,0,1.3,89645,822,89191,253.38,174.46,5.50076923076923,0.92,99.49
2020-04-17,Mizoram,901,12,893,11211,1022,407,8.04,0,1.3,90546,834,90084,78.62,31.31,8.623846153846154,0.92,99.49
2020-04-18,Mizoram,771,11,763,9826,2519,1366,7.85,0,1.3,91317,845,90847,193.77,105.08,7.558461538461539,0.93,99.49
2020-04-19,Mizoram,1430,5,1424,17873,4095,1523,8.0,1,1.3,92747,850,92271,315.0,117.15,13.74846153846154,0.92,99.49
2020-04-20,Mizoram,277,2,273,3297,1963,760,8.4,2,1.3,93024,852,92544,151.0,58.46,2.536153846153846,0.92,99.48
2020-04-21,Mizoram,405,5,399,5186,4543,127,7.81,1,1.3,93429,857,92943,349.46,9.77,3.9892307692307694,0.92,99.48
2020-04-22,Mizoram,955,10,953,12007,278,231,7.95,0,1.3,94384,867,93896,21.38,17.77,9.236153846153845,0.92,99.48
2020-04-23,Mizoram,1552,16,1551,19018,3945,825,8.16,0,1.3,95936,883,95447,303.46,63.46,14.62923076923077,0.92,99.49
2020-04-24,Mizoram,941,11,932,11822,1314,797,7.96,0,1.3,96877,894,96379,101.08,61.31,9.093846153846155,0.92,99.49
2020-04-25,Mizoram,774,6,765,9817,3704,854,7.88,3,1.3,97651,900,97144,284.92,65.69,7.5515384615384615,0.92,99.48
2020-04-26,Mizoram,552,3,545,6624,2570,2007,8.33,4,1.3,98203,903,97689,197.69,154.38,5.095384615384615,0.92,99.48
2020-04-27,Mizoram,1247,17,1242,15769,369,143,7.91,0,1.3,99450,920,98931,28.38,11.0,12.13,0.93,99.48
2020-04-28,Mizoram,936,5,930,11351,3300,3113,8.25,1,1.3,100386,925,99861,253.85,239.46,8.731538461538461,0.92,99.48
2020-04-29,Mizoram,756,2,748,9453,1120,647,8.0,6,1.3,101142,927,100609,86.15,49.77,7.271538461538461,0.92,99.47
2020-04-30,Mizoram,980,10,975,12092,25,20,8.1,0,1.3,102122,937,101584,1.92,1.54,9.301538461538462,0.92,99.47
2020-05-01,Mizoram,1156,5,1155,14541,1718,780,7.95,0,1.3,103278,942,102739,132.15,60.0,11.185384615384615,0.91,99.48
2020-05-02,Mizoram,406,2,397,5153,4418,2887,7.88,7,1.3,103684,944,103136,339.85,222.08,3.963846153846154,0.91,99.47
2020-05-03,Mizoram,356,2,351,4631,4525,3014,7.69,3,1.3,104040,946,103487,348.08,231.85,3.562307692307692,0.91,99.47
2020-05-04,Mizoram,1553,13,1544,19665,4261,2934,7.9,0,1.3,105593,959,105031,327.77,225.69,15.126923076923077,0.91,99.47
2020-05-05,Mizoram,880,8,871,11457,2975,2968,7.68,1,1.3,106473,967,105902,228.85,228.31,8.813076923076924,0.91,99.46
2020-05-06,Mizoram,1389,15,1389,17237,2865,1716,8.06,0,1.3,107862,982,107291,220.38,132.0,13.259230769230768,0.91,99.47
2020-05-07,Mizoram,798,6,789,9643,625,547,8.28,3,1.3,108660,988,108080,48.08,42.08,7.417692307692308,0.91,99.47
2020-05-08,Mizoram,571,1,571,7282,673,334,7.84,0,1.3,109231,989,108651,51.77,25.69,5.601538461538461,0.91,99.47
2020-05-09,Mizoram,392,5,390,4870,2970,1432,8.05,0,1.3,109623,994,109041,228.46,110.15,3.746153846153846,0.91,99.47
2020-05-10,Mizoram,93,0,88,1505,1079,724,6.18,5,1.3,109716,994,109129,83.0,55.69,1.1576923076923078,0.91,99.46
2020-05-11,Mizoram,626,4,617,7354,2363,456,8.51,5,1.3,110342,998,109746,181.77,35.08,5.656923076923077,0.9,99.46
2020-05-12,Mizoram,1398,11,1391,17359,1034,586,8.05,0,1.3,111740,1009,111137,79.54,45.08,13.353076923076923,0.9,99.46
2020-05-13,Mizoram,1337,9,1329,16331,12,0,8.19,0,1.3,113077,1018,112466,0.92,0.0,12.562307692307693,0.9,99.46
2020-05-14,Mizoram,470,1,469,5752,2981,1773,8.17,0,1.3,113547,1019,112935,229.31,136.38,4.424615384615384,0.9,99.46
2020-05-15,Mizoram,255,3,250,2871,343,183,8.88,2,1.3,113802,1022,113185,26.38,14.08,2.2084615384615383,0.9,99.46
2020-05-16,Mizoram,406,5,398,5049,578,92,8.04,3,1.3,114208,1027,113583,44.46,7.08,3.8838461538461537,0.9,99.45
2020-05-17,Mizoram,1094,15,1092,13704,2501,1489,7.98,0,1.3,115302,1042,114675,192.38,114.54,10.541538461538462,0.9,99.46
2020-05-18,Mizoram,213,1,211,2420,1099,951,8.8,1,1.3,115515,1043,114886,84.54,73.15,1.8615384615384616,0.9,99.46
2020-05-19,Mizoram,292,4,284,3795,614,555,7.69,4,1.3,115807,1047,115170,47.23,42.69,2.919230769230769,0.9,99.45
2020-05-20,Mizoram,166,0,159,2058,2262,1291,8.07,7,1.3,115973,1047,115329,174.0,99.31,1.583076923076923,0.9,99.44
2020-05-21,Mizoram,1088,5,1083,14051,1395,324,7.74,0,1.3,117061,1052,116412,107.31,24.92,10.808461538461538,0.9,99.45
2020-05-22,Mizoram,150,1,141,2285,250,200,6.56,8,1.3,117211,1053,116553,19.23,15.38,1.7576923076923077,0.9,99.44
2020-05-23,Mizoram,1437,6,1437,17867,319,31,8.04,0,1.3,118648,1059,117990,24.54,2.38,13.743846153846153,0.89,99.45
2020-05-24,Mizoram,187,1,187,2783,3627,475,6.72,0,1.3,118835,1060,118177,279.0,36.54,2.140769230769231,0.89,99.45
2020-05-25,Mizoram,505,5,500,6071,640,343,8.32,0,1.3,119340,1065,118677,49.23,26.38,4.67,0.89,99.44
2020-05-26,Mizoram,1143,15,1135,14926,4403,233,7.66,0,1.3,120483,1080,119812,338.69,17.92,11.481538461538461,0.9,99.44
2020-05-27,Mizoram,1244,7,1235,15642,3941,2616,7.95,2,1.3,121727,1087,121047,303.15,201.23,12.032307692307691,0.89,99.44
2020-05-28,Mizoram,998,8,991,12521,3832,1056,7.97,0,1.3,122725,1095,122038,294.77,81.23,9.631538461538462,0.89,99.44
2020-05-29,Mizoram,1123,10,1119,13879,106,88,8.09,0,1.3,123848,1105,123157,8.15,6.77,10.676153846153847,0.89,99.44
2020-05-30,Mizoram,1505,7,1503,19020,86,75,7.91,0,1.3,125353,1112,124660,6.62,5.77,14.63076923076923,0.89,99.45
2020-05-31,Mizoram,1269,18,1268,15595,2073,348,8.14,0,1.3,126622,1130,125928,159.46,26.77,11.996153846153845,0.89,99.45
2020-06-01,Mizoram,1535,6,1534,19423,213,201,7.9,0,1.3,128157,1136,127462,16.38,15.46,14.94076923076923,0.89,99.46
2020-06-02,Mizoram,1376,17,1375,16677,3747,2952,8.25,0,1.3,129533,1153,128837,288.23,227.08,12.82846153846154,0.89,99.46
2020-06-03,Mizoram,1454,16,1445,18552,617,82,7.84,0,1.3,130987,1169,130282,47.46,6.31,14.27076923076923,0.89,99.46
2020-06-04,Mizoram,1453,5,1446,18032,389,116,8.06,2,1.3,132440,1174,131728,29.92,8.92,13.87076923076923,0.89,99.46
2020-06-05,Mizoram,931,10,922,11617,2009,895,8.01,0,1.3,133371,1184,132650,154.54,68.85,8.936153846153847,0.89,99.46
2020-06-06,Mizoram,540,4,536,6779,1411,773,7.97,0,1.3,133911,1188,133186,108.54,59.46,5.214615384615384,0.89,99.46
2020-06-07,Mizoram,1326,17,1317,16912,1363,1209,7.84,0,1.3,135237,1205,134503,104.85,93.0,13.009230769230768,0.89,99.46
2020-06-08,Mizoram,806,6,799,10457,3237,2520,7.71,1,1.3,136043,1211,135302,249.0,193.85,8.043846153846154,0.89,99.46
2020-06-09,Mizoram,1580,9,1574,19829,2513,402,7.97,0,1.3,137623,1220,136876,193.31,30.92,15.253076923076923,0.89,99.46
2020-06-10,Mizoram,180,0,176,2320,1296,137,7.76,4,1.3,137803,1220,137052,99.69,10.54,1.7846153846153847,0.89,99.46
2020-06-11,Mizoram,542,2,538,6541,3300,2031,8.29,2,1.3,138345,1222,137590,253.85,156.23,5.031538461538462,0.88,99.45
2020-06-12,Mizoram,1481,10,1474,18703,1885,1681,7.92,0,1.3,139826,1232,139064,145.0,129.31,14.386923076923077,0.88,99.46
2020-06-13,Mizoram,1398,11,1391,17291,2218,1967,8.09,0,1.3,141224,1243,140455,170.62,151.31,13.30076923076923,0.88,99.46
2020-06-14,Mizoram,1036,10,1034,12610,3477,2856,8.22,0,1.3,142260,1253,141489,267.46,219.69,9.7,0.88,99.46
2020-06-15,Mizoram,1072,15,1069,13257,2619,541,8.09,0,1.3,143332,1268,142558,201.46,41.62,10.197692307692307,0.88,99.46
2020-06-16,Mizoram,353,1,346,4879,629,146,7.24,6,1.3,143685,1269,142904,48.38,11.23,3.753076923076923,0.88,99.46
2020-06-17,Mizoram,847,10,847,10482,4675,615,8.08,0,1.3,144532,1279,143751,359.62,47.31,8.063076923076924,0.88,99.46
2020-06-18,Mizoram,281,1,280,3653,4624,1325,7.69,0,1.3,144813,1280,144031,355.69,101.92,2.81,0.88,99.46
2020-06-19,Mizoram,1123,13,1118,13627,423,60,8.24,0,1.3,145936,1293,145149,32.54,4.62,10.482307692307693,0.89,99.46
2020-06-20,Mizoram,1036,7,1030,12641,4097,35,8.2,0,1.3,146972,1300,146179,315.15,2.69,9.723846153846154,0.88,99.46
2020-06-21,Mizoram,1398,13,1392,17311,3980,2698,8.08,0,1.3,148370,1313,147571,306.15,207.54,13.316153846153846,0.88,99.46
2020-06-22,Mizoram,1100,4,1093,13772,3528,2032,7.99,3,1.3,149470,1317,148664,271.38,156.31,10.593846153846155,0.88,99.46
2020-06-23,Mizoram,134,1,132,2206,3574,1241,6.07,1,1.3,149604,1318,148796,274.92,95.46,1.696923076923077,0.88,99.46
2020-06-24,Mizoram,305,4,302,3925,4196,2975,7.77,0,1.3,149909,1322,149098,322.77,228.85,3.019230769230769,0.88,99.46
2020-06-25,Mizoram,1040,10,1035,12817,4690,207,8.11,0,1.3,150949,1332,150133,360.77,15.92,9.85923076923077,0.88,99.46
2020-06-26,Mizoram,1294,19,1291,15444,208,143,8.38,0,1.3,152243,1351,151424,16.0,11.0,11.88,0.89,99.46
2020-06-27,Mizoram,685,6,682,8700,4036,358,7.87,0,1.3,152928,1357,152106,310.46,27.54,6.6923076923076925,0.89,99.46
2020-06-28,Mizoram,599,3,597,7438,1435,995,8.05,0,1.3,153527,1360,152703,110.38,76.54,5.7215384615384615,0.89,99.46
2020-06-29,Mizoram,411,6,407,4907,54,21,8.38,0,1.3,153938,1366,153110,4.15,1.62,3.7746153846153847,0.89,99.46
2020-06-30,Mizoram,627,5,623,7425,74,40,8.44,0,1.3,154565,1371,153733,5.69,3.08,5.711538461538462,0.89,99.46
2020-07-01,Mizoram,1294,17,1286,16125,3200,1022,8.02,0,1.3,155859,1388,155019,246.15,78.62,12.403846153846153,0.89,99.46
2020-07-02,Mizoram,1193,5,1184,14949,3831,859,7.98,4,1.3,157052,1393,156203,294.69,66.08,11.499230769230769,0.89,99.46
2020-07-03,Mizoram,140,0,131,2196,394,118,6.38,9,1.3,157192,1393,156334,30.31,9.08,1.6892307692307693,0.89,99.45
2020-07-04,Mizoram,302,2,301,3774,3873,3054,8.0,0,1.3,157494,1395,156635,297.92,234.92,2.903076923076923,0.89,99.45
2020-07-05,Mizoram,287,1,280,3569,2055,1430,8.04,6,1.3,157781,1396,156915,158.08,110.0,2.7453846153846153,0.88,99.45
2020-07-06,Mizoram,642,2,636,7949,1177,207,8.08,4,1.3,158423,1398,157551,90.54,15.92,6.114615384615385,0.88,99.45
2020-07-07,Mizoram,841,4,840,10528,4100,869,7.99,0,1.3,159264,1402,158391,315.38,66.85,8.098461538461539,0.88,99.45
2020-07-08,Mizoram,737,9,729,9440,3978,1875,7.81,0,1.3,160001,1411,159120,306.0,144.23,7.2615384615384615,0.88,99.45
2020-07-09,Mizoram,1323,9,1317,16266,3902,1090,8.13,0,1.3,161324,1420,160437,300.15,83.85,12.512307692307692,0.88,99.45
2020-07-10,Mizoram,1315,17,1311,15905,2899,1704,8.27,0,1.3,162639,1437,161748,223.0,131.08,12.234615384615385,0.88,99.45
2020-07-11,Mizoram,1378,15,1378,16930,1212,1170,8.14,0,1.3,164017,1452,163126,93.23,90.0,13.023076923076923,0.89,99.46
2020-07-12,Mizoram,404,4,397,5265,3948,3568,7.67,3,1.3,164421,1456,163523,303.69,274.46,4.05,0.89,99.45
2020-07-13,Mizoram,466,5,459,5128,4821,4522,9.09,2,1.3,164887,1461,163982,370.85,347.85,3.9446153846153846,0.89,99.45
2020-07-14,Mizoram,135,1,133,1479,3405,1807,9.13,1,1.3,165022,1462,164115,261.92,139.0,1.1376923076923078,0.89,99.45
2020-07-15,Mizoram,705,2,700,9434,950,720,7.47,3,1.3,165727,1464,164815,73.08,55.38,7.256923076923077,0.88,99.45
2020-07-16,Mizoram,321,4,313,3450,2957,598,9.3,4,1.3,166048,1468,165128,227.46,46.0,2.6538461538461537,0.88,99.45
2020-07-17,Mizoram,498,4,489,6126,1533,1518,8.13,5,1.3,166546,1472,165617,117.92,116.77,4.712307692307692,0.88,99.44
2020-07-18,Mizoram,343,2,338,4407,3538,1260,7.78,3,1.3,166889,1474,165955,272.15,96.92,3.39,0.88,99.44
2020-07-19,Mizoram,1270,8,1268,16137,1609,1122,7.87,0,1.3,168159,1482,167223,123.77,86.31,12.413076923076924,0.88,99.44
2020-07-20,Mizoram,1093,15,1085,12997,889,170,8.41,0,1.3,169252,1497,168308,68.38,13.08,9.997692307692308,0.88,99.44
2020-07-21,Mizoram,374,3,373,4688,4686,2175,7.98,0,1.3,169626,1500,168681,360.46,167.31,3.606153846153846,0.88,99.44
2020-07-22,Mizoram,723,9,722,9187,993,126,7.87,0,1.3,170349,1509,169403,76.38,9.69,7.066923076923077,0.89,99.44
2020-07-23,Mizoram,1612,23,1608,19382,4012,2533,8.32,0,1.3,171961,1532,171011,308.62,194.85,14.909230769230769,0.89,99.45
2020-07-24,Mizoram,589,6,584,7631,631,339,7.72,0,1.3,172550,1538,171595,48.54,26.08,5.87,0.89,99.45
2020-07-25,Mizoram,1068,4,1066,13566,1413,43,7.87,0,1.3,173618,1542,172661,108.69,3.31,10.435384615384615,0.89,99.45
2020-07-26,Mizoram,538,4,532,6935,4999,3491,7.76,2,1.3,174156,1546,173193,384.54,268.54,5.334615384615384,0.89,99.45
2020-07-27,Mizoram,1114,4,1105,13941,3141,123,7.99,5,1.3,175270,1550,174298,241.62,9.46,10.723846153846154,0.88,99.45
2020-07-28,Mizoram,1368,5,1364,17050,4838,1628,8.02,0,1.3,176638,1555,175662,372.15,125.23,13.115384615384615,0.88,99.45
2020-07-29,Mizoram,390,3,382,4378,3083,3030,8.91,5,1.3,177028,1558,176044,237.15,233.08,3.3676923076923075,0.88,99.44
2020-07-30,Mizoram,552,5,543,6751,29,27,8.18,4,1.3,177580,1563,176587,2.23,2.08,5.193076923076923,0.88,99.44
2020-07-31,Mizoram,1010,8,1007,12070,4044,923,8.37,0,1.3,178590,1571,177594,311.08,71.0,9.284615384615385,0.88,99.44
2020-08-01,Mizoram,59,0,55,931,794,100,6.34,4,1.3,178649,1571,177649,61.08,7.69,0.7161538461538461,0.88,99.44
2020-08-02,Mizoram,791,10,784,10148,1275,151,7.79,0,1.3,179440,1581,178433,98.08,11.62,7.806153846153846,0.88,99.44
2020-08-03,Mizoram,936,3,933,11729,1028,964,7.98,0,1.3,180376,1584,179366,79.08,74.15,9.022307692307692,0.88,99.44
2020-08-04,Mizoram,412,4,407,4968,1801,1082,8.29,1,1.3,180788,1588,179773,138.54,83.23,3.8215384615384616,0.88,99.44
2020-08-05,Mizoram,957,3,957,12018,3626,3289,7.96,0,1.3,181745,1591,180730,278.92,253.0,9.244615384615384,0.88,99.44
2020-08-06,Mizoram,101,1,97,1033,153,128,9.78,3,1.3,181846,1592,180827,11.77,9.85,0.7946153846153846,0.88,99.44
2020-08-07,Mizoram,351,2,343,4322,595,339,8.12,6,1.3,182197,1594,181170,45.77,26.08,3.3246153846153845,0.87,99.44
2020-08-08,Mizoram,174,1,166,2053,4641,4448,8.48,7,1.3,182371,1595,181336,357.0,342.15,1.5792307692307692,0.87,99.43
2020-08-09,Mizoram,105,0,104,1077,4956,2742,9.75,1,1.3,182476,1595,181440,381.23,210.92,0.8284615384615385,0.87,99.43
2020-08-10,Mizoram,174,0,165,2188,356,113,7.95,9,1.3,182650,1595,181605,27.38,8.69,1.6830769230769231,0.87,99.43
2020-08-11,Mizoram,326,4,322,4316,3428,872,7.55,0,1.3,182976,1599,181927,263.69,67.08,3.32,0.87,99.43
2020-08-12,Mizoram,297,3,291,3635,189,153,8.17,3,1.3,183273,1602,182218,14.54,11.77,2.796153846153846,0.87,99.42
2020-08-13,Mizoram,1204,6,1196,14954,3744,664,8.05,2,1.3,184477,1608,183414,288.0,51.08,11.503076923076923,0.87,99.42
2020-08-14,Mizoram,520,3,513,6807,725,253,7.64,4,1.3,184997,1611,183927,55.77,19.46,5.236153846153846,0.87,99.42
2020-08-15,Mizoram,114,0,106,1316,4908,940,8.66,8,1.3,185111,1611,184033,377.54,72.31,1.0123076923076924,0.87,99.42
2020-08-16,Mizoram,283,2,278,3580,408,275,7.91,3,1.3,185394,1613,184311,31.38,21.15,2.753846153846154,0.87,99.42
2020-08-17,Mizoram,54,0,52,532,1310,28,10.15,2,1.3,185448,1613,184363,100.77,2.15,0.40923076923076923,0.87,99.41
2020-08-18,Mizoram,1337,13,1329,16847,4543,461,7.94,0,1.3,186785,1626,185692,349.46,35.46,12.95923076923077,0.87,99.41
2020-08-19,Mizoram,793,5,791,10028,2540,600,7.91,0,1.3,187578,1631,186483,195.38,46.15,7.713846153846154,0.87,99.42
2020-08-20,Mizoram,1066,12,1065,13309,4400,3646,8.01,0,1.3,188644,1643,187548,338.46,280.46,10.237692307692308,0.87,99.42
2020-08-21,Mizoram,481,5,474,6158,2384,113,7.81,2,1.3,189125,1648,188022,183.38,8.69,4.736923076923077,0.87,99.42
2020-08-22,Mizoram,560,3,554,6721,3392,2806,8.33,3,1.3,189685,1651,188576,260.92,215.85,5.17,0.87,99.42
2020-08-23,Mizoram,110,1,108,886,2031,707,12.42,1,1.3,189795,1652,188684,156.23,54.38,0.6815384615384615,0.87,99.41
2020-08-24,Mizoram,915,10,915,11425,2556,2400,8.01,0,1.3,190710,1662,189599,196.62,184.62,8.788461538461538,0.87,99.42
2020-08-25,Mizoram,821,7,819,10319,2607,2523,7.96,0,1.3,191531,1669,190418,200.54,194.08,7.937692307692307,0.87,99.42
2020-08-26,Mizoram,462,6,455,5779,3494,1559,7.99,1,1.3,191993,1675,190873,268.77,119.92,4.445384615384615,0.87,99.42
2020-08-27,Mizoram,1025,7,1024,12911,559,9,7.94,0,1.3,193018,1682,191897,43.0,0.69,9.931538461538462,0.87,99.42
2020-08-28,Mizoram,321,1,319,3951,2868,539,8.12,1,1.3,193339,1683,192216,220.62,41.46,3.039230769230769,0.87,99.42
2020-08-29,Mizoram,1115,15,1106,14143,866,217,7.88,0,1.3,194454,1698,193322,66.62,16.69,10.87923076923077,0.87,99.42
2020-08-30,Mizoram,1351,7,1345,17206,4155,2249,7.85,0,1.3,195805,1705,194667,319.62,173.0,13.235384615384616,0.87,99.42
2020-08-31,Mizoram,958,8,954,12094,3776,676,7.92,0,1.3,196763,1713,195621,290.46,52.0,9.303076923076922,0.87,99.42
2020-09-01,Mizoram,1364,12,1362,17147,1655,1334,7.95,0,1.3,198127,1725,196983,127.31,102.62,13.19,0.87,99.42
2020-09-02,Mizoram,126,1,124,1450,3619,1680,8.69,1,1.3,198253,1726,197107,278.38,129.23,1.1153846153846154,0.87,99.42
2020-09-03,Mizoram,408,2,399,4976,1828,926,8.2,7,1.3,198661,1728,197506,140.62,71.23,3.8276923076923075,0.87,99.42
2020-09-04,Mizoram,207,2,200,2790,991,281,7.42,5,1.3,198868,1730,197706,76.23,21.62,2.146153846153846,0.87,99.42
2020-09-05,Mizoram,1465,18,1464,18661,4025,426,7.85,0,1.3,200333,1748,199170,309.62,32.77,14.354615384615384,0.87,99.42
2020-09-06,Mizoram,1217,18,1209,14989,1762,1488,8.12,0,1.3,201550,1766,200379,135.54,114.46,11.53,0.88,99.42
2020-09-07,Mizoram,495,7,487,5945,2915,1500,8.33,1,1.3,202045,1773,200866,224.23,115.38,4.573076923076923,0.88,99.42
2020-09-08,Mizoram,649,2,646,8113,2957,1968,8.0,1,1.3,202694,1775,201512,227.46,151.38,6.240769230769231,0.88,99.42
2020-09-09,Mizoram,1496,10,1490,18664,3068,2539,8.02,0,1.3,204190,1785,203002,236.0,195.31,14.356923076923078,0.87,99.42
2020-09-10,Mizoram,187,2,181,1935,3671,935,9.66,4,1.3,204377,1787,203183,282.38,71.92,1.4884615384615385,0.87,99.42
2020-09-11,Mizoram,325,1,321,4210,4860,2804,7.72,3,1.3,204702,1788,203504,373.85,215.69,3.2384615384615385,0.87,99.41
2020-09-12,Mizoram,812,10,804,10632,480,135,7.64,0,1.3,205514,1798,204308,36.92,10.38,8.178461538461539,0.87,99.41
2020-09-13,Mizoram,1152,15,1148,14211,2383,1331,8.11,0,1.3,206666,1813,205456,183.31,102.38,10.931538461538462,0.88,99.41
2020-09-14,Mizoram,1161,5,1161,14664,2945,2315,7.92,0,1.3,207827,1818,206617,226.54,178.08,11.28,0.87,99.42
2020-09-15,Mizoram,127,1,123,1843,4161,2102,6.89,3,1.3,207954,1819,206740,320.08,161.69,1.4176923076923076,0.87,99.42
2020-09-16,Mizoram,954,11,954,11294,1841,85,8.45,0,1.3,208908,1830,207694,141.62,6.54,8.687692307692307,0.88,99.42
2020-09-17,Mizoram,1336,9,1335,16479,1316,591,8.11,0,1.3,210244,1839,209029,101.23,45.46,12.676153846153847,0.87,99.42
2020-09-18,Mizoram,152,0,148,2260,594,228,6.73,4,1.3,210396,1839,209177,45.69,17.54,1.7384615384615385,0.87,99.42
2020-09-19,Mizoram,366,1,361,4697,2844,1160,7.79,4,1.3,210762,1840,209538,218.77,89.23,3.6130769230769233,0.87,99.42
2020-09-20,Mizoram,1278,12,1276,15990,1971,1670,7.99,0,1.3,212040,1852,210814,151.62,128.46,12.3,0.87,99.42
2020-09-21,Mizoram,1326,16,1319,16650,2155,483,7.96,0,1.3,213366,1868,212133,165.77,37.15,12.807692307692308,0.88,99.42
2020-09-22,Mizoram,376,4,376,4752,1686,1251,7.91,0,1.3,213742,1872,212509,129.69,96.23,3.6553846153846155,0.88,99.42
2020-09-23,Mizoram,787,11,779,10011,595,401,7.86,0,1.3,214529,1883,213288,45.77,30.85,7.700769230769231,0.88,99.42
2020-09-24,Mizoram,1076,11,1067,13605,2743,1517,7.91,0,1.3,215605,1894,214355,211.0,116.69,10.465384615384615,0.88,99.42
2020-09-25,Mizoram,1005,9,1003,12956,4013,2260,7.76,0,1.3,216610,1903,215358,308.69,173.85,9.966153846153846,0.88,99.42
2020-09-26,Mizoram,1395,9,1394,17434,862,442,8.0,0,1.3,218005,1912,216752,66.31,34.0,13.410769230769231,0.88,99.43
2020-09-27,Mizoram,1035,10,1032,13042,1624,1499,7.94,0,1.3,219040,1922,217784,124.92,115.31,10.032307692307691,0.88,99.43
2020-09-28,Mizoram,136,0,129,1558,56,12,8.73,7,1.3,219176,1922,217913,4.31,0.92,1.1984615384615385,0.88,99.42
2020-09-29,Mizoram,1233,8,1224,15084,3830,2396,8.17,1,1.3,220409,1930,219137,294.62,184.31,11.603076923076923,0.88,99.42
2020-09-30,Mizoram,1531,9,1530,18907,47,6,8.1,0,1.3,221940,1939,220667,3.62,0.46,14.543846153846154,0.87,99.43
2020-10-01,Mizoram,980,4,977,12348,1292,897,7.94,0,1.3,222920,1943,221644,99.38,69.0,9.49846153846154,0.87,99.43
2020-10-02,Mizoram,145,0,139,1729,4315,1240,8.39,6,1.3,223065,1943,221783,331.92,95.38,1.33,0.87,99.43
2020-10-03,Mizoram,1459,18,1450,18548,774,212,7.87,0,1.3,224524,1961,223233,59.54,16.31,14.267692307692307,0.87,99.43
2020-10-04,Mizoram,582,3,573,7528,2388,2163,7.73,6,1.3,225106,1964,223806,183.69,166.38,5.7907692307692304,0.87,99.42
2020-10-05,Mizoram,364,4,357,4547,3173,771,8.01,3,1.3,225470,1968,224163,244.08,59.31,3.497692307692308,0.87,99.42
2020-10-06,Mizoram,360,2,358,4549,185,128,7.91,0,1.3,225830,1970,224521,14.23,9.85,3.499230769230769,0.87,99.42
2020-10-07,Mizoram,988,10,987,12084,3203,594,8.18,0,1.3,226818,1980,225508,246.38,45.69,9.295384615384615,0.87,99.42
2020-10-08,Mizoram,119,1,117,1534,2199,257,7.76,1,1.3,226937,1981,225625,169.15,19.77,1.18,0.87,99.42
2020-10-09,Mizoram,228,3,226,2877,3814,3008,7.92,0,1.3,227165,1984,225851,293.38,231.38,2.213076923076923,0.87,99.42
2020-10-10,Mizoram,900,4,898,11213,4605,3587,8.03,0,1.3,228065,1988,226749,354.23,275.92,8.625384615384615,0.87,99.42
2020-10-11,Mizoram,321,1,316,4004,1251,675,8.02,4,1.3,228386,1989,227065,96.23,51.92,3.08,0.87,99.42
2020-10-12,Mizoram,725,3,718,8815,300,293,8.22,4,1.3,229111,1992,227783,23.08,22.54,6.780769230769231,0.87,99.42
2020-10-13,Mizoram,351,2,348,4312,3394,1966,8.14,1,1.3,229462,1994,228131,261.08,151.23,3.316923076923077,0.87,99.42
2020-10-14,Mizoram,1181,13,1178,14500,2431,2224,8.14,0,1.3,230643,2007,229309,187.0,171.08,11.153846153846153,0.87,99.42
2020-10-15,Mizoram,1554,8,1550,19477,9,0,7.98,0,1.3,232197,2015,230859,0.69,0.0,14.982307692307693,0.87,99.42
2020-10-16,Mizoram,931,5,926,11626,4965,3468,8.01,0,1.3,233128,2020,231785,381.92,266.77,8.943076923076923,0.87,99.42
2020-10-17,Mizoram,1113,6,1107,13641,146,79,8.16,0,1.3,234241,2026,232892,11.23,6.08,10.493076923076924,0.86,99.42
2020-10-18,Mizoram,1349,11,1349,16941,4727,4519,7.96,0,1.3,235590,2037,234241,363.62,347.62,13.031538461538462,0.86,99.43
2020-10-19,Mizoram,1111,5,1106,13790,1606,892,8.06,0,1.3,236701,2042,235347,123.54,68.62,10.607692307692307,0.86,99.43
2020-10-20,Mizoram,413,5,409,5128,161,64,8.05,0,1.3,237114,2047,235756,12.38,4.92,3.9446153846153846,0.86,99.43
2020-10-21,Mizoram,1294,14,1292,16345,382,93,7.92,0,1.3,238408,2061,237048,29.38,7.15,12.573076923076924,0.86,99.43
2020-10-22,Mizoram,302,4,301,4192,1907,802,7.2,0,1.3,238710,2065,237349,146.69,61.69,3.2246153846153844,0.87,99.43
2020-10-23,Mizoram,861,12,855,10818,66,20,7.96,0,1.3,239571,2077,238204,5.08,1.54,8.321538461538461,0.87,99.43
2020-10-24,Mizoram,1390,16,1388,17718,893,38,7.85,0,1.3,240961,2093,239592,68.69,2.92,13.62923076923077,0.87,99.43
2020-10-25,Mizoram,1106,12,1102,13535,4647,2636,8.17,0,1.3,242067,2105,240694,357.46,202.77,10.411538461538461,0.87,99.43
2020-10-26,Mizoram,304,2,303,3385,2372,94,8.98,0,1.3,242371,2107,240997,182.46,7.23,2.603846153846154,0.87,99.43
2020-10-27,Mizoram,395,3,390,4663,423,339,8.47,2,1.3,242766,2110,241387,32.54,26.08,3.586923076923077,0.87,99.43
2020-10-28,Mizoram,1291,17,1283,16147,860,329,8.0,0,1.3,244057,2127,242670,66.15,25.31,12.420769230769231,0.87,99.43
2020-10-29,Mizoram,505,5,503,6417,1016,358,7.87,0,1.3,244562,2132,243173,78.15,27.54,4.936153846153847,0.87,99.43
2020-10-30,Mizoram,1227,16,1227,15364,4253,2416,7.99,0,1.3,245789,2148,244400,327.15,185.85,11.818461538461538,0.87,99.43
2020-10-31,Mizoram,219,2,213,2717,1015,934,8.06,4,1.3,246008,2150,244613,78.08,71.85,2.09,0.87,99.43
2020-11-01,Mizoram,616,6,610,7547,3351,2974,8.16,0,1.3,246624,2156,245223,257.77,228.77,5.805384615384615,0.87,99.43
2020-11-02,Mizoram,1587,14,1581,19715,4341,3513,8.05,0,1.3,248211,2170,246804,333.92,270.23,15.165384615384616,0.87,99.43
2020-11-03,Mizoram,527,2,524,6601,2697,137,7.98,1,1.3,248738,2172,247328,207.46,10.54,5.077692307692308,0.87,99.43
2020-11-04,Mizoram,368,3,361,4545,1968,1421,8.1,4,1.3,249106,2175,247689,151.38,109.31,3.496153846153846,0.87,99.43
2020-11-05,Mizoram,607,8,603,7555,286,79,8.03,0,1.3,249713,2183,248292,22.0,6.08,5.811538461538461,0.87,99.43
2020-11-06,Mizoram,211,1,205,2075,2477,1794,10.17,5,1.3,249924,2184,248497,190.54,138.0,1.5961538461538463,0.87,99.43
2020-11-07,Mizoram,1080,7,1072,13458,875,523,8.02,1,1.3,251004,2191,249569,67.31,40.23,10.352307692307692,0.87,99.43
2020-11-08,Mizoram,770,8,762,9423,106,18,8.17,0,1.3,251774,2199,250331,8.15,1.38,7.248461538461538,0.87,99.43
2020-11-09,Mizoram,395,5,390,5081,3344,1827,7.77,0,1.3,252169,2204,250721,257.23,140.54,3.9084615384615384,0.87,99.43
2020-11-10,Mizoram,364,4,355,4462,905,812,8.16,5,1.3,252533,2208,251076,69.62,62.46,3.4323076923076923,0.87,99.42
2020-11-11,Mizoram,1266,12,1259,15901,2757,2103,7.96,0,1.3,253799,2220,252335,212.08,161.77,12.231538461538461,0.87,99.42
2020-11-12,Mizoram,330,3,326,3820,2101,1460,8.64,1,1.3,254129,2223,252661,161.62,112.31,2.9384615384615387,0.87,99.42
2020-11-13,Mizoram,1340,12,1335,16518,3938,559,8.11,0,1.3,255469,2235,253996,302.92,43.0,12.706153846153846,0.87,99.42
2020-11-14,Mizoram,1192,16,1189,14704,2527,1704,8.11,0,1.3,256661,2251,255185,194.38,131.08,11.31076923076923,0.88,99.42
2020-11-15,Mizoram,545,3,541,6503,2362,1102,8.38,1,1.3,257206,2254,255726,181.69,84.77,5.002307692307692,0.88,99.42
2020-11-16,Mizoram,1612,9,1610,19961,2048,1317,8.08,0,1.3,258818,2263,257336,157.54,101.31,15.354615384615384,0.87,99.43
2020-11-17,Mizoram,859,12,857,10970,1047,287,7.83,0,1.3,259677,2275,258193,80.54,22.08,8.438461538461539,0.88,99.43
2020-11-18,Mizoram,1554,11,1552,19604,2286,413,7.93,0,1.3,261231,2286,259745,175.85,31.77,15.08,0.88,99.43
2020-11-19,Mizoram,975,5,970,12185,4284,1994,8.0,0,1.3,262206,2291,260715,329.54,153.38,9.373076923076923,0.87,99.43
2020-11-20,Mizoram,1509,12,1503,18935,1945,562,7.97,0,1.3,263715,2303,262218,149.62,43.23,14.565384615384616,0.87,99.43
2020-11-21,Mizoram,440,5,431,5795,242,158,7.59,4,1.3,264155,2308,262649,18.62,12.15,4.457692307692308,0.87,99.43
2020-11-22,Mizoram,1193,3,1189,14778,4088,2681,8.07,1,1.3,265348,2311,263838,314.46,206.23,11.367692307692307,0.87,99.43
2020-11-23,Mizoram,120,1,116,1240,2975,1098,9.68,3,1.3,265468,2312,263954,228.85,84.46,0.9538461538461539,0.87,99.43
2020-11-24,Mizoram,637,5,636,8207,4645,4038,7.76,0,1.3,266105,2317,264590,357.31,310.62,6.313076923076923,0.87,99.43
2020-11-25,Mizoram,1452,4,1447,18589,668,585,7.81,1,1.3,267557,2321,266037,51.38,45.0,14.29923076923077,0.87,99.43
2020-11-26,Mizoram,1507,4,1499,18991,320,203,7.94,4,1.3,269064,2325,267536,24.62,15.62,14.608461538461539,0.86,99.43
2020-11-27,Mizoram,1231,10,1223,15508,3469,2604,7.94,0,1.3,270295,2335,268759,266.85,200.31,11.929230769230768,0.86,99.43
2020-11-28,Mizoram,899,6,898,11045,1672,1509,8.14,0,1.3,271194,2341,269657,128.62,116.08,8.496153846153845,0.86,99.43
2020-11-29,Mizoram,184,2,175,2100,4771,2989,8.76,7,1.3,271378,2343,269832,367.0,229.92,1.6153846153846154,0.86,99.43
2020-11-30,Mizoram,1384,7,1378,17231,4162,838,8.03,0,1.3,272762,2350,271210,320.15,64.46,13.254615384615384,0.86,99.43
2020-12-01,Mizoram,237,2,228,3002,3953,3278,7.89,7,1.3,272999,2352,271438,304.08,252.15,2.309230769230769,0.86,99.43
2020-12-02,Mizoram,518,4,517,6409,1433,39,8.08,0,1.3,273517,2356,271955,110.23,3.0,4.93,0.86,99.43
2020-12-03,Mizoram,812,9,810,10207,4572,3812,7.96,0,1.3,274329,2365,272765,351.69,293.23,7.851538461538461,0.86,99.43
2020-12-04,Mizoram,1195,14,1188,14766,555,139,8.09,0,1.3,275524,2379,273953,42.69,10.69,11.358461538461539,0.86,99.43
2020-12-05,Mizoram,707,3,705,9273,3772,761,7.62,0,1.3,276231,2382,274658,290.15,58.54,7.133076923076923,0.86,99.43
2020-12-06,Mizoram,321,4,320,4334,61,60,7.41,0,1.3,276552,2386,274978,4.69,4.62,3.333846153846154,0.86,99.43
2020-12-07,Mizoram,204,1,203,2674,4685,1213,7.63,0,1.3,276756,2387,275181,360.38,93.31,2.056923076923077,0.86,99.43
2020-12-08,Mizoram,267,1,258,3093,2331,1990,8.63,8,1.3,277023,2388,275439,179.31,153.08,2.379230769230769,0.86,99.43
2020-12-09,Mizoram,1193,16,1192,14861,4480,3389,8.03,0,1.3,278216,2404,276631,344.62,260.69,11.431538461538462,0.86,99.43
2020-12-10,Mizoram,1132,6,1131,13834,4454,3096,8.18,0,1.3,279348,2410,277762,342.62,238.15,10.641538461538461,0.86,99.43
2020-12-11,Mizoram,293,1,290,3616,835,795,8.1,2,1.3,279641,2411,278052,64.23,61.15,2.7815384615384615,0.86,99.43
2020-12-12,Mizoram,1453,12,1450,18092,314,288,8.03,0,1.3,281094,2423,279502,24.15,22.15,13.916923076923077,0.86,99.43
2020-12-13,Mizoram,196,0,192,2599,1849,1401,7.54,4,1.3,281290,2423,279694,142.23,107.77,1.9992307692307691,0.86,99.43
2020-12-14,Mizoram,1502,18,1498,19276,259,4,7.79,0,1.3,282792,2441,281192,19.92,0.31,14.827692307692308,0.86,99.43
2020-12-15,Mizoram,397,4,395,4937,4185,2800,8.04,0,1.3,283189,2445,281587,321.92,215.38,3.7976923076923077,0.86,99.43
2020-12-16,Mizoram,302,1,295,3961,3033,2658,7.62,6,1.3,283491,2446,281882,233.31,204.46,3.046923076923077,0.86,99.43
2020-12-17,Mizoram,500,1,498,6045,2951,2178,8.27,1,1.3,283991,2447,282380,227.0,167.54,4.65,0.86,99.43
2020-12-18,Mizoram,1490,9,1484,18834,2465,315,7.91,0,1.3,285481,2456,283864,189.62,24.23,14.487692307692308,0.86,99.43
2020-12-19,Mizoram,575,4,574,7062,2136,849,8.14,0,1.3,286056,2460,284438,164.31,65.31,5.432307692307693,0.86,99.43
2020-12-20,Mizoram,1422,18,1417,17736,4455,4129,8.02,0,1.3,287478,2478,285855,342.69,317.62,13.643076923076922,0.86,99.44
2020-12-21,Mizoram,1472,15,1469,18062,11,3,8.15,0,1.3,288950,2493,287324,0.85,0.23,13.893846153846154,0.86,99.44
2020-12-22,Mizoram,1414,7,1408,18044,3978,1257,7.84,0,1.3,290364,2500,288732,306.0,96.69,13.88,0.86,99.44
2020-12-23,Mizoram,471,3,468,5767,1012,938,8.17,0,1.3,290835,2503,289200,77.85,72.15,4.436153846153847,0.86,99.44
2020-12-24,Mizoram,320,4,319,4122,2184,1097,7.76,0,1.3,291155,2507,289519,168.0,84.38,3.170769230769231,0.86,99.44
2020-12-25,Mizoram,617,6,616,8449,2857,1429,7.3,0,1.3,291772,2513,290135,219.77,109.92,6.49923076923077,0.86,99.44
2020-12-26,Mizoram,1139,15,1137,14069,4256,1965,8.1,0,1.3,292911,2528,291272,327.38,151.15,10.822307692307692,0.86,99.44
2020-12-27,Mizoram,1149,10,1144,14505,2013,1218,7.92,0,1.3,294060,2538,292416,154.85,93.69,11.157692307692308,0.86,99.44
2020-12-28,Mizoram,1343,10,1339,16612,66,44,8.08,0,1.3,295403,2548,293755,5.08,3.38,12.778461538461539,0.86,99.44
2020-12-29,Mizoram,127,1,123,1537,1731,1011,8.26,3,1.3,295530,2549,293878,133.15,77.77,1.1823076923076923,0.86,99.44
2020-12-30,Mizoram,1134,9,1129,14439,693,28,7.85,0,1.3,296664,2558,295007,53.31,2.15,11.106923076923078,0.86,99.44
2020-12-31,Mizoram,1337,6,1335,16316,4962,4176,8.19,0,1.3,298001,2564,296342,381.69,321.23,12.55076923076923,0.86,99.44
2021-01-01,Mizoram,362,4,354,4893,4761,2636,7.4,4,1.3,298363,2568,296696,366.23,202.77,3.763846153846154,0.86,99.44
2021-01-02,Mizoram,523,4,520,6531,2980,847,8.01,0,1.3,298886,2572,297216,229.23,65.15,5.023846153846153,0.86,99.44
2021-01-03,Mizoram,223,1,223,2796,1963,1290,7.98,0,1.3,299109,2573,297439,151.0,99.23,2.1507692307692308,0.86,99.44
2021-01-04,Mizoram,1466,20,1464,18297,77,61,8.01,0,1.3,300575,2593,298903,5.92,4.69,14.074615384615385,0.86,99.44
2021-01-05,Mizoram,828,3,826,10326,1513,163,8.02,0,1.3,301403,2596,299729,116.38,12.54,7.943076923076923,0.86,99.44
2021-01-06,Mizoram,1540,15,1535,19603,4378,1728,7.86,0,1.3,302943,2611,301264,336.77,132.92,15.079230769230769,0.86,99.45
2021-01-07,Mizoram,1512,13,1512,19047,2679,737,7.94,0,1.3,304455,2624,302776,206.08,56.69,14.651538461538461,0.86,99.45
2021-01-08,Mizoram,813,5,812,9935,3177,1608,8.18,0,1.3,305268,2629,303588,244.38,123.69,7.642307692307693,0.86,99.45
2021-01-09,Mizoram,991,10,990,12611,3852,2175,7.86,0,1.3,306259,2639,304578,296.31,167.31,9.70076923076923,0.86,99.45
2021-01-10,Mizoram,117,1,111,1475,2601,1286,7.93,5,1.3,306376,2640,304689,200.08,98.92,1.1346153846153846,0.86,99.45
2021-01-11,Mizoram,1525,22,1523,19260,1379,956,7.92,0,1.3,307901,2662,306212,106.08,73.54,14.815384615384616,0.86,99.45
2021-01-12,Mizoram,68,0,60,1278,3419,314,5.32,8,1.3,307969,2662,306272,263.0,24.15,0.9830769230769231,0.86,99.45
2021-01-13,Mizoram,1494,4,1489,18913,4490,2176,7.9,1,1.3,309463,2666,307761,345.38,167.38,14.548461538461538,0.86,99.45
2021-01-14,Mizoram,236,2,236,3056,2094,1060,7.72,0,1.3,309699,2668,307997,161.08,81.54,2.350769230769231,0.86,99.45
2021-01-15,Mizoram,384,2,376,4847,1070,1063,7.92,6,1.3,310083,2670,308373,82.31,81.77,3.7284615384615383,0.86,99.45
2021-01-16,Mizoram,1180,4,1177,14565,803,577,8.1,0,1.3,311263,2674,309550,61.77,44.38,11.203846153846154,0.86,99.45
2021-01-17,Mizoram,690,9,688,8736,1338,1071,7.9,0,1.3,311953,2683,310238,102.92,82.38,6.72,0.86,99.45
2021-01-18,Mizoram,195,0,190,2507,2844,53,7.78,5,1.3,312148,2683,310428,218.77,4.08,1.9284615384615384,0.86,99.45
2021-01-19,Mizoram,226,2,221,2470,1405,88,9.15,3,1.3,312374,2685,310649,108.08,6.77,1.9,0.86,99.45
2021-01-20,Mizoram,1086,3,1085,13936,3523,234,7.79,0,1.3,313460,2688,311734,271.0,18.0,10.72,0.86,99.45
2021-01-21,Mizoram,1430,14,1425,17785,2894,1987,8.04,0,1.3,314890,2702,313159,222.62,152.85,13.680769230769231,0.86,99.45
2021-01-22,Mizoram,133,0,125,2021,695,234,6.58,8,1.3,315023,2702,313284,53.46,18.0,1.5546153846153845,0.86,99.45
2021-01-23,Mizoram,530,4,522,6811,414,396,7.78,4,1.3,315553,2706,313806,31.85,30.46,5.239230769230769,0.86,99.45
2021-01-24,Mizoram,1096,9,1091,13683,2348,2249,8.01,0,1.3,316649,2715,314897,180.62,173.0,10.525384615384615,0.86,99.45
2021-01-25,Mizoram,1435,16,1434,18061,2295,2035,7.95,0,1.3,318084,2731,316331,176.54,156.54,13.893076923076922,0.86,99.45
2021-01-26,Mizoram,551,6,547,6493,3536,2212,8.49,0,1.3,318635,2737,316878,272.0,170.15,4.9946153846153845,0.86,99.45
2021-01-27,Mizoram,416,1,416,5298,2463,1627,7.85,0,1.3,319051,2738,317294,189.46,125.15,4.075384615384616,0.86,99.45
2021-01-28,Mizoram,86,0,82,1047,4740,123,8.21,4,1.3,319137,2738,317376,364.62,9.46,0.8053846153846154,0.86,99.45
2021-01-29,Mizoram,349,5,340,4630,3418,1888,7.54,4,1.3,319486,2743,317716,262.92,145.23,3.5615384615384613,0.86,99.45
2021-01-30,Mizoram,1535,17,1527,19345,4193,3166,7.93,0,1.3,321021,2760,319243,322.54,243.54,14.88076923076923,0.86,99.45
2021-01-31,Mizoram,476,4,470,5912,229,166,8.05,2,1.3,321497,2764,319713,17.62,12.77,4.547692307692308,0.86,99.45
2021-02-01,Mizoram,82,0,73,1282,1369,487,6.4,9,1.3,321579,2764,319786,105.31,37.46,0.9861538461538462,0.86,99.44
2021-02-02,Mizoram,523,2,516,6381,3970,258,8.2,5,1.3,322102,2766,320302,305.38,19.85,4.908461538461538,0.86,99.44
2021-02-03,Mizoram,1332,16,1330,16638,2602,1726,8.01,0,1.3,323434,2782,321632,200.15,132.77,12.798461538461538,0.86,99.44
2021-02-04,Mizoram,1039,6,1032,13253,4813,902,7.84,1,1.3,324473,2788,322664,370.23,69.38,10.194615384615384,0.86,99.44
2021-02-05,Mizoram,1068,7,1064,13291,4045,3829,8.04,0,1.3,325541,2795,323728,311.15,294.54,10.223846153846154,0.86,99.44
2021-02-06,Mizoram,858,9,850,10919,2647,1100,7.86,0,1.3,326399,2804,324578,203.62,84.62,8.399230769230769,0.86,99.44
2021-02-07,Mizoram,83,0,79,1239,3258,1994,6.7,4,1.3,326482,2804,324657,250.62,153.38,0.953076923076923,0.86,99.44
2021-02-08,Mizoram,1271,8,1267,15641,3704,1885,8.13,0,1.3,327753,2812,325924,284.92,145.0,12.031538461538462,0.86,99.44
2021-02-09,Mizoram,895,3,892,11524,2773,2279,7.77,0,1.3,328648,2815,326816,213.31,175.31,8.864615384615385,0.86,99.44
2021-02-10,Mizoram,777,9,770,9671,1546,92,8.03,0,1.3,329425,2824,327586,118.92,7.08,7.439230769230769,0.86,99.44
2021-02-11,Mizoram,639,5,632,7996,4201,3650,7.99,2,1.3,330064,2829,328218,323.15,280.77,6.150769230769231,0.86,99.44
2021-02-12,Mizoram,64,0,62,752,1201,469,8.51,2,1.3,330128,2829,328280,92.38,36.08,0.5784615384615385,0.86,99.44
2021-02-13,Mizoram,1084,3,1078,13720,667,498,7.9,3,1.3,331212,2832,329358,51.31,38.31,10.553846153846154,0.86,99.44
2021-02-14,Mizoram,1591,6,1590,19630,3855,844,8.1,0,1.3,332803,2838,330948,296.54,64.92,15.1,0.85,99.44
2021-02-15,Mizoram,237,3,232,2822,224,21,8.4,2,1.3,333040,2841,331180,17.23,1.62,2.170769230769231,0.85,99.44
2021-02-16,Mizoram,232,2,230,2850,373,86,8.14,0,1.3,333272,2843,331410,28.69,6.62,2.1923076923076925,0.85,99.44
2021-02-17,Mizoram,1338,19,1334,16376,2761,465,8.17,0,1.3,334610,2862,332744,212.38,35.77,12.596923076923076,0.86,99.44
2021-02-18,Mizoram,668,5,663,8492,3100,2769,7.87,0,1.3,335278,2867,333407,238.46,213.0,6.532307692307692,0.86,99.44
2021-02-19,Mizoram,748,6,744,9892,19,5,7.56,0,1.3,336026,2873,334151,1.46,0.38,7.609230769230769,0.85,99.44
2021-02-20,Mizoram,383,1,381,5135,1289,65,7.46,1,1.3,336409,2874,334532,99.15,5.0,3.95,0.85,99.44
2021-02-21,Mizoram,1441,4,1441,17718,2998,152,8.13,0,1.3,337850,2878,335973,230.62,11.69,13.62923076923077,0.85,99.44
2021-02-22,Mizoram,271,4,271,3078,4203,3177,8.8,0,1.3,338121,2882,336244,323.31,244.38,2.3676923076923075,0.85,99.44
2021-02-23,Mizoram,229,1,226,2982,3223,580,7.68,2,1.3,338350,2883,336470,247.92,44.62,2.293846153846154,0.85,99.44
2021-02-24,Mizoram,1522,12,1517,18451,3691,727,8.25,0,1.3,339872,2895,337987,283.92,55.92,14.193076923076923,0.85,99.45
2021-02-25,Mizoram,885,3,880,10836,4134,2280,8.17,2,1.3,340757,2898,338867,318.0,175.38,8.335384615384616,0.85,99.45
2021-02-26,Mizoram,275,4,270,3179,378,276,8.65,1,1.3,341032,2902,339137,29.08,21.23,2.4453846153846155,0.85,99.44
2021-02-27,Mizoram,1576,14,1567,19532,4344,4325,8.07,0,1.3,342608,2916,340704,334.15,332.69,15.024615384615384,0.85,99.44
2021-02-28,Mizoram,496,3,494,6252,3945,2456,7.93,0,1.3,343104,2919,341198,303.46,188.92,4.809230769230769,0.85,99.44
2021-03-01,Mizoram,805,4,802,9821,1878,451,8.2,0,1.3,343909,2923,342000,144.46,34.69,7.554615384615385,0.85,99.44
2021-03-02,Mizoram,935,4,932,11965,4226,2880,7.81,0,1.3,344844,2927,342932,325.08,221.54,9.203846153846154,0.85,99.45
2021-03-03,Mizoram,880,9,871,10739,3947,2170,8.19,0,1.3,345724,2936,343803,303.62,166.92,8.260769230769231,0.85,99.44
2021-03-04,Mizoram,1331,12,1331,16499,1325,461,8.07,0,1.3,347055,2948,345134,101.92,35.46,12.691538461538462,0.85,99.45
2021-03-05,Mizoram,1109,7,1102,13996,600,507,7.92,0,1.3,348164,2955,346236,46.15,39.0,10.766153846153847,0.85,99.45
2021-03-06,Mizoram,1044,4,1040,12955,4454,3123,8.06,0,1.3,349208,2959,347276,342.62,240.23,9.965384615384615,0.85,99.45
2021-03-07,Mizoram,1456,9,1456,18450,1396,285,7.89,0,1.3,350664,2968,348732,107.38,21.92,14.192307692307692,0.85,99.45
2021-03-08,Mizoram,1454,11,1448,17855,420,227,8.14,0,1.3,352118,2979,350180,32.31,17.46,13.734615384615385,0.85,99.45
2021-03-09,Mizoram,1565,8,1556,19441,1284,1267,8.05,1,1.3,353683,2987,351736,98.77,97.46,14.954615384615385,0.84,99.45
2021-03-10,Mizoram,103,1,94,1385,4865,4010,7.44,8,1.3,353786,2988,351830,374.23,308.46,1.0653846153846154,0.84,99.45
2021-03-11,Mizoram,559,6,559,7064,4466,3754,7.91,0,1.3,354345,2994,352389,343.54,288.77,5.4338461538461535,0.84,99.45
2021-03-12,Mizoram,1466,14,1459,18380,1622,938,7.98,0,1.3,355811,3008,353848,124.77,72.15,14.138461538461538,0.85,99.45
2021-03-13,Mizoram,733,10,729,9201,3362,3084,7.97,0,1.3,356544,3018,354577,258.62,237.23,7.077692307692308,0.85,99.45
2021-03-14,Mizoram,666,2,666,8750,4035,1989,7.61,0,1.3,357210,3020,355243,310.38,153.0,6.730769230769231,0.85,99.45
2021-03-15,Mizoram,1234,14,1234,15514,4412,1852,7.95,0,1.3,358444,3034,356477,339.38,142.46,11.933846153846154,0.85,99.45
2021-03-16,Mizoram,1279,13,1278,16054,3304,1260,7.97,0,1.3,359723,3047,357755,254.15,96.92,12.349230769230768,0.85,99.45
2021-03-17,Mizoram,232,1,230,2577,3880,992,9.0,1,1.3,359955,3048,357985,298.46,76.31,1.9823076923076923,0.85,99.45
2021-03-18,Mizoram,333,4,331,4396,1424,612,7.58,0,1.3,360288,3052,358316,109.54,47.08,3.3815384615384616,0.85,99.45
2021-03-19,Mizoram,669,8,669,7866,3943,1106,8.5,0,1.3,360957,3060,358985,303.31,85.08,6.050769230769231,0.85,99.45
2021-03-20,Mizoram,1244,10,1235,15705,2943,935,7.92,0,1.3,362201,3070,360220,226.38,71.92,12.080769230769231,0.85,99.45
2021-03-21,Mizoram,990,5,984,12538,2086,514,7.9,1,1.3,363191,3075,361204,160.46,39.54,9.644615384615385,0.85,99.45
2021-03-22,Mizoram,1155,4,1152,14416,6,5,8.01,0,1.3,364346,3079,362356,0.46,0.38,11.089230769230769,0.85,99.45
2021-03-23,Mizoram,733,3,728,9129,75,20,8.03,2,1.3,365079,3082,363084,5.77,1.54,7.022307692307693,0.84,99.45
2021-03-24,Mizoram,622,6,618,7848,4853,853,7.93,0,1.3,365701,3088,363702,373.31,65.62,6.036923076923077,0.84,99.45
2021-03-25,Mizoram,564,7,563,6956,3428,1929,8.11,0,1.3,366265,3095,364265,263.69,148.38,5.350769230769231,0.85,99.45
2021-03-26,Mizoram,884,2,876,11237,4888,4014,7.87,6,1.3,367149,3097,365141,376.0,308.77,8.643846153846154,0.84,99.45
2021-03-27,Mizoram,683,6,680,8481,2895,1897,8.05,0,1.3,367832,3103,365821,222.69,145.92,6.523846153846153,0.84,99.45
2021-03-28,Mizoram,1418,14,1410,17648,157,63,8.03,0,1.3,369250,3117,367231,12.08,4.85,13.575384615384616,0.84,99.45
2021-03-29,Mizoram,239,2,233,3553,1563,1092,6.73,4,1.3,369489,3119,367464,120.23,84.0,2.733076923076923,0.84,99.45
2021-03-30,Mizoram,1518,22,1515,19000,739,718,7.99,0,1.3,371007,3141,368979,56.85,55.23,14.615384615384615,0.85,99.45
2021-03-31,Mizoram,304,2,304,3666,3034,825,8.29,0,1.3,371311,3143,369283,233.38,63.46,2.82,0.85,99.45
2021-04-01,Mizoram,800,7,798,10073,3286,2264,7.94,0,1.3,372111,3150,370081,252.77,174.15,7.748461538461538,0.85,99.45
2021-04-02,Mizoram,667,6,658,8045,3456,1578,8.29,3,1.3,372778,3156,370739,265.85,121.38,6.188461538461539,0.85,99.45
2021-04-03,Mizoram,1124,13,1123,13479,3041,2116,8.34,0,1.3,373902,3169,371862,233.92,162.77,10.368461538461538,0.85,99.45
2021-04-04,Mizoram,1009,9,1005,13083,1589,595,7.71,0,1.3,374911,3178,372867,122.23,45.77,10.063846153846153,0.85,99.45
2021-04-05,Mizoram,814,9,806,10323,4053,1321,7.89,0,1.3,375725,3187,373673,311.77,101.62,7.940769230769231,0.85,99.45
2021-04-06,Mizoram,992,11,983,12302,1846,837,8.06,0,1.3,376717,3198,374656,142.0,64.38,9.463076923076922,0.85,99.45
2021-04-07,Mizoram,314,3,311,3713,1383,568,8.46,0,1.3,377031,3201,374967,106.38,43.69,2.856153846153846,0.85,99.45
2021-04-08,Mizoram,978,6,973,12209,1154,699,8.01,0,1.3,378009,3207,375940,88.77,53.77,9.391538461538461,0.85,99.45
2021-04-09,Mizoram,102,0,102,1509,2625,270,6.76,0,1.3,378111,3207,376042,201.92,20.77,1.1607692307692308,0.85,99.45
2021-04-10,Mizoram,1417,18,1414,17813,2625,1559,7.95,0,1.3,379528,3225,377456,201.92,119.92,13.702307692307693,0.85,99.45
2021-04-11,Mizoram,1147,7,1139,14000,2530,1648,8.19,1,1.3,380675,3232,378595,194.62,126.77,10.76923076923077,0.85,99.45
2021-04-12,Mizoram,794,10,785,9888,4987,907,8.03,0,1.3,381469,3242,379380,383.62,69.77,7.6061538461538465,0.85,99.45
2021-04-13,Mizoram,1411,14,1404,17258,3726,3294,8.18,0,1.3,382880,3256,380784,286.62,253.38,13.275384615384615,0.85,99.45
2021-04-14,Mizoram,316,3,309,4171,99,71,7.58,4,1.3,383196,3259,381093,7.62,5.46,3.2084615384615383,0.85,99.45
2021-04-15,Mizoram,1235,14,1230,15181,4430,1380,8.14,0,1.3,384431,3273,382323,340.77,106.15,11.677692307692308,0.85,99.45
2021-04-16,Mizoram,335,2,332,4042,2079,840,8.29,1,1.3,384766,3275,382655,159.92,64.62,3.109230769230769,0.85,99.45
2021-04-17,Mizoram,594,3,592,7676,1876,1045,7.74,0,1.3,385360,3278,383247,144.31,80.38,5.904615384615385,0.85,99.45
2021-04-18,Mizoram,1004,11,998,12636,1422,196,7.95,0,1.3,386364,3289,384245,109.38,15.08,9.72,0.85,99.45
2021-04-19,Mizoram,522,7,520,6649,2148,1896,7.85,0,1.3,386886,3296,384765,165.23,145.85,5.114615384615385,0.85,99.45
2021-04-20,Mizoram,825,6,820,9799,384,284,8.42,0,1.3,387711,3302,385585,29.54,21.85,7.537692307692308,0.85,99.45
2021-04-21,Mizoram,1179,14,1176,14962,3657,2047,7.88,0,1.3,388890,3316,386761,281.31,157.46,11.509230769230768,0.85,99.45
2021-04-22,Mizoram,1412,20,1404,17580,2211,1922,8.03,0,1.3,390302,3336,388165,170.08,147.85,13.523076923076923,0.85,99.45
2021-04-23,Mizoram,685,9,680,8581,3126,681,7.98,0,1.3,390987,3345,388845,240.46,52.38,6.600769230769231,0.86,99.45
2021-04-24,Mizoram,342,4,338,4275,2260,1677,8.0,0,1.3,391329,3349,389183,173.85,129.0,3.2884615384615383,0.86,99.45
2021-04-25,Mizoram,153,1,148,2122,4900,3748,7.21,4,1.3,391482,3350,389331,376.92,288.31,1.6323076923076922,0.86,99.45
2021-04-26,Mizoram,185,1,179,2058,2794,2583,8.99,5,1.3,391667,3351,389510,214.92,198.69,1.583076923076923,0.86,99.45
2021-04-27,Mizoram,1214,9,1208,15466,959,516,7.85,0,1.3,392881,3360,390718,73.77,39.69,11.896923076923077,0.86,99.45
2021-04-28,Mizoram,860,12,853,10918,2511,1312,7.88,0,1.3,393741,3372,391571,193.15,100.92,8.398461538461538,0.86,99.45
2021-04-29,Mizoram,1095,13,1086,13681,4202,418,8.0,0,1.3,394836,3385,392657,323.23,32.15,10.523846153846154,0.86,99.45
2021-04-30,Mizoram,407,4,407,4981,2759,920,8.17,0,1.3,395243,3389,393064,212.23,70.77,3.8315384615384613,0.86,99.45
2021-05-01,Mizoram,1510,7,1501,18963,3285,236,7.96,2,1.3,396753,3396,394565,252.69,18.15,14.586923076923076,0.86,99.45
2021-05-02,Mizoram,795,2,788,9582,2376,1090,8.3,5,1.3,397548,3398,395353,182.77,83.85,7.3707692307692305,0.85,99.45
2021-05-03,Mizoram,1219,11,1219,15444,3006,2553,7.89,0,1.3,398767,3409,396572,231.23,196.38,11.88,0.85,99.45
2021-05-04,Mizoram,753,3,750,9240,2802,30,8.15,0,1.3,399520,3412,397322,215.54,2.31,7.107692307692307,0.85,99.45
2021-05-05,Mizoram,1345,5,1341,16790,2206,92,8.01,0,1.3,400865,3417,398663,169.69,7.08,12.915384615384616,0.85,99.45
2021-05-06,Mizoram,1142,4,1142,14413,545,400,7.92,0,1.3,402007,3421,399805,41.92,30.77,11.086923076923076,0.85,99.45
2021-05-07,Mizoram,466,1,458,5816,198,128,8.01,7,1.3,402473,3422,400263,15.23,9.85,4.473846153846154,0.85,99.45
2021-05-08,Mizoram,1439,18,1434,18016,654,490,7.99,0,1.3,403912,3440,401697,50.31,37.69,13.858461538461539,0.85,99.45
2021-05-09,Mizoram,587,5,580,7627,4343,3161,7.7,2,1.3,404499,3445,402277,334.08,243.15,5.866923076923077,0.85,99.45
2021-05-10,Mizoram,790,2,788,9753,2346,1104,8.1,0,1.3,405289,3447,403065,180.46,84.92,7.502307692307692,0.85,99.45
2021-05-11,Mizoram,647,9,645,7960,2735,404,8.13,0,1.3,405936,3456,403710,210.38,31.08,6.123076923076923,0.85,99.45
2021-05-12,Mizoram,1037,12,1031,12915,4311,29,8.03,0,1.3,406973,3468,404741,331.62,2.23,9.934615384615384,0.85,99.45
2021-05-13,Mizoram,1421,9,1420,17473,1741,5,8.13,0,1.3,408394,3477,406161,133.92,0.38,13.44076923076923,0.85,99.45
2021-05-14,Mizoram,350,1,344,3994,1485,190,8.76,5,1.3,408744,3478,406505,114.23,14.62,3.0723076923076924,0.85,99.45
2021-05-15,Mizoram,353,3,352,4534,3290,918,7.79,0,1.3,409097,3481,406857,253.08,70.62,3.4876923076923076,0.85,99.45
2021-05-16,Mizoram,720,2,720,8809,107,59,8.17,0,1.3,409817,3483,407577,8.23,4.54,6.776153846153846,0.85,99.45
2021-05-17,Mizoram,930,4,930,11469,2091,1854,8.11,0,1.3,410747,3487,408507,160.85,142.62,8.822307692307692,0.85,99.45
2021-05-18,Mizoram,1585,22,1583,19633,2985,1200,8.07,0,1.3,412332,3509,410090,229.62,92.31,15.102307692307692,0.85,99.46
2021-05-19,Mizoram,1367,14,1360,17143,2720,713,7.97,0,1.3,413699,3523,411450,209.23,54.85,13.186923076923076,0.85,99.46
2021-05-20,Mizoram,1014,12,1010,13152,513,252,7.71,0,1.3,414713,3535,412460,39.46,19.38,10.116923076923078,0.85,99.46
2021-05-21,Mizoram,536,5,535,6838,198,117,7.84,0,1.3,415249,3540,412995,15.23,9.0,5.26,0.85,99.46
2021-05-22,Mizoram,675,9,666,8522,1518,155,7.92,0,1.3,415924,3549,413661,116.77,11.92,6.555384615384615,0.85,99.46
2021-05-23,Mizoram,1409,14,1400,17329,3472,2285,8.13,0,1.3,417333,3563,415061,267.08,175.77,13.33,0.85,99.46
2021-05-24,Mizoram,776,6,771,9511,600,43,8.16,0,1.3,418109,3569,415832,46.15,3.31,7.3161538461538465,0.85,99.46
2021-05-25,Mizoram,625,3,617,7380,4262,346,8.47,5,1.3,418734,3572,416449,327.85,26.62,5.676923076923077,0.85,99.45
2021-05-26,Mizoram,856,5,850,10742,2673,1819,7.97,1,1.3,419590,3577,417299,205.62,139.92,8.263076923076923,0.85,99.45
2021-05-27,Mizoram,880,5,872,11253,2582,1941,7.82,3,1.3,420470,3582,418171,198.62,149.31,8.656153846153845,0.85,99.45
2021-05-28,Mizoram,1351,4,1349,17008,2145,1689,7.94,0,1.3,421821,3586,419520,165.0,129.92,13.083076923076923,0.85,99.45
2021-05-29,Mizoram,616,6,610,7616,96,54,8.09,0,1.3,422437,3592,420130,7.38,4.15,5.858461538461539,0.85,99.45
2021-05-30,Mizoram,220,3,214,2863,3601,185,7.68,3,1.3,422657,3595,420344,277.0,14.23,2.2023076923076923,0.85,99.45
2021-05-31,Mizoram,1547,21,1546,19604,4882,3511,7.89,0,1.3,424204,3616,421890,375.54,270.08,15.08,0.85,99.45
2021-06-01,Mizoram,329,1,322,4244,1659,176,7.75,6,1.3,424533,3617,422212,127.62,13.54,3.2646153846153845,0.85,99.45
2021-06-02,Mizoram,1594,22,1592,19732,2132,1766,8.08,0,1.3,426127,3639,423804,164.0,135.85,15.178461538461539,0.85,99.45
2021-06-03,Mizoram,743,8,743,9575,3205,1298,7.76,0,1.3,426870,3647,424547,246.54,99.85,7.365384615384615,0.85,99.46
2021-06-04,Mizoram,1444,18,1437,18236,3176,3021,7.92,0,1.3,428314,3665,425984,244.31,232.38,14.027692307692307,0.86,99.46
2021-06-05,Mizoram,1211,6,1209,15141,1921,1532,8.0,0,1.3,429525,3671,427193,147.77,117.85,11.646923076923077,0.85,99.46
2021-06-06,Mizoram,1349,10,1344,16970,4436,3530,7.95,0,1.3,430874,3681,428537,341.23,271.54,13.053846153846154,0.85,99.46
2021-06-07,Mizoram,130,1,125,1499,4952,1850,8.67,4,1.3,431004,3682,428662,380.92,142.31,1.153076923076923,0.85,99.46
2021-06-08,Mizoram,830,3,827,10633,3122,2482,7.81,0,1.3,431834,3685,429489,240.15,190.92,8.179230769230768,0.85,99.46
2021-06-09,Mizoram,410,2,406,4999,4032,998,8.2,2,1.3,432244,3687,429895,310.15,76.77,3.8453846153846154,0.85,99.46
2021-06-10,Mizoram,1595,10,1592,19656,2547,390,8.11,0,1.3,433839,3697,431487,195.92,30.0,15.12,0.85,99.46
2021-06-11,Mizoram,1277,8,1274,15780,2119,494,8.09,0,1.3,435116,3705,432761,163.0,38.0,12.138461538461538,0.85,99.46
2021-06-12,Mizoram,941,3,933,11989,1857,1673,7.85,5,1.3,436057,3708,433694,142.85,128.69,9.222307692307693,0.85,99.46
2021-06-13,Mizoram,781,8,773,9867,667,134,7.92,0,1.3,436838,3716,434467,51.31,10.31,7.59,0.85,99.46
2021-06-14,Mizoram,158,2,149,1798,1257,240,8.79,7,1.3,436996,3718,434616,96.69,18.46,1.383076923076923,0.85,99.46
2021-06-15,Mizoram,291,2,284,3599,819,677,8.09,5,1.3,437287,3720,434900,63.0,52.08,2.7684615384615383,0.85,99.45
2021-06-16,Mizoram,299,4,299,3902,4622,3308,7.66,0,1.3,437586,3724,435199,355.54,254.46,3.0015384615384617,0.85,99.45
2021-06-17,Mizoram,1063,8,1056,13246,880,542,8.03,0,1.3,438649,3732,436255,67.69,41.69,10.18923076923077,0.85,99.45
2021-06-18,Mizoram,762,3,755,9809,867,688,7.77,4,1.3,439411,3735,437010,66.69,52.92,7.545384615384616,0.85,99.45
2021-06-19,Mizoram,122,0,116,1418,944,425,8.6,6,1.3,439533,3735,437126,72.62,32.69,1.0907692307692307,0.85,99.45
2021-06-20,Mizoram,1211,14,1207,15272,606,243,7.93,0,1.3,440744,3749,438333,46.62,18.69,11.747692307692308,0.85,99.45
2021-06-21,Mizoram,1586,20,1585,19716,1107,43,8.04,0,1.3,442330,3769,439918,85.15,3.31,15.166153846153847,0.85,99.45
2021-06-22,Mizoram,92,1,92,1260,1933,1575,7.3,0,1.3,442422,3770,440010,148.69,121.15,0.9692307692307692,0.85,99.45
2021-06-23,Mizoram,1111,5,1103,14145,4934,2874,7.85,3,1.3,443533,3775,441113,379.54,221.08,10.88076923076923,0.85,99.45
2021-06-24,Mizoram,961,10,952,11816,3516,1099,8.13,0,1.3,444494,3785,442065,270.46,84.54,9.089230769230769,0.85,99.45
2021-06-25,Mizoram,793,10,788,9868,4879,530,8.04,0,1.3,445287,3795,442853,375.31,40.77,7.590769230769231,0.85,99.45
2021-06-26,Mizoram,935,7,933,11507,4765,921,8.13,0,1.3,446222,3802,443786,366.54,70.85,8.851538461538462,0.85,99.45
2021-06-27,Mizoram,213,0,208,2662,2431,382,8.0,5,1.3,446435,3802,443994,187.0,29.38,2.0476923076923077,0.85,99.45
2021-06-28,Mizoram,573,6,573,7418,3464,1056,7.72,0,1.3,447008,3808,444567,266.46,81.23,5.706153846153846,0.85,99.45
2021-06-29,Mizoram,1162,8,1154,14547,1666,722,7.99,0,1.3,448170,3816,445721,128.15,55.54,11.19,0.85,99.45
2021-06-30,Mizoram,1086,6,1082,13938,3984,910,7.79,0,1.3,449256,3822,446803,306.46,70.0,10.721538461538461,0.85,99.45
2021-07-01,Mizoram,1559,20,1556,19383,1554,1401,8.04,0,1.3,450815,3842,448359,119.54,107.77,14.91,0.85,99.46
2021-07-02,Mizoram,118,1,111,1132,584,164,10.42,6,1.3,450933,3843,448470,44.92,12.62,0.8707692307692307,0.85,99.45
2021-07-03,Mizoram,789,5,781,9746,4613,264,8.1,3,1.3,451722,3848,449251,354.85,20.31,7.496923076923077,0.85,99.45
2021-07-04,Mizoram,1294,8,1292,16063,37,20,8.06,0,1.3,453016,3856,450543,2.85,1.54,12.356153846153846,0.85,99.45
2021-07-05,Mizoram,99,1,94,1653,3868,2104,5.99,4,1.3,453115,3857,450637,297.54,161.85,1.2715384615384615,0.85,99.45
2021-07-06,Mizoram,1535,10,1535,19183,1555,880,8.0,0,1.3,454650,3867,452172,119.62,67.69,14.756153846153847,0.85,99.45
2021-07-07,Mizoram,171,1,165,2379,2834,2197,7.19,5,1.3,454821,3868,452337,218.0,169.0,1.83,0.85,99.45
2021-07-08,Mizoram,714,10,713,9213,4823,253,7.75,0,1.3,455535,3878,453050,371.0,19.46,7.086923076923077,0.85,99.45
2021-07-09,Mizoram,751,7,747,9789,4316,840,7.67,0,1.3,456286,3885,453797,332.0,64.62,7.53,0.85,99.45
2021-07-10,Mizoram,1186,8,1184,15287,3931,2921,7.76,0,1.3,457472,3893,454981,302.38,224.69,11.759230769230768,0.85,99.46
2021-07-11,Mizoram,1465,10,1456,18377,4280,4030,7.97,0,1.3,458937,3903,456437,329.23,310.0,14.136153846153846,0.85,99.46
2021-07-12,Mizoram,1312,17,1310,16218,4516,3460,8.09,0,1.3,460249,3920,457747,347.38,266.15,12.475384615384616,0.85,99.46
2021-07-13,Mizoram,671,6,666,8155,2461,2144,8.23,0,1.3,460920,3926,458413,189.31,164.92,6.273076923076923,0.85,99.46
2021-07-14,Mizoram,731,10,731,9517,458,165,7.68,0,1.3,461651,3936,459144,35.23,12.69,7.320769230769231,0.85,99.46
2021-07-15,Mizoram,1477,9,1468,18091,2790,2032,8.16,0,1.3,463128,3945,460612,214.62,156.31,13.916153846153847,0.85,99.46
2021-07-16,Mizoram,565,8,557,6884,4945,1537,8.21,0,1.3,463693,3953,461169,380.38,118.23,5.295384615384616,0.85,99.46
2021-07-17,Mizoram,1558,4,1549,19565,336,38,7.96,5,1.3,465251,3957,462718,25.85,2.92,15.05,0.85,99.46
2021-07-18,Mizoram,1296,12,1296,15928,1895,1360,8.14,0,1.3,466547,3969,464014,145.77,104.62,12.252307692307692,0.85,99.46
2021-07-19,Mizoram,1191,8,1191,14974,3936,2908,7.95,0,1.3,467738,3977,465205,302.77,223.69,11.518461538461539,0.85,99.46
2021-07-20,Mizoram,503,3,496,6001,1689,338,8.38,4,1.3,468241,3980,465701,129.92,26.0,4.616153846153846,0.85,99.46
2021-07-21,Mizoram,789,9,780,9470,3163,2009,8.33,0,1.3,469030,3989,466481,243.31,154.54,7.2846153846153845,0.85,99.46
2021-07-22,Mizoram,1275,15,1270,15756,3736,1068,8.09,0,1.3,470305,4004,467751,287.38,82.15,12.12,0.85,99.46
2021-07-23,Mizoram,1300,15,1296,16276,4990,1198,7.99,0,1.3,471605,4019,469047,383.85,92.15,12.52,0.85,99.46
2021-07-24,Mizoram,642,7,641,7793,3151,29,8.24,0,1.3,472247,4026,469688,242.38,2.23,5.9946153846153845,0.85,99.46
2021-07-25,Mizoram,1452,9,1449,18011,3881,3506,8.06,0,1.3,473699,4035,471137,298.54,269.69,13.854615384615384,0.85,99.46
2021-07-26,Mizoram,773,4,767,9655,4627,3835,8.01,2,1.3,474472,4039,471904,355.92,295.0,7.426923076923077,0.85,99.46
2021-07-27,Mizoram,1061,4,1055,13555,4996,3595,7.83,2,1.3,475533,4043,472959,384.31,276.54,10.426923076923076,0.85,99.46
2021-07-28,Mizoram,80,0,74,844,4251,2710,9.48,6,1.3,475613,4043,473033,327.0,208.46,0.6492307692307693,0.85,99.46
2021-07-29,Mizoram,802,4,798,9652,4897,3832,8.31,0,1.3,476415,4047,473831,376.69,294.77,7.424615384615384,0.85,99.46
2021-07-30,Mizoram,982,8,974,12375,2054,1762,7.94,0,1.3,477397,4055,474805,158.0,135.54,9.51923076923077,0.85,99.46
2021-07-31,Mizoram,785,9,782,10030,583,573,7.83,0,1.3,478182,4064,475587,44.85,44.08,7.7153846153846155,0.85,99.46
2021-08-01,Mizoram,245,2,243,2808,4556,15,8.73,0,1.3,478427,4066,475830,350.46,1.15,2.16,0.85,99.46
2021-08-02,Mizoram,503,4,498,6396,2931,1965,7.86,1,1.3,478930,4070,476328,225.46,151.15,4.92,0.85,99.46
2021-08-03,Mizoram,1111,5,1108,14285,737,658,7.78,0,1.3,480041,4075,477436,56.69,50.62,10.988461538461538,0.85,99.46
2021-08-04,Mizoram,1054,8,1054,13232,848,249,7.97,0,1.3,481095,4083,478490,65.23,19.15,10.178461538461539,0.85,99.46
2021-08-05,Mizoram,969,12,968,12237,4187,3405,7.92,0,1.3,482064,4095,479458,322.08,261.92,9.413076923076924,0.85,99.46
2021-08-06,Mizoram,962,6,960,12580,1946,1705,7.65,0,1.3,483026,4101,480418,149.69,131.15,9.676923076923076,0.85,99.46
2021-08-07,Mizoram,1370,10,1370,16920,1351,820,8.1,0,1.3,484396,4111,481788,103.92,63.08,13.015384615384615,0.85,99.46
2021-08-08,Mizoram,1268,9,1262,15856,3184,184,8.0,0,1.3,485664,4120,483050,244.92,14.15,12.196923076923078,0.85,99.46
2021-08-09,Mizoram,543,8,542,6867,2136,977,7.91,0,1.3,486207,4128,483592,164.31,75.15,5.282307692307692,0.85,99.46
2021-08-10,Mizoram,326,1,319,4072,3640,2998,8.01,6,1.3,486533,4129,483911,280.0,230.62,3.1323076923076925,0.85,99.46
2021-08-11,Mizoram,861,7,852,10933,1179,185,7.88,2,1.3,487394,4136,484763,90.69,14.23,8.41,0.85,99.46
2021-08-12,Mizoram,343,2,336,4449,1202,1100,7.71,5,1.3,487737,4138,485099,92.46,84.62,3.4223076923076925,0.85,99.46
2021-08-13,Mizoram,1135,14,1126,13985,1697,12,8.12,0,1.3,488872,4152,486225,130.54,0.92,10.757692307692308,0.85,99.46
2021-08-14,Mizoram,993,8,990,11839,2004,1825,8.39,0,1.3,489865,4160,487215,154.15,140.38,9.106923076923078,0.85,99.46
2021-08-15,Mizoram,1123,4,1121,14122,2707,1857,7.95,0,1.3,490988,4164,488336,208.23,142.85,10.863076923076923,0.85,99.46
2021-08-16,Mizoram,724,7,724,9046,2138,745,8.0,0,1.3,491712,4171,489060,164.46,57.31,6.958461538461538,0.85,99.46
2021-08-17,Mizoram,619,8,617,8333,2849,597,7.43,0,1.3,492331,4179,489677,219.15,45.92,6.41,0.85,99.46
2021-08-18,Mizoram,1120,6,1119,14399,2938,753,7.78,0,1.3,493451,4185,490796,226.0,57.92,11.076153846153845,0.85,99.46
2021-08-19,Mizoram,266,2,257,3628,2878,1422,7.33,7,1.3,493717,4187,491053,221.38,109.38,2.790769230769231,0.85,99.46
2021-08-20,Mizoram,1329,14,1325,16493,3756,75,8.06,0,1.3,495046,4201,492378,288.92,5.77,12.686923076923076,0.85,99.46
2021-08-21,Mizoram,1397,17,1392,17631,4653,2416,7.92,0,1.3,496443,4218,493770,357.92,185.85,13.562307692307693,0.85,99.46
2021-08-22,Mizoram,1157,4,1149,14617,3401,2317,7.92,4,1.3,497600,4222,494919,261.62,178.23,11.243846153846153,0.85,99.46
2021-08-23,Mizoram,202,1,198,2635,513,5,7.67,3,1.3,497802,4223,495117,39.46,0.38,2.026923076923077,0.85,99.46
2021-08-24,Mizoram,1390,7,1385,17155,4603,454,8.1,0,1.3,499192,4230,496502,354.08,34.92,13.196153846153846,0.85,99.46
2021-08-25,Mizoram,241,1,232,3197,4389,2598,7.54,8,1.3,499433,4231,496734,337.62,199.85,2.459230769230769,0.85,99.46
2021-08-26,Mizoram,561,5,553,7351,2539,83,7.63,3,1.3,499994,4236,497287,195.31,6.38,5.654615384615385,0.85,99.46
2021-08-27,Mizoram,1406,4,1402,17834,4878,3224,7.88,0,1.3,501400,4240,498689,375.23,248.0,13.718461538461538,0.85,99.46
2021-08-28,Mizoram,555,4,551,6879,2428,1864,8.07,0,1.3,501955,4244,499240,186.77,143.38,5.291538461538462,0.85,99.46
2021-08-29,Mizoram,162,1,155,2099,858,740,7.72,6,1.3,502117,4245,499395,66.0,56.92,1.6146153846153846,0.85,99.46
2021-08-30,Mizoram,113,1,113,1403,2430,230,8.05,0,1.3,502230,4246,499508,186.92,17.69,1.0792307692307692,0.85,99.46
2021-08-31,Mizoram,735,5,731,9460,4088,514,7.77,0,1.3,502965,4251,500239,314.46,39.54,7.276923076923077,0.85,99.46
2021-09-01,Mizoram,1358,14,1353,16839,3095,1755,8.06,0,1.3,504323,4265,501592,238.08,135.0,12.953076923076923,0.85,99.46
2021-09-02,Mizoram,917,8,909,11626,275,165,7.89,0,1.3,505240,4273,502501,21.15,12.69,8.943076923076923,0.85,99.46
2021-09-03,Mizoram,832,9,829,10692,3917,63,7.78,0,1.3,506072,4282,503330,301.31,4.85,8.224615384615385,0.85,99.46
2021-09-04,Mizoram,1576,23,1570,19352,1392,1343,8.14,0,1.3,507648,4305,504900,107.08,103.31,14.886153846153846,0.85,99.46
2021-09-05,Mizoram,1495,21,1486,19107,3811,2344,7.82,0,1.3,509143,4326,506386,293.15,180.31,14.697692307692307,0.85,99.46
2021-09-06,Mizoram,528,6,528,6676,1024,119,7.91,0,1.3,509671,4332,506914,78.77,9.15,5.135384615384615,0.85,99.46
2021-09-07,Mizoram,1223,13,1220,15304,1348,1246,7.99,0,1.3,510894,4345,508134,103.69,95.85,11.772307692307692,0.85,99.46
2021-09-08,Mizoram,395,1,390,4948,3940,551,7.98,4,1.3,511289,4346,508524,303.08,42.38,3.806153846153846,0.85,99.46
2021-09-09,Mizoram,1211,6,1204,15174,4246,160,7.98,1,1.3,512500,4352,509728,326.62,12.31,11.672307692307692,0.85,99.46
2021-09-10,Mizoram,739,10,738,9368,3713,629,7.89,0,1.3,513239,4362,510466,285.62,48.38,7.206153846153846,0.85,99.46
2021-09-11,Mizoram,71,0,63,1074,2751,1688,6.61,8,1.3,513310,4362,510529,211.62,129.85,0.8261538461538461,0.85,99.46
2021-09-12,Mizoram,1510,14,1505,19021,4765,3261,7.94,0,1.3,514820,4376,512034,366.54,250.85,14.631538461538462,0.85,99.46
2021-09-13,Mizoram,240,1,240,3162,3156,164,7.59,0,1.3,515060,4377,512274,242.77,12.62,2.4323076923076923,0.85,99.46
2021-09-14,Mizoram,711,9,703,8646,2027,1055,8.22,0,1.3,515771,4386,512977,155.92,81.15,6.650769230769231,0.85,99.46
2021-09-15,Mizoram,1154,13,1145,14526,4798,4648,7.94,0,1.3,516925,4399,514122,369.08,357.54,11.173846153846155,0.85,99.46
2021-09-16,Mizoram,1187,17,1183,14684,3665,649,8.08,0,1.3,518112,4416,515305,281.92,49.92,11.295384615384615,0.85,99.46
2021-09-17,Mizoram,681,6,674,8633,3258,2436,7.89,1,1.3,518793,4422,515979,250.62,187.38,6.640769230769231,0.85,99.46
2021-09-18,Mizoram,1008,14,1002,12417,3904,3073,8.12,0,1.3,519801,4436,516981,300.31,236.38,9.551538461538462,0.85,99.46
2021-09-19,Mizoram,870,9,867,11142,462,411,7.81,0,1.3,520671,4445,517848,35.54,31.62,8.570769230769232,0.85,99.46
2021-09-20,Mizoram,583,7,578,7225,1513,676,8.07,0,1.3,521254,4452,518426,116.38,52.0,5.5576923076923075,0.85,99.46
2021-09-21,Mizoram,1134,8,1132,14560,2489,1620,7.79,0,1.3,522388,4460,519558,191.46,124.62,11.2,0.85,99.46
2021-09-22,Mizoram,105,1,101,1078,103,18,9.74,3,1.3,522493,4461,519659,7.92,1.38,0.8292307692307692,0.85,99.46
2021-09-23,Mizoram,83,1,77,992,1640,175,8.37,5,1.3,522576,4462,519736,126.15,13.46,0.7630769230769231,0.85,99.46
2021-09-24,Mizoram,583,5,583,7364,3691,875,7.92,0,1.3,523159,4467,520319,283.92,67.31,5.664615384615384,0.85,99.46
2021-09-25,Mizoram,377,3,377,4640,3641,3585,8.12,0,1.3,523536,4470,520696,280.08,275.77,3.5692307692307694,0.85,99.46
2021-09-26,Mizoram,457,2,454,5712,4010,3528,8.0,1,1.3,523993,4472,521150,308.46,271.38,4.3938461538461535,0.85,99.46
2021-09-27,Mizoram,810,7,801,9822,625,558,8.25,2,1.3,524803,4479,521951,48.08,42.92,7.555384615384615,0.85,99.46
2021-09-28,Mizoram,495,6,488,6202,3086,263,7.98,1,1.3,525298,4485,522439,237.38,20.23,4.770769230769231,0.85,99.46
2021-09-29,Mizoram,1452,10,1443,18222,2132,1707,7.97,0,1.3,526750,4495,523882,164.0,131.31,14.016923076923076,0.85,99.46
2021-09-30,Mizoram,1478,14,1469,18426,4061,1623,8.02,0,1.3,528228,4509,525351,312.38,124.85,14.173846153846155,0.85,99.46
2021-10-01,Mizoram,177,1,173,2654,3783,3289,6.67,3,1.3,528405,4510,525524,291.0,253.0,2.0415384615384617,0.85,99.45
2021-10-02,Mizoram,1542,7,1537,18838,4502,241,8.19,0,1.3,529947,4517,527061,346.31,18.54,14.490769230769232,0.85,99.46
2021-10-03,Mizoram,1471,9,1462,18521,3860,3346,7.94,0,1.3,531418,4526,528523,296.92,257.38,14.246923076923077,0.85,99.46
2021-10-04,Mizoram,278,3,278,3701,492,165,7.51,0,1.3,531696,4529,528801,37.85,12.69,2.846923076923077,0.85,99.46
2021-10-05,Mizoram,207,1,198,2697,851,447,7.68,8,1.3,531903,4530,528999,65.46,34.38,2.0746153846153845,0.85,99.45
2021-10-06,Mizoram,551,4,549,7537,4977,1572,7.31,0,1.3,532454,4534,529548,382.85,120.92,5.797692307692308,0.85,99.45
2021-10-07,Mizoram,312,4,312,3410,3402,2924,9.15,0,1.3,532766,4538,529860,261.69,224.92,2.623076923076923,0.85,99.45
2021-10-08,Mizoram,275,1,270,3620,2032,1390,7.6,4,1.3,533041,4539,530130,156.31,106.92,2.7846153846153845,0.85,99.45
2021-10-09,Mizoram,348,2,342,4514,4022,2595,7.71,4,1.3,533389,4541,530472,309.38,199.62,3.4723076923076923,0.85,99.45
2021-10-10,Mizoram,1513,14,1507,18918,829,566,8.0,0,1.3,534902,4555,531979,63.77,43.54,14.552307692307693,0.85,99.45
2021-10-11,Mizoram,1546,17,1539,18987,476,364,8.14,0,1.3,536448,4572,533518,36.62,28.0,14.605384615384615,0.85,99.45
2021-10-12,Mizoram,598,8,590,7270,1347,1027,8.23,0,1.3,537046,4580,534108,103.62,79.0,5.592307692307692,0.85,99.45
2021-10-13,Mizoram,585,6,584,7813,3305,562,7.49,0,1.3,537631,4586,534692,254.23,43.23,6.01,0.85,99.45
2021-10-14,Mizoram,1124,12,1120,14342,643,107,7.84,0,1.3,538755,4598,535812,49.46,8.23,11.032307692307691,0.85,99.45
2021-10-15,Mizoram,1394,6,1393,16997,946,560,8.2,0,1.3,540149,4604,537205,72.77,43.08,13.074615384615385,0.85,99.45
2021-10-16,Mizoram,1446,11,1446,17985,2333,1383,8.04,0,1.3,541595,4615,538651,179.46,106.38,13.834615384615384,0.85,99.46
2021-10-17,Mizoram,1072,11,1072,13363,2745,1097,8.02,0,1.3,542667,4626,539723,211.15,84.38,10.27923076923077,0.85,99.46
2021-10-18,Mizoram,1010,14,1003,12880,4041,2120,7.84,0,1.3,543677,4640,540726,310.85,163.08,9.907692307692308,0.85,99.46
2021-10-19,Mizoram,719,9,716,8958,2143,493,8.03,0,1.3,544396,4649,541442,164.85,37.92,6.890769230769231,0.85,99.46
2021-10-20,Mizoram,447,5,443,5598,3097,705,7.98,0,1.3,544843,4654,541885,238.23,54.23,4.306153846153846,0.85,99.46
2021-10-21,Mizoram,1406,11,1398,17906,3936,481,7.85,0,1.3,546249,4665,543283,302.77,37.0,13.773846153846154,0.85,99.46
2021-10-22,Mizoram,703,4,699,9097,756,16,7.73,0,1.3,546952,4669,543982,58.15,1.23,6.997692307692308,0.85,99.46
2021-10-23,Mizoram,253,3,246,3402,2397,1766,7.44,4,1.3,547205,4672,544228,184.38,135.85,2.616923076923077,0.85,99.46
2021-10-24,Mizoram,1322,8,1318,16593,106,76,7.97,0,1.3,548527,4680,545546,8.15,5.85,12.763846153846155,0.85,99.46
2021-10-25,Mizoram,249,3,241,3451,2711,1414,7.22,5,1.3,548776,4683,545787,208.54,108.77,2.6546153846153846,0.85,99.46
2021-10-26,Mizoram,1589,7,1587,19608,2614,876,8.1,0,1.3,550365,4690,547374,201.08,67.38,15.083076923076923,0.85,99.46
2021-10-27,Mizoram,1450,20,1446,18197,171,5,7.97,0,1.3,551815,4710,548820,13.15,0.38,13.997692307692308,0.85,99.46
2021-10-28,Mizoram,650,2,650,8441,2888,21,7.7,0,1.3,552465,4712,549470,222.15,1.62,6.493076923076923,0.85,99.46
2021-10-29,Mizoram,295,1,291,3750,2292,874,7.87,3,1.3,552760,4713,549761,176.31,67.23,2.8846153846153846,0.85,99.46
2021-10-30,Mizoram,1504,5,1501,18577,549,527,8.1,0,1.3,554264,4718,551262,42.23,40.54,14.29,0.85,99.46
2021-10-31,Mizoram,1201,5,1200,15279,3577,1146,7.86,0,1.3,555465,4723,552462,275.15,88.15,11.753076923076923,0.85,99.46
2021-11-01,Mizoram,1392,14,1384,17191,3430,2904,8.1,0,1.3,556857,4737,553846,263.85,223.38,13.223846153846154,0.85,99.46
2021-11-02,Mizoram,719,9,710,8873,4812,2902,8.1,0,1.3,557576,4746,554556,370.15,223.23,6.825384615384616,0.85,99.46
2021-11-03,Mizoram,1374,16,1372,17306,1074,795,7.94,0,1.3,558950,4762,555928,82.62,61.15,13.312307692307693,0.85,99.46
2021-11-04,Mizoram,69,0,60,1040,4253,2875,6.63,9,1.3,559019,4762,555988,327.15,221.15,0.8,0.85,99.46
2021-11-05,Mizoram,672,3,671,8282,2918,1650,8.11,0,1.3,559691,4765,556659,224.46,126.92,6.3707692307692305,0.85,99.46
2021-11-06,Mizoram,1503,8,1496,18633,3834,2783,8.07,0,1.3,561194,4773,558155,294.92,214.08,14.333076923076923,0.85,99.46
2021-11-07,Mizoram,50,0,46,922,3045,2331,5.42,4,1.3,561244,4773,558201,234.23,179.31,0.7092307692307692,0.85,99.46
2021-11-08,Mizoram,519,6,518,6529,1019,998,7.95,0,1.3,561763,4779,558719,78.38,76.77,5.022307692307693,0.85,99.46
2021-11-09,Mizoram,910,7,908,10971,3113,442,8.29,0,1.3,562673,4786,559627,239.46,34.0,8.43923076923077,0.85,99.46
2021-11-10,Mizoram,920,8,918,11676,2344,2297,7.88,0,1.3,563593,4794,560545,180.31,176.69,8.981538461538461,0.85,99.46
2021-11-11,Mizoram,461,4,458,5947,1516,580,7.75,0,1.3,564054,4798,561003,116.62,44.62,4.5746153846153845,0.85,99.46
2021-11-12,Mizoram,484,5,480,6065,2615,1143,7.98,0,1.3,564538,4803,561483,201.15,87.92,4.665384615384616,0.85,99.46
2021-11-13,Mizoram,62,0,53,950,4622,1193,6.53,9,1.3,564600,4803,561536,355.54,91.77,0.7307692307692307,0.85,99.46
2021-11-14,Mizoram,1045,7,1040,13263,268,150,7.88,0,1.3,565645,4810,562576,20.62,11.54,10.202307692307693,0.85,99.46
2021-11-15,Mizoram,605,3,597,7666,3651,2354,7.89,5,1.3,566250,4813,563173,280.85,181.08,5.896923076923077,0.85,99.46
2021-11-16,Mizoram,1495,17,1488,18731,2608,1739,7.98,0,1.3,567745,4830,564661,200.62,133.77,14.40846153846154,0.85,99.46
2021-11-17,Mizoram,1108,14,1103,13501,4808,1924,8.21,0,1.3,568853,4844,565764,369.85,148.0,10.385384615384615,0.85,99.46
2021-11-18,Mizoram,662,2,658,8310,2236,1105,7.97,2,1.3,569515,4846,566422,172.0,85.0,6.392307692307693,0.85,99.46
2021-11-19,Mizoram,1240,11,1233,15037,3531,1845,8.25,0,1.3,570755,4857,567655,271.62,141.92,11.566923076923077,0.85,99.46
2021-11-20,Mizoram,575,7,568,7108,913,871,8.09,0,1.3,571330,4864,568223,70.23,67.0,5.467692307692308,0.85,99.46
2021-11-21,Mizoram,232,2,228,2983,1531,1081,7.78,2,1.3,571562,4866,568451,117.77,83.15,2.2946153846153847,0.85,99.46
2021-11-22,Mizoram,1314,10,1312,16241,3768,3457,8.09,0,1.3,572876,4876,569763,289.85,265.92,12.493076923076924,0.85,99.46
2021-11-23,Mizoram,1173,11,1169,15258,4689,3854,7.69,0,1.3,574049,4887,570932,360.69,296.46,11.736923076923077,0.85,99.46
2021-11-24,Mizoram,433,6,429,5251,3312,2954,8.25,0,1.3,574482,4893,571361,254.77,227.23,4.03923076923077,0.85,99.46
2021-11-25,Mizoram,1382,11,1377,17177,1119,618,8.05,0,1.3,575864,4904,572738,86.08,47.54,13.213076923076922,0.85,99.46
2021-11-26,Mizoram,1388,12,1380,17220,3289,2628,8.06,0,1.3,577252,4916,574118,253.0,202.15,13.246153846153845,0.85,99.46
2021-11-27,Mizoram,1527,12,1521,19213,1038,46,7.95,0,1.3,578779,4928,575639,79.85,3.54,14.77923076923077,0.85,99.46
2021-11-28,Mizoram,613,3,606,7379,925,277,8.31,4,1.3,579392,4931,576245,71.15,21.31,5.676153846153846,0.85,99.46
2021-11-29,Mizoram,1375,11,1368,17182,1013,851,8.0,0,1.3,580767,4942,577613,77.92,65.46,13.216923076923077,0.85,99.46
2021-11-30,Mizoram,134,1,132,1682,2112,102,7.97,1,1.3,580901,4943,577745,162.46,7.85,1.2938461538461539,0.85,99.46
2021-12-01,Mizoram,1167,13,1158,14348,2700,381,8.13,0,1.3,582068,4956,578903,207.69,29.31,11.036923076923078,0.85,99.46
2021-12-02,Mizoram,1456,17,1452,18144,3308,429,8.02,0,1.3,583524,4973,580355,254.46,33.0,13.956923076923077,0.85,99.46
2021-12-03,Mizoram,557,3,554,7059,2466,186,7.89,0,1.3,584081,4976,580909,189.69,14.31,5.43,0.85,99.46
2021-12-04,Mizoram,672,6,666,8035,3750,940,8.36,0,1.3,584753,4982,581575,288.46,72.31,6.180769230769231,0.85,99.46
2021-12-05,Mizoram,590,2,583,7325,866,113,8.05,5,1.3,585343,4984,582158,66.62,8.69,5.634615384615385,0.85,99.46
2021-12-06,Mizoram,893,4,887,10904,4070,32,8.19,2,1.3,586236,4988,583045,313.08,2.46,8.387692307692308,0.85,99.46
2021-12-07,Mizoram,1331,17,1327,16888,3373,2067,7.88,0,1.3,587567,5005,584372,259.46,159.0,12.990769230769232,0.85,99.46
2021-12-08,Mizoram,1334,9,1332,16271,626,165,8.2,0,1.3,588901,5014,585704,48.15,12.69,12.516153846153847,0.85,99.46
2021-12-09,Mizoram,1060,5,1051,13357,3161,1775,7.94,4,1.3,589961,5019,586755,243.15,136.54,10.274615384615384,0.85,99.46
2021-12-10,Mizoram,969,3,962,11705,3210,1405,8.28,4,1.3,590930,5022,587717,246.92,108.08,9.003846153846155,0.85,99.46
2021-12-11,Mizoram,74,0,65,1160,1729,1688,6.38,9,1.3,591004,5022,587782,133.0,129.85,0.8923076923076924,0.85,99.45
2021-12-12,Mizoram,1515,15,1506,19025,2244,730,7.96,0,1.3,592519,5037,589288,172.62,56.15,14.634615384615385,0.85,99.45
2021-12-13,Mizoram,933,12,924,12227,604,583,7.63,0,1.3,593452,5049,590212,46.46,44.85,9.405384615384616,0.85,99.45
2021-12-14,Mizoram,1153,4,1152,14188,4536,4482,8.13,0,1.3,594605,5053,591364,348.92,344.77,10.913846153846153,0.85,99.45
2021-12-15,Mizoram,605,3,604,7543,801,76,8.02,0,1.3,595210,5056,591968,61.62,5.85,5.802307692307692,0.85,99.46
2021-12-16,Mizoram,936,3,930,11776,4127,2057,7.95,3,1.3,596146,5059,592898,317.46,158.23,9.058461538461538,0.85,99.46
2021-12-17,Mizoram,319,3,318,3870,4103,3308,8.24,0,1.3,596465,5062,593216,315.62,254.46,2.976923076923077,0.85,99.46
2021-12-18,Mizoram,506,4,505,6178,67,20,8.19,0,1.3,596971,5066,593721,5.15,1.54,4.752307692307692,0.85,99.46
2021-12-19,Mizoram,1128,13,1127,14155,268,152,7.97,0,1.3,598099,5079,594848,20.62,11.69,10.888461538461538,0.85,99.46
2021-12-20,Mizoram,1365,10,1358,17315,4249,3097,7.88,0,1.3,599464,5089,596206,326.85,238.23,13.319230769230769,0.85,99.46
2021-12-21,Mizoram,1424,13,1423,17822,3506,2346,7.99,0,1.3,600888,5102,597629,269.69,180.46,13.70923076923077,0.85,99.46
2021-12-22,Mizoram,1350,13,1343,17260,630,82,7.82,0,1.3,602238,5115,598972,48.46,6.31,13.276923076923078,0.85,99.46
2021-12-23,Mizoram,1565,9,1561,19235,2118,1476,8.14,0,1.3,603803,5124,600533,162.92,113.54,14.796153846153846,0.85,99.46
2021-12-24,Mizoram,500,6,497,6148,2877,555,8.13,0,1.3,604303,5130,601030,221.31,42.69,4.729230769230769,0.85,99.46
2021-12-25,Mizoram,149,0,148,2080,3640,269,7.16,1,1.3,604452,5130,601178,280.0,20.69,1.6,0.85,99.46
2021-12-26,Mizoram,879,6,870,10711,4525,117,8.21,3,1.3,605331,5136,602048,348.08,9.0,8.239230769230769,0.85,99.46
2021-12-27,Mizoram,1149,11,1143,14253,2077,1674,8.06,0,1.3,606480,5147,603191,159.77,128.77,10.963846153846154,0.85,99.46
2021-12-28,Mizoram,558,7,557,6815,853,5,8.19,0,1.3,607038,5154,603748,65.62,0.38,5.242307692307692,0.85,99.46
2021-12-29,Mizoram,1356,12,1352,16972,3551,2239,7.99,0,1.3,608394,5166,605100,273.15,172.23,13.055384615384616,0.85,99.46
2021-12-30,Mizoram,1504,10,1495,19018,1777,1547,7.91,0,1.3,609898,5176,606595,136.69,119.0,14.62923076923077,0.85,99.46
2021-12-31,Mizoram,44,0,42,603,1536,986,7.3,2,1.3,609942,5176,606637,118.15,75.85,0.46384615384615385,0.85,99.46
2022-01-01,Mizoram,1142,15,1137,14012,2480,1323,8.15,0,1.3,611084,5191,607774,190.77,101.77,10.778461538461539,0.85,99.46
2022-01-02,Mizoram,1404,8,1400,17778,4679,2305,7.9,0,1.3,612488,5199,609174,359.92,177.31,13.675384615384615,0.85,99.46
2022-01-03,Mizoram,739,4,733,9330,3492,1900,7.92,2,1.3,613227,5203,609907,268.62,146.15,7.176923076923077,0.85,99.46
2022-01-04,Mizoram,1307,10,1298,16317,4181,3999,8.01,0,1.3,614534,5213,611205,321.62,307.62,12.551538461538462,0.85,99.46
2022-01-05,Mizoram,1113,5,1104,13350,1787,1213,8.34,4,1.3,615647,5218,612309,137.46,93.31,10.26923076923077,0.85,99.46
2022-01-06,Mizoram,918,7,914,11779,4292,3648,7.79,0,1.3,616565,5225,613223,330.15,280.62,9.06076923076923,0.85,99.46
2022-01-07,Mizoram,1011,4,1008,12496,882,522,8.09,0,1.3,617576,5229,614231,67.85,40.15,9.612307692307692,0.85,99.46
2022-01-08,Mizoram,1412,4,1412,17438,789,226,8.1,0,1.3,618988,5233,615643,60.69,17.38,13.413846153846153,0.85,99.46
2022-01-09,Mizoram,240,2,237,3040,1000,6,7.89,1,1.3,619228,5235,615880,76.92,0.46,2.3384615384615386,0.85,99.46
2022-01-10,Mizoram,1054,9,1050,13005,1536,1326,8.1,0,1.3,620282,5244,616930,118.15,102.0,10.003846153846155,0.85,99.46
2022-01-11,Mizoram,731,5,730,8778,2247,815,8.33,0,1.3,621013,5249,617660,172.85,62.69,6.752307692307692,0.85,99.46
2022-01-12,Mizoram,646,7,644,7912,3252,805,8.16,0,1.3,621659,5256,618304,250.15,61.92,6.086153846153846,0.85,99.46
2022-01-13,Mizoram,1356,18,1352,16861,2275,1258,8.04,0,1.3,623015,5274,619656,175.0,96.77,12.97,0.85,99.46
2022-01-14,Mizoram,252,1,247,2564,4190,599,9.83,4,1.3,623267,5275,619903,322.31,46.08,1.9723076923076923,0.85,99.46
2022-01-15,Mizoram,363,2,354,4492,4453,2398,8.08,7,1.3,623630,5277,620257,342.54,184.46,3.4553846153846153,0.85,99.46
2022-01-16,Mizoram,654,3,651,8161,1763,922,8.01,0,1.3,624284,5280,620908,135.62,70.92,6.277692307692308,0.85,99.46
2022-01-17,Mizoram,890,5,889,10830,798,254,8.22,0,1.3,625174,5285,621797,61.38,19.54,8.330769230769231,0.85,99.46
2022-01-18,Mizoram,906,9,903,11379,4315,3913,7.96,0,1.3,626080,5294,622700,331.92,301.0,8.753076923076923,0.85,99.46
2022-01-19,Mizoram,454,1,450,5708,2041,1459,7.95,3,1.3,626534,5295,623150,157.0,112.23,4.390769230769231,0.85,99.46
2022-01-20,Mizoram,93,0,93,1456,819,291,6.39,0,1.3,626627,5295,623243,63.0,22.38,1.12,0.85,99.46
2022-01-21,Mizoram,950,2,949,11788,553,532,8.06,0,1.3,627577,5297,624192,42.54,40.92,9.067692307692308,0.84,99.46
2022-01-22,Mizoram,371,5,369,4906,3969,2498,7.56,0,1.3,627948,5302,624561,305.31,192.15,3.773846153846154,0.84,99.46
2022-01-23,Mizoram,624,8,617,7959,4101,2920,7.84,0,1.3,628572,5310,625178,315.46,224.62,6.122307692307692,0.84,99.46
2022-01-24,Mizoram,381,3,381,5096,2496,2400,7.48,0,1.3,628953,5313,625559,192.0,184.62,3.92,0.84,99.46
2022-01-25,Mizoram,205,1,201,2220,4350,3377,9.23,3,1.3,629158,5314,625760,334.62,259.77,1.7076923076923076,0.84,99.46
2022-01-26,Mizoram,1076,8,1076,13492,119,50,7.98,0,1.3,630234,5322,626836,9.15,3.85,10.378461538461538,0.84,99.46
2022-01-27,Mizoram,1455,8,1446,18142,4432,2334,8.02,1,1.3,631689,5330,628282,340.92,179.54,13.955384615384615,0.84,99.46
2022-01-28,Mizoram,711,7,706,8531,4736,4230,8.33,0,1.3,632400,5337,628988,364.31,325.38,6.562307692307693,0.84,99.46
2022-01-29,Mizoram,1539,8,1533,19208,982,109,8.01,0,1.3,633939,5345,630521,75.54,8.38,14.775384615384615,0.84,99.46
2022-01-30,Mizoram,697,7,696,8610,3592,3184,8.1,0,1.3,634636,5352,631217,276.31,244.92,6.623076923076923,0.84,99.46
2022-01-31,Mizoram,1472,12,1472,18312,2141,123,8.04,0,1.3,636108,5364,632689,164.69,9.46,14.086153846153847,0.84,99.46
2022-02-01,Mizoram,750,6,747,9370,2401,1877,8.0,0,1.3,636858,5370,633436,184.69,144.38,7.207692307692308,0.84,99.46
2022-02-02,Mizoram,943,5,934,11569,4020,1244,8.15,4,1.3,637801,5375,634370,309.23,95.69,8.899230769230769,0.84,99.46
2022-02-03,Mizoram,249,0,247,2866,2529,1781,8.69,2,1.3,638050,5375,634617,194.54,137.0,2.2046153846153844,0.84,99.46
2022-02-04,Mizoram,603,8,595,7523,3756,3687,8.02,0,1.3,638653,5383,635212,288.92,283.62,5.786923076923077,0.84,99.46
2022-02-05,Mizoram,1406,11,1401,17596,1838,980,7.99,0,1.3,640059,5394,636613,141.38,75.38,13.535384615384615,0.84,99.46
2022-02-06,Mizoram,624,5,616,7760,3844,2169,8.04,3,1.3,640683,5399,637229,295.69,166.85,5.969230769230769,0.84,99.46
2022-02-07,Mizoram,67,0,67,717,133,57,9.34,0,1.3,640750,5399,637296,10.23,4.38,0.5515384615384615,0.84,99.46
2022-02-08,Mizoram,1431,7,1425,17495,1309,1213,8.18,0,1.3,642181,5406,638721,100.69,93.31,13.457692307692307,0.84,99.46
2022-02-09,Mizoram,1546,22,1538,19091,3280,1112,8.1,0,1.3,643727,5428,640259,252.31,85.54,14.685384615384615,0.84,99.46
2022-02-10,Mizoram,1160,5,1158,14740,143,122,7.87,0,1.3,644887,5433,641417,11.0,9.38,11.338461538461539,0.84,99.46
2022-02-11,Mizoram,574,6,568,7172,545,73,8.0,0,1.3,645461,5439,641985,41.92,5.62,5.516923076923077,0.84,99.46
2022-02-12,Mizoram,1327,9,1325,16993,4217,1525,7.81,0,1.3,646788,5448,643310,324.38,117.31,13.071538461538461,0.84,99.46
2022-02-13,Mizoram,510,3,504,6290,954,557,8.11,3,1.3,647298,5451,643814,73.38,42.85,4.838461538461538,0.84,99.46
2022-02-14,Mizoram,1085,11,1079,13340,3646,1039,8.13,0,1.3,648383,5462,644893,280.46,79.92,10.261538461538462,0.84,99.46
2022-02-15,Mizoram,651,3,647,7913,2038,910,8.23,1,1.3,649034,5465,645540,156.77,70.0,6.086923076923077,0.84,99.46
2022-02-16,Mizoram,1188,6,1183,15295,2734,2309,7.77,0,1.3,650222,5471,646723,210.31,177.62,11.765384615384615,0.84,99.46
2022-02-17,Mizoram,474,6,467,5794,2020,1501,8.18,1,1.3,650696,5477,647190,155.38,115.46,4.4569230769230765,0.84,99.46
2022-02-18,Mizoram,524,5,523,6757,3979,1733,7.75,0,1.3,651220,5482,647713,306.08,133.31,5.197692307692308,0.84,99.46
2022-02-19,Mizoram,491,3,488,6568,254,118,7.48,0,1.3,651711,5485,648201,19.54,9.08,5.052307692307692,0.84,99.46
2022-02-20,Mizoram,1359,15,1352,17189,320,68,7.91,0,1.3,653070,5500,649553,24.62,5.23,13.222307692307693,0.84,99.46
2022-02-21,Mizoram,687,8,687,9009,1633,721,7.63,0,1.3,653757,5508,650240,125.62,55.46,6.93,0.84,99.46
2022-02-22,Mizoram,1209,15,1206,15592,454,433,7.75,0,1.3,654966,5523,651446,34.92,33.31,11.993846153846153,0.84,99.46
2022-02-23,Mizoram,806,9,797,10374,2312,1555,7.77,0,1.3,655772,5532,652243,177.85,119.62,7.98,0.84,99.46
2022-02-24,Mizoram,304,2,295,3845,664,156,7.91,7,1.3,656076,5534,652538,51.08,12.0,2.957692307692308,0.84,99.46
2022-02-25,Mizoram,351,2,345,4515,3144,819,7.77,4,1.3,656427,5536,652883,241.85,63.0,3.473076923076923,0.84,99.46
2022-02-26,Mizoram,1462,5,1458,17987,3619,2541,8.13,0,1.3,657889,5541,654341,278.38,195.46,13.836153846153847,0.84,99.46
2022-02-27,Mizoram,304,2,302,3613,3592,3579,8.41,0,1.3,658193,5543,654643,276.31,275.31,2.7792307692307694,0.84,99.46
2022-02-28,Mizoram,941,8,936,11897,3356,2863,7.91,0,1.3,659134,5551,655579,258.15,220.23,9.151538461538461,0.84,99.46
2022-03-01,Mizoram,459,1,457,5714,2838,571,8.03,1,1.3,659593,5552,656036,218.31,43.92,4.395384615384615,0.84,99.46
2022-03-02,Mizoram,175,2,172,2024,4810,2542,8.65,1,1.3,659768,5554,656208,370.0,195.54,1.5569230769230769,0.84,99.46
2022-03-03,Mizoram,1445,9,1440,18525,3953,1849,7.8,0,1.3,661213,5563,657648,304.08,142.23,14.25,0.84,99.46
2022-03-04,Mizoram,71,0,62,919,1362,1195,7.73,9,1.3,661284,5563,657710,104.77,91.92,0.7069230769230769,0.84,99.46
2022-03-05,Mizoram,375,2,367,4643,543,316,8.08,6,1.3,661659,5565,658077,41.77,24.31,3.5715384615384616,0.84,99.46
2022-03-06,Mizoram,1365,14,1365,17100,4403,3705,7.98,0,1.3,663024,5579,659442,338.69,285.0,13.153846153846153,0.84,99.46
2022-03-07,Mizoram,1417,4,1409,17674,3312,1140,8.02,4,1.3,664441,5583,660851,254.77,87.69,13.595384615384615,0.84,99.46
2022-03-08,Mizoram,334,4,332,4198,1554,1508,7.96,0,1.3,664775,5587,661183,119.54,116.0,3.229230769230769,0.84,99.46
2022-03-09,Mizoram,459,3,459,6094,4446,3901,7.53,0,1.3,665234,5590,661642,342.0,300.08,4.687692307692307,0.84,99.46
2022-03-10,Mizoram,981,11,973,12412,3949,3147,7.9,0,1.3,666215,5601,662615,303.77,242.08,9.547692307692307,0.84,99.46
2022-03-11,Mizoram,878,7,870,10694,431,246,8.21,1,1.3,667093,5608,663485,33.15,18.92,8.226153846153846,0.84,99.46
2022-03-12,Mizoram,673,5,672,8182,3650,3461,8.23,0,1.3,667766,5613,664157,280.77,266.23,6.293846153846154,0.84,99.46
2022-03-13,Mizoram,854,12,852,10433,3047,2276,8.19,0,1.3,668620,5625,665009,234.38,175.08,8.025384615384615,0.84,99.46
2022-03-14,Mizoram,1418,9,1409,17995,4462,2398,7.88,0,1.3,670038,5634,666418,343.23,184.46,13.842307692307692,0.84,99.46
2022-03-15,Mizoram,111,1,107,1496,1706,1296,7.42,3,1.3,670149,5635,666525,131.23,99.69,1.1507692307692308,0.84,99.46
2022-03-16,Mizoram,59,0,59,698,2913,2080,8.45,0,1.3,670208,5635,666584,224.08,160.0,0.536923076923077,0.84,99.46
2022-03-17,Mizoram,215,2,210,2479,2622,1625,8.67,3,1.3,670423,5637,666794,201.69,125.0,1.906923076923077,0.84,99.46
2022-03-18,Mizoram,1044,3,1042,13401,1515,119,7.79,0,1.3,671467,5640,667836,116.54,9.15,10.308461538461538,0.84,99.46
2022-03-19,Mizoram,134,1,130,1724,3688,462,7.77,3,1.3,671601,5641,667966,283.69,35.54,1.3261538461538462,0.84,99.46
2022-03-20,Mizoram,37,0,34,699,1402,1314,5.29,3,1.3,671638,5641,668000,107.85,101.08,0.5376923076923077,0.84,99.46
2022-03-21,Mizoram,729,6,722,9229,4236,3674,7.9,1,1.3,672367,5647,668722,325.85,282.62,7.099230769230769,0.84,99.46
2022-03-22,Mizoram,922,6,921,11710,3954,3377,7.87,0,1.3,673289,5653,669643,304.15,259.77,9.007692307692308,0.84,99.46
2022-03-23,Mizoram,628,8,621,7865,2401,1693,7.98,0,1.3,673917,5661,670264,184.69,130.23,6.05,0.84,99.46
2022-03-24,Mizoram,385,3,379,4667,1049,787,8.25,3,1.3,674302,5664,670643,80.69,60.54,3.59,0.84,99.46
2022-03-25,Mizoram,1431,8,1427,17494,3647,3294,8.18,0,1.3,675733,5672,672070,280.54,253.38,13.456923076923077,0.84,99.46
2022-03-26,Mizoram,328,1,327,4154,4157,2872,7.9,0,1.3,676061,5673,672397,319.77,220.92,3.1953846153846155,0.84,99.46
2022-03-27,Mizoram,1136,10,1128,14771,3196,13,7.69,0,1.3,677197,5683,673525,245.85,1.0,11.362307692307692,0.84,99.46
2022-03-28,Mizoram,126,1,119,1415,2221,1389,8.9,6,1.3,677323,5684,673644,170.85,106.85,1.0884615384615384,0.84,99.46
2022-03-29,Mizoram,1491,19,1487,18828,1007,969,7.92,0,1.3,678814,5703,675131,77.46,74.54,14.483076923076924,0.84,99.46
2022-03-30,Mizoram,710,6,708,8643,3629,1268,8.21,0,1.3,679524,5709,675839,279.15,97.54,6.648461538461539,0.84,99.46
2022-03-31,Mizoram,241,2,236,3156,831,116,7.64,3,1.3,679765,5711,676075,63.92,8.92,2.4276923076923076,0.84,99.46
2022-04-01,Mizoram,573,1,568,6815,2727,532,8.41,4,1.3,680338,5712,676643,209.77,40.92,5.242307692307692,0.84,99.46
2022-04-02,Mizoram,860,4,858,10551,1914,1227,8.15,0,1.3,681198,5716,677501,147.23,94.38,8.116153846153846,0.84,99.46
2022-04-03,Mizoram,259,1,258,3257,557,47,7.95,0,1.3,681457,5717,677759,42.85,3.62,2.5053846153846155,0.84,99.46
2022-04-04,Mizoram,83,0,81,955,1450,1387,8.69,2,1.3,681540,5717,677840,111.54,106.69,0.7346153846153847,0.84,99.46
2022-04-05,Mizoram,255,1,255,3255,3456,2947,7.83,0,1.3,681795,5718,678095,265.85,226.69,2.503846153846154,0.84,99.46
2022-04-06,Mizoram,42,0,33,539,4366,2185,7.79,9,1.3,681837,5718,678128,335.85,168.08,0.4146153846153846,0.84,99.46
2022-04-07,Mizoram,830,4,821,10273,1653,35,8.08,5,1.3,682667,5722,678949,127.15,2.69,7.9023076923076925,0.84,99.46
2022-04-08,Mizoram,64,0,56,664,3318,2392,9.64,8,1.3,682731,5722,679005,255.23,184.0,0.5107692307692308,0.84,99.45
2022-04-09,Mizoram,141,1,140,1653,3547,1986,8.53,0,1.3,682872,5723,679145,272.85,152.77,1.2715384615384615,0.84,99.45
2022-04-10,Mizoram,838,4,831,10257,1751,1694,8.17,3,1.3,683710,5727,679976,134.69,130.31,7.89,0.84,99.45
2022-04-11,Mizoram,737,6,735,9161,293,32,8.04,0,1.3,684447,5733,680711,22.54,2.46,7.046923076923077,0.84,99.45
2022-04-12,Mizoram,639,4,631,8234,1896,1271,7.76,4,1.3,685086,5737,681342,145.85,97.77,6.333846153846154,0.84,99.45
2022-04-13,Mizoram,591,5,584,7658,119,70,7.72,2,1.3,685677,5742,681926,9.15,5.38,5.890769230769231,0.84,99.45
2022-04-14,Mizoram,69,0,62,542,3557,1926,12.73,7,1.3,685746,5742,681988,273.62,148.15,0.4169230769230769,0.84,99.45
2022-04-15,Mizoram,1523,12,1515,19031,3305,3232,8.0,0,1.3,687269,5754,683503,254.23,248.62,14.63923076923077,0.84,99.45
2022-04-16,Mizoram,1523,8,1522,18951,447,437,8.04,0,1.3,688792,5762,685025,34.38,33.62,14.577692307692308,0.84,99.45
2022-04-17,Mizoram,576,5,567,7236,3385,885,7.96,4,1.3,689368,5767,685592,260.38,68.08,5.5661538461538465,0.84,99.45
2022-04-18,Mizoram,632,2,631,8396,1740,1007,7.53,0,1.3,690000,5769,686223,133.85,77.46,6.458461538461538,0.84,99.45
2022-04-19,Mizoram,1359,15,1350,16807,1010,30,8.09,0,1.3,691359,5784,687573,77.69,2.31,12.928461538461539,0.84,99.45
2022-04-20,Mizoram,181,0,173,2323,3807,1472,7.79,8,1.3,691540,5784,687746,292.85,113.23,1.7869230769230768,0.84,99.45
2022-04-21,Mizoram,589,4,582,6821,3558,145,8.64,3,1.3,692129,5788,688328,273.69,11.15,5.246923076923077,0.84,99.45
2022-04-22,Mizoram,1124,12,1119,14195,4317,3437,7.92,0,1.3,693253,5800,689447,332.08,264.38,10.919230769230769,0.84,99.45
2022-04-23,Mizoram,593,2,592,7344,4119,149,8.07,0,1.3,693846,5802,690039,316.85,11.46,5.649230769230769,0.84,99.45
2022-04-24,Mizoram,675,7,668,8258,2655,2193,8.17,0,1.3,694521,5809,690707,204.23,168.69,6.352307692307693,0.84,99.45
2022-04-25,Mizoram,893,6,889,10820,3560,3452,8.25,0,1.3,695414,5815,691596,273.85,265.54,8.323076923076924,0.84,99.45
2022-04-26,Mizoram,1004,12,996,12763,1167,323,7.87,0,1.3,696418,5827,692592,89.77,24.85,9.817692307692308,0.84,99.45
2022-04-27,Mizoram,378,5,373,4379,2750,186,8.63,0,1.3,696796,5832,692965,211.54,14.31,3.3684615384615384,0.84,99.45
2022-04-28,Mizoram,1291,15,1283,15880,1619,793,8.13,0,1.3,698087,5847,694248,124.54,61.0,12.215384615384615,0.84,99.45
2022-04-29,Mizoram,387,3,381,4925,239,175,7.86,3,1.3,698474,5850,694629,18.38,13.46,3.7884615384615383,0.84,99.45
2022-04-30,Mizoram,1490,11,1481,18331,450,418,8.13,0,1.3,699964,5861,696110,34.62,32.15,14.100769230769231,0.84,99.45
2022-05-01,Mizoram,1170,8,1170,14423,2932,1154,8.11,0,1.3,701134,5869,697280,225.54,88.77,11.094615384615384,0.84,99.45
2022-05-02,Mizoram,512,2,511,6804,893,461,7.52,0,1.3,701646,5871,697791,68.69,35.46,5.233846153846154,0.84,99.45
2022-05-03,Mizoram,1100,15,1098,13542,387,71,8.12,0,1.3,702746,5886,698889,29.77,5.46,10.416923076923077,0.84,99.45
2022-05-04,Mizoram,495,4,487,6337,4115,1787,7.81,4,1.3,703241,5890,699376,316.54,137.46,4.874615384615384,0.84,99.45
2022-05-05,Mizoram,1602,7,1594,19924,2058,1146,8.04,1,1.3,704843,5897,700970,158.31,88.15,15.326153846153845,0.84,99.45
2022-05-06,Mizoram,605,5,601,7323,773,620,8.26,0,1.3,705448,5902,701571,59.46,47.69,5.633076923076923,0.84,99.45
2022-05-07,Mizoram,597,5,597,7558,4622,4622,7.9,0,1.3,706045,5907,702168,355.54,355.54,5.813846153846153,0.84,99.45
2022-05-08,Mizoram,1584,11,1581,19745,1265,940,8.02,0,1.3,707629,5918,703749,97.31,72.31,15.188461538461539,0.84,99.45
2022-05-09,Mizoram,478,6,473,5773,1963,1305,8.28,0,1.3,708107,5924,704222,151.0,100.38,4.440769230769231,0.84,99.45
2022-05-10,Mizoram,109,0,100,1468,1774,845,7.43,9,1.3,708216,5924,704322,136.46,65.0,1.1292307692307693,0.84,99.45
2022-05-11,Mizoram,1367,10,1361,17332,3531,368,7.89,0,1.3,709583,5934,705683,271.62,28.31,13.332307692307692,0.84,99.45
2022-05-12,Mizoram,165,1,157,2128,281,8,7.75,7,1.3,709748,5935,705840,21.62,0.62,1.636923076923077,0.84,99.45
2022-05-13,Mizoram,1450,7,1450,18526,3945,408,7.83,0,1.3,711198,5942,707290,303.46,31.38,14.250769230769231,0.84,99.45
2022-05-14,Mizoram,1073,15,1067,13189,4411,1666,8.14,0,1.3,712271,5957,708357,339.31,128.15,10.145384615384616,0.84,99.45
2022-05-15,Mizoram,730,5,721,9246,2305,2248,7.9,4,1.3,713001,5962,709078,177.31,172.92,7.112307692307692,0.84,99.45
2022-05-16,Mizoram,381,2,377,5039,3888,2016,7.56,2,1.3,713382,5964,709455,299.08,155.08,3.876153846153846,0.84,99.45
2022-05-17,Mizoram,1065,10,1062,13421,4496,944,7.94,0,1.3,714447,5974,710517,345.85,72.62,10.323846153846153,0.84,99.45
2022-05-18,Mizoram,1556,15,1551,19337,909,462,8.05,0,1.3,716003,5989,712068,69.92,35.54,14.874615384615385,0.84,99.45
2022-05-19,Mizoram,1007,7,999,12544,2618,2399,8.03,1,1.3,717010,5996,713067,201.38,184.54,9.649230769230769,0.84,99.45
2022-05-20,Mizoram,1090,15,1088,13503,540,249,8.07,0,1.3,718100,6011,714155,41.54,19.15,10.386923076923077,0.84,99.45
2022-05-21,Mizoram,1593,22,1592,19769,2326,437,8.06,0,1.3,719693,6033,715747,178.92,33.62,15.206923076923077,0.84,99.45
2022-05-22,Mizoram,309,4,301,4006,3591,206,7.71,4,1.3,720002,6037,716048,276.23,15.85,3.0815384615384613,0.84,99.45
2022-05-23,Mizoram,230,2,225,2607,4312,266,8.82,3,1.3,720232,6039,716273,331.69,20.46,2.0053846153846155,0.84,99.45
2022-05-24,Mizoram,1162,7,1161,14584,645,457,7.97,0,1.3,721394,6046,717434,49.62,35.15,11.218461538461538,0.84,99.45
2022-05-25,Mizoram,744,7,739,9737,3393,1838,7.64,0,1.3,722138,6053,718173,261.0,141.38,7.49,0.84,99.45
2022-05-26,Mizoram,265,1,263,3852,1309,483,6.88,1,1.3,722403,6054,718436,100.69,37.15,2.963076923076923,0.84,99.45
2022-05-27,Mizoram,1040,6,1037,12607,3381,1295,8.25,0,1.3,723443,6060,719473,260.08,99.62,9.697692307692307,0.84,99.45
2022-05-28,Mizoram,888,5,879,11100,4962,2783,8.0,4,1.3,724331,6065,720352,381.69,214.08,8.538461538461538,0.84,99.45
2022-05-29,Mizoram,89,1,80,916,1329,557,9.72,8,1.3,724420,6066,720432,102.23,42.85,0.7046153846153846,0.84,99.45
2022-05-30,Mizoram,977,4,974,12184,37,26,8.02,0,1.3,725397,6070,721406,2.85,2.0,9.372307692307693,0.84,99.45
2022-05-31,Mizoram,216,1,216,2334,2422,87,9.25,0,1.3,725613,6071,721622,186.31,6.69,1.7953846153846154,0.84,99.45
2022-06-01,Mizoram,698,9,691,8899,2546,852,7.84,0,1.3,726311,6080,722313,195.85,65.54,6.845384615384615,0.84,99.45
2022-06-02,Mizoram,1244,6,1242,15927,1121,352,7.81,0,1.3,727555,6086,723555,86.23,27.08,12.25153846153846,0.84,99.45
2022-06-03,Mizoram,179,2,174,1838,3418,175,9.74,3,1.3,727734,6088,723729,262.92,13.46,1.4138461538461538,0.84,99.45
2022-06-04,Mizoram,415,2,415,5584,2054,1493,7.43,0,1.3,728149,6090,724144,158.0,114.85,4.295384615384616,0.84,99.45
2022-06-05,Mizoram,1135,3,1127,14171,588,499,8.01,5,1.3,729284,6093,725271,45.23,38.38,10.900769230769232,0.84,99.45
2022-06-06,Mizoram,764,5,764,9490,1476,526,8.05,0,1.3,730048,6098,726035,113.54,40.46,7.3,0.84,99.45
2022-06-07,Mizoram,1570,22,1563,19678,1359,98,7.98,0,1.3,731618,6120,727598,104.54,7.54,15.136923076923077,0.84,99.45
2022-06-08,Mizoram,135,1,132,1756,1749,806,7.69,2,1.3,731753,6121,727730,134.54,62.0,1.3507692307692307,0.84,99.45
2022-06-09,Mizoram,449,6,444,5527,2072,1710,8.12,0,1.3,732202,6127,728174,159.38,131.54,4.251538461538462,0.84,99.45
2022-06-10,Mizoram,56,0,51,829,582,294,6.76,5,1.3,732258,6127,728225,44.77,22.62,0.6376923076923077,0.84,99.45
2022-06-11,Mizoram,130,1,126,1683,2878,2706,7.72,3,1.3,732388,6128,728351,221.38,208.15,1.2946153846153847,0.84,99.45
2022-06-12,Mizoram,1214,14,1210,15143,3561,709,8.02,0,1.3,733602,6142,729561,273.92,54.54,11.648461538461538,0.84,99.45
2022-06-13,Mizoram,1031,7,1028,12529,600,177,8.23,0,1.3,734633,6149,730589,46.15,13.62,9.637692307692308,0.84,99.45
2022-06-14,Mizoram,888,7,885,10957,2665,174,8.1,0,1.3,735521,6156,731474,205.0,13.38,8.428461538461539,0.84,99.45
2022-06-15,Mizoram,285,3,281,3484,2765,291,8.18,1,1.3,735806,6159,731755,212.69,22.38,2.68,0.84,99.45
2022-06-16,Mizoram,1515,14,1511,18591,4711,1686,8.15,0,1.3,737321,6173,733266,362.38,129.69,14.30076923076923,0.84,99.45
2022-06-17,Mizoram,1183,16,1175,14592,3742,1329,8.11,0,1.3,738504,6189,734441,287.85,102.23,11.224615384615385,0.84,99.45
2022-06-18,Mizoram,1420,18,1413,18030,4847,3078,7.88,0,1.3,739924,6207,735854,372.85,236.77,13.86923076923077,0.84,99.45
2022-06-19,Mizoram,1204,16,1199,15081,1839,1817,7.98,0,1.3,741128,6223,737053,141.46,139.77,11.600769230769231,0.84,99.45
2022-06-20,Mizoram,1123,10,1114,13525,4138,4041,8.3,0,1.3,742251,6233,738167,318.31,310.85,10.403846153846153,0.84,99.45
2022-06-21,Mizoram,416,4,408,5122,4515,2597,8.12,4,1.3,742667,6237,738575,347.31,199.77,3.94,0.84,99.45
2022-06-22,Mizoram,1316,12,1311,16302,1300,1226,8.07,0,1.3,743983,6249,739886,100.0,94.31,12.54,0.84,99.45
2022-06-23,Mizoram,1329,19,1322,16199,3513,1008,8.2,0,1.3,745312,6268,741208,270.23,77.54,12.46076923076923,0.84,99.45
2022-06-24,Mizoram,418,3,416,4927,17,9,8.48,0,1.3,745730,6271,741624,1.31,0.69,3.79,0.84,99.45
2022-06-25,Mizoram,545,6,542,7079,4625,1008,7.7,0,1.3,746275,6277,742166,355.77,77.54,5.445384615384615,0.84,99.45
2022-06-26,Mizoram,902,8,902,10651,4367,410,8.47,0,1.3,747177,6285,743068,335.92,31.54,8.193076923076923,0.84,99.45
2022-06-27,Mizoram,210,1,203,2822,325,66,7.44,6,1.3,747387,6286,743271,25.0,5.08,2.170769230769231,0.84,99.45
2022-06-28,Mizoram,1185,7,1178,14746,2805,2161,8.04,0,1.3,748572,6293,744449,215.77,166.23,11.343076923076923,0.84,99.45
2022-06-29,Mizoram,340,4,337,4653,406,173,7.31,0,1.3,748912,6297,744786,31.23,13.31,3.579230769230769,0.84,99.45
2022-06-30,Mizoram,1293,12,1286,15824,929,908,8.17,0,1.3,750205,6309,746072,71.46,69.85,12.172307692307692,0.84,99.45
2022-07-01,Mizoram,619,2,615,7921,4480,2228,7.81,2,1.3,750824,6311,746687,344.62,171.38,6.093076923076923,0.84,99.45
2022-07-02,Mizoram,1340,7,1334,16763,4514,719,7.99,0,1.3,752164,6318,748021,347.23,55.31,12.894615384615385,0.84,99.45
2022-07-03,Mizoram,276,3,271,3297,780,476,8.37,2,1.3,752440,6321,748292,60.0,36.62,2.536153846153846,0.84,99.45
2022-07-04,Mizoram,389,4,386,5095,2340,1031,7.63,0,1.3,752829,6325,748678,180.0,79.31,3.919230769230769,0.84,99.45
2022-07-05,Mizoram,292,3,283,3108,2202,319,9.4,6,1.3,753121,6328,748961,169.38,24.54,2.390769230769231,0.84,99.45
2022-07-06,Mizoram,1452,13,1451,17795,2977,2381,8.16,0,1.3,754573,6341,750412,229.0,183.15,13.688461538461539,0.84,99.45
2022-07-07,Mizoram,1571,15,1571,19716,306,219,7.97,0,1.3,756144,6356,751983,23.54,16.85,15.166153846153847,0.84,99.45
2022-07-08,Mizoram,654,8,653,8108,4820,3359,8.07,0,1.3,756798,6364,752636,370.77,258.38,6.236923076923077,0.84,99.45
2022-07-09,Mizoram,1284,13,1282,15897,3224,1902,8.08,0,1.3,758082,6377,753918,248.0,146.31,12.228461538461538,0.84,99.45
2022-07-10,Mizoram,373,1,364,4290,1365,498,8.69,8,1.3,758455,6378,754282,105.0,38.31,3.3,0.84,99.45
2022-07-11,Mizoram,1048,5,1040,13236,4399,3850,7.92,3,1.3,759503,6383,755322,338.38,296.15,10.181538461538462,0.84,99.45
2022-07-12,Mizoram,892,5,892,11104,853,212,8.03,0,1.3,760395,6388,756214,65.62,16.31,8.541538461538462,0.84,99.45
2022-07-13,Mizoram,893,11,885,11050,4027,1637,8.08,0,1.3,761288,6399,757099,309.77,125.92,8.5,0.84,99.45
2022-07-14,Mizoram,1415,17,1407,17575,4728,2313,8.05,0,1.3,762703,6416,758506,363.69,177.92,13.51923076923077,0.84,99.45
2022-07-15,Mizoram,478,4,477,6199,220,62,7.71,0,1.3,763181,6420,758983,16.92,4.77,4.768461538461539,0.84,99.45
2022-07-16,Mizoram,519,4,513,6681,2442,427,7.77,2,1.3,763700,6424,759496,187.85,32.85,5.139230769230769,0.84,99.45
2022-07-17,Mizoram,74,0,69,957,1557,1489,7.73,5,1.3,763774,6424,759565,119.77,114.54,0.7361538461538462,0.84,99.45
2022-07-18,Mizoram,459,3,450,5534,1005,838,8.29,6,1.3,764233,6427,760015,77.31,64.46,4.256923076923077,0.84,99.45
2022-07-19,Mizoram,543,2,541,6445,4177,2108,8.43,0,1.3,764776,6429,760556,321.31,162.15,4.957692307692308,0.84,99.45
2022-07-20,Mizoram,847,7,841,10577,156,150,8.01,0,1.3,765623,6436,761397,12.0,11.54,8.136153846153846,0.84,99.45
2022-07-21,Mizoram,1403,20,1396,17421,4650,2722,8.05,0,1.3,767026,6456,762793,357.69,209.38,13.400769230769232,0.84,99.45
2022-07-22,Mizoram,820,8,820,9963,2801,1198,8.23,0,1.3,767846,6464,763613,215.46,92.15,7.663846153846154,0.84,99.45
2022-07-23,Mizoram,926,6,918,11891,4406,195,7.79,2,1.3,768772,6470,764531,338.92,15.0,9.146923076923077,0.84,99.45
2022-07-24,Mizoram,970,13,963,11849,1566,16,8.19,0,1.3,769742,6483,765494,120.46,1.23,9.114615384615385,0.84,99.45
2022-07-25,Mizoram,350,1,350,4570,4542,1438,7.66,0,1.3,770092,6484,765844,349.38,110.62,3.5153846153846153,0.84,99.45
2022-07-26,Mizoram,875,3,872,11095,709,565,7.89,0,1.3,770967,6487,766716,54.54,43.46,8.534615384615385,0.84,99.45
2022-07-27,Mizoram,1288,7,1285,16393,4536,484,7.86,0,1.3,772255,6494,768001,348.92,37.23,12.61,0.84,99.45
2022-07-28,Mizoram,1513,10,1507,19150,2034,1040,7.9,0,1.3,773768,6504,769508,156.46,80.0,14.73076923076923,0.84,99.45
2022-07-29,Mizoram,906,11,901,11224,2162,499,8.07,0,1.3,774674,6515,770409,166.31,38.38,8.633846153846154,0.84,99.45
2022-07-30,Mizoram,803,9,794,10172,4983,2849,7.89,0,1.3,775477,6524,771203,383.31,219.15,7.8246153846153845,0.84,99.45
2022-07-31,Mizoram,1000,10,998,12374,1820,17,8.08,0,1.3,776477,6534,772201,140.0,1.31,9.518461538461539,0.84,99.45
2022-08-01,Mizoram,1354,6,1346,16998,1950,1849,7.97,2,1.3,777831,6540,773547,150.0,142.23,13.075384615384616,0.84,99.45
2022-08-02,Mizoram,103,1,100,1686,1724,300,6.11,2,1.3,777934,6541,773647,132.62,23.08,1.2969230769230768,0.84,99.45
2022-08-03,Mizoram,391,1,388,5277,760,16,7.41,2,1.3,778325,6542,774035,58.46,1.23,4.059230769230769,0.84,99.45
2022-08-04,Mizoram,561,5,558,7119,2555,563,7.88,0,1.3,778886,6547,774593,196.54,43.31,5.476153846153847,0.84,99.45
2022-08-05,Mizoram,1229,12,1226,15063,3818,1551,8.16,0,1.3,780115,6559,775819,293.69,119.31,11.586923076923076,0.84,99.45
2022-08-06,Mizoram,226,1,226,3448,3730,1243,6.55,0,1.3,780341,6560,776045,286.92,95.62,2.6523076923076925,0.84,99.45
2022-08-07,Mizoram,1036,10,1028,12817,1418,162,8.08,0,1.3,781377,6570,777073,109.08,12.46,9.85923076923077,0.84,99.45
2022-08-08,Mizoram,386,5,382,4754,756,384,8.12,0,1.3,781763,6575,777455,58.15,29.54,3.6569230769230767,0.84,99.45
2022-08-09,Mizoram,1122,11,1114,13858,3323,2418,8.1,0,1.3,782885,6586,778569,255.62,186.0,10.66,0.84,99.45
2022-08-10,Mizoram,541,7,536,6581,2710,2270,8.22,0,1.3,783426,6593,779105,208.46,174.62,5.062307692307693,0.84,99.45
2022-08-11,Mizoram,571,4,563,6714,4089,3302,8.5,4,1.3,783997,6597,779668,314.54,254.0,5.164615384615384,0.84,99.45
2022-08-12,Mizoram,713,2,710,8688,4656,828,8.21,1,1.3,784710,6599,780378,358.15,63.69,6.683076923076923,0.84,99.45
2022-08-13,Mizoram,1462,12,1461,18277,772,199,8.0,0,1.3,786172,6611,781839,59.38,15.31,14.05923076923077,0.84,99.45
2022-08-14,Mizoram,660,6,651,8408,1455,1029,7.85,3,1.3,786832,6617,782490,111.92,79.15,6.467692307692308,0.84,99.45
2022-08-15,Mizoram,1304,5,1302,16081,963,667,8.11,0,1.3,788136,6622,783792,74.08,51.31,12.37,0.84,99.45
2022-08-16,Mizoram,1175,10,1169,14376,2937,1047,8.17,0,1.3,789311,6632,784961,225.92,80.54,11.058461538461538,0.84,99.45
2022-08-17,Mizoram,1552,10,1548,19703,4914,1382,7.88,0,1.3,790863,6642,786509,378.0,106.31,15.156153846153845,0.84,99.45
2022-08-18,Mizoram,333,4,324,4300,2731,2454,7.74,5,1.3,791196,6646,786833,210.08,188.77,3.3076923076923075,0.84,99.45
2022-08-19,Mizoram,595,6,590,7831,1736,76,7.6,0,1.3,791791,6652,787423,133.54,5.85,6.023846153846153,0.84,99.45
2022-08-20,Mizoram,406,3,401,4944,95,69,8.21,2,1.3,792197,6655,787824,7.31,5.31,3.8030769230769232,0.84,99.45
2022-08-21,Mizoram,941,5,932,11734,4546,1232,8.02,4,1.3,793138,6660,788756,349.69,94.77,9.026153846153846,0.84,99.45
2022-08-22,Mizoram,186,1,177,2227,2398,1139,8.35,8,1.3,793324,6661,788933,184.46,87.62,1.7130769230769232,0.84,99.45
2022-08-23,Mizoram,508,3,508,6490,1240,61,7.83,0,1.3,793832,6664,789441,95.38,4.69,4.992307692307692,0.84,99.45
2022-08-24,Mizoram,1438,16,1434,18253,175,167,7.88,0,1.3,795270,6680,790875,13.46,12.85,14.04076923076923,0.84,99.45
2022-08-25,Mizoram,1140,7,1133,14810,3641,1999,7.7,0,1.3,796410,6687,792008,280.08,153.77,11.392307692307693,0.84,99.45
2022-08-26,Mizoram,885,5,880,10964,2532,363,8.07,0,1.3,797295,6692,792888,194.77,27.92,8.433846153846154,0.84,99.45
2022-08-27,Mizoram,1565,22,1561,19222,3574,3210,8.14,0,1.3,798860,6714,794449,274.92,246.92,14.786153846153846,0.84,99.45
2022-08-28,Mizoram,271,3,264,3403,140,125,7.96,4,1.3,799131,6717,794713,10.77,9.62,2.6176923076923075,0.84,99.45
2022-08-29,Mizoram,186,2,184,2431,462,260,7.65,0,1.3,799317,6719,794897,35.54,20.0,1.87,0.84,99.45
2022-08-30,Mizoram,683,3,683,8724,2668,146,7.83,0,1.3,800000,6722,795580,205.23,11.23,6.71076923076923,0.84,99.45
2022-08-31,Mizoram,183,0,181,2426,3446,835,7.54,2,1.3,800183,6722,795761,265.08,64.23,1.866153846153846,0.84,99.45
2022-09-01,Mizoram,1000,11,994,12654,2331,2327,7.9,0,1.3,801183,6733,796755,179.31,179.0,9.733846153846153,0.84,99.45
2022-09-02,Mizoram,1388,8,1379,17345,1360,1163,8.0,1,1.3,802571,6741,798134,104.62,89.46,13.342307692307692,0.84,99.45
2022-09-03,Mizoram,1524,14,1523,19094,3004,2542,7.98,0,1.3,804095,6755,799657,231.08,195.54,14.687692307692307,0.84,99.45
2022-09-04,Mizoram,1482,12,1482,18283,970,629,8.11,0,1.3,805577,6767,801139,74.62,48.38,14.063846153846153,0.84,99.45
2022-09-05,Mizoram,869,6,861,10789,4632,3003,8.05,2,1.3,806446,6773,802000,356.31,231.0,8.29923076923077,0.84,99.45
2022-09-06,Mizoram,1428,6,1423,17794,2397,657,8.03,0,1.3,807874,6779,803423,184.38,50.54,13.687692307692307,0.84,99.45
2022-09-07,Mizoram,246,3,237,2812,1950,934,8.75,6,1.3,808120,6782,803660,150.0,71.85,2.163076923076923,0.84,99.45
2022-09-08,Mizoram,808,2,801,10245,2537,2206,7.89,5,1.3,808928,6784,804461,195.15,169.69,7.880769230769231,0.84,99.45
2022-09-09,Mizoram,1439,14,1436,17878,2744,1688,8.05,0,1.3,810367,6798,805897,211.08,129.85,13.752307692307692,0.84,99.45
2022-09-10,Mizoram,964,13,959,12055,1433,600,8.0,0,1.3,811331,6811,806856,110.23,46.15,9.273076923076923,0.84,99.45
2022-09-11,Mizoram,641,1,639,8155,4681,1977,7.86,1,1.3,811972,6812,807495,360.08,152.08,6.273076923076923,0.84,99.45
2022-09-12,Mizoram,117,0,113,1549,213,128,7.55,4,1.3,812089,6812,807608,16.38,9.85,1.1915384615384614,0.84,99.45
2022-09-13,Mizoram,576,4,573,7232,2711,2107,7.96,0,1.3,812665,6816,808181,208.54,162.08,5.563076923076923,0.84,99.45
2022-09-14,Mizoram,1493,12,1492,18241,371,134,8.18,0,1.3,814158,6828,809673,28.54,10.31,14.031538461538462,0.84,99.45
2022-09-15,Mizoram,740,4,734,9165,2757,146,8.07,2,1.3,814898,6832,810407,212.08,11.23,7.05,0.84,99.45
2022-09-16,Mizoram,1391,13,1388,16770,4998,738,8.29,0,1.3,816289,6845,811795,384.46,56.77,12.9,0.84,99.45
2022-09-17,Mizoram,284,1,282,3366,4419,3571,8.44,1,1.3,816573,6846,812077,339.92,274.69,2.5892307692307694,0.84,99.45
2022-09-18,Mizoram,337,1,330,4589,4093,353,7.34,6,1.3,816910,6847,812407,314.85,27.15,3.53,0.84,99.45
2022-09-19,Mizoram,1397,4,1392,17644,3008,1314,7.92,1,1.3,818307,6851,813799,231.38,101.08,13.572307692307692,0.84,99.45
2022-09-20,Mizoram,118,0,117,1614,3548,1473,7.31,1,1.3,818425,6851,813916,272.92,113.31,1.2415384615384615,0.84,99.45
2022-09-21,Mizoram,88,0,81,1057,1562,48,8.33,7,1.3,818513,6851,813997,120.15,3.69,0.813076923076923,0.84,99.45
2022-09-22,Mizoram,891,11,889,10897,4646,2687,8.18,0,1.3,819404,6862,814886,357.38,206.69,8.382307692307693,0.84,99.45
2022-09-23,Mizoram,388,1,385,4995,1529,35,7.77,2,1.3,819792,6863,815271,117.62,2.69,3.8423076923076924,0.84,99.45
2022-09-24,Mizoram,416,1,415,4966,1650,74,8.38,0,1.3,820208,6864,815686,126.92,5.69,3.82,0.84,99.45
2022-09-25,Mizoram,1105,11,1105,13483,1411,620,8.2,0,1.3,821313,6875,816791,108.54,47.69,10.371538461538462,0.84,99.45
2022-09-26,Mizoram,118,1,114,1873,1407,527,6.3,3,1.3,821431,6876,816905,108.23,40.54,1.4407692307692308,0.84,99.45
2022-09-27,Mizoram,716,9,708,9297,3232,1059,7.7,0,1.3,822147,6885,817613,248.62,81.46,7.151538461538461,0.84,99.45
2022-09-28,Mizoram,180,0,175,2353,4463,4291,7.65,5,1.3,822327,6885,817788,343.31,330.08,1.81,0.84,99.45
2022-09-29,Mizoram,540,4,535,6689,1937,1922,8.07,1,1.3,822867,6889,818323,149.0,147.85,5.145384615384615,0.84,99.45
2022-09-30,Mizoram,215,2,214,2697,2854,1966,7.97,0,1.3,823082,6891,818537,219.54,151.23,2.0746153846153845,0.84,99.45
2022-10-01,Mizoram,877,4,873,11206,4473,692,7.83,0,1.3,823959,6895,819410,344.08,53.23,8.62,0.84,99.45
2022-10-02,Mizoram,739,10,731,9091,1191,460,8.13,0,1.3,824698,6905,820141,91.62,35.38,6.993076923076923,0.84,99.45
2022-10-03,Mizoram,1023,10,1017,13182,2188,795,7.76,0,1.3,825721,6915,821158,168.31,61.15,10.14,0.84,99.45
2022-10-04,Mizoram,97,0,89,847,1008,598,11.45,8,1.3,825818,6915,821247,77.54,46.0,0.6515384615384615,0.84,99.45
2022-10-05,Mizoram,193,1,190,2482,520,127,7.78,2,1.3,826011,6916,821437,40.0,9.77,1.9092307692307693,0.84,99.45
2022-10-06,Mizoram,378,3,372,4694,723,253,8.05,3,1.3,826389,6919,821809,55.62,19.46,3.6107692307692307,0.84,99.45
2022-10-07,Mizoram,1411,15,1410,17777,1460,966,7.94,0,1.3,827800,6934,823219,112.31,74.31,13.674615384615384,0.84,99.45
2022-10-08,Mizoram,622,2,616,7464,4315,3783,8.33,4,1.3,828422,6936,823835,331.92,291.0,5.741538461538462,0.84,99.45
2022-10-09,Mizoram,1048,6,1045,12710,1105,464,8.25,0,1.3,829470,6942,824880,85.0,35.69,9.776923076923078,0.84,99.45
2022-10-10,Mizoram,388,3,382,5318,4912,1147,7.3,3,1.3,829858,6945,825262,377.85,88.23,4.090769230769231,0.84,99.45
2022-10-11,Mizoram,463,4,456,5856,1425,1000,7.91,3,1.3,830321,6949,825718,109.62,76.92,4.504615384615384,0.84,99.45
2022-10-12,Mizoram,1555,11,1554,19442,2739,1978,8.0,0,1.3,831876,6960,827272,210.69,152.15,14.955384615384615,0.84,99.45
2022-10-13,Mizoram,1254,14,1251,15450,4523,233,8.12,0,1.3,833130,6974,828523,347.92,17.92,11.884615384615385,0.84,99.45
2022-10-14,Mizoram,867,4,862,10456,1999,1152,8.29,1,1.3,833997,6978,829385,153.77,88.62,8.043076923076923,0.84,99.45
2022-10-15,Mizoram,1526,10,1523,19137,1372,1140,7.97,0,1.3,835523,6988,830908,105.54,87.69,14.72076923076923,0.84,99.45
2022-10-16,Mizoram,1427,10,1426,17765,1670,1174,8.03,0,1.3,836950,6998,832334,128.46,90.31,13.665384615384616,0.84,99.45
2022-10-17,Mizoram,1197,14,1188,15193,2365,1316,7.88,0,1.3,838147,7012,833522,181.92,101.23,11.686923076923076,0.84,99.45
2022-10-18,Mizoram,477,3,472,6217,1133,377,7.67,2,1.3,838624,7015,833994,87.15,29.0,4.782307692307692,0.84,99.45
2022-10-19,Mizoram,1327,17,1324,16589,419,91,8.0,0,1.3,839951,7032,835318,32.23,7.0,12.760769230769231,0.84,99.45
2022-10-20,Mizoram,489,2,487,6242,745,124,7.83,0,1.3,840440,7034,835805,57.31,9.54,4.8015384615384615,0.84,99.45
2022-10-21,Mizoram,205,2,203,2625,4421,888,7.81,0,1.3,840645,7036,836008,340.08,68.31,2.019230769230769,0.84,99.45
2022-10-22,Mizoram,191,0,182,2615,685,217,7.3,9,1.3,840836,7036,836190,52.69,16.69,2.0115384615384615,0.84,99.45
2022-10-23,Mizoram,1120,4,1116,13680,1868,303,8.19,0,1.3,841956,7040,837306,143.69,23.31,10.523076923076923,0.84,99.45
2022-10-24,Mizoram,667,4,658,8525,3232,2722,7.82,5,1.3,842623,7044,837964,248.62,209.38,6.5576923076923075,0.84,99.45
2022-10-25,Mizoram,1106,16,1106,14047,1272,201,7.87,0,1.3,843729,7060,839070,97.85,15.46,10.805384615384616,0.84,99.45
2022-10-26,Mizoram,377,1,374,4739,3008,1652,7.96,2,1.3,844106,7061,839444,231.38,127.08,3.6453846153846152,0.84,99.45
2022-10-27,Mizoram,705,3,705,8512,3786,2491,8.28,0,1.3,844811,7064,840149,291.23,191.62,6.547692307692308,0.84,99.45
2022-10-28,Mizoram,285,1,279,3393,1737,1334,8.4,5,1.3,845096,7065,840428,133.62,102.62,2.61,0.84,99.45
2022-10-29,Mizoram,988,5,980,12571,3225,2996,7.86,3,1.3,846084,7070,841408,248.08,230.46,9.67,0.84,99.45
2022-10-30,Mizoram,810,6,810,9547,4418,2204,8.48,0,1.3,846894,7076,842218,339.85,169.54,7.343846153846154,0.84,99.45
2022-10-31,Mizoram,1136,7,1136,13972,782,57,8.13,0,1.3,848030,7083,843354,60.15,4.38,10.747692307692308,0.84,99.45
2022-11-01,Mizoram,1273,12,1269,16111,3822,225,7.9,0,1.3,849303,7095,844623,294.0,17.31,12.393076923076922,0.84,99.45
2022-11-02,Mizoram,336,1,336,3996,4160,3985,8.41,0,1.3,849639,7096,844959,320.0,306.54,3.0738461538461537,0.84,99.45
2022-11-03,Mizoram,1119,15,1114,13965,4855,740,8.01,0,1.3,850758,7111,846073,373.46,56.92,10.742307692307692,0.84,99.45
2022-11-04,Mizoram,273,2,267,3010,1511,439,9.07,4,1.3,851031,7113,846340,116.23,33.77,2.3153846153846156,0.84,99.45
2022-11-05,Mizoram,35,0,32,868,3229,1420,4.03,3,1.3,851066,7113,846372,248.38,109.23,0.6676923076923077,0.84,99.45
2022-11-06,Mizoram,1066,5,1058,13190,3142,1492,8.08,3,1.3,852132,7118,847430,241.69,114.77,10.146153846153846,0.84,99.45
2022-11-07,Mizoram,1139,4,1133,14148,33,2,8.05,2,1.3,853271,7122,848563,2.54,0.15,10.883076923076922,0.83,99.45
2022-11-08,Mizoram,1504,11,1504,18934,4234,1116,7.94,0,1.3,854775,7133,850067,325.69,85.85,14.564615384615385,0.83,99.45
2022-11-09,Mizoram,1397,10,1390,17159,1329,7,8.14,0,1.3,856172,7143,851457,102.23,0.54,13.19923076923077,0.83,99.45
2022-11-10,Mizoram,1507,7,1502,18733,3820,872,8.04,0,1.3,857679,7150,852959,293.85,67.08,14.41,0.83,99.45
2022-11-11,Mizoram,435,5,427,4945,4693,4056,8.8,3,1.3,858114,7155,853386,361.0,312.0,3.8038461538461537,0.83,99.45
2022-11-12,Mizoram,204,0,197,2349,1634,428,8.68,7,1.3,858318,7155,853583,125.69,32.92,1.8069230769230769,0.83,99.45
2022-11-13,Mizoram,276,1,267,4089,3950,1500,6.75,8,1.3,858594,7156,853850,303.85,115.38,3.1453846153846152,0.83,99.45
2022-11-14,Mizoram,607,6,607,7249,2723,17,8.37,0,1.3,859201,7162,854457,209.46,1.31,5.576153846153846,0.83,99.45
2022-11-15,Mizoram,539,2,534,6583,3631,918,8.19,3,1.3,859740,7164,854991,279.31,70.62,5.063846153846153,0.83,99.45
2022-11-16,Mizoram,976,10,970,12509,1741,1205,7.8,0,1.3,860716,7174,855961,133.92,92.69,9.622307692307693,0.83,99.45
2022-11-17,Mizoram,1299,15,1290,16057,879,582,8.09,0,1.3,862015,7189,857251,67.62,44.77,12.351538461538462,0.83,99.45
2022-11-18,Mizoram,701,4,694,8832,4493,3308,7.94,3,1.3,862716,7193,857945,345.62,254.46,6.793846153846154,0.83,99.45
2022-11-19,Mizoram,5,0,0,501,260,66,1.0,5,1.3,862721,7193,857945,20.0,5.08,0.3853846153846154,0.83,99.45
2022-11-20,Mizoram,313,3,308,3866,4971,1505,8.1,2,1.3,863034,7196,858253,382.38,115.77,2.973846153846154,0.83,99.45
2022-11-21,Mizoram,601,8,600,7426,92,11,8.09,0,1.3,863635,7204,858853,7.08,0.85,5.712307692307692,0.83,99.45
2022-11-22,Mizoram,915,11,908,11353,3152,1199,8.06,0,1.3,864550,7215,859761,242.46,92.23,8.733076923076924,0.83,99.45
2022-11-23,Mizoram,251,2,251,3406,3753,1649,7.37,0,1.3,864801,7217,860012,288.69,126.85,2.62,0.83,99.45
2022-11-24,Mizoram,435,6,426,5750,3451,638,7.57,3,1.3,865236,7223,860438,265.46,49.08,4.423076923076923,0.83,99.45
2022-11-25,Mizoram,1133,11,1124,14044,3940,55,8.07,0,1.3,866369,7234,861562,303.08,4.23,10.803076923076922,0.83,99.45
2022-11-26,Mizoram,787,5,782,9036,2488,1194,8.71,0,1.3,867156,7239,862344,191.38,91.85,6.950769230769231,0.83,99.45
2022-11-27,Mizoram,207,1,205,2672,4334,2856,7.75,1,1.3,867363,7240,862549,333.38,219.69,2.0553846153846154,0.83,99.44
2022-11-28,Mizoram,1018,14,1017,12815,1105,907,7.94,0,1.3,868381,7254,863566,85.0,69.77,9.857692307692307,0.84,99.45
2022-11-29,Mizoram,284,3,282,3690,1275,109,7.7,0,1.3,868665,7257,863848,98.08,8.38,2.8384615384615386,0.84,99.45
2022-11-30,Mizoram,1158,9,1152,14534,4518,2954,7.97,0,1.3,869823,7266,865000,347.54,227.23,11.18,0.84,99.45
2022-12-01,Mizoram,777,4,769,10235,86,63,7.59,4,1.3,870600,7270,865769,6.62,4.85,7.873076923076923,0.84,99.45
2022-12-02,Mizoram,279,1,275,3669,1966,1487,7.6,3,1.3,870879,7271,866044,151.23,114.38,2.8223076923076924,0.83,99.44
2022-12-03,Mizoram,1245,12,1242,15734,959,406,7.91,0,1.3,872124,7283,867286,73.77,31.23,12.103076923076923,0.84,99.45
2022-12-04,Mizoram,438,2,435,5178,1840,931,8.46,1,1.3,872562,7285,867721,141.54,71.62,3.983076923076923,0.83,99.45
2022-12-05,Mizoram,1047,13,1042,12697,943,737,8.25,0,1.3,873609,7298,868763,72.54,56.69,9.766923076923076,0.84,99.45
2022-12-06,Mizoram,412,1,410,4961,2070,572,8.3,1,1.3,874021,7299,869173,159.23,44.0,3.816153846153846,0.84,99.45
2022-12-07,Mizoram,409,4,409,4977,3049,199,8.22,0,1.3,874430,7303,869582,234.54,15.31,3.8284615384615384,0.84,99.45
2022-12-08,Mizoram,453,3,445,5614,3833,3373,8.07,5,1.3,874883,7306,870027,294.85,259.46,4.318461538461539,0.84,99.44
2022-12-09,Mizoram,772,3,766,9339,2740,1593,8.27,3,1.3,875655,7309,870793,210.77,122.54,7.1838461538461535,0.83,99.44
2022-12-10,Mizoram,1100,11,1099,13884,3162,101,7.92,0,1.3,876755,7320,871892,243.23,7.77,10.68,0.83,99.45
2022-12-11,Mizoram,774,4,765,9641,2861,1678,8.03,5,1.3,877529,7324,872657,220.08,129.08,7.416153846153846,0.83,99.44
2022-12-12,Mizoram,1006,12,1000,12471,1815,1595,8.07,0,1.3,878535,7336,873657,139.62,122.69,9.593076923076923,0.84,99.44
2022-12-13,Mizoram,60,0,58,730,3140,375,8.22,2,1.3,878595,7336,873715,241.54,28.85,0.5615384615384615,0.83,99.44
2022-12-14,Mizoram,892,7,883,11350,773,24,7.86,2,1.3,879487,7343,874598,59.46,1.85,8.73076923076923,0.83,99.44
2022-12-15,Mizoram,960,12,953,12235,2917,1747,7.85,0,1.3,880447,7355,875551,224.38,134.38,9.411538461538461,0.84,99.44
2022-12-16,Mizoram,1437,11,1431,18138,734,11,7.92,0,1.3,881884,7366,876982,56.46,0.85,13.952307692307693,0.84,99.44
2022-12-17,Mizoram,1509,15,1509,18765,2560,672,8.04,0,1.3,883393,7381,878491,196.92,51.69,14.434615384615384,0.84,99.45
2022-12-18,Mizoram,1591,22,1590,19978,4198,2730,7.96,0,1.3,884984,7403,880081,322.92,210.0,15.367692307692307,0.84,99.45
2022-12-19,Mizoram,750,7,749,9510,3443,2350,7.89,0,1.3,885734,7410,880830,264.85,180.77,7.315384615384615,0.84,99.45
2022-12-20,Mizoram,782,5,774,9711,3452,2179,8.05,3,1.3,886516,7415,881604,265.54,167.62,7.47,0.84,99.45
2022-12-21,Mizoram,988,6,983,12051,4934,2126,8.2,0,1.3,887504,7421,882587,379.54,163.54,9.27,0.84,99.45
2022-12-22,Mizoram,1429,4,1428,18024,2530,2280,7.93,0,1.3,888933,7425,884015,194.62,175.38,13.864615384615385,0.84,99.45
2022-12-23,Mizoram,1241,11,1234,15373,1233,74,8.07,0,1.3,890174,7436,885249,94.85,5.69,11.825384615384616,0.84,99.45
2022-12-24,Mizoram,605,3,596,7329,3453,2978,8.25,6,1.3,890779,7439,885845,265.62,229.08,5.637692307692308,0.84,99.45
2022-12-25,Mizoram,554,2,552,7018,825,356,7.89,0,1.3,891333,7441,886397,63.46,27.38,5.398461538461539,0.83,99.45
2022-12-26,Mizoram,565,8,562,7606,3855,2843,7.43,0,1.3,891898,7449,886959,296.54,218.69,5.850769230769231,0.84,99.45
2022-12-27,Mizoram,1213,5,1206,14885,1113,108,8.15,2,1.3,893111,7454,888165,85.62,8.31,11.45,0.83,99.45
2022-12-28,Mizoram,735,2,728,9416,4888,2881,7.81,5,1.3,893846,7456,888893,376.0,221.62,7.243076923076923,0.83,99.45
2022-12-29,Mizoram,1279,6,1271,15840,3048,1761,8.07,2,1.3,895125,7462,890164,234.46,135.46,12.184615384615384,0.83,99.45
2022-12-30,Mizoram,669,4,660,7994,3958,97,8.37,5,1.3,895794,7466,890824,304.46,7.46,6.149230769230769,0.83,99.45
2022-12-31,Mizoram,1189,3,1189,15093,4937,2777,7.88,0,1.3,896983,7469,892013,379.77,213.62,11.61,0.83,99.45
2020-01-01,Nagaland,871,13,869,10635,3635,2299,8.19,0,2.2,871,13,869,165.23,104.5,4.834090909090909,1.49,99.77
2020-01-02,Nagaland,117,0,112,1571,3397,1476,7.45,5,2.2,988,13,981,154.41,67.09,0.7140909090909091,1.32,99.29
2020-01-03,Nagaland,187,1,185,2559,4503,1927,7.31,1,2.2,1175,14,1166,204.68,87.59,1.163181818181818,1.19,99.23
2020-01-04,Nagaland,926,9,921,11396,2316,1339,8.13,0,2.2,2101,23,2087,105.27,60.86,5.18,1.09,99.33
2020-01-05,Nagaland,58,0,58,755,2742,629,7.68,0,2.2,2159,23,2145,124.64,28.59,0.3431818181818182,1.07,99.35
2020-01-06,Nagaland,1477,19,1468,18269,4786,1643,8.08,0,2.2,3636,42,3613,217.55,74.68,8.30409090909091,1.16,99.37
2020-01-07,Nagaland,202,2,198,2602,4172,1817,7.76,2,2.2,3838,44,3811,189.64,82.59,1.1827272727272726,1.15,99.3
2020-01-08,Nagaland,725,5,717,9257,1267,577,7.83,3,2.2,4563,49,4528,57.59,26.23,4.207727272727273,1.07,99.23
2020-01-09,Nagaland,110,0,108,950,3551,3279,11.58,2,2.2,4673,49,4636,161.41,149.05,0.4318181818181818,1.05,99.21
2020-01-10,Nagaland,279,3,279,3743,2093,2085,7.45,0,2.2,4952,52,4915,95.14,94.77,1.7013636363636364,1.05,99.25
2020-01-11,Nagaland,421,5,413,4973,1626,757,8.47,3,2.2,5373,57,5328,73.91,34.41,2.2604545454545453,1.06,99.16
2020-01-12,Nagaland,1396,13,1396,17586,1649,466,7.94,0,2.2,6769,70,6724,74.95,21.18,7.993636363636363,1.03,99.34
2020-01-13,Nagaland,1185,14,1176,15090,4696,1743,7.85,0,2.2,7954,84,7900,213.45,79.23,6.859090909090909,1.06,99.32
2020-01-14,Nagaland,1232,17,1229,15087,1784,1143,8.17,0,2.2,9186,101,9129,81.09,51.95,6.8577272727272724,1.1,99.38
2020-01-15,Nagaland,1409,9,1404,17762,2614,737,7.93,0,2.2,10595,110,10533,118.82,33.5,8.073636363636364,1.04,99.41
2020-01-16,Nagaland,1306,17,1305,16122,4040,862,8.1,0,2.2,11901,127,11838,183.64,39.18,7.328181818181818,1.07,99.47
2020-01-17,Nagaland,397,1,390,4914,1025,495,8.08,6,2.2,12298,128,12228,46.59,22.5,2.2336363636363634,1.04,99.43
2020-01-18,Nagaland,231,2,223,2918,2098,1512,7.92,6,2.2,12529,130,12451,95.36,68.73,1.3263636363636364,1.04,99.38
2020-01-19,Nagaland,808,4,802,10199,1731,1473,7.92,2,2.2,13337,134,13253,78.68,66.95,4.635909090909091,1.0,99.37
2020-01-20,Nagaland,1149,16,1149,14451,2653,1204,7.95,0,2.2,14486,150,14402,120.59,54.73,6.568636363636363,1.04,99.42
2020-01-21,Nagaland,1485,9,1480,18601,700,486,7.98,0,2.2,15971,159,15882,31.82,22.09,8.455,1.0,99.44
2020-01-22,Nagaland,1103,7,1102,14189,4816,740,7.77,0,2.2,17074,166,16984,218.91,33.64,6.449545454545454,0.97,99.47
2020-01-23,Nagaland,119,0,112,1332,2777,2771,8.93,7,2.2,17193,166,17096,126.23,125.95,0.6054545454545455,0.97,99.44
2020-01-24,Nagaland,466,6,461,5689,1586,225,8.19,0,2.2,17659,172,17557,72.09,10.23,2.585909090909091,0.97,99.42
2020-01-25,Nagaland,123,1,120,1240,3787,3299,9.92,2,2.2,17782,173,17677,172.14,149.95,0.5636363636363636,0.97,99.41
2020-01-26,Nagaland,1584,9,1580,19569,400,359,8.09,0,2.2,19366,182,19257,18.18,16.32,8.895,0.94,99.44
2020-01-27,Nagaland,1279,18,1272,15880,1015,268,8.05,0,2.2,20645,200,20529,46.14,12.18,7.218181818181818,0.97,99.44
2020-01-28,Nagaland,234,2,234,2833,2910,881,8.26,0,2.2,20879,202,20763,132.27,40.05,1.2877272727272728,0.97,99.44
2020-01-29,Nagaland,1414,8,1410,17580,3385,582,8.04,0,2.2,22293,210,22173,153.86,26.45,7.990909090909091,0.94,99.46
2020-01-30,Nagaland,1085,4,1083,13069,4500,1994,8.3,0,2.2,23378,214,23256,204.55,90.64,5.940454545454545,0.92,99.48
2020-01-31,Nagaland,127,1,125,1727,1347,569,7.35,1,2.2,23505,215,23381,61.23,25.86,0.785,0.91,99.47
2020-02-01,Nagaland,447,3,446,5503,767,447,8.12,0,2.2,23952,218,23827,34.86,20.32,2.5013636363636365,0.91,99.48
2020-02-02,Nagaland,963,9,954,12152,2610,1016,7.92,0,2.2,24915,227,24781,118.64,46.18,5.5236363636363635,0.91,99.46
2020-02-03,Nagaland,169,0,162,2439,1207,436,6.93,7,2.2,25084,227,24943,54.86,19.82,1.1086363636363636,0.9,99.44
2020-02-04,Nagaland,115,1,109,1348,1904,725,8.53,5,2.2,25199,228,25052,86.55,32.95,0.6127272727272727,0.9,99.42
2020-02-05,Nagaland,407,3,407,5626,1532,1253,7.23,0,2.2,25606,231,25459,69.64,56.95,2.557272727272727,0.9,99.43
2020-02-06,Nagaland,1260,14,1256,16165,1992,209,7.79,0,2.2,26866,245,26715,90.55,9.5,7.347727272727273,0.91,99.44
2020-02-07,Nagaland,566,5,561,7246,4214,567,7.81,0,2.2,27432,250,27276,191.55,25.77,3.2936363636363635,0.91,99.43
2020-02-08,Nagaland,788,10,783,9639,2142,932,8.18,0,2.2,28220,260,28059,97.36,42.36,4.381363636363637,0.92,99.43
2020-02-09,Nagaland,353,2,352,4212,5,0,8.38,0,2.2,28573,262,28411,0.23,0.0,1.9145454545454546,0.92,99.43
2020-02-10,Nagaland,892,11,883,11242,1529,605,7.93,0,2.2,29465,273,29294,69.5,27.5,5.11,0.93,99.42
2020-02-11,Nagaland,409,1,400,5176,4204,235,7.9,8,2.2,29874,274,29694,191.09,10.68,2.3527272727272726,0.92,99.4
2020-02-12,Nagaland,804,8,801,10682,3125,1654,7.53,0,2.2,30678,282,30495,142.05,75.18,4.8554545454545455,0.92,99.4
2020-02-13,Nagaland,1075,13,1070,14236,3559,1044,7.55,0,2.2,31753,295,31565,161.77,47.45,6.470909090909091,0.93,99.41
2020-02-14,Nagaland,1158,6,1151,14607,3093,2185,7.93,1,2.2,32911,301,32716,140.59,99.32,6.639545454545455,0.91,99.41
2020-02-15,Nagaland,136,1,129,1329,4465,2643,10.23,6,2.2,33047,302,32845,202.95,120.14,0.6040909090909091,0.91,99.39
2020-02-16,Nagaland,1242,10,1233,15333,1040,173,8.1,0,2.2,34289,312,34078,47.27,7.86,6.969545454545455,0.91,99.38
2020-02-17,Nagaland,1019,8,1011,12382,2378,138,8.23,0,2.2,35308,320,35089,108.09,6.27,5.628181818181818,0.91,99.38
2020-02-18,Nagaland,1567,18,1562,19089,3998,2683,8.21,0,2.2,36875,338,36651,181.73,121.95,8.676818181818183,0.92,99.39
2020-02-19,Nagaland,1444,14,1436,17986,2836,648,8.03,0,2.2,38319,352,38087,128.91,29.45,8.175454545454546,0.92,99.39
2020-02-20,Nagaland,1537,5,1533,19136,2901,445,8.03,0,2.2,39856,357,39620,131.86,20.23,8.698181818181817,0.9,99.41
2020-02-21,Nagaland,594,8,590,7609,49,39,7.81,0,2.2,40450,365,40210,2.23,1.77,3.4586363636363635,0.9,99.41
2020-02-22,Nagaland,950,11,946,12018,2929,1318,7.9,0,2.2,41400,376,41156,133.14,59.91,5.462727272727273,0.91,99.41
2020-02-23,Nagaland,490,3,485,6232,1041,290,7.86,2,2.2,41890,379,41641,47.32,13.18,2.8327272727272725,0.9,99.41
2020-02-24,Nagaland,716,4,710,8770,3505,1115,8.16,2,2.2,42606,383,42351,159.32,50.68,3.9863636363636363,0.9,99.4
2020-02-25,Nagaland,1252,17,1250,15856,2744,2722,7.9,0,2.2,43858,400,43601,124.73,123.73,7.207272727272727,0.91,99.41
2020-02-26,Nagaland,1274,9,1268,15817,2573,641,8.05,0,2.2,45132,409,44869,116.95,29.14,7.1895454545454545,0.91,99.42
2020-02-27,Nagaland,834,11,832,10215,1036,1001,8.16,0,2.2,45966,420,45701,47.09,45.5,4.6431818181818185,0.91,99.42
2020-02-28,Nagaland,1295,10,1295,15664,4450,4137,8.27,0,2.2,47261,430,46996,202.27,188.05,7.12,0.91,99.44
2020-02-29,Nagaland,1543,4,1542,19284,1506,969,8.0,0,2.2,48804,434,48538,68.45,44.05,8.765454545454546,0.89,99.45
2020-03-01,Nagaland,623,9,615,7802,1986,211,7.99,0,2.2,49427,443,49153,90.27,9.59,3.5463636363636364,0.9,99.45
2020-03-02,Nagaland,1459,21,1457,18461,1300,1166,7.9,0,2.2,50886,464,50610,59.09,53.0,8.391363636363636,0.91,99.46
2020-03-03,Nagaland,250,3,244,3424,4216,1836,7.3,3,2.2,51136,467,50854,191.64,83.45,1.5563636363636364,0.91,99.45
2020-03-04,Nagaland,1470,9,1462,18352,1914,482,8.01,0,2.2,52606,476,52316,87.0,21.91,8.341818181818182,0.9,99.45
2020-03-05,Nagaland,381,4,377,4683,622,57,8.14,0,2.2,52987,480,52693,28.27,2.59,2.1286363636363634,0.91,99.45
2020-03-06,Nagaland,453,3,451,5574,4753,277,8.13,0,2.2,53440,483,53144,216.05,12.59,2.5336363636363637,0.9,99.45
2020-03-07,Nagaland,1046,5,1040,13132,2978,2281,7.97,1,2.2,54486,488,54184,135.36,103.68,5.969090909090909,0.9,99.45
2020-03-08,Nagaland,1494,6,1492,18886,1372,1147,7.91,0,2.2,55980,494,55676,62.36,52.14,8.584545454545454,0.88,99.46
2020-03-09,Nagaland,1376,19,1374,17700,4829,1012,7.77,0,2.2,57356,513,57050,219.5,46.0,8.045454545454545,0.89,99.47
2020-03-10,Nagaland,990,6,984,12583,1770,1697,7.87,0,2.2,58346,519,58034,80.45,77.14,5.719545454545455,0.89,99.47
2020-03-11,Nagaland,577,6,570,7318,2781,1314,7.88,1,2.2,58923,525,58604,126.41,59.73,3.326363636363636,0.89,99.46
2020-03-12,Nagaland,1253,10,1246,15521,2657,558,8.07,0,2.2,60176,535,59850,120.77,25.36,7.055,0.89,99.46
2020-03-13,Nagaland,348,2,341,4395,1702,1157,7.92,5,2.2,60524,537,60191,77.36,52.59,1.9977272727272728,0.89,99.45
2020-03-14,Nagaland,1276,17,1268,15984,4200,1472,7.98,0,2.2,61800,554,61459,190.91,66.91,7.265454545454546,0.9,99.45
2020-03-15,Nagaland,1529,18,1529,18959,1739,698,8.06,0,2.2,63329,572,62988,79.05,31.73,8.617727272727272,0.9,99.46
2020-03-16,Nagaland,1155,13,1153,14101,1879,616,8.19,0,2.2,64484,585,64141,85.41,28.0,6.409545454545454,0.91,99.47
2020-03-17,Nagaland,1300,4,1295,16302,4344,2676,7.97,1,2.2,65784,589,65436,197.45,121.64,7.41,0.9,99.47
2020-03-18,Nagaland,250,1,248,3164,3790,3344,7.9,1,2.2,66034,590,65684,172.27,152.0,1.4381818181818182,0.89,99.47
2020-03-19,Nagaland,489,1,482,6227,1161,432,7.85,6,2.2,66523,591,66166,52.77,19.64,2.8304545454545456,0.89,99.46
2020-03-20,Nagaland,509,4,502,6023,737,347,8.45,3,2.2,67032,595,66668,33.5,15.77,2.737727272727273,0.89,99.46
2020-03-21,Nagaland,1129,7,1122,14273,3694,2892,7.91,0,2.2,68161,602,67790,167.91,131.45,6.487727272727272,0.88,99.46
2020-03-22,Nagaland,138,0,129,1835,2261,1302,7.52,9,2.2,68299,602,67919,102.77,59.18,0.8340909090909091,0.88,99.44
2020-03-23,Nagaland,1278,11,1276,15699,2301,745,8.14,0,2.2,69577,613,69195,104.59,33.86,7.135909090909091,0.88,99.45
2020-03-24,Nagaland,416,2,415,5373,1312,1185,7.74,0,2.2,69993,615,69610,59.64,53.86,2.4422727272727274,0.88,99.45
2020-03-25,Nagaland,540,2,540,6425,833,42,8.4,0,2.2,70533,617,70150,37.86,1.91,2.9204545454545454,0.87,99.46
2020-03-26,Nagaland,1162,6,1157,14832,2208,1314,7.83,0,2.2,71695,623,71307,100.36,59.73,6.741818181818182,0.87,99.46
2020-03-27,Nagaland,143,0,135,1621,3075,803,8.82,8,2.2,71838,623,71442,139.77,36.5,0.7368181818181818,0.87,99.45
2020-03-28,Nagaland,1197,9,1190,14780,1895,826,8.1,0,2.2,73035,632,72632,86.14,37.55,6.718181818181818,0.87,99.45
2020-03-29,Nagaland,814,5,810,10257,266,253,7.94,0,2.2,73849,637,73442,12.09,11.5,4.662272727272727,0.86,99.45
2020-03-30,Nagaland,1152,14,1152,14781,1209,289,7.79,0,2.2,75001,651,74594,54.95,13.14,6.718636363636364,0.87,99.46
2020-03-31,Nagaland,1394,11,1394,17294,1412,1064,8.06,0,2.2,76395,662,75988,64.18,48.36,7.860909090909091,0.87,99.47
2020-04-01,Nagaland,479,2,474,6230,769,157,7.69,3,2.2,76874,664,76462,34.95,7.14,2.831818181818182,0.86,99.46
2020-04-02,Nagaland,933,10,931,11634,3548,2272,8.02,0,2.2,77807,674,77393,161.27,103.27,5.288181818181818,0.87,99.47
2020-04-03,Nagaland,504,5,500,6282,929,113,8.02,0,2.2,78311,679,77893,42.23,5.14,2.8554545454545455,0.87,99.47
2020-04-04,Nagaland,381,2,381,4537,300,219,8.4,0,2.2,78692,681,78274,13.64,9.95,2.0622727272727275,0.87,99.47
2020-04-05,Nagaland,986,3,978,12563,2975,471,7.85,5,2.2,79678,684,79252,135.23,21.41,5.710454545454546,0.86,99.47
2020-04-06,Nagaland,753,5,750,9702,681,381,7.76,0,2.2,80431,689,80002,30.95,17.32,4.41,0.86,99.47
2020-04-07,Nagaland,1562,9,1561,19641,104,6,7.95,0,2.2,81993,698,81563,4.73,0.27,8.927727272727273,0.85,99.48
2020-04-08,Nagaland,96,0,90,1352,1785,429,7.1,6,2.2,82089,698,81653,81.14,19.5,0.6145454545454545,0.85,99.47
2020-04-09,Nagaland,789,7,789,9583,4088,504,8.23,0,2.2,82878,705,82442,185.82,22.91,4.3559090909090905,0.85,99.47
2020-04-10,Nagaland,207,1,200,2831,3734,980,7.31,6,2.2,83085,706,82642,169.73,44.55,1.2868181818181819,0.85,99.47
2020-04-11,Nagaland,1579,9,1570,19924,3885,2150,7.93,0,2.2,84664,715,84212,176.59,97.73,9.056363636363637,0.84,99.47
2020-04-12,Nagaland,354,1,354,4677,2723,1479,7.57,0,2.2,85018,716,84566,123.77,67.23,2.125909090909091,0.84,99.47
2020-04-13,Nagaland,699,6,693,8769,2714,1382,7.97,0,2.2,85717,722,85259,123.36,62.82,3.985909090909091,0.84,99.47
2020-04-14,Nagaland,590,4,584,7415,2152,281,7.96,2,2.2,86307,726,85843,97.82,12.77,3.3704545454545456,0.84,99.46
2020-04-15,Nagaland,637,5,633,8040,3443,2200,7.92,0,2.2,86944,731,86476,156.5,100.0,3.6545454545454548,0.84,99.46
2020-04-16,Nagaland,1169,13,1162,14529,3639,1657,8.05,0,2.2,88113,744,87638,165.41,75.32,6.6040909090909095,0.84,99.46
2020-04-17,Nagaland,734,4,729,9449,2544,2074,7.77,1,2.2,88847,748,88367,115.64,94.27,4.295,0.84,99.46
2020-04-18,Nagaland,1265,16,1264,16050,2146,1330,7.88,0,2.2,90112,764,89631,97.55,60.45,7.295454545454546,0.85,99.47
2020-04-19,Nagaland,1270,15,1262,15464,2038,1110,8.21,0,2.2,91382,779,90893,92.64,50.45,7.029090909090909,0.85,99.46
2020-04-20,Nagaland,653,4,648,8312,4389,994,7.86,1,2.2,92035,783,91541,199.5,45.18,3.7781818181818183,0.85,99.46
2020-04-21,Nagaland,1546,6,1538,19371,320,0,7.98,2,2.2,93581,789,93079,14.55,0.0,8.805,0.84,99.46
2020-04-22,Nagaland,688,5,683,9272,1881,185,7.42,0,2.2,94269,794,93762,85.5,8.41,4.214545454545455,0.84,99.46
2020-04-23,Nagaland,1464,13,1464,18303,654,647,8.0,0,2.2,95733,807,95226,29.73,29.41,8.319545454545455,0.84,99.47
2020-04-24,Nagaland,646,2,645,8096,4749,1719,7.98,0,2.2,96379,809,95871,215.86,78.14,3.68,0.84,99.47
2020-04-25,Nagaland,217,3,208,2774,2820,2768,7.82,6,2.2,96596,812,96079,128.18,125.82,1.260909090909091,0.84,99.46
2020-04-26,Nagaland,45,0,45,785,3049,412,5.73,0,2.2,96641,812,96124,138.59,18.73,0.3568181818181818,0.84,99.47
2020-04-27,Nagaland,1100,14,1091,13911,848,207,7.91,0,2.2,97741,826,97215,38.55,9.41,6.323181818181818,0.85,99.46
2020-04-28,Nagaland,973,4,966,11923,107,42,8.16,3,2.2,98714,830,98181,4.86,1.91,5.419545454545455,0.84,99.46
2020-04-29,Nagaland,125,1,121,1942,190,48,6.44,3,2.2,98839,831,98302,8.64,2.18,0.8827272727272727,0.84,99.46
2020-04-30,Nagaland,862,5,853,10744,4060,3845,8.02,4,2.2,99701,836,99155,184.55,174.77,4.883636363636364,0.84,99.45
2020-05-01,Nagaland,1216,14,1210,15330,4663,2020,7.93,0,2.2,100917,850,100365,211.95,91.82,6.968181818181818,0.84,99.45
2020-05-02,Nagaland,1387,10,1384,17487,1905,486,7.93,0,2.2,102304,860,101749,86.59,22.09,7.948636363636363,0.84,99.46
2020-05-03,Nagaland,1021,10,1014,12484,4485,3645,8.18,0,2.2,103325,870,102763,203.86,165.68,5.674545454545455,0.84,99.46
2020-05-04,Nagaland,324,1,323,3737,754,164,8.67,0,2.2,103649,871,103086,34.27,7.45,1.6986363636363637,0.84,99.46
2020-05-05,Nagaland,400,4,399,5318,2574,2353,7.52,0,2.2,104049,875,103485,117.0,106.95,2.4172727272727275,0.84,99.46
2020-05-06,Nagaland,1069,6,1069,13508,1793,1042,7.91,0,2.2,105118,881,104554,81.5,47.36,6.14,0.84,99.46
2020-05-07,Nagaland,134,0,128,1919,1867,1013,6.98,6,2.2,105252,881,104682,84.86,46.05,0.8722727272727273,0.84,99.46
2020-05-08,Nagaland,209,2,209,2380,2956,646,8.78,0,2.2,105461,883,104891,134.36,29.36,1.0818181818181818,0.84,99.46
2020-05-09,Nagaland,283,1,281,3732,3635,1150,7.58,1,2.2,105744,884,105172,165.23,52.27,1.6963636363636363,0.84,99.46
2020-05-10,Nagaland,1595,14,1587,19566,4489,4381,8.15,0,2.2,107339,898,106759,204.05,199.14,8.893636363636364,0.84,99.46
2020-05-11,Nagaland,1567,5,1563,19821,3576,529,7.91,0,2.2,108906,903,108322,162.55,24.05,9.009545454545455,0.83,99.46
2020-05-12,Nagaland,192,0,186,2328,4205,409,8.25,6,2.2,109098,903,108508,191.14,18.59,1.0581818181818181,0.83,99.46
2020-05-13,Nagaland,1231,14,1227,15409,4155,1293,7.99,0,2.2,110329,917,109735,188.86,58.77,7.004090909090909,0.83,99.46
2020-05-14,Nagaland,454,3,451,5221,295,234,8.7,0,2.2,110783,920,110186,13.41,10.64,2.373181818181818,0.83,99.46
2020-05-15,Nagaland,430,4,422,5163,2988,966,8.33,4,2.2,111213,924,110608,135.82,43.91,2.3468181818181817,0.83,99.46
2020-05-16,Nagaland,156,0,156,2111,4587,877,7.39,0,2.2,111369,924,110764,208.5,39.86,0.9595454545454546,0.83,99.46
2020-05-17,Nagaland,337,3,335,4439,3532,1347,7.59,0,2.2,111706,927,111099,160.55,61.23,2.0177272727272726,0.83,99.46
2020-05-18,Nagaland,206,2,198,2609,1243,566,7.9,6,2.2,111912,929,111297,56.5,25.73,1.1859090909090908,0.83,99.45
2020-05-19,Nagaland,1004,14,1001,12208,3207,2718,8.22,0,2.2,112916,943,112298,145.77,123.55,5.549090909090909,0.84,99.45
2020-05-20,Nagaland,1515,12,1509,18994,789,285,7.98,0,2.2,114431,955,113807,35.86,12.95,8.633636363636363,0.83,99.45
2020-05-21,Nagaland,1014,8,1012,12848,3673,2203,7.89,0,2.2,115445,963,114819,166.95,100.14,5.84,0.83,99.46
2020-05-22,Nagaland,260,3,256,3772,1540,223,6.89,1,2.2,115705,966,115075,70.0,10.14,1.7145454545454546,0.83,99.46
2020-05-23,Nagaland,690,6,689,8398,4143,2863,8.22,0,2.2,116395,972,115764,188.32,130.14,3.8172727272727274,0.84,99.46
2020-05-24,Nagaland,799,6,797,9923,585,44,8.05,0,2.2,117194,978,116561,26.59,2.0,4.510454545454546,0.83,99.46
2020-05-25,Nagaland,376,1,372,4423,3947,425,8.5,3,2.2,117570,979,116933,179.41,19.32,2.0104545454545453,0.83,99.46
2020-05-26,Nagaland,408,1,403,4571,4578,2359,8.93,4,2.2,117978,980,117336,208.09,107.23,2.0777272727272726,0.83,99.46
2020-05-27,Nagaland,235,1,232,2983,2739,919,7.88,2,2.2,118213,981,117568,124.5,41.77,1.355909090909091,0.83,99.45
2020-05-28,Nagaland,1328,5,1323,16722,883,8,7.94,0,2.2,119541,986,118891,40.14,0.36,7.600909090909091,0.82,99.46
2020-05-29,Nagaland,624,9,618,7826,1888,1684,7.97,0,2.2,120165,995,119509,85.82,76.55,3.557272727272727,0.83,99.45
2020-05-30,Nagaland,577,2,574,7339,4449,3415,7.86,1,2.2,120742,997,120083,202.23,155.23,3.335909090909091,0.83,99.45
2020-05-31,Nagaland,1057,13,1057,13428,1474,135,7.87,0,2.2,121799,1010,121140,67.0,6.14,6.1036363636363635,0.83,99.46
2020-06-01,Nagaland,899,6,891,11098,3726,1982,8.1,2,2.2,122698,1016,122031,169.36,90.09,5.044545454545455,0.83,99.46
2020-06-02,Nagaland,1142,5,1136,14393,1654,1517,7.93,1,2.2,123840,1021,123167,75.18,68.95,6.542272727272727,0.82,99.46
2020-06-03,Nagaland,950,7,946,12025,3728,2703,7.9,0,2.2,124790,1028,124113,169.45,122.86,5.465909090909091,0.82,99.46
2020-06-04,Nagaland,951,7,949,11652,3415,80,8.16,0,2.2,125741,1035,125062,155.23,3.64,5.296363636363636,0.82,99.46
2020-06-05,Nagaland,1319,4,1314,16247,1768,1113,8.12,1,2.2,127060,1039,126376,80.36,50.59,7.385,0.82,99.46
2020-06-06,Nagaland,718,5,710,8854,3485,3424,8.11,3,2.2,127778,1044,127086,158.41,155.64,4.024545454545454,0.82,99.46
2020-06-07,Nagaland,1522,8,1519,19038,3167,2122,7.99,0,2.2,129300,1052,128605,143.95,96.45,8.653636363636364,0.81,99.46
2020-06-08,Nagaland,1456,16,1452,18600,136,118,7.83,0,2.2,130756,1068,130057,6.18,5.36,8.454545454545455,0.82,99.47
2020-06-09,Nagaland,874,3,868,10691,1357,539,8.18,3,2.2,131630,1071,130925,61.68,24.5,4.859545454545454,0.81,99.46
2020-06-10,Nagaland,212,1,208,2961,4091,77,7.16,3,2.2,131842,1072,131133,185.95,3.5,1.345909090909091,0.81,99.46
2020-06-11,Nagaland,1369,7,1366,17439,4233,310,7.85,0,2.2,133211,1079,132499,192.41,14.09,7.926818181818182,0.81,99.47
2020-06-12,Nagaland,190,2,184,2397,4932,1568,7.93,4,2.2,133401,1081,132683,224.18,71.27,1.0895454545454546,0.81,99.46
2020-06-13,Nagaland,1095,6,1086,13819,2558,1998,7.92,3,2.2,134496,1087,133769,116.27,90.82,6.281363636363636,0.81,99.46
2020-06-14,Nagaland,1400,12,1395,17178,4671,3851,8.15,0,2.2,135896,1099,135164,212.32,175.05,7.808181818181819,0.81,99.46
2020-06-15,Nagaland,371,2,363,4919,3012,583,7.54,6,2.2,136267,1101,135527,136.91,26.5,2.235909090909091,0.81,99.46
2020-06-16,Nagaland,592,3,585,7428,1490,1089,7.97,4,2.2,136859,1104,136112,67.73,49.5,3.3763636363636365,0.81,99.45
2020-06-17,Nagaland,1121,10,1117,13617,3522,880,8.23,0,2.2,137980,1114,137229,160.09,40.0,6.1895454545454545,0.81,99.46
2020-06-18,Nagaland,912,6,904,11359,983,118,8.03,2,2.2,138892,1120,138133,44.68,5.36,5.163181818181818,0.81,99.45
2020-06-19,Nagaland,225,2,224,2784,3534,3525,8.08,0,2.2,139117,1122,138357,160.64,160.23,1.2654545454545454,0.81,99.45
2020-06-20,Nagaland,946,7,937,12003,122,84,7.88,2,2.2,140063,1129,139294,5.55,3.82,5.455909090909091,0.81,99.45
2020-06-21,Nagaland,703,3,701,8880,3891,2734,7.92,0,2.2,140766,1132,139995,176.86,124.27,4.036363636363636,0.8,99.45
2020-06-22,Nagaland,191,2,191,2388,1749,984,8.0,0,2.2,140957,1134,140186,79.5,44.73,1.0854545454545454,0.8,99.45
2020-06-23,Nagaland,1354,17,1349,16705,3940,3533,8.11,0,2.2,142311,1151,141535,179.09,160.59,7.593181818181818,0.81,99.45
2020-06-24,Nagaland,1464,18,1460,18195,1330,143,8.05,0,2.2,143775,1169,142995,60.45,6.5,8.270454545454545,0.81,99.46
2020-06-25,Nagaland,1591,5,1591,19560,3223,2473,8.13,0,2.2,145366,1174,144586,146.5,112.41,8.89090909090909,0.81,99.46
2020-06-26,Nagaland,166,1,159,2292,2600,1416,7.24,6,2.2,145532,1175,144745,118.18,64.36,1.0418181818181818,0.81,99.46
2020-06-27,Nagaland,198,1,193,2393,853,735,8.27,4,2.2,145730,1176,144938,38.77,33.41,1.0877272727272727,0.81,99.46
2020-06-28,Nagaland,804,7,798,9843,2616,1354,8.17,0,2.2,146534,1183,145736,118.91,61.55,4.474090909090909,0.81,99.46
2020-06-29,Nagaland,1282,5,1273,15823,4669,1383,8.1,4,2.2,147816,1188,147009,212.23,62.86,7.192272727272727,0.8,99.45
2020-06-30,Nagaland,996,9,994,11956,2112,845,8.33,0,2.2,148812,1197,148003,96.0,38.41,5.434545454545455,0.8,99.46
2020-07-01,Nagaland,340,3,331,4352,2994,2782,7.81,6,2.2,149152,1200,148334,136.09,126.45,1.9781818181818183,0.8,99.45
2020-07-02,Nagaland,1479,8,1472,18019,484,367,8.21,0,2.2,150631,1208,149806,22.0,16.68,8.190454545454546,0.8,99.45
2020-07-03,Nagaland,1475,11,1472,18118,2191,433,8.14,0,2.2,152106,1219,151278,99.59,19.68,8.235454545454546,0.8,99.46
2020-07-04,Nagaland,1537,6,1532,18888,1874,1457,8.14,0,2.2,153643,1225,152810,85.18,66.23,8.585454545454546,0.8,99.46
2020-07-05,Nagaland,1083,15,1075,13143,4310,1055,8.24,0,2.2,154726,1240,153885,195.91,47.95,5.974090909090909,0.8,99.46
2020-07-06,Nagaland,860,6,852,10860,4748,3087,7.92,2,2.2,155586,1246,154737,215.82,140.32,4.9363636363636365,0.8,99.45
2020-07-07,Nagaland,269,1,260,3662,3535,919,7.35,8,2.2,155855,1247,154997,160.68,41.77,1.6645454545454546,0.8,99.45
2020-07-08,Nagaland,608,5,599,7289,4695,457,8.34,4,2.2,156463,1252,155596,213.41,20.77,3.313181818181818,0.8,99.45
2020-07-09,Nagaland,1372,13,1366,17353,3223,1063,7.91,0,2.2,157835,1265,156962,146.5,48.32,7.887727272727273,0.8,99.45
2020-07-10,Nagaland,687,5,683,8582,3072,769,8.01,0,2.2,158522,1270,157645,139.64,34.95,3.900909090909091,0.8,99.45
2020-07-11,Nagaland,1524,11,1518,18593,425,68,8.2,0,2.2,160046,1281,159163,19.32,3.09,8.451363636363636,0.8,99.45
2020-07-12,Nagaland,1490,5,1484,18355,1043,203,8.12,1,2.2,161536,1286,160647,47.41,9.23,8.343181818181819,0.8,99.45
2020-07-13,Nagaland,881,3,873,11210,2635,1052,7.86,5,2.2,162417,1289,161520,119.77,47.82,5.095454545454546,0.79,99.45
2020-07-14,Nagaland,1421,11,1413,17892,1929,262,7.94,0,2.2,163838,1300,162933,87.68,11.91,8.132727272727273,0.79,99.45
2020-07-15,Nagaland,738,4,735,9673,1537,1359,7.63,0,2.2,164576,1304,163668,69.86,61.77,4.3968181818181815,0.79,99.45
2020-07-16,Nagaland,974,6,971,12087,1496,179,8.06,0,2.2,165550,1310,164639,68.0,8.14,5.494090909090909,0.79,99.45
2020-07-17,Nagaland,1254,15,1245,15712,4374,2393,7.98,0,2.2,166804,1325,165884,198.82,108.77,7.141818181818182,0.79,99.45
2020-07-18,Nagaland,1463,14,1457,17935,1142,817,8.16,0,2.2,168267,1339,167341,51.91,37.14,8.152272727272727,0.8,99.45
2020-07-19,Nagaland,520,5,513,6595,4976,2500,7.88,2,2.2,168787,1344,167854,226.18,113.64,2.9977272727272726,0.8,99.45
2020-07-20,Nagaland,890,10,886,10817,4390,2657,8.23,0,2.2,169677,1354,168740,199.55,120.77,4.916818181818182,0.8,99.45
2020-07-21,Nagaland,500,4,495,6351,4952,2965,7.87,1,2.2,170177,1358,169235,225.09,134.77,2.8868181818181817,0.8,99.45
2020-07-22,Nagaland,673,9,668,8792,2524,875,7.65,0,2.2,170850,1367,169903,114.73,39.77,3.9963636363636366,0.8,99.45
2020-07-23,Nagaland,340,2,333,4024,482,286,8.45,5,2.2,171190,1369,170236,21.91,13.0,1.829090909090909,0.8,99.44
2020-07-24,Nagaland,1517,5,1513,18925,2218,997,8.02,0,2.2,172707,1374,171749,100.82,45.32,8.602272727272727,0.8,99.45
2020-07-25,Nagaland,342,2,335,4101,2779,1421,8.34,5,2.2,173049,1376,172084,126.32,64.59,1.864090909090909,0.8,99.44
2020-07-26,Nagaland,664,2,655,8350,2439,1985,7.95,7,2.2,173713,1378,172739,110.86,90.23,3.7954545454545454,0.79,99.44
2020-07-27,Nagaland,597,4,597,7911,2118,729,7.55,0,2.2,174310,1382,173336,96.27,33.14,3.5959090909090907,0.79,99.44
2020-07-28,Nagaland,1027,6,1019,12683,977,650,8.1,2,2.2,175337,1388,174355,44.41,29.55,5.765,0.79,99.44
2020-07-29,Nagaland,1179,13,1174,14749,70,29,7.99,0,2.2,176516,1401,175529,3.18,1.32,6.704090909090909,0.79,99.44
2020-07-30,Nagaland,1211,3,1210,14762,1933,181,8.2,0,2.2,177727,1404,176739,87.86,8.23,6.71,0.79,99.44
2020-07-31,Nagaland,294,2,286,3891,4893,186,7.56,6,2.2,178021,1406,177025,222.41,8.45,1.7686363636363636,0.79,99.44
2020-08-01,Nagaland,1001,10,999,12843,3968,131,7.79,0,2.2,179022,1416,178024,180.36,5.95,5.837727272727273,0.79,99.44
2020-08-02,Nagaland,849,6,844,10466,4739,1261,8.11,0,2.2,179871,1422,178868,215.41,57.32,4.757272727272727,0.79,99.44
2020-08-03,Nagaland,104,0,99,874,4357,1216,11.9,5,2.2,179975,1422,178967,198.05,55.27,0.3972727272727273,0.79,99.44
2020-08-04,Nagaland,1443,4,1434,17884,459,453,8.07,5,2.2,181418,1426,180401,20.86,20.59,8.129090909090909,0.79,99.44
2020-08-05,Nagaland,488,3,481,6357,4831,4248,7.68,4,2.2,181906,1429,180882,219.59,193.09,2.8895454545454546,0.79,99.44
2020-08-06,Nagaland,1259,12,1256,15992,3652,762,7.87,0,2.2,183165,1441,182138,166.0,34.64,7.2690909090909095,0.79,99.44
2020-08-07,Nagaland,1528,9,1527,18348,1950,1368,8.33,0,2.2,184693,1450,183665,88.64,62.18,8.34,0.79,99.44
2020-08-08,Nagaland,458,4,450,5708,1308,527,8.02,4,2.2,185151,1454,184115,59.45,23.95,2.5945454545454547,0.79,99.44
2020-08-09,Nagaland,789,10,781,10084,1125,269,7.82,0,2.2,185940,1464,184896,51.14,12.23,4.583636363636364,0.79,99.44
2020-08-10,Nagaland,554,8,552,6855,2262,1285,8.08,0,2.2,186494,1472,185448,102.82,58.41,3.1159090909090907,0.79,99.44
2020-08-11,Nagaland,47,0,38,744,254,78,6.32,9,2.2,186541,1472,185486,11.55,3.55,0.3381818181818182,0.79,99.43
2020-08-12,Nagaland,966,3,958,12283,1815,544,7.86,5,2.2,187507,1475,186444,82.5,24.73,5.583181818181818,0.79,99.43
2020-08-13,Nagaland,1047,9,1039,13128,656,436,7.98,0,2.2,188554,1484,187483,29.82,19.82,5.967272727272727,0.79,99.43
2020-08-14,Nagaland,954,5,953,11577,903,279,8.24,0,2.2,189508,1489,188436,41.05,12.68,5.262272727272728,0.79,99.43
2020-08-15,Nagaland,310,2,301,3964,3592,1686,7.82,7,2.2,189818,1491,188737,163.27,76.64,1.8018181818181818,0.79,99.43
2020-08-16,Nagaland,1148,16,1147,14247,1948,1247,8.06,0,2.2,190966,1507,189884,88.55,56.68,6.475909090909091,0.79,99.43
2020-08-17,Nagaland,357,2,352,4484,4466,795,7.96,3,2.2,191323,1509,190236,203.0,36.14,2.038181818181818,0.79,99.43
2020-08-18,Nagaland,803,8,795,10601,3049,2704,7.57,0,2.2,192126,1517,191031,138.59,122.91,4.818636363636363,0.79,99.43
2020-08-19,Nagaland,1443,8,1436,18128,2484,972,7.96,0,2.2,193569,1525,192467,112.91,44.18,8.24,0.79,99.43
2020-08-20,Nagaland,673,8,668,8442,2365,1859,7.97,0,2.2,194242,1533,193135,107.5,84.5,3.8372727272727274,0.79,99.43
2020-08-21,Nagaland,1413,5,1411,17620,4143,2542,8.02,0,2.2,195655,1538,194546,188.32,115.55,8.00909090909091,0.79,99.43
2020-08-22,Nagaland,1476,5,1473,18689,1214,88,7.9,0,2.2,197131,1543,196019,55.18,4.0,8.495,0.78,99.44
2020-08-23,Nagaland,109,0,106,1603,2311,2098,6.8,3,2.2,197240,1543,196125,105.05,95.36,0.7286363636363636,0.78,99.43
2020-08-24,Nagaland,933,10,931,12103,3235,1134,7.71,0,2.2,198173,1553,197056,147.05,51.55,5.501363636363636,0.78,99.44
2020-08-25,Nagaland,1512,4,1512,18696,15,15,8.09,0,2.2,199685,1557,198568,0.68,0.68,8.498181818181818,0.78,99.44
2020-08-26,Nagaland,734,2,726,8768,786,21,8.37,6,2.2,200419,1559,199294,35.73,0.95,3.9854545454545454,0.78,99.44
2020-08-27,Nagaland,842,8,834,10463,4834,3943,8.05,0,2.2,201261,1567,200128,219.73,179.23,4.755909090909091,0.78,99.44
2020-08-28,Nagaland,496,6,492,6211,4163,2441,7.99,0,2.2,201757,1573,200620,189.23,110.95,2.8231818181818182,0.78,99.44
2020-08-29,Nagaland,858,10,854,10620,3768,3492,8.08,0,2.2,202615,1583,201474,171.27,158.73,4.827272727272727,0.78,99.44
2020-08-30,Nagaland,863,9,856,10854,587,367,7.95,0,2.2,203478,1592,202330,26.68,16.68,4.933636363636364,0.78,99.44
2020-08-31,Nagaland,276,3,275,3361,4313,2329,8.21,0,2.2,203754,1595,202605,196.05,105.86,1.5277272727272728,0.78,99.44
2020-09-01,Nagaland,683,6,678,8969,4131,2249,7.62,0,2.2,204437,1601,203283,187.77,102.23,4.076818181818182,0.78,99.44
2020-09-02,Nagaland,612,3,606,7182,4129,2376,8.52,3,2.2,205049,1604,203889,187.68,108.0,3.2645454545454546,0.78,99.43
2020-09-03,Nagaland,1490,7,1484,18683,1731,1103,7.98,0,2.2,206539,1611,205373,78.68,50.14,8.492272727272727,0.78,99.44
2020-09-04,Nagaland,1131,13,1128,14165,3922,2588,7.98,0,2.2,207670,1624,206501,178.27,117.64,6.4386363636363635,0.78,99.44
2020-09-05,Nagaland,143,0,142,1706,3157,244,8.38,1,2.2,207813,1624,206643,143.5,11.09,0.7754545454545455,0.78,99.44
2020-09-06,Nagaland,1255,17,1251,16188,2742,2029,7.75,0,2.2,209068,1641,207894,124.64,92.23,7.358181818181818,0.78,99.44
2020-09-07,Nagaland,727,6,726,8792,2267,287,8.27,0,2.2,209795,1647,208620,103.05,13.05,3.9963636363636366,0.79,99.44
2020-09-08,Nagaland,1533,5,1525,19491,2708,2211,7.87,3,2.2,211328,1652,210145,123.09,100.5,8.859545454545454,0.78,99.44
2020-09-09,Nagaland,392,2,384,4652,4371,1595,8.43,6,2.2,211720,1654,210529,198.68,72.5,2.1145454545454547,0.78,99.44
2020-09-10,Nagaland,1321,15,1318,16628,3819,695,7.94,0,2.2,213041,1669,211847,173.59,31.59,7.558181818181819,0.78,99.44
2020-09-11,Nagaland,1094,12,1090,13454,4360,3874,8.13,0,2.2,214135,1681,212937,198.18,176.09,6.115454545454545,0.79,99.44
2020-09-12,Nagaland,265,2,262,2928,4039,3492,9.05,1,2.2,214400,1683,213199,183.59,158.73,1.3309090909090908,0.78,99.44
2020-09-13,Nagaland,622,4,615,7291,2799,2535,8.53,3,2.2,215022,1687,213814,127.23,115.23,3.314090909090909,0.78,99.44
2020-09-14,Nagaland,1022,6,1013,12780,3837,1265,8.0,3,2.2,216044,1693,214827,174.41,57.5,5.8090909090909095,0.78,99.44
2020-09-15,Nagaland,712,7,705,8870,718,651,8.03,0,2.2,216756,1700,215532,32.64,29.59,4.031818181818182,0.78,99.44
2020-09-16,Nagaland,1232,7,1231,15800,2615,1905,7.8,0,2.2,217988,1707,216763,118.86,86.59,7.181818181818182,0.78,99.44
2020-09-17,Nagaland,1158,16,1149,14418,19,6,8.03,0,2.2,219146,1723,217912,0.86,0.27,6.553636363636364,0.79,99.44
2020-09-18,Nagaland,1560,14,1553,19788,2253,1656,7.88,0,2.2,220706,1737,219465,102.41,75.27,8.994545454545454,0.79,99.44
2020-09-19,Nagaland,597,5,596,7162,710,551,8.34,0,2.2,221303,1742,220061,32.27,25.05,3.2554545454545454,0.79,99.44
2020-09-20,Nagaland,515,2,509,6796,4205,1132,7.58,4,2.2,221818,1744,220570,191.14,51.45,3.089090909090909,0.79,99.44
2020-09-21,Nagaland,156,2,155,2146,3525,213,7.27,0,2.2,221974,1746,220725,160.23,9.68,0.9754545454545455,0.79,99.44
2020-09-22,Nagaland,498,6,491,6253,1755,643,7.96,1,2.2,222472,1752,221216,79.77,29.23,2.8422727272727273,0.79,99.44
2020-09-23,Nagaland,1093,14,1089,13491,3095,1200,8.1,0,2.2,223565,1766,222305,140.68,54.55,6.132272727272727,0.79,99.44
2020-09-24,Nagaland,1449,20,1441,18106,126,60,8.0,0,2.2,225014,1786,223746,5.73,2.73,8.23,0.79,99.44
2020-09-25,Nagaland,702,6,696,8926,541,99,7.86,0,2.2,225716,1792,224442,24.59,4.5,4.057272727272728,0.79,99.44
2020-09-26,Nagaland,1435,21,1431,17736,754,34,8.09,0,2.2,227151,1813,225873,34.27,1.55,8.061818181818182,0.8,99.44
2020-09-27,Nagaland,159,0,153,2157,1488,1365,7.37,6,2.2,227310,1813,226026,67.64,62.05,0.9804545454545455,0.8,99.44
2020-09-28,Nagaland,759,7,751,9593,3299,3165,7.91,1,2.2,228069,1820,226777,149.95,143.86,4.360454545454545,0.8,99.43
2020-09-29,Nagaland,1595,13,1588,19999,2761,1651,7.98,0,2.2,229664,1833,228365,125.5,75.05,9.090454545454545,0.8,99.43
2020-09-30,Nagaland,1505,9,1502,18325,1774,155,8.21,0,2.2,231169,1842,229867,80.64,7.05,8.329545454545455,0.8,99.44
2020-10-01,Nagaland,721,2,720,9276,2522,1629,7.77,0,2.2,231890,1844,230587,114.64,74.05,4.216363636363637,0.8,99.44
2020-10-02,Nagaland,587,3,579,7526,234,228,7.8,5,2.2,232477,1847,231166,10.64,10.36,3.420909090909091,0.79,99.44
2020-10-03,Nagaland,720,8,711,9021,2187,589,7.98,1,2.2,233197,1855,231877,99.41,26.77,4.100454545454546,0.8,99.43
2020-10-04,Nagaland,84,0,80,1150,3020,359,7.3,4,2.2,233281,1855,231957,137.27,16.32,0.5227272727272727,0.8,99.43
2020-10-05,Nagaland,1508,12,1508,19137,2210,600,7.88,0,2.2,234789,1867,233465,100.45,27.27,8.698636363636364,0.8,99.44
2020-10-06,Nagaland,237,1,231,2831,3721,2108,8.37,5,2.2,235026,1868,233696,169.14,95.82,1.2868181818181819,0.79,99.43
2020-10-07,Nagaland,1456,5,1451,18174,4821,3540,8.01,0,2.2,236482,1873,235147,219.14,160.91,8.260909090909092,0.79,99.44
2020-10-08,Nagaland,435,4,432,5429,1007,69,8.01,0,2.2,236917,1877,235579,45.77,3.14,2.4677272727272728,0.79,99.44
2020-10-09,Nagaland,1485,11,1482,18260,3507,2493,8.13,0,2.2,238402,1888,237061,159.41,113.32,8.3,0.79,99.44
2020-10-10,Nagaland,1215,13,1211,15316,479,320,7.93,0,2.2,239617,1901,238272,21.77,14.55,6.961818181818182,0.79,99.44
2020-10-11,Nagaland,869,7,863,10743,4124,3296,8.09,0,2.2,240486,1908,239135,187.45,149.82,4.883181818181818,0.79,99.44
2020-10-12,Nagaland,69,0,64,857,1114,527,8.05,5,2.2,240555,1908,239199,50.64,23.95,0.38954545454545453,0.79,99.44
2020-10-13,Nagaland,195,2,187,2830,3284,1913,6.89,6,2.2,240750,1910,239386,149.27,86.95,1.2863636363636364,0.79,99.43
2020-10-14,Nagaland,674,4,667,8246,213,197,8.17,3,2.2,241424,1914,240053,9.68,8.95,3.748181818181818,0.79,99.43
2020-10-15,Nagaland,922,4,913,11879,1547,767,7.76,5,2.2,242346,1918,240966,70.32,34.86,5.399545454545454,0.79,99.43
2020-10-16,Nagaland,1279,15,1277,15858,650,74,8.07,0,2.2,243625,1933,242243,29.55,3.36,7.208181818181818,0.79,99.43
2020-10-17,Nagaland,752,4,745,9501,1543,1225,7.91,3,2.2,244377,1937,242988,70.14,55.68,4.318636363636363,0.79,99.43
2020-10-18,Nagaland,1065,14,1061,13663,204,144,7.79,0,2.2,245442,1951,244049,9.27,6.55,6.210454545454546,0.79,99.43
2020-10-19,Nagaland,582,3,576,7208,3153,787,8.07,3,2.2,246024,1954,244625,143.32,35.77,3.2763636363636364,0.79,99.43
2020-10-20,Nagaland,911,8,909,11349,2265,742,8.03,0,2.2,246935,1962,245534,102.95,33.73,5.158636363636363,0.79,99.43
2020-10-21,Nagaland,401,3,399,5144,4552,3981,7.8,0,2.2,247336,1965,245933,206.91,180.95,2.3381818181818184,0.79,99.43
2020-10-22,Nagaland,1055,12,1050,13588,1169,1074,7.76,0,2.2,248391,1977,246983,53.14,48.82,6.176363636363637,0.8,99.43
2020-10-23,Nagaland,479,6,479,5961,4483,1648,8.04,0,2.2,248870,1983,247462,203.77,74.91,2.7095454545454545,0.8,99.43
2020-10-24,Nagaland,1176,12,1170,15145,2943,2632,7.76,0,2.2,250046,1995,248632,133.77,119.64,6.884090909090909,0.8,99.43
2020-10-25,Nagaland,1036,8,1030,13177,4194,2811,7.86,0,2.2,251082,2003,249662,190.64,127.77,5.989545454545454,0.8,99.43
2020-10-26,Nagaland,1098,13,1094,14222,3269,3060,7.72,0,2.2,252180,2016,250756,148.59,139.09,6.464545454545455,0.8,99.44
2020-10-27,Nagaland,1378,12,1375,17350,1386,427,7.94,0,2.2,253558,2028,252131,63.0,19.41,7.886363636363637,0.8,99.44
2020-10-28,Nagaland,898,4,892,11063,3124,972,8.12,2,2.2,254456,2032,253023,142.0,44.18,5.028636363636363,0.8,99.44
2020-10-29,Nagaland,625,9,618,7743,1680,1389,8.07,0,2.2,255081,2041,253641,76.36,63.14,3.5195454545454545,0.8,99.44
2020-10-30,Nagaland,147,0,147,1817,1299,1021,8.09,0,2.2,255228,2041,253788,59.05,46.41,0.8259090909090909,0.8,99.44
2020-10-31,Nagaland,964,9,961,11914,2249,2019,8.09,0,2.2,256192,2050,254749,102.23,91.77,5.415454545454545,0.8,99.44
2020-11-01,Nagaland,646,8,645,8249,2712,702,7.83,0,2.2,256838,2058,255394,123.27,31.91,3.7495454545454545,0.8,99.44
2020-11-02,Nagaland,890,4,888,10949,2263,780,8.13,0,2.2,257728,2062,256282,102.86,35.45,4.976818181818182,0.8,99.44
2020-11-03,Nagaland,561,7,554,7010,1564,526,8.0,0,2.2,258289,2069,256836,71.09,23.91,3.1863636363636365,0.8,99.44
2020-11-04,Nagaland,1163,5,1160,14317,972,963,8.12,0,2.2,259452,2074,257996,44.18,43.77,6.507727272727273,0.8,99.44
2020-11-05,Nagaland,832,3,823,10720,4318,3544,7.76,6,2.2,260284,2077,258819,196.27,161.09,4.872727272727273,0.8,99.44
2020-11-06,Nagaland,392,2,389,4067,563,523,9.64,1,2.2,260676,2079,259208,25.59,23.77,1.8486363636363636,0.8,99.44
2020-11-07,Nagaland,1453,20,1452,18546,4990,1992,7.83,0,2.2,262129,2099,260660,226.82,90.55,8.43,0.8,99.44
2020-11-08,Nagaland,670,4,670,7921,1858,1346,8.46,0,2.2,262799,2103,261330,84.45,61.18,3.6004545454545456,0.8,99.44
2020-11-09,Nagaland,935,5,926,11667,557,376,8.01,4,2.2,263734,2108,262256,25.32,17.09,5.303181818181818,0.8,99.44
2020-11-10,Nagaland,756,7,752,9691,759,190,7.8,0,2.2,264490,2115,263008,34.5,8.64,4.405,0.8,99.44
2020-11-11,Nagaland,172,0,164,2132,521,115,8.07,8,2.2,264662,2115,263172,23.68,5.23,0.9690909090909091,0.8,99.44
2020-11-12,Nagaland,1286,10,1283,15824,4874,2394,8.13,0,2.2,265948,2125,264455,221.55,108.82,7.192727272727272,0.8,99.44
2020-11-13,Nagaland,1571,19,1570,19664,708,672,7.99,0,2.2,267519,2144,266025,32.18,30.55,8.938181818181818,0.8,99.44
2020-11-14,Nagaland,983,13,974,12413,4575,3038,7.92,0,2.2,268502,2157,266999,207.95,138.09,5.6422727272727276,0.8,99.44
2020-11-15,Nagaland,1103,12,1095,13719,288,114,8.04,0,2.2,269605,2169,268094,13.09,5.18,6.235909090909091,0.8,99.44
2020-11-16,Nagaland,1285,9,1277,16060,517,25,8.0,0,2.2,270890,2178,269371,23.5,1.14,7.3,0.8,99.44
2020-11-17,Nagaland,471,2,467,5675,1785,442,8.3,2,2.2,271361,2180,269838,81.14,20.09,2.5795454545454546,0.8,99.44
2020-11-18,Nagaland,1085,15,1083,12794,2203,1765,8.48,0,2.2,272446,2195,270921,100.14,80.23,5.815454545454545,0.81,99.44
2020-11-19,Nagaland,215,2,209,2592,3942,1355,8.29,4,2.2,272661,2197,271130,179.18,61.59,1.1781818181818182,0.81,99.44
2020-11-20,Nagaland,462,2,459,5822,4160,648,7.94,1,2.2,273123,2199,271589,189.09,29.45,2.6463636363636365,0.81,99.44
2020-11-21,Nagaland,1400,15,1399,17254,117,105,8.11,0,2.2,274523,2214,272988,5.32,4.77,7.842727272727273,0.81,99.44
2020-11-22,Nagaland,788,6,784,9752,1500,490,8.08,0,2.2,275311,2220,273772,68.18,22.27,4.432727272727273,0.81,99.44
2020-11-23,Nagaland,108,0,104,1412,4369,542,7.65,4,2.2,275419,2220,273876,198.59,24.64,0.6418181818181818,0.81,99.44
2020-11-24,Nagaland,193,2,185,2274,207,127,8.49,6,2.2,275612,2222,274061,9.41,5.77,1.0336363636363637,0.81,99.44
2020-11-25,Nagaland,1577,8,1573,19705,1070,324,8.0,0,2.2,277189,2230,275634,48.64,14.73,8.956818181818182,0.8,99.44
2020-11-26,Nagaland,422,6,416,5385,452,112,7.84,0,2.2,277611,2236,276050,20.55,5.09,2.4477272727272728,0.81,99.44
2020-11-27,Nagaland,1277,6,1269,16206,1276,98,7.88,2,2.2,278888,2242,277319,58.0,4.45,7.366363636363636,0.8,99.44
2020-11-28,Nagaland,1229,16,1224,15641,3203,884,7.86,0,2.2,280117,2258,278543,145.59,40.18,7.109545454545454,0.81,99.44
2020-11-29,Nagaland,286,3,279,3977,3688,271,7.19,4,2.2,280403,2261,278822,167.64,12.32,1.8077272727272726,0.81,99.44
2020-11-30,Nagaland,1317,9,1311,16766,1571,990,7.86,0,2.2,281720,2270,280133,71.41,45.0,7.620909090909091,0.81,99.44
2020-12-01,Nagaland,617,2,609,7615,2420,1168,8.1,6,2.2,282337,2272,280742,110.0,53.09,3.4613636363636364,0.8,99.44
2020-12-02,Nagaland,1485,20,1476,18232,3531,390,8.15,0,2.2,283822,2292,282218,160.5,17.73,8.287272727272727,0.81,99.43
2020-12-03,Nagaland,821,8,816,10601,190,117,7.74,0,2.2,284643,2300,283034,8.64,5.32,4.818636363636363,0.81,99.43
2020-12-04,Nagaland,894,11,885,11337,2572,172,7.89,0,2.2,285537,2311,283919,116.91,7.82,5.153181818181818,0.81,99.43
2020-12-05,Nagaland,187,1,180,2246,4787,3712,8.33,6,2.2,285724,2312,284099,217.59,168.73,1.020909090909091,0.81,99.43
2020-12-06,Nagaland,275,2,272,3637,1904,475,7.56,1,2.2,285999,2314,284371,86.55,21.59,1.653181818181818,0.81,99.43
2020-12-07,Nagaland,167,1,165,2189,4661,1250,7.63,1,2.2,286166,2315,284536,211.86,56.82,0.995,0.81,99.43
2020-12-08,Nagaland,1010,9,1007,12362,4004,2550,8.17,0,2.2,287176,2324,285543,182.0,115.91,5.619090909090909,0.81,99.43
2020-12-09,Nagaland,887,10,886,10760,354,100,8.24,0,2.2,288063,2334,286429,16.09,4.55,4.890909090909091,0.81,99.43
2020-12-10,Nagaland,906,12,900,11466,3170,1832,7.9,0,2.2,288969,2346,287329,144.09,83.27,5.211818181818182,0.81,99.43
2020-12-11,Nagaland,387,1,378,4811,3536,1163,8.04,8,2.2,289356,2347,287707,160.73,52.86,2.186818181818182,0.81,99.43
2020-12-12,Nagaland,885,3,881,11112,2087,1462,7.96,1,2.2,290241,2350,288588,94.86,66.45,5.050909090909091,0.81,99.43
2020-12-13,Nagaland,660,4,659,8531,857,132,7.74,0,2.2,290901,2354,289247,38.95,6.0,3.877727272727273,0.81,99.43
2020-12-14,Nagaland,244,3,237,2983,2854,2516,8.18,4,2.2,291145,2357,289484,129.73,114.36,1.355909090909091,0.81,99.43
2020-12-15,Nagaland,1554,18,1551,19324,4009,419,8.04,0,2.2,292699,2375,291035,182.23,19.05,8.783636363636363,0.81,99.43
2020-12-16,Nagaland,734,3,725,9279,962,337,7.91,6,2.2,293433,2378,291760,43.73,15.32,4.217727272727273,0.81,99.43
2020-12-17,Nagaland,631,5,623,7734,4590,243,8.16,3,2.2,294064,2383,292383,208.64,11.05,3.5154545454545456,0.81,99.43
2020-12-18,Nagaland,1016,6,1014,12440,4738,4631,8.17,0,2.2,295080,2389,293397,215.36,210.5,5.654545454545454,0.81,99.43
2020-12-19,Nagaland,172,1,168,2110,2215,1097,8.15,3,2.2,295252,2390,293565,100.68,49.86,0.9590909090909091,0.81,99.43
2020-12-20,Nagaland,1090,10,1087,13964,2124,1503,7.81,0,2.2,296342,2400,294652,96.55,68.32,6.347272727272728,0.81,99.43
2020-12-21,Nagaland,968,10,960,12410,4102,2182,7.8,0,2.2,297310,2410,295612,186.45,99.18,5.640909090909091,0.81,99.43
2020-12-22,Nagaland,892,5,888,11068,3793,2913,8.06,0,2.2,298202,2415,296500,172.41,132.41,5.030909090909091,0.81,99.43
2020-12-23,Nagaland,1532,9,1524,19168,2385,804,7.99,0,2.2,299734,2424,298024,108.41,36.55,8.712727272727273,0.81,99.43
2020-12-24,Nagaland,1549,7,1543,19313,2289,2242,8.02,0,2.2,301283,2431,299567,104.05,101.91,8.778636363636364,0.81,99.43
2020-12-25,Nagaland,1539,7,1534,19141,4266,2921,8.04,0,2.2,302822,2438,301101,193.91,132.77,8.700454545454546,0.81,99.43
2020-12-26,Nagaland,1220,8,1215,15148,1742,1534,8.05,0,2.2,304042,2446,302316,79.18,69.73,6.885454545454546,0.8,99.43
2020-12-27,Nagaland,562,7,555,7214,1584,279,7.79,0,2.2,304604,2453,302871,72.0,12.68,3.2790909090909093,0.81,99.43
2020-12-28,Nagaland,1255,17,1250,15591,4134,2057,8.05,0,2.2,305859,2470,304121,187.91,93.5,7.086818181818182,0.81,99.43
2020-12-29,Nagaland,1356,4,1352,16967,4102,3846,7.99,0,2.2,307215,2474,305473,186.45,174.82,7.712272727272727,0.81,99.43
2020-12-30,Nagaland,287,3,278,3646,310,66,7.87,6,2.2,307502,2477,305751,14.09,3.0,1.6572727272727272,0.81,99.43
2020-12-31,Nagaland,1031,9,1028,13189,3390,745,7.82,0,2.2,308533,2486,306779,154.09,33.86,5.995,0.81,99.43
2021-01-01,Nagaland,1029,5,1023,12662,359,237,8.13,1,2.2,309562,2491,307802,16.32,10.77,5.755454545454546,0.8,99.43
2021-01-02,Nagaland,569,8,569,7212,398,54,7.89,0,2.2,310131,2499,308371,18.09,2.45,3.2781818181818183,0.81,99.43
2021-01-03,Nagaland,460,3,452,5281,1387,113,8.71,5,2.2,310591,2502,308823,63.05,5.14,2.4004545454545454,0.81,99.43
2021-01-04,Nagaland,355,1,352,4609,2085,1362,7.7,2,2.2,310946,2503,309175,94.77,61.91,2.095,0.8,99.43
2021-01-05,Nagaland,209,1,206,3050,4210,3040,6.85,2,2.2,311155,2504,309381,191.36,138.18,1.3863636363636365,0.8,99.43
2021-01-06,Nagaland,973,6,967,12244,3443,1962,7.95,0,2.2,312128,2510,310348,156.5,89.18,5.565454545454545,0.8,99.43
2021-01-07,Nagaland,424,2,416,5141,897,541,8.25,6,2.2,312552,2512,310764,40.77,24.59,2.336818181818182,0.8,99.43
2021-01-08,Nagaland,1387,13,1386,17442,1716,445,7.95,0,2.2,313939,2525,312150,78.0,20.23,7.928181818181818,0.8,99.43
2021-01-09,Nagaland,559,1,554,7136,2459,2093,7.83,4,2.2,314498,2526,312704,111.77,95.14,3.2436363636363637,0.8,99.43
2021-01-10,Nagaland,1348,4,1342,17000,4187,1413,7.93,2,2.2,315846,2530,314046,190.32,64.23,7.7272727272727275,0.8,99.43
2021-01-11,Nagaland,301,3,299,3889,4151,2224,7.74,0,2.2,316147,2533,314345,188.68,101.09,1.7677272727272728,0.8,99.43
2021-01-12,Nagaland,884,4,879,11400,864,207,7.75,1,2.2,317031,2537,315224,39.27,9.41,5.181818181818182,0.8,99.43
2021-01-13,Nagaland,740,5,738,9325,2206,1617,7.94,0,2.2,317771,2542,315962,100.27,73.5,4.238636363636363,0.8,99.43
2021-01-14,Nagaland,1447,8,1440,18024,798,203,8.03,0,2.2,319218,2550,317402,36.27,9.23,8.192727272727273,0.8,99.43
2021-01-15,Nagaland,1467,20,1462,18220,3154,938,8.05,0,2.2,320685,2570,318864,143.36,42.64,8.281818181818181,0.8,99.43
2021-01-16,Nagaland,1037,12,1029,12950,832,262,8.01,0,2.2,321722,2582,319893,37.82,11.91,5.886363636363637,0.8,99.43
2021-01-17,Nagaland,1513,17,1509,18767,3632,1091,8.06,0,2.2,323235,2599,321402,165.09,49.59,8.530454545454546,0.8,99.43
2021-01-18,Nagaland,1265,16,1260,15682,4907,4402,8.07,0,2.2,324500,2615,322662,223.05,200.09,7.128181818181818,0.81,99.43
2021-01-19,Nagaland,484,4,479,5761,3442,58,8.4,1,2.2,324984,2619,323141,156.45,2.64,2.6186363636363637,0.81,99.43
2021-01-20,Nagaland,691,9,691,8908,375,308,7.76,0,2.2,325675,2628,323832,17.05,14.0,4.049090909090909,0.81,99.43
2021-01-21,Nagaland,1063,10,1055,13664,644,533,7.78,0,2.2,326738,2638,324887,29.27,24.23,6.210909090909091,0.81,99.43
2021-01-22,Nagaland,604,6,596,7585,789,60,7.96,2,2.2,327342,2644,325483,35.86,2.73,3.4477272727272728,0.81,99.43
2021-01-23,Nagaland,1527,18,1527,19153,383,134,7.97,0,2.2,328869,2662,327010,17.41,6.09,8.70590909090909,0.81,99.43
2021-01-24,Nagaland,126,0,123,1954,1183,666,6.45,3,2.2,328995,2662,327133,53.77,30.27,0.8881818181818182,0.81,99.43
2021-01-25,Nagaland,1342,11,1336,16830,3299,558,7.97,0,2.2,330337,2673,328469,149.95,25.36,7.65,0.81,99.43
2021-01-26,Nagaland,1584,15,1580,19835,280,236,7.99,0,2.2,331921,2688,330049,12.73,10.73,9.01590909090909,0.81,99.44
2021-01-27,Nagaland,563,8,556,6919,1189,649,8.14,0,2.2,332484,2696,330605,54.05,29.5,3.145,0.81,99.43
2021-01-28,Nagaland,1242,11,1236,15353,4694,3868,8.09,0,2.2,333726,2707,331841,213.36,175.82,6.9786363636363635,0.81,99.44
2021-01-29,Nagaland,297,1,288,3795,3998,2113,7.83,8,2.2,334023,2708,332129,181.73,96.05,1.725,0.81,99.43
2021-01-30,Nagaland,749,8,742,9179,3435,236,8.16,0,2.2,334772,2716,332871,156.14,10.73,4.172272727272727,0.81,99.43
2021-01-31,Nagaland,950,9,946,11838,4487,2418,8.03,0,2.2,335722,2725,333817,203.95,109.91,5.380909090909091,0.81,99.43
2021-02-01,Nagaland,445,3,443,5181,3958,1635,8.59,0,2.2,336167,2728,334260,179.91,74.32,2.355,0.81,99.43
2021-02-02,Nagaland,943,4,938,11776,3614,3044,8.01,1,2.2,337110,2732,335198,164.27,138.36,5.352727272727273,0.81,99.43
2021-02-03,Nagaland,992,10,988,12011,2126,1957,8.26,0,2.2,338102,2742,336186,96.64,88.95,5.459545454545455,0.81,99.43
2021-02-04,Nagaland,1038,12,1038,12919,277,230,8.03,0,2.2,339140,2754,337224,12.59,10.45,5.872272727272727,0.81,99.44
2021-02-05,Nagaland,1563,12,1555,19969,353,92,7.83,0,2.2,340703,2766,338779,16.05,4.18,9.076818181818181,0.81,99.44
2021-02-06,Nagaland,1196,9,1195,15310,2910,628,7.81,0,2.2,341899,2775,339974,132.27,28.55,6.959090909090909,0.81,99.44
2021-02-07,Nagaland,804,8,799,10136,784,549,7.93,0,2.2,342703,2783,340773,35.64,24.95,4.607272727272727,0.81,99.44
2021-02-08,Nagaland,880,13,873,11044,1455,743,7.97,0,2.2,343583,2796,341646,66.14,33.77,5.02,0.81,99.44
2021-02-09,Nagaland,429,5,428,5643,648,233,7.6,0,2.2,344012,2801,342074,29.45,10.59,2.565,0.81,99.44
2021-02-10,Nagaland,417,3,410,5280,1282,1138,7.9,4,2.2,344429,2804,342484,58.27,51.73,2.4,0.81,99.44
2021-02-11,Nagaland,1077,9,1070,13162,3836,2325,8.18,0,2.2,345506,2813,343554,174.36,105.68,5.9827272727272724,0.81,99.44
2021-02-12,Nagaland,1592,12,1591,19397,980,778,8.21,0,2.2,347098,2825,345145,44.55,35.36,8.816818181818181,0.81,99.44
2021-02-13,Nagaland,996,3,990,12409,1164,42,8.03,3,2.2,348094,2828,346135,52.91,1.91,5.640454545454546,0.81,99.44
2021-02-14,Nagaland,735,10,732,9342,227,147,7.87,0,2.2,348829,2838,346867,10.32,6.68,4.246363636363636,0.81,99.44
2021-02-15,Nagaland,1248,5,1246,15115,544,164,8.26,0,2.2,350077,2843,348113,24.73,7.45,6.870454545454545,0.81,99.44
2021-02-16,Nagaland,536,6,529,6605,3867,3405,8.12,1,2.2,350613,2849,348642,175.77,154.77,3.0022727272727274,0.81,99.44
2021-02-17,Nagaland,1585,20,1584,19856,847,386,7.98,0,2.2,352198,2869,350226,38.5,17.55,9.025454545454545,0.81,99.44
2021-02-18,Nagaland,950,7,945,11875,4136,1903,8.0,0,2.2,353148,2876,351171,188.0,86.5,5.3977272727272725,0.81,99.44
2021-02-19,Nagaland,712,3,712,8383,255,213,8.49,0,2.2,353860,2879,351883,11.59,9.68,3.8104545454545455,0.81,99.44
2021-02-20,Nagaland,1011,4,1006,12562,3503,3247,8.05,1,2.2,354871,2883,352889,159.23,147.59,5.71,0.81,99.44
2021-02-21,Nagaland,1275,14,1267,16071,1938,1914,7.93,0,2.2,356146,2897,354156,88.09,87.0,7.305,0.81,99.44
2021-02-22,Nagaland,638,5,629,7871,4736,3842,8.11,4,2.2,356784,2902,354785,215.27,174.64,3.5777272727272726,0.81,99.44
2021-02-23,Nagaland,810,8,803,10074,2526,1825,8.04,0,2.2,357594,2910,355588,114.82,82.95,4.579090909090909,0.81,99.44
2021-02-24,Nagaland,769,10,762,9478,141,118,8.11,0,2.2,358363,2920,356350,6.41,5.36,4.308181818181819,0.81,99.44
2021-02-25,Nagaland,758,10,756,9992,2631,478,7.59,0,2.2,359121,2930,357106,119.59,21.73,4.541818181818182,0.82,99.44
2021-02-26,Nagaland,731,9,724,8756,1257,1142,8.35,0,2.2,359852,2939,357830,57.14,51.91,3.98,0.82,99.44
2021-02-27,Nagaland,221,1,219,2942,3852,3041,7.51,1,2.2,360073,2940,358049,175.09,138.23,1.3372727272727272,0.82,99.44
2021-02-28,Nagaland,1191,15,1183,14703,3740,2638,8.1,0,2.2,361264,2955,359232,170.0,119.91,6.683181818181819,0.82,99.44
2021-03-01,Nagaland,557,6,555,6364,1744,833,8.75,0,2.2,361821,2961,359787,79.27,37.86,2.8927272727272726,0.82,99.44
2021-03-02,Nagaland,1498,18,1493,18509,3908,189,8.09,0,2.2,363319,2979,361280,177.64,8.59,8.413181818181819,0.82,99.44
2021-03-03,Nagaland,238,1,232,3202,4217,1319,7.43,5,2.2,363557,2980,361512,191.68,59.95,1.4554545454545456,0.82,99.44
2021-03-04,Nagaland,1167,16,1165,14692,4194,3482,7.94,0,2.2,364724,2996,362677,190.64,158.27,6.678181818181818,0.82,99.44
2021-03-05,Nagaland,1018,13,1017,12796,2485,1781,7.96,0,2.2,365742,3009,363694,112.95,80.95,5.816363636363636,0.82,99.44
2021-03-06,Nagaland,1053,10,1045,13448,2269,1443,7.83,0,2.2,366795,3019,364739,103.14,65.59,6.112727272727272,0.82,99.44
2021-03-07,Nagaland,1131,15,1122,13931,1514,1311,8.12,0,2.2,367926,3034,365861,68.82,59.59,6.332272727272727,0.82,99.44
2021-03-08,Nagaland,865,12,859,10838,4717,3963,7.98,0,2.2,368791,3046,366720,214.41,180.14,4.926363636363637,0.83,99.44
2021-03-09,Nagaland,1153,12,1144,14649,4893,3501,7.87,0,2.2,369944,3058,367864,222.41,159.14,6.658636363636363,0.83,99.44
2021-03-10,Nagaland,1314,16,1314,16375,16,10,8.02,0,2.2,371258,3074,369178,0.73,0.45,7.443181818181818,0.83,99.44
2021-03-11,Nagaland,501,6,501,6076,499,68,8.25,0,2.2,371759,3080,369679,22.68,3.09,2.7618181818181817,0.83,99.44
2021-03-12,Nagaland,184,0,183,2337,3929,27,7.87,1,2.2,371943,3080,369862,178.59,1.23,1.0622727272727273,0.83,99.44
2021-03-13,Nagaland,284,2,279,3743,789,150,7.59,3,2.2,372227,3082,370141,35.86,6.82,1.7013636363636364,0.83,99.44
2021-03-14,Nagaland,790,11,781,10422,1650,231,7.58,0,2.2,373017,3093,370922,75.0,10.5,4.737272727272727,0.83,99.44
2021-03-15,Nagaland,147,1,140,1739,4461,1906,8.45,6,2.2,373164,3094,371062,202.77,86.64,0.7904545454545454,0.83,99.44
2021-03-16,Nagaland,813,9,808,9715,3165,104,8.37,0,2.2,373977,3103,371870,143.86,4.73,4.415909090909091,0.83,99.44
2021-03-17,Nagaland,1099,12,1097,13846,2556,2071,7.94,0,2.2,375076,3115,372967,116.18,94.14,6.293636363636364,0.83,99.44
2021-03-18,Nagaland,860,8,859,10922,2075,907,7.87,0,2.2,375936,3123,373826,94.32,41.23,4.964545454545455,0.83,99.44
2021-03-19,Nagaland,408,5,402,5355,4881,111,7.62,1,2.2,376344,3128,374228,221.86,5.05,2.434090909090909,0.83,99.44
2021-03-20,Nagaland,90,1,86,1172,3715,1490,7.68,3,2.2,376434,3129,374314,168.86,67.73,0.5327272727272727,0.83,99.44
2021-03-21,Nagaland,452,2,445,5787,3754,1839,7.81,5,2.2,376886,3131,374759,170.64,83.59,2.6304545454545454,0.83,99.44
2021-03-22,Nagaland,930,13,926,11792,3417,3285,7.89,0,2.2,377816,3144,375685,155.32,149.32,5.36,0.83,99.44
2021-03-23,Nagaland,114,1,112,1621,1852,1822,7.03,1,2.2,377930,3145,375797,84.18,82.82,0.7368181818181818,0.83,99.44
2021-03-24,Nagaland,531,7,531,6768,4020,2568,7.85,0,2.2,378461,3152,376328,182.73,116.73,3.076363636363636,0.83,99.44
2021-03-25,Nagaland,448,6,443,5353,1587,419,8.37,0,2.2,378909,3158,376771,72.14,19.05,2.433181818181818,0.83,99.44
2021-03-26,Nagaland,153,1,144,2152,3504,514,7.11,8,2.2,379062,3159,376915,159.27,23.36,0.9781818181818182,0.83,99.43
2021-03-27,Nagaland,672,6,667,8753,4762,1924,7.68,0,2.2,379734,3165,377582,216.45,87.45,3.9786363636363635,0.83,99.43
2021-03-28,Nagaland,523,7,516,6598,4023,2108,7.93,0,2.2,380257,3172,378098,182.86,95.82,2.999090909090909,0.83,99.43
2021-03-29,Nagaland,1384,13,1382,17362,4456,419,7.97,0,2.2,381641,3185,379480,202.55,19.05,7.891818181818182,0.83,99.43
2021-03-30,Nagaland,274,3,269,3743,1664,714,7.32,2,2.2,381915,3188,379749,75.64,32.45,1.7013636363636364,0.83,99.43
2021-03-31,Nagaland,162,1,161,1888,1467,114,8.58,0,2.2,382077,3189,379910,66.68,5.18,0.8581818181818182,0.83,99.43
2021-04-01,Nagaland,407,2,401,4904,3002,2232,8.3,4,2.2,382484,3191,380311,136.45,101.45,2.229090909090909,0.83,99.43
2021-04-02,Nagaland,146,1,146,1829,1411,45,7.98,0,2.2,382630,3192,380457,64.14,2.05,0.8313636363636364,0.83,99.43
2021-04-03,Nagaland,638,7,630,7817,3168,2492,8.16,1,2.2,383268,3199,381087,144.0,113.27,3.553181818181818,0.83,99.43
2021-04-04,Nagaland,1158,5,1157,14376,3746,1686,8.06,0,2.2,384426,3204,382244,170.27,76.64,6.534545454545454,0.83,99.43
2021-04-05,Nagaland,1437,15,1436,18491,1677,616,7.77,0,2.2,385863,3219,383680,76.23,28.0,8.405,0.83,99.43
2021-04-06,Nagaland,1290,17,1289,16373,754,241,7.88,0,2.2,387153,3236,384969,34.27,10.95,7.442272727272727,0.84,99.44
2021-04-07,Nagaland,1603,5,1597,19996,4562,4476,8.02,1,2.2,388756,3241,386566,207.36,203.45,9.08909090909091,0.83,99.44
2021-04-08,Nagaland,901,7,900,10893,2542,885,8.27,0,2.2,389657,3248,387466,115.55,40.23,4.951363636363636,0.83,99.44
2021-04-09,Nagaland,1086,14,1083,13650,840,193,7.96,0,2.2,390743,3262,388549,38.18,8.77,6.204545454545454,0.83,99.44
2021-04-10,Nagaland,1206,9,1206,15289,167,44,7.89,0,2.2,391949,3271,389755,7.59,2.0,6.949545454545454,0.83,99.44
2021-04-11,Nagaland,1022,12,1015,13000,3858,1178,7.86,0,2.2,392971,3283,390770,175.36,53.55,5.909090909090909,0.84,99.44
2021-04-12,Nagaland,342,3,342,4256,2896,1260,8.04,0,2.2,393313,3286,391112,131.64,57.27,1.9345454545454546,0.84,99.44
2021-04-13,Nagaland,1627,19,1625,19800,2192,338,8.22,0,2.2,394940,3305,392737,99.64,15.36,9.0,0.84,99.44
2021-04-14,Nagaland,522,6,520,6198,1747,91,8.42,0,2.2,395462,3311,393257,79.41,4.14,2.8172727272727274,0.84,99.44
2021-04-15,Nagaland,1191,3,1190,14775,1398,806,8.06,0,2.2,396653,3314,394447,63.55,36.64,6.715909090909091,0.84,99.44
2021-04-16,Nagaland,1025,13,1025,13081,4825,1856,7.84,0,2.2,397678,3327,395472,219.32,84.36,5.945909090909091,0.84,99.45
2021-04-17,Nagaland,645,8,638,8479,1105,771,7.61,0,2.2,398323,3335,396110,50.23,35.05,3.854090909090909,0.84,99.44
2021-04-18,Nagaland,1152,7,1149,14381,4623,2395,8.01,0,2.2,399475,3342,397259,210.14,108.86,6.536818181818182,0.84,99.45
2021-04-19,Nagaland,1385,7,1379,17290,3474,1397,8.01,0,2.2,400860,3349,398638,157.91,63.5,7.859090909090909,0.84,99.45
2021-04-20,Nagaland,77,0,73,1322,80,28,5.82,4,2.2,400937,3349,398711,3.64,1.27,0.600909090909091,0.84,99.44
2021-04-21,Nagaland,1172,4,1169,14754,4482,2504,7.94,0,2.2,402109,3353,399880,203.73,113.82,6.706363636363636,0.83,99.45
2021-04-22,Nagaland,101,1,98,1153,712,275,8.76,2,2.2,402210,3354,399978,32.36,12.5,0.524090909090909,0.83,99.45
2021-04-23,Nagaland,1085,12,1082,13667,1652,435,7.94,0,2.2,403295,3366,401060,75.09,19.77,6.212272727272727,0.83,99.45
2021-04-24,Nagaland,1107,16,1100,13614,998,759,8.13,0,2.2,404402,3382,402160,45.36,34.5,6.1881818181818184,0.84,99.45
2021-04-25,Nagaland,1068,10,1065,13137,4582,4301,8.13,0,2.2,405470,3392,403225,208.27,195.5,5.971363636363637,0.84,99.45
2021-04-26,Nagaland,1081,13,1080,13511,3856,1921,8.0,0,2.2,406551,3405,404305,175.27,87.32,6.141363636363637,0.84,99.45
2021-04-27,Nagaland,1335,16,1331,16509,2768,1188,8.09,0,2.2,407886,3421,405636,125.82,54.0,7.504090909090909,0.84,99.45
2021-04-28,Nagaland,1583,14,1577,19607,32,0,8.07,0,2.2,409469,3435,407213,1.45,0.0,8.912272727272727,0.84,99.45
2021-04-29,Nagaland,1065,15,1061,13876,1222,939,7.68,0,2.2,410534,3450,408274,55.55,42.68,6.307272727272728,0.84,99.45
2021-04-30,Nagaland,723,2,714,9412,1309,275,7.68,7,2.2,411257,3452,408988,59.5,12.5,4.278181818181818,0.84,99.45
2021-05-01,Nagaland,448,3,442,5524,3808,597,8.11,3,2.2,411705,3455,409430,173.09,27.14,2.5109090909090908,0.84,99.45
2021-05-02,Nagaland,707,5,701,8947,1255,1070,7.9,1,2.2,412412,3460,410131,57.05,48.64,4.066818181818181,0.84,99.45
2021-05-03,Nagaland,646,4,639,7757,337,13,8.33,3,2.2,413058,3464,410770,15.32,0.59,3.525909090909091,0.84,99.45
2021-05-04,Nagaland,759,6,751,9575,2094,1735,7.93,2,2.2,413817,3470,411521,95.18,78.86,4.3522727272727275,0.84,99.45
2021-05-05,Nagaland,836,9,834,10193,2028,755,8.2,0,2.2,414653,3479,412355,92.18,34.32,4.633181818181818,0.84,99.45
2021-05-06,Nagaland,300,3,297,3642,3637,3010,8.24,0,2.2,414953,3482,412652,165.32,136.82,1.6554545454545455,0.84,99.45
2021-05-07,Nagaland,1399,12,1399,17700,1160,1021,7.9,0,2.2,416352,3494,414051,52.73,46.41,8.045454545454545,0.84,99.45
2021-05-08,Nagaland,1467,19,1459,18895,2683,2391,7.76,0,2.2,417819,3513,415510,121.95,108.68,8.588636363636363,0.84,99.45
2021-05-09,Nagaland,1311,17,1303,16639,4786,4785,7.88,0,2.2,419130,3530,416813,217.55,217.5,7.5631818181818184,0.84,99.45
2021-05-10,Nagaland,483,6,479,6103,439,346,7.91,0,2.2,419613,3536,417292,19.95,15.73,2.774090909090909,0.84,99.45
2021-05-11,Nagaland,1467,8,1458,18042,1280,662,8.13,1,2.2,421080,3544,418750,58.18,30.09,8.200909090909091,0.84,99.45
2021-05-12,Nagaland,1119,14,1112,14105,2492,1081,7.93,0,2.2,422199,3558,419862,113.27,49.14,6.411363636363636,0.84,99.45
2021-05-13,Nagaland,516,4,508,6400,4997,1648,8.06,4,2.2,422715,3562,420370,227.14,74.91,2.909090909090909,0.84,99.45
2021-05-14,Nagaland,530,2,528,6431,2342,696,8.24,0,2.2,423245,3564,420898,106.45,31.64,2.9231818181818183,0.84,99.45
2021-05-15,Nagaland,404,5,401,5168,417,334,7.82,0,2.2,423649,3569,421299,18.95,15.18,2.349090909090909,0.84,99.45
2021-05-16,Nagaland,678,8,669,8228,2437,743,8.24,1,2.2,424327,3577,421968,110.77,33.77,3.74,0.84,99.44
2021-05-17,Nagaland,930,13,925,11321,4510,4338,8.21,0,2.2,425257,3590,422893,205.0,197.18,5.1459090909090905,0.84,99.44
2021-05-18,Nagaland,461,6,459,5514,180,133,8.36,0,2.2,425718,3596,423352,8.18,6.05,2.5063636363636363,0.84,99.44
2021-05-19,Nagaland,979,7,972,12109,4413,345,8.08,0,2.2,426697,3603,424324,200.59,15.68,5.504090909090909,0.84,99.44
2021-05-20,Nagaland,155,2,150,1721,2541,306,9.01,3,2.2,426852,3605,424474,115.5,13.91,0.7822727272727272,0.84,99.44
2021-05-21,Nagaland,527,4,522,6990,4505,3448,7.54,1,2.2,427379,3609,424996,204.77,156.73,3.1772727272727272,0.84,99.44
2021-05-22,Nagaland,1553,13,1547,19404,141,37,8.0,0,2.2,428932,3622,426543,6.41,1.68,8.82,0.84,99.44
2021-05-23,Nagaland,1394,18,1392,17736,3381,2630,7.86,0,2.2,430326,3640,427935,153.68,119.55,8.061818181818182,0.85,99.44
2021-05-24,Nagaland,1374,8,1369,17013,686,293,8.08,0,2.2,431700,3648,429304,31.18,13.32,7.733181818181818,0.85,99.44
2021-05-25,Nagaland,301,3,299,4041,848,542,7.45,0,2.2,432001,3651,429603,38.55,24.64,1.836818181818182,0.85,99.44
2021-05-26,Nagaland,683,2,682,8625,2795,1410,7.92,0,2.2,432684,3653,430285,127.05,64.09,3.9204545454545454,0.84,99.45
2021-05-27,Nagaland,772,4,764,9507,1405,870,8.12,4,2.2,433456,3657,431049,63.86,39.55,4.321363636363636,0.84,99.44
2021-05-28,Nagaland,435,4,428,5433,3177,2910,8.01,3,2.2,433891,3661,431477,144.41,132.27,2.4695454545454547,0.84,99.44
2021-05-29,Nagaland,271,3,263,3715,1882,283,7.29,5,2.2,434162,3664,431740,85.55,12.86,1.6886363636363637,0.84,99.44
2021-05-30,Nagaland,834,9,828,10282,4545,2100,8.11,0,2.2,434996,3673,432568,206.59,95.45,4.673636363636364,0.84,99.44
2021-05-31,Nagaland,565,6,556,7557,4290,1745,7.48,3,2.2,435561,3679,433124,195.0,79.32,3.435,0.84,99.44
2021-06-01,Nagaland,1165,7,1159,14844,3552,3508,7.85,0,2.2,436726,3686,434283,161.45,159.45,6.747272727272727,0.84,99.44
2021-06-02,Nagaland,1527,22,1518,19258,2674,2454,7.93,0,2.2,438253,3708,435801,121.55,111.55,8.753636363636364,0.85,99.44
2021-06-03,Nagaland,543,5,542,6382,1753,1352,8.51,0,2.2,438796,3713,436343,79.68,61.45,2.900909090909091,0.85,99.44
2021-06-04,Nagaland,631,5,630,7832,3887,915,8.06,0,2.2,439427,3718,436973,176.68,41.59,3.56,0.85,99.44
2021-06-05,Nagaland,1117,16,1109,14165,1991,1071,7.89,0,2.2,440544,3734,438082,90.5,48.68,6.4386363636363635,0.85,99.44
2021-06-06,Nagaland,576,6,572,7183,1638,307,8.02,0,2.2,441120,3740,438654,74.45,13.95,3.265,0.85,99.44
2021-06-07,Nagaland,801,7,795,10434,1819,1147,7.68,0,2.2,441921,3747,439449,82.68,52.14,4.742727272727273,0.85,99.44
2021-06-08,Nagaland,575,8,572,7611,2196,6,7.55,0,2.2,442496,3755,440021,99.82,0.27,3.4595454545454545,0.85,99.44
2021-06-09,Nagaland,546,5,539,7062,623,619,7.73,2,2.2,443042,3760,440560,28.32,28.14,3.21,0.85,99.44
2021-06-10,Nagaland,185,0,185,2729,2988,1593,6.78,0,2.2,443227,3760,440745,135.82,72.41,1.2404545454545455,0.85,99.44
2021-06-11,Nagaland,933,5,933,12264,4980,2341,7.61,0,2.2,444160,3765,441678,226.36,106.41,5.574545454545454,0.85,99.44
2021-06-12,Nagaland,1271,18,1264,15764,4134,412,8.06,0,2.2,445431,3783,442942,187.91,18.73,7.165454545454545,0.85,99.44
2021-06-13,Nagaland,1310,6,1308,16492,2463,78,7.94,0,2.2,446741,3789,444250,111.95,3.55,7.496363636363636,0.85,99.44
2021-06-14,Nagaland,1274,13,1266,15849,984,769,8.04,0,2.2,448015,3802,445516,44.73,34.95,7.204090909090909,0.85,99.44
2021-06-15,Nagaland,337,4,337,4031,4425,136,8.36,0,2.2,448352,3806,445853,201.14,6.18,1.8322727272727273,0.85,99.44
2021-06-16,Nagaland,445,2,441,5590,3700,1639,7.96,2,2.2,448797,3808,446294,168.18,74.5,2.540909090909091,0.85,99.44
2021-06-17,Nagaland,1335,16,1332,16500,3778,97,8.09,0,2.2,450132,3824,447626,171.73,4.41,7.5,0.85,99.44
2021-06-18,Nagaland,197,1,192,2813,3126,913,7.0,4,2.2,450329,3825,447818,142.09,41.5,1.2786363636363636,0.85,99.44
2021-06-19,Nagaland,732,5,724,9078,1539,1493,8.06,3,2.2,451061,3830,448542,69.95,67.86,4.126363636363636,0.85,99.44
2021-06-20,Nagaland,341,4,333,3883,4903,884,8.78,4,2.2,451402,3834,448875,222.86,40.18,1.765,0.85,99.44
2021-06-21,Nagaland,1336,19,1333,16982,4670,861,7.87,0,2.2,452738,3853,450208,212.27,39.14,7.719090909090909,0.85,99.44
2021-06-22,Nagaland,784,3,783,9404,4169,2146,8.34,0,2.2,453522,3856,450991,189.5,97.55,4.274545454545454,0.85,99.44
2021-06-23,Nagaland,1326,12,1317,16849,4165,1098,7.87,0,2.2,454848,3868,452308,189.32,49.91,7.658636363636363,0.85,99.44
2021-06-24,Nagaland,878,11,878,10671,83,13,8.23,0,2.2,455726,3879,453186,3.77,0.59,4.850454545454546,0.85,99.44
2021-06-25,Nagaland,420,3,418,5236,1359,1101,8.02,0,2.2,456146,3882,453604,61.77,50.05,2.38,0.85,99.44
2021-06-26,Nagaland,728,3,721,9564,4181,1526,7.61,4,2.2,456874,3885,454325,190.05,69.36,4.347272727272728,0.85,99.44
2021-06-27,Nagaland,885,10,877,11302,4272,3152,7.83,0,2.2,457759,3895,455202,194.18,143.27,5.137272727272728,0.85,99.44
2021-06-28,Nagaland,1427,9,1425,17697,58,42,8.06,0,2.2,459186,3904,456627,2.64,1.91,8.04409090909091,0.85,99.44
2021-06-29,Nagaland,1040,6,1033,13065,3587,27,7.96,1,2.2,460226,3910,457660,163.05,1.23,5.9386363636363635,0.85,99.44
2021-06-30,Nagaland,1338,9,1338,16198,3841,3654,8.26,0,2.2,461564,3919,458998,174.59,166.09,7.362727272727272,0.85,99.44
2021-07-01,Nagaland,160,1,158,2155,1305,192,7.42,1,2.2,461724,3920,459156,59.32,8.73,0.9795454545454545,0.85,99.44
2021-07-02,Nagaland,134,1,128,1314,1274,249,10.2,5,2.2,461858,3921,459284,57.91,11.32,0.5972727272727273,0.85,99.44
2021-07-03,Nagaland,499,3,493,6377,2333,1812,7.82,3,2.2,462357,3924,459777,106.05,82.36,2.8986363636363635,0.85,99.44
2021-07-04,Nagaland,927,5,923,11578,2122,1059,8.01,0,2.2,463284,3929,460700,96.45,48.14,5.262727272727273,0.85,99.44
2021-07-05,Nagaland,599,5,593,7317,3607,2798,8.19,1,2.2,463883,3934,461293,163.95,127.18,3.3259090909090907,0.85,99.44
2021-07-06,Nagaland,1161,6,1157,14049,4969,864,8.26,0,2.2,465044,3940,462450,225.86,39.27,6.385909090909091,0.85,99.44
2021-07-07,Nagaland,55,0,54,1004,2250,920,5.48,1,2.2,465099,3940,462504,102.27,41.82,0.45636363636363636,0.85,99.44
2021-07-08,Nagaland,1304,18,1295,16404,3405,1038,7.95,0,2.2,466403,3958,463799,154.77,47.18,7.456363636363636,0.85,99.44
2021-07-09,Nagaland,835,10,833,10018,3674,1207,8.33,0,2.2,467238,3968,464632,167.0,54.86,4.553636363636364,0.85,99.44
2021-07-10,Nagaland,155,1,153,1852,3552,381,8.37,1,2.2,467393,3969,464785,161.45,17.32,0.8418181818181818,0.85,99.44
2021-07-11,Nagaland,594,8,590,7547,368,20,7.87,0,2.2,467987,3977,465375,16.73,0.91,3.4304545454545456,0.85,99.44
2021-07-12,Nagaland,1140,4,1136,13888,3891,1286,8.21,0,2.2,469127,3981,466511,176.86,58.45,6.3127272727272725,0.85,99.44
2021-07-13,Nagaland,1523,6,1514,18888,1919,202,8.06,3,2.2,470650,3987,468025,87.23,9.18,8.585454545454546,0.85,99.44
2021-07-14,Nagaland,1235,14,1229,15459,745,256,7.99,0,2.2,471885,4001,469254,33.86,11.64,7.026818181818181,0.85,99.44
2021-07-15,Nagaland,902,5,894,11330,1730,753,7.96,3,2.2,472787,4006,470148,78.64,34.23,5.15,0.85,99.44
2021-07-16,Nagaland,729,6,722,9012,2703,1580,8.09,1,2.2,473516,4012,470870,122.86,71.82,4.096363636363637,0.85,99.44
2021-07-17,Nagaland,285,2,278,3468,1941,5,8.22,5,2.2,473801,4014,471148,88.23,0.23,1.5763636363636364,0.85,99.44
2021-07-18,Nagaland,1584,13,1575,19773,8,1,8.01,0,2.2,475385,4027,472723,0.36,0.05,8.987727272727273,0.85,99.44
2021-07-19,Nagaland,1211,11,1205,15363,2579,2495,7.88,0,2.2,476596,4038,473928,117.23,113.41,6.983181818181818,0.85,99.44
2021-07-20,Nagaland,1101,4,1097,14203,3791,1074,7.75,0,2.2,477697,4042,475025,172.32,48.82,6.455909090909091,0.85,99.44
2021-07-21,Nagaland,866,6,864,10910,1086,909,7.94,0,2.2,478563,4048,475889,49.36,41.32,4.959090909090909,0.85,99.44
2021-07-22,Nagaland,479,6,471,6279,3340,1674,7.63,2,2.2,479042,4054,476360,151.82,76.09,2.854090909090909,0.85,99.44
2021-07-23,Nagaland,714,6,711,8647,1838,1441,8.26,0,2.2,479756,4060,477071,83.55,65.5,3.9304545454545456,0.85,99.44
2021-07-24,Nagaland,1272,12,1264,15380,2864,1238,8.27,0,2.2,481028,4072,478335,130.18,56.27,6.990909090909091,0.85,99.44
2021-07-25,Nagaland,604,4,595,7547,1039,96,8.0,5,2.2,481632,4076,478930,47.23,4.36,3.4304545454545456,0.85,99.44
2021-07-26,Nagaland,1364,6,1362,16789,3525,2576,8.12,0,2.2,482996,4082,480292,160.23,117.09,7.631363636363637,0.85,99.44
2021-07-27,Nagaland,147,1,143,1583,359,184,9.29,3,2.2,483143,4083,480435,16.32,8.36,0.7195454545454546,0.85,99.44
2021-07-28,Nagaland,692,8,683,8565,4798,3964,8.08,1,2.2,483835,4091,481118,218.09,180.18,3.893181818181818,0.85,99.44
2021-07-29,Nagaland,765,5,757,9534,1558,1483,8.02,3,2.2,484600,4096,481875,70.82,67.41,4.333636363636364,0.85,99.44
2021-07-30,Nagaland,1329,4,1327,16908,3949,3019,7.86,0,2.2,485929,4100,483202,179.5,137.23,7.6854545454545455,0.84,99.44
2021-07-31,Nagaland,479,6,477,6096,4945,681,7.86,0,2.2,486408,4106,483679,224.77,30.95,2.770909090909091,0.84,99.44
2021-08-01,Nagaland,1422,18,1413,17785,3220,810,8.0,0,2.2,487830,4124,485092,146.36,36.82,8.084090909090909,0.85,99.44
2021-08-02,Nagaland,395,3,392,4946,2314,1608,7.99,0,2.2,488225,4127,485484,105.18,73.09,2.248181818181818,0.85,99.44
2021-08-03,Nagaland,1219,8,1213,15159,714,19,8.04,0,2.2,489444,4135,486697,32.45,0.86,6.890454545454546,0.84,99.44
2021-08-04,Nagaland,272,2,265,2738,2055,407,9.93,5,2.2,489716,4137,486962,93.41,18.5,1.2445454545454546,0.84,99.44
2021-08-05,Nagaland,400,4,398,4942,2371,31,8.09,0,2.2,490116,4141,487360,107.77,1.41,2.2463636363636366,0.84,99.44
2021-08-06,Nagaland,996,4,993,12753,676,446,7.81,0,2.2,491112,4145,488353,30.73,20.27,5.796818181818182,0.84,99.44
2021-08-07,Nagaland,131,0,130,1671,2513,1377,7.84,1,2.2,491243,4145,488483,114.23,62.59,0.7595454545454545,0.84,99.44
2021-08-08,Nagaland,79,0,71,1226,257,152,6.44,8,2.2,491322,4145,488554,11.68,6.91,0.5572727272727273,0.84,99.44
2021-08-09,Nagaland,113,0,113,1125,2226,2025,10.04,0,2.2,491435,4145,488667,101.18,92.05,0.5113636363636364,0.84,99.44
2021-08-10,Nagaland,1305,18,1304,16458,271,4,7.93,0,2.2,492740,4163,489971,12.32,0.18,7.4809090909090905,0.84,99.44
2021-08-11,Nagaland,568,8,567,6891,3789,818,8.24,0,2.2,493308,4171,490538,172.23,37.18,3.1322727272727273,0.85,99.44
2021-08-12,Nagaland,1600,22,1598,19997,970,351,8.0,0,2.2,494908,4193,492136,44.09,15.95,9.089545454545455,0.85,99.44
2021-08-13,Nagaland,348,3,340,4400,250,198,7.91,5,2.2,495256,4196,492476,11.36,9.0,2.0,0.85,99.44
2021-08-14,Nagaland,1475,16,1472,18790,4090,1290,7.85,0,2.2,496731,4212,493948,185.91,58.64,8.540909090909091,0.85,99.44
2021-08-15,Nagaland,1045,12,1040,12669,2635,1623,8.25,0,2.2,497776,4224,494988,119.77,73.77,5.758636363636364,0.85,99.44
2021-08-16,Nagaland,1225,15,1219,15383,4057,2073,7.96,0,2.2,499001,4239,496207,184.41,94.23,6.992272727272727,0.85,99.44
2021-08-17,Nagaland,1473,20,1473,18630,1343,83,7.91,0,2.2,500474,4259,497680,61.05,3.77,8.468181818181819,0.85,99.44
2021-08-18,Nagaland,115,1,114,1497,4098,3465,7.68,0,2.2,500589,4260,497794,186.27,157.5,0.6804545454545454,0.85,99.44
2021-08-19,Nagaland,1128,5,1119,14400,1815,250,7.83,4,2.2,501717,4265,498913,82.5,11.36,6.545454545454546,0.85,99.44
2021-08-20,Nagaland,563,7,556,7085,4296,217,7.95,0,2.2,502280,4272,499469,195.27,9.86,3.2204545454545452,0.85,99.44
2021-08-21,Nagaland,642,9,636,7939,214,136,8.09,0,2.2,502922,4281,500105,9.73,6.18,3.6086363636363634,0.85,99.44
2021-08-22,Nagaland,524,4,518,6552,4599,1995,8.0,2,2.2,503446,4285,500623,209.05,90.68,2.978181818181818,0.85,99.44
2021-08-23,Nagaland,380,4,377,4984,4728,2019,7.62,0,2.2,503826,4289,501000,214.91,91.77,2.2654545454545456,0.85,99.44
2021-08-24,Nagaland,404,1,400,4994,3246,1316,8.09,3,2.2,504230,4290,501400,147.55,59.82,2.27,0.85,99.44
2021-08-25,Nagaland,1187,13,1179,14805,2933,2854,8.02,0,2.2,505417,4303,502579,133.32,129.73,6.7295454545454545,0.85,99.44
2021-08-26,Nagaland,1105,5,1098,14197,3789,275,7.78,2,2.2,506522,4308,503677,172.23,12.5,6.453181818181818,0.85,99.44
2021-08-27,Nagaland,1456,18,1454,18265,2771,1335,7.97,0,2.2,507978,4326,505131,125.95,60.68,8.302272727272728,0.85,99.44
2021-08-28,Nagaland,559,7,559,6867,3576,646,8.14,0,2.2,508537,4333,505690,162.55,29.36,3.1213636363636366,0.85,99.44
2021-08-29,Nagaland,471,6,471,5430,4223,4157,8.67,0,2.2,509008,4339,506161,191.95,188.95,2.4681818181818183,0.85,99.44
2021-08-30,Nagaland,72,0,65,963,2586,1379,7.48,7,2.2,509080,4339,506226,117.55,62.68,0.43772727272727274,0.85,99.44
2021-08-31,Nagaland,1458,4,1458,18205,2037,450,8.01,0,2.2,510538,4343,507684,92.59,20.45,8.275,0.85,99.44
2021-09-01,Nagaland,893,11,884,11111,3031,217,8.04,0,2.2,511431,4354,508568,137.77,9.86,5.050454545454546,0.85,99.44
2021-09-02,Nagaland,713,4,711,8967,697,341,7.95,0,2.2,512144,4358,509279,31.68,15.5,4.075909090909091,0.85,99.44
2021-09-03,Nagaland,906,9,904,11378,2251,500,7.96,0,2.2,513050,4367,510183,102.32,22.73,5.171818181818182,0.85,99.44
2021-09-04,Nagaland,898,4,892,11064,1701,673,8.12,2,2.2,513948,4371,511075,77.32,30.59,5.029090909090909,0.85,99.44
2021-09-05,Nagaland,1432,15,1424,18047,2438,1233,7.93,0,2.2,515380,4386,512499,110.82,56.05,8.203181818181818,0.85,99.44
2021-09-06,Nagaland,901,8,899,11479,45,43,7.85,0,2.2,516281,4394,513398,2.05,1.95,5.217727272727273,0.85,99.44
2021-09-07,Nagaland,757,7,748,9639,49,4,7.85,2,2.2,517038,4401,514146,2.23,0.18,4.381363636363637,0.85,99.44
2021-09-08,Nagaland,556,7,550,7049,286,83,7.89,0,2.2,517594,4408,514696,13.0,3.77,3.204090909090909,0.85,99.44
2021-09-09,Nagaland,325,3,323,3906,2080,453,8.32,0,2.2,517919,4411,515019,94.55,20.59,1.7754545454545454,0.85,99.44
2021-09-10,Nagaland,831,3,831,10579,649,177,7.86,0,2.2,518750,4414,515850,29.5,8.05,4.808636363636364,0.85,99.44
2021-09-11,Nagaland,474,1,471,5571,386,259,8.51,2,2.2,519224,4415,516321,17.55,11.77,2.5322727272727272,0.85,99.44
2021-09-12,Nagaland,213,2,209,2560,4785,3405,8.32,2,2.2,519437,4417,516530,217.5,154.77,1.1636363636363636,0.85,99.44
2021-09-13,Nagaland,90,0,87,1044,4969,1405,8.62,3,2.2,519527,4417,516617,225.86,63.86,0.47454545454545455,0.85,99.44
2021-09-14,Nagaland,81,0,80,968,3940,2393,8.37,1,2.2,519608,4417,516697,179.09,108.77,0.44,0.85,99.44
2021-09-15,Nagaland,1204,7,1196,14686,2353,1396,8.2,1,2.2,520812,4424,517893,106.95,63.45,6.675454545454546,0.85,99.44
2021-09-16,Nagaland,717,2,708,9024,712,557,7.95,7,2.2,521529,4426,518601,32.36,25.32,4.101818181818182,0.85,99.44
2021-09-17,Nagaland,375,1,371,4466,142,120,8.4,3,2.2,521904,4427,518972,6.45,5.45,2.03,0.85,99.44
2021-09-18,Nagaland,98,0,89,1425,2050,1362,6.88,9,2.2,522002,4427,519061,93.18,61.91,0.6477272727272727,0.85,99.44
2021-09-19,Nagaland,1100,10,1091,13900,599,580,7.91,0,2.2,523102,4437,520152,27.23,26.36,6.318181818181818,0.85,99.44
2021-09-20,Nagaland,323,4,315,3922,2917,2836,8.24,4,2.2,523425,4441,520467,132.59,128.91,1.7827272727272727,0.85,99.43
2021-09-21,Nagaland,1373,18,1368,17716,21,6,7.75,0,2.2,524798,4459,521835,0.95,0.27,8.052727272727273,0.85,99.44
2021-09-22,Nagaland,235,1,232,3172,4230,2718,7.41,2,2.2,525033,4460,522067,192.27,123.55,1.4418181818181819,0.85,99.44
2021-09-23,Nagaland,1044,5,1044,13307,3960,1155,7.85,0,2.2,526077,4465,523111,180.0,52.5,6.048636363636364,0.85,99.44
2021-09-24,Nagaland,607,4,606,7507,3064,1997,8.09,0,2.2,526684,4469,523717,139.27,90.77,3.412272727272727,0.85,99.44
2021-09-25,Nagaland,338,2,333,4062,611,171,8.32,3,2.2,527022,4471,524050,27.77,7.77,1.8463636363636364,0.85,99.44
2021-09-26,Nagaland,162,0,153,1853,1515,1206,8.74,9,2.2,527184,4471,524203,68.86,54.82,0.8422727272727273,0.85,99.43
2021-09-27,Nagaland,721,4,716,9307,3714,409,7.75,1,2.2,527905,4475,524919,168.82,18.59,4.2304545454545455,0.85,99.43
2021-09-28,Nagaland,923,13,917,11518,787,594,8.01,0,2.2,528828,4488,525836,35.77,27.0,5.235454545454545,0.85,99.43
2021-09-29,Nagaland,1518,18,1515,19444,4044,2891,7.81,0,2.2,530346,4506,527351,183.82,131.41,8.838181818181818,0.85,99.44
2021-09-30,Nagaland,252,3,252,3429,1489,510,7.35,0,2.2,530598,4509,527603,67.68,23.18,1.5586363636363636,0.85,99.44
2021-10-01,Nagaland,1286,14,1282,15764,556,189,8.16,0,2.2,531884,4523,528885,25.27,8.59,7.165454545454545,0.85,99.44
2021-10-02,Nagaland,882,5,878,10433,443,197,8.45,0,2.2,532766,4528,529763,20.14,8.95,4.742272727272727,0.85,99.44
2021-10-03,Nagaland,733,9,726,9003,266,241,8.14,0,2.2,533499,4537,530489,12.09,10.95,4.092272727272727,0.85,99.44
2021-10-04,Nagaland,1493,7,1493,18790,3451,1836,7.95,0,2.2,534992,4544,531982,156.86,83.45,8.540909090909091,0.85,99.44
2021-10-05,Nagaland,1121,5,1112,14189,4602,1779,7.9,4,2.2,536113,4549,533094,209.18,80.86,6.449545454545454,0.85,99.44
2021-10-06,Nagaland,344,3,344,3965,1795,680,8.68,0,2.2,536457,4552,533438,81.59,30.91,1.8022727272727272,0.85,99.44
2021-10-07,Nagaland,1524,13,1519,19664,4084,1933,7.75,0,2.2,537981,4565,534957,185.64,87.86,8.938181818181818,0.85,99.44
2021-10-08,Nagaland,1074,6,1068,13438,3859,2836,7.99,0,2.2,539055,4571,536025,175.41,128.91,6.108181818181818,0.85,99.44
2021-10-09,Nagaland,832,3,829,10523,744,43,7.91,0,2.2,539887,4574,536854,33.82,1.95,4.783181818181818,0.85,99.44
2021-10-10,Nagaland,416,1,408,4840,3663,2443,8.6,7,2.2,540303,4575,537262,166.5,111.05,2.2,0.85,99.44
2021-10-11,Nagaland,1321,10,1321,16360,2272,1167,8.07,0,2.2,541624,4585,538583,103.27,53.05,7.4363636363636365,0.85,99.44
2021-10-12,Nagaland,785,8,777,9867,3038,1891,7.96,0,2.2,542409,4593,539360,138.09,85.95,4.485,0.85,99.44
2021-10-13,Nagaland,1140,10,1137,14050,655,81,8.11,0,2.2,543549,4603,540497,29.77,3.68,6.386363636363637,0.85,99.44
2021-10-14,Nagaland,85,0,85,1420,1014,925,5.99,0,2.2,543634,4603,540582,46.09,42.05,0.6454545454545455,0.85,99.44
2021-10-15,Nagaland,910,7,906,10770,1243,892,8.45,0,2.2,544544,4610,541488,56.5,40.55,4.8954545454545455,0.85,99.44
2021-10-16,Nagaland,902,10,893,11339,1633,1251,7.95,0,2.2,545446,4620,542381,74.23,56.86,5.154090909090909,0.85,99.44
2021-10-17,Nagaland,1174,14,1170,14862,2551,2316,7.9,0,2.2,546620,4634,543551,115.95,105.27,6.755454545454546,0.85,99.44
2021-10-18,Nagaland,1599,16,1597,19920,377,253,8.03,0,2.2,548219,4650,545148,17.14,11.5,9.054545454545455,0.85,99.44
2021-10-19,Nagaland,1554,18,1547,19712,2698,1822,7.88,0,2.2,549773,4668,546695,122.64,82.82,8.96,0.85,99.44
2021-10-20,Nagaland,1035,3,1031,12554,2661,1384,8.24,1,2.2,550808,4671,547726,120.95,62.91,5.706363636363636,0.85,99.44
2021-10-21,Nagaland,446,1,437,5904,4904,1822,7.55,8,2.2,551254,4672,548163,222.91,82.82,2.6836363636363636,0.85,99.44
2021-10-22,Nagaland,1336,18,1336,16463,3352,2204,8.12,0,2.2,552590,4690,549499,152.36,100.18,7.483181818181818,0.85,99.44
2021-10-23,Nagaland,680,9,672,8697,4243,882,7.82,0,2.2,553270,4699,550171,192.86,40.09,3.953181818181818,0.85,99.44
2021-10-24,Nagaland,1203,15,1197,15243,174,108,7.89,0,2.2,554473,4714,551368,7.91,4.91,6.928636363636364,0.85,99.44
2021-10-25,Nagaland,249,2,245,2841,2743,2719,8.76,2,2.2,554722,4716,551613,124.68,123.59,1.2913636363636363,0.85,99.44
2021-10-26,Nagaland,1443,8,1438,17722,347,60,8.14,0,2.2,556165,4724,553051,15.77,2.73,8.055454545454545,0.85,99.44
2021-10-27,Nagaland,1020,10,1017,12624,3647,414,8.08,0,2.2,557185,4734,554068,165.77,18.82,5.738181818181818,0.85,99.44
2021-10-28,Nagaland,1420,4,1417,17960,2198,1323,7.91,0,2.2,558605,4738,555485,99.91,60.14,8.163636363636364,0.85,99.44
2021-10-29,Nagaland,1253,10,1246,15963,4783,4125,7.85,0,2.2,559858,4748,556731,217.41,187.5,7.255909090909091,0.85,99.44
2021-10-30,Nagaland,787,5,779,9906,1678,861,7.94,3,2.2,560645,4753,557510,76.27,39.14,4.502727272727273,0.85,99.44
2021-10-31,Nagaland,563,2,557,6950,3212,1217,8.1,4,2.2,561208,4755,558067,146.0,55.32,3.159090909090909,0.85,99.44
2021-11-01,Nagaland,1489,7,1486,18552,1112,971,8.03,0,2.2,562697,4762,559553,50.55,44.14,8.432727272727274,0.85,99.44
2021-11-02,Nagaland,424,3,423,5292,3250,1474,8.01,0,2.2,563121,4765,559976,147.73,67.0,2.4054545454545453,0.85,99.44
2021-11-03,Nagaland,1539,19,1538,19405,876,517,7.93,0,2.2,564660,4784,561514,39.82,23.5,8.820454545454545,0.85,99.44
2021-11-04,Nagaland,1470,16,1463,18561,3815,1246,7.92,0,2.2,566130,4800,562977,173.41,56.64,8.436818181818182,0.85,99.44
2021-11-05,Nagaland,1032,10,1030,13251,320,317,7.79,0,2.2,567162,4810,564007,14.55,14.41,6.023181818181818,0.85,99.44
2021-11-06,Nagaland,596,4,590,7477,3672,48,7.97,2,2.2,567758,4814,564597,166.91,2.18,3.3986363636363635,0.85,99.44
2021-11-07,Nagaland,691,4,685,8497,926,904,8.13,2,2.2,568449,4818,565282,42.09,41.09,3.8622727272727273,0.85,99.44
2021-11-08,Nagaland,197,1,191,2510,203,11,7.85,5,2.2,568646,4819,565473,9.23,0.5,1.1409090909090909,0.85,99.44
2021-11-09,Nagaland,1287,12,1278,16392,2450,899,7.85,0,2.2,569933,4831,566751,111.36,40.86,7.450909090909091,0.85,99.44
2021-11-10,Nagaland,1463,12,1456,18776,2856,494,7.79,0,2.2,571396,4843,568207,129.82,22.45,8.534545454545455,0.85,99.44
2021-11-11,Nagaland,1365,13,1358,16680,767,717,8.18,0,2.2,572761,4856,569565,34.86,32.59,7.581818181818182,0.85,99.44
2021-11-12,Nagaland,1484,12,1484,18935,1903,657,7.84,0,2.2,574245,4868,571049,86.5,29.86,8.606818181818182,0.85,99.44
2021-11-13,Nagaland,50,0,47,707,2311,559,7.07,3,2.2,574295,4868,571096,105.05,25.41,0.32136363636363635,0.85,99.44
2021-11-14,Nagaland,175,2,169,2569,3509,2568,6.81,4,2.2,574470,4870,571265,159.5,116.73,1.1677272727272727,0.85,99.44
2021-11-15,Nagaland,860,10,857,10618,2381,37,8.1,0,2.2,575330,4880,572122,108.23,1.68,4.826363636363636,0.85,99.44
2021-11-16,Nagaland,784,4,780,9818,2159,1236,7.99,0,2.2,576114,4884,572902,98.14,56.18,4.462727272727273,0.85,99.44
2021-11-17,Nagaland,932,5,927,11784,432,405,7.91,0,2.2,577046,4889,573829,19.64,18.41,5.356363636363636,0.85,99.44
2021-11-18,Nagaland,508,6,507,6334,2569,383,8.02,0,2.2,577554,4895,574336,116.77,17.41,2.879090909090909,0.85,99.44
2021-11-19,Nagaland,107,0,102,1260,4152,3384,8.49,5,2.2,577661,4895,574438,188.73,153.82,0.5727272727272728,0.85,99.44
2021-11-20,Nagaland,1291,4,1286,16007,455,74,8.07,1,2.2,578952,4899,575724,20.68,3.36,7.275909090909091,0.85,99.44
2021-11-21,Nagaland,135,1,131,1549,3839,1352,8.72,3,2.2,579087,4900,575855,174.5,61.45,0.7040909090909091,0.85,99.44
2021-11-22,Nagaland,1260,10,1254,15886,4381,2711,7.93,0,2.2,580347,4910,577109,199.14,123.23,7.220909090909091,0.85,99.44
2021-11-23,Nagaland,39,0,33,688,129,121,5.67,6,2.2,580386,4910,577142,5.86,5.5,0.31272727272727274,0.85,99.44
2021-11-24,Nagaland,83,1,74,1536,937,456,5.4,8,2.2,580469,4911,577216,42.59,20.73,0.6981818181818182,0.85,99.44
2021-11-25,Nagaland,533,1,528,6400,1475,596,8.33,4,2.2,581002,4912,577744,67.05,27.09,2.909090909090909,0.85,99.44
2021-11-26,Nagaland,1052,3,1051,13375,4946,1251,7.87,0,2.2,582054,4915,578795,224.82,56.86,6.079545454545454,0.84,99.44
2021-11-27,Nagaland,1206,9,1199,14582,52,21,8.27,0,2.2,583260,4924,579994,2.36,0.95,6.628181818181818,0.84,99.44
2021-11-28,Nagaland,260,1,258,3228,4559,3512,8.05,1,2.2,583520,4925,580252,207.23,159.64,1.4672727272727273,0.84,99.44
2021-11-29,Nagaland,472,4,470,5307,2543,1322,8.89,0,2.2,583992,4929,580722,115.59,60.09,2.412272727272727,0.84,99.44
2021-11-30,Nagaland,642,5,641,7937,2281,87,8.09,0,2.2,584634,4934,581363,103.68,3.95,3.607727272727273,0.84,99.44
2021-12-01,Nagaland,1436,19,1433,17925,4347,1098,8.01,0,2.2,586070,4953,582796,197.59,49.91,8.147727272727273,0.85,99.44
2021-12-02,Nagaland,1497,12,1494,18600,152,17,8.05,0,2.2,587567,4965,584290,6.91,0.77,8.454545454545455,0.85,99.44
2021-12-03,Nagaland,871,3,867,10522,4913,3110,8.28,1,2.2,588438,4968,585157,223.32,141.36,4.782727272727273,0.84,99.44
2021-12-04,Nagaland,128,0,125,1409,1993,131,9.08,3,2.2,588566,4968,585282,90.59,5.95,0.6404545454545455,0.84,99.44
2021-12-05,Nagaland,259,2,254,3602,3314,370,7.19,3,2.2,588825,4970,585536,150.64,16.82,1.6372727272727272,0.84,99.44
2021-12-06,Nagaland,113,0,105,1466,2197,31,7.71,8,2.2,588938,4970,585641,99.86,1.41,0.6663636363636364,0.84,99.44
2021-12-07,Nagaland,751,10,742,9192,2386,1022,8.17,0,2.2,589689,4980,586383,108.45,46.45,4.178181818181818,0.84,99.44
2021-12-08,Nagaland,994,8,987,12616,1378,182,7.88,0,2.2,590683,4988,587370,62.64,8.27,5.734545454545454,0.84,99.44
2021-12-09,Nagaland,1421,14,1414,17883,13,4,7.95,0,2.2,592104,5002,588784,0.59,0.18,8.128636363636364,0.84,99.44
2021-12-10,Nagaland,716,5,709,9425,4315,1213,7.6,2,2.2,592820,5007,589493,196.14,55.14,4.284090909090909,0.84,99.44
2021-12-11,Nagaland,1485,6,1484,18478,1056,445,8.04,0,2.2,594305,5013,590977,48.0,20.23,8.399090909090908,0.84,99.44
2021-12-12,Nagaland,1134,5,1130,14560,1181,647,7.79,0,2.2,595439,5018,592107,53.68,29.41,6.618181818181818,0.84,99.44
2021-12-13,Nagaland,1118,7,1115,14526,2979,319,7.7,0,2.2,596557,5025,593222,135.41,14.5,6.602727272727273,0.84,99.44
2021-12-14,Nagaland,208,2,205,2601,4671,2090,8.0,1,2.2,596765,5027,593427,212.32,95.0,1.1822727272727274,0.84,99.44
2021-12-15,Nagaland,690,3,687,8419,3139,2161,8.2,0,2.2,597455,5030,594114,142.68,98.23,3.8268181818181817,0.84,99.44
2021-12-16,Nagaland,1599,19,1592,19859,2790,1719,8.05,0,2.2,599054,5049,595706,126.82,78.14,9.026818181818182,0.84,99.44
2021-12-17,Nagaland,873,5,868,11092,3264,380,7.87,0,2.2,599927,5054,596574,148.36,17.27,5.041818181818182,0.84,99.44
2021-12-18,Nagaland,241,1,236,2834,3609,3573,8.5,4,2.2,600168,5055,596810,164.05,162.41,1.288181818181818,0.84,99.44
2021-12-19,Nagaland,1524,8,1523,19408,4835,4307,7.85,0,2.2,601692,5063,598333,219.77,195.77,8.821818181818182,0.84,99.44
2021-12-20,Nagaland,678,5,677,8735,14,12,7.76,0,2.2,602370,5068,599010,0.64,0.55,3.9704545454545452,0.84,99.44
2021-12-21,Nagaland,1215,13,1215,15107,3942,3517,8.04,0,2.2,603585,5081,600225,179.18,159.86,6.866818181818182,0.84,99.44
2021-12-22,Nagaland,1584,17,1576,19782,2790,776,8.01,0,2.2,605169,5098,601801,126.82,35.27,8.991818181818182,0.84,99.44
2021-12-23,Nagaland,484,4,484,6369,4070,2088,7.6,0,2.2,605653,5102,602285,185.0,94.91,2.895,0.84,99.44
2021-12-24,Nagaland,1238,4,1232,15382,4825,1042,8.05,2,2.2,606891,5106,603517,219.32,47.36,6.991818181818182,0.84,99.44
2021-12-25,Nagaland,850,11,846,10361,4142,104,8.2,0,2.2,607741,5117,604363,188.27,4.73,4.709545454545455,0.84,99.44
2021-12-26,Nagaland,438,3,435,5378,864,788,8.14,0,2.2,608179,5120,604798,39.27,35.82,2.4445454545454544,0.84,99.44
2021-12-27,Nagaland,579,6,575,7138,4399,2980,8.11,0,2.2,608758,5126,605373,199.95,135.45,3.2445454545454546,0.84,99.44
2021-12-28,Nagaland,609,5,600,7640,51,31,7.97,4,2.2,609367,5131,605973,2.32,1.41,3.4727272727272727,0.84,99.44
2021-12-29,Nagaland,674,8,669,8305,846,163,8.12,0,2.2,610041,5139,606642,38.45,7.41,3.775,0.84,99.44
2021-12-30,Nagaland,1013,8,1009,12660,3359,1352,8.0,0,2.2,611054,5147,607651,152.68,61.45,5.754545454545455,0.84,99.44
2021-12-31,Nagaland,491,4,482,5933,2743,637,8.28,5,2.2,611545,5151,608133,124.68,28.95,2.696818181818182,0.84,99.44
2022-01-01,Nagaland,803,11,803,9899,3973,3924,8.11,0,2.2,612348,5162,608936,180.59,178.36,4.499545454545455,0.84,99.44
2022-01-02,Nagaland,545,7,541,6619,177,163,8.23,0,2.2,612893,5169,609477,8.05,7.41,3.0086363636363638,0.84,99.44
2022-01-03,Nagaland,893,8,889,11538,1814,1679,7.74,0,2.2,613786,5177,610366,82.45,76.32,5.244545454545454,0.84,99.44
2022-01-04,Nagaland,809,2,800,10304,3181,857,7.85,7,2.2,614595,5179,611166,144.59,38.95,4.683636363636364,0.84,99.44
2022-01-05,Nagaland,253,1,244,3563,2832,2275,7.1,8,2.2,614848,5180,611410,128.73,103.41,1.6195454545454546,0.84,99.44
2022-01-06,Nagaland,571,7,565,7299,4077,668,7.82,0,2.2,615419,5187,611975,185.32,30.36,3.317727272727273,0.84,99.44
2022-01-07,Nagaland,865,2,860,10953,3454,3188,7.9,3,2.2,616284,5189,612835,157.0,144.91,4.9786363636363635,0.84,99.44
2022-01-08,Nagaland,210,2,206,2174,4086,2124,9.66,2,2.2,616494,5191,613041,185.73,96.55,0.9881818181818182,0.84,99.44
2022-01-09,Nagaland,646,8,638,7655,3948,2271,8.44,0,2.2,617140,5199,613679,179.45,103.23,3.4795454545454545,0.84,99.44
2022-01-10,Nagaland,321,2,319,4034,1388,840,7.96,0,2.2,617461,5201,613998,63.09,38.18,1.8336363636363637,0.84,99.44
2022-01-11,Nagaland,50,0,43,714,4290,1605,7.0,7,2.2,617511,5201,614041,195.0,72.95,0.3245454545454545,0.84,99.44
2022-01-12,Nagaland,1197,3,1189,14781,4837,1731,8.1,5,2.2,618708,5204,615230,219.86,78.68,6.718636363636364,0.84,99.44
2022-01-13,Nagaland,907,9,901,11517,2345,2025,7.88,0,2.2,619615,5213,616131,106.59,92.05,5.235,0.84,99.44
2022-01-14,Nagaland,698,3,691,8801,2030,809,7.93,4,2.2,620313,5216,616822,92.27,36.77,4.000454545454545,0.84,99.44
2022-01-15,Nagaland,116,1,109,1242,4445,3987,9.34,6,2.2,620429,5217,616931,202.05,181.23,0.5645454545454546,0.84,99.44
2022-01-16,Nagaland,987,5,986,12541,4222,2109,7.87,0,2.2,621416,5222,617917,191.91,95.86,5.700454545454545,0.84,99.44
2022-01-17,Nagaland,1224,14,1220,15125,2639,1609,8.09,0,2.2,622640,5236,619137,119.95,73.14,6.875,0.84,99.44
2022-01-18,Nagaland,603,2,598,7412,1908,61,8.14,3,2.2,623243,5238,619735,86.73,2.77,3.369090909090909,0.84,99.44
2022-01-19,Nagaland,442,4,440,5483,3840,3556,8.06,0,2.2,623685,5242,620175,174.55,161.64,2.492272727272727,0.84,99.44
2022-01-20,Nagaland,507,6,499,6410,122,22,7.91,2,2.2,624192,5248,620674,5.55,1.0,2.9136363636363636,0.84,99.44
2022-01-21,Nagaland,843,6,837,10204,2191,2056,8.26,0,2.2,625035,5254,621511,99.59,93.45,4.638181818181818,0.84,99.44
2022-01-22,Nagaland,1335,6,1333,16342,1386,1258,8.17,0,2.2,626370,5260,622844,63.0,57.18,7.428181818181818,0.84,99.44
2022-01-23,Nagaland,1461,21,1459,18561,1766,1295,7.87,0,2.2,627831,5281,624303,80.27,58.86,8.436818181818182,0.84,99.44
2022-01-24,Nagaland,1375,9,1369,17269,2881,792,7.96,0,2.2,629206,5290,625672,130.95,36.0,7.849545454545455,0.84,99.44
2022-01-25,Nagaland,840,6,834,10161,4139,2606,8.27,0,2.2,630046,5296,626506,188.14,118.45,4.618636363636363,0.84,99.44
2022-01-26,Nagaland,1053,13,1044,12516,712,583,8.41,0,2.2,631099,5309,627550,32.36,26.5,5.689090909090909,0.84,99.44
2022-01-27,Nagaland,1180,5,1176,14239,3552,922,8.29,0,2.2,632279,5314,628726,161.45,41.91,6.472272727272728,0.84,99.44
2022-01-28,Nagaland,101,0,92,1554,4080,1524,6.5,9,2.2,632380,5314,628818,185.45,69.27,0.7063636363636364,0.84,99.44
2022-01-29,Nagaland,1233,13,1232,15179,4763,1135,8.12,0,2.2,633613,5327,630050,216.5,51.59,6.899545454545454,0.84,99.44
2022-01-30,Nagaland,537,5,532,6681,4305,2659,8.04,0,2.2,634150,5332,630582,195.68,120.86,3.0368181818181816,0.84,99.44
2022-01-31,Nagaland,904,4,901,11114,3861,90,8.13,0,2.2,635054,5336,631483,175.5,4.09,5.051818181818182,0.84,99.44
2022-02-01,Nagaland,1025,4,1020,12838,4107,2156,7.98,1,2.2,636079,5340,632503,186.68,98.0,5.835454545454546,0.84,99.44
2022-02-02,Nagaland,279,3,272,2987,1721,711,9.34,4,2.2,636358,5343,632775,78.23,32.32,1.3577272727272727,0.84,99.44
2022-02-03,Nagaland,1469,18,1460,18198,3781,2110,8.07,0,2.2,637827,5361,634235,171.86,95.91,8.271818181818182,0.84,99.44
2022-02-04,Nagaland,312,2,303,3691,1769,1579,8.45,7,2.2,638139,5363,634538,80.41,71.77,1.6777272727272727,0.84,99.44
2022-02-05,Nagaland,925,6,917,11493,2197,781,8.05,2,2.2,639064,5369,635455,99.86,35.5,5.224090909090909,0.84,99.44
2022-02-06,Nagaland,821,3,817,10705,62,37,7.67,1,2.2,639885,5372,636272,2.82,1.68,4.865909090909091,0.84,99.44
2022-02-07,Nagaland,1151,11,1144,14495,1880,1198,7.94,0,2.2,641036,5383,637416,85.45,54.45,6.588636363636364,0.84,99.44
2022-02-08,Nagaland,1156,15,1152,14047,575,23,8.23,0,2.2,642192,5398,638568,26.14,1.05,6.385,0.84,99.44
2022-02-09,Nagaland,617,7,609,8219,197,114,7.51,1,2.2,642809,5405,639177,8.95,5.18,3.735909090909091,0.84,99.43
2022-02-10,Nagaland,479,6,472,6358,3397,237,7.53,1,2.2,643288,5411,639649,154.41,10.77,2.89,0.84,99.43
2022-02-11,Nagaland,1134,14,1131,14629,2002,231,7.75,0,2.2,644422,5425,640780,91.0,10.5,6.649545454545454,0.84,99.43
2022-02-12,Nagaland,352,4,346,4232,2281,1758,8.32,2,2.2,644774,5429,641126,103.68,79.91,1.9236363636363636,0.84,99.43
2022-02-13,Nagaland,1606,17,1598,19988,4776,1900,8.03,0,2.2,646380,5446,642724,217.09,86.36,9.085454545454546,0.84,99.43
2022-02-14,Nagaland,885,9,881,10947,3111,2188,8.08,0,2.2,647265,5455,643605,141.41,99.45,4.975909090909091,0.84,99.43
2022-02-15,Nagaland,890,8,885,11302,2352,2334,7.87,0,2.2,648155,5463,644490,106.91,106.09,5.137272727272728,0.84,99.43
2022-02-16,Nagaland,52,0,46,715,3946,1917,7.27,6,2.2,648207,5463,644536,179.36,87.14,0.325,0.84,99.43
2022-02-17,Nagaland,1480,16,1479,18378,4557,3202,8.05,0,2.2,649687,5479,646015,207.14,145.55,8.353636363636364,0.84,99.43
2022-02-18,Nagaland,236,3,236,3025,4860,2781,7.8,0,2.2,649923,5482,646251,220.91,126.41,1.375,0.84,99.44
2022-02-19,Nagaland,617,3,613,7664,1522,406,8.05,1,2.2,650540,5485,646864,69.18,18.45,3.4836363636363634,0.84,99.43
2022-02-20,Nagaland,245,1,241,3502,801,550,7.0,3,2.2,650785,5486,647105,36.41,25.0,1.5918181818181818,0.84,99.43
2022-02-21,Nagaland,1515,16,1511,19331,3889,2903,7.84,0,2.2,652300,5502,648616,176.77,131.95,8.786818181818182,0.84,99.44
2022-02-22,Nagaland,1227,4,1220,15375,4768,1589,7.98,3,2.2,653527,5506,649836,216.73,72.23,6.988636363636363,0.84,99.44
2022-02-23,Nagaland,1080,11,1074,13386,1313,1211,8.07,0,2.2,654607,5517,650910,59.68,55.05,6.084545454545455,0.84,99.44
2022-02-24,Nagaland,1290,12,1289,16105,4268,2064,8.01,0,2.2,655897,5529,652199,194.0,93.82,7.320454545454545,0.84,99.44
2022-02-25,Nagaland,293,4,284,3755,3647,1397,7.8,5,2.2,656190,5533,652483,165.77,63.5,1.7068181818181818,0.84,99.44
2022-02-26,Nagaland,718,4,715,9103,4818,2367,7.89,0,2.2,656908,5537,653198,219.0,107.59,4.137727272727273,0.84,99.44
2022-02-27,Nagaland,784,3,783,9980,1903,1602,7.86,0,2.2,657692,5540,653981,86.5,72.82,4.536363636363636,0.84,99.44
2022-02-28,Nagaland,675,2,673,8577,4010,2315,7.87,0,2.2,658367,5542,654654,182.27,105.23,3.8986363636363635,0.84,99.44
2022-03-01,Nagaland,42,0,38,544,460,305,7.72,4,2.2,658409,5542,654692,20.91,13.86,0.24727272727272728,0.84,99.44
2022-03-02,Nagaland,1488,20,1480,18657,1278,315,7.98,0,2.2,659897,5562,656172,58.09,14.32,8.480454545454545,0.84,99.44
2022-03-03,Nagaland,1560,9,1555,19535,4114,3163,7.99,0,2.2,661457,5571,657727,187.0,143.77,8.879545454545454,0.84,99.44
2022-03-04,Nagaland,60,0,58,1039,4809,3462,5.77,2,2.2,661517,5571,657785,218.59,157.36,0.4722727272727273,0.84,99.44
2022-03-05,Nagaland,1587,15,1579,19781,2162,214,8.02,0,2.2,663104,5586,659364,98.27,9.73,8.991363636363637,0.84,99.44
2022-03-06,Nagaland,602,6,599,7340,3189,1330,8.2,0,2.2,663706,5592,659963,144.95,60.45,3.3363636363636364,0.84,99.44
2022-03-07,Nagaland,58,0,58,758,4601,682,7.65,0,2.2,663764,5592,660021,209.14,31.0,0.34454545454545454,0.84,99.44
2022-03-08,Nagaland,1562,12,1562,19228,3776,546,8.12,0,2.2,665326,5604,661583,171.64,24.82,8.74,0.84,99.44
2022-03-09,Nagaland,18,0,18,694,172,62,2.59,0,2.2,665344,5604,661601,7.82,2.82,0.31545454545454543,0.84,99.44
2022-03-10,Nagaland,864,3,857,11070,3219,658,7.8,4,2.2,666208,5607,662458,146.32,29.91,5.031818181818182,0.84,99.44
2022-03-11,Nagaland,1587,18,1582,19923,1052,752,7.97,0,2.2,667795,5625,664040,47.82,34.18,9.055909090909092,0.84,99.44
2022-03-12,Nagaland,646,2,643,7764,3651,455,8.32,1,2.2,668441,5627,664683,165.95,20.68,3.5290909090909093,0.84,99.44
2022-03-13,Nagaland,1591,15,1584,19721,1145,856,8.07,0,2.2,670032,5642,666267,52.05,38.91,8.96409090909091,0.84,99.44
2022-03-14,Nagaland,1419,17,1418,17431,612,98,8.14,0,2.2,671451,5659,667685,27.82,4.45,7.923181818181818,0.84,99.44
2022-03-15,Nagaland,320,1,318,3971,4324,3577,8.06,1,2.2,671771,5660,668003,196.55,162.59,1.805,0.84,99.44
2022-03-16,Nagaland,229,1,220,3513,1156,398,6.52,8,2.2,672000,5661,668223,52.55,18.09,1.596818181818182,0.84,99.44
2022-03-17,Nagaland,1493,12,1489,19046,2604,1699,7.84,0,2.2,673493,5673,669712,118.36,77.23,8.657272727272728,0.84,99.44
2022-03-18,Nagaland,244,2,242,2981,3946,3095,8.19,0,2.2,673737,5675,669954,179.36,140.68,1.355,0.84,99.44
2022-03-19,Nagaland,1406,12,1401,17606,4093,2516,7.99,0,2.2,675143,5687,671355,186.05,114.36,8.002727272727272,0.84,99.44
2022-03-20,Nagaland,274,2,270,3708,462,148,7.39,2,2.2,675417,5689,671625,21.0,6.73,1.6854545454545455,0.84,99.44
2022-03-21,Nagaland,1424,9,1419,17806,2685,1297,8.0,0,2.2,676841,5698,673044,122.05,58.95,8.093636363636364,0.84,99.44
2022-03-22,Nagaland,1302,10,1302,16509,2724,1933,7.89,0,2.2,678143,5708,674346,123.82,87.86,7.504090909090909,0.84,99.44
2022-03-23,Nagaland,732,3,731,8904,1355,663,8.22,0,2.2,678875,5711,675077,61.59,30.14,4.047272727272727,0.84,99.44
2022-03-24,Nagaland,1557,15,1557,19424,1098,306,8.02,0,2.2,680432,5726,676634,49.91,13.91,8.829090909090908,0.84,99.44
2022-03-25,Nagaland,982,9,981,12302,2661,276,7.98,0,2.2,681414,5735,677615,120.95,12.55,5.591818181818182,0.84,99.44
2022-03-26,Nagaland,1247,17,1241,15612,1558,1437,7.99,0,2.2,682661,5752,678856,70.82,65.32,7.096363636363637,0.84,99.44
2022-03-27,Nagaland,115,1,115,1018,789,499,11.3,0,2.2,682776,5753,678971,35.86,22.68,0.4627272727272727,0.84,99.44
2022-03-28,Nagaland,1303,7,1301,16518,502,101,7.89,0,2.2,684079,5760,680272,22.82,4.59,7.508181818181818,0.84,99.44
2022-03-29,Nagaland,693,4,689,8585,2355,576,8.07,0,2.2,684772,5764,680961,107.05,26.18,3.9022727272727273,0.84,99.44
2022-03-30,Nagaland,411,3,411,5591,4998,2850,7.35,0,2.2,685183,5767,681372,227.18,129.55,2.5413636363636365,0.84,99.44
2022-03-31,Nagaland,885,6,879,10981,2009,1660,8.06,0,2.2,686068,5773,682251,91.32,75.45,4.991363636363636,0.84,99.44
2022-04-01,Nagaland,1001,5,1001,12160,4362,807,8.23,0,2.2,687069,5778,683252,198.27,36.68,5.527272727272727,0.84,99.44
2022-04-02,Nagaland,1184,15,1178,14420,39,35,8.21,0,2.2,688253,5793,684430,1.77,1.59,6.554545454545455,0.84,99.44
2022-04-03,Nagaland,832,3,827,10468,61,22,7.95,2,2.2,689085,5796,685257,2.77,1.0,4.758181818181818,0.84,99.44
2022-04-04,Nagaland,810,8,803,10268,4740,1707,7.89,0,2.2,689895,5804,686060,215.45,77.59,4.667272727272727,0.84,99.44
2022-04-05,Nagaland,374,2,370,4661,29,8,8.02,2,2.2,690269,5806,686430,1.32,0.36,2.1186363636363637,0.84,99.44
2022-04-06,Nagaland,1402,14,1393,17631,4640,245,7.95,0,2.2,691671,5820,687823,210.91,11.14,8.014090909090909,0.84,99.44
2022-04-07,Nagaland,765,4,756,9301,4528,522,8.22,5,2.2,692436,5824,688579,205.82,23.73,4.227727272727273,0.84,99.44
2022-04-08,Nagaland,1195,15,1193,14964,24,0,7.99,0,2.2,693631,5839,689772,1.09,0.0,6.801818181818182,0.84,99.44
2022-04-09,Nagaland,617,5,614,8269,1137,6,7.46,0,2.2,694248,5844,690386,51.68,0.27,3.7586363636363638,0.84,99.44
2022-04-10,Nagaland,1637,9,1630,19786,3576,996,8.27,0,2.2,695885,5853,692016,162.55,45.27,8.993636363636364,0.84,99.44
2022-04-11,Nagaland,1273,14,1265,16202,1890,596,7.86,0,2.2,697158,5867,693281,85.91,27.09,7.364545454545454,0.84,99.44
2022-04-12,Nagaland,406,2,401,5294,3248,2140,7.67,3,2.2,697564,5869,693682,147.64,97.27,2.4063636363636363,0.84,99.44
2022-04-13,Nagaland,1368,9,1367,17112,3767,778,7.99,0,2.2,698932,5878,695049,171.23,35.36,7.778181818181818,0.84,99.44
2022-04-14,Nagaland,271,1,266,3228,1947,1802,8.4,4,2.2,699203,5879,695315,88.5,81.91,1.4672727272727273,0.84,99.44
2022-04-15,Nagaland,1443,10,1440,17820,1240,207,8.1,0,2.2,700646,5889,696755,56.36,9.41,8.1,0.84,99.44
2022-04-16,Nagaland,745,8,739,9495,3766,1089,7.85,0,2.2,701391,5897,697494,171.18,49.5,4.3159090909090905,0.84,99.44
2022-04-17,Nagaland,961,6,956,12176,4086,744,7.89,0,2.2,702352,5903,698450,185.73,33.82,5.534545454545454,0.84,99.44
2022-04-18,Nagaland,598,3,598,7643,4358,1388,7.82,0,2.2,702950,5906,699048,198.09,63.09,3.474090909090909,0.84,99.44
2022-04-19,Nagaland,555,6,553,6826,2888,1421,8.13,0,2.2,703505,5912,699601,131.27,64.59,3.1027272727272726,0.84,99.45
2022-04-20,Nagaland,1196,15,1194,14532,3519,2611,8.23,0,2.2,704701,5927,700795,159.95,118.68,6.6054545454545455,0.84,99.45
2022-04-21,Nagaland,865,5,859,10950,930,597,7.9,1,2.2,705566,5932,701654,42.27,27.14,4.9772727272727275,0.84,99.45
2022-04-22,Nagaland,1125,13,1116,14004,114,114,8.03,0,2.2,706691,5945,702770,5.18,5.18,6.365454545454545,0.84,99.45
2022-04-23,Nagaland,1550,10,1544,19634,3699,519,7.89,0,2.2,708241,5955,704314,168.14,23.59,8.924545454545454,0.84,99.45
2022-04-24,Nagaland,430,3,422,5303,3514,1879,8.11,5,2.2,708671,5958,704736,159.73,85.41,2.4104545454545456,0.84,99.44
2022-04-25,Nagaland,798,7,791,10604,1629,1031,7.53,0,2.2,709469,5965,705527,74.05,46.86,4.82,0.84,99.44
2022-04-26,Nagaland,195,1,190,2484,4012,3231,7.85,4,2.2,709664,5966,705717,182.36,146.86,1.1290909090909091,0.84,99.44
2022-04-27,Nagaland,64,0,62,1061,4212,2106,6.03,2,2.2,709728,5966,705779,191.45,95.73,0.4822727272727273,0.84,99.44
2022-04-28,Nagaland,1388,14,1387,16934,2666,433,8.2,0,2.2,711116,5980,707166,121.18,19.68,7.697272727272727,0.84,99.44
2022-04-29,Nagaland,133,1,126,1615,253,178,8.24,6,2.2,711249,5981,707292,11.5,8.09,0.7340909090909091,0.84,99.44
2022-04-30,Nagaland,115,1,115,1484,1526,1127,7.75,0,2.2,711364,5982,707407,69.36,51.23,0.6745454545454546,0.84,99.44
2022-05-01,Nagaland,279,0,275,3544,1473,1314,7.87,4,2.2,711643,5982,707682,66.95,59.73,1.6109090909090908,0.84,99.44
2022-05-02,Nagaland,459,4,457,6095,4235,1999,7.53,0,2.2,712102,5986,708139,192.5,90.86,2.7704545454545455,0.84,99.44
2022-05-03,Nagaland,1093,6,1090,13855,1569,1191,7.89,0,2.2,713195,5992,709229,71.32,54.14,6.297727272727273,0.84,99.44
2022-05-04,Nagaland,641,4,633,8250,627,486,7.77,4,2.2,713836,5996,709862,28.5,22.09,3.75,0.84,99.44
2022-05-05,Nagaland,1140,14,1138,14649,1652,1079,7.78,0,2.2,714976,6010,711000,75.09,49.05,6.658636363636363,0.84,99.44
2022-05-06,Nagaland,938,7,936,11391,4796,1879,8.23,0,2.2,715914,6017,711936,218.0,85.41,5.177727272727273,0.84,99.44
2022-05-07,Nagaland,148,1,143,2080,1947,1686,7.12,4,2.2,716062,6018,712079,88.5,76.64,0.9454545454545454,0.84,99.44
2022-05-08,Nagaland,897,12,888,11451,226,123,7.83,0,2.2,716959,6030,712967,10.27,5.59,5.205,0.84,99.44
2022-05-09,Nagaland,874,11,869,11138,2770,674,7.85,0,2.2,717833,6041,713836,125.91,30.64,5.0627272727272725,0.84,99.44
2022-05-10,Nagaland,324,2,318,4051,3106,2597,8.0,4,2.2,718157,6043,714154,141.18,118.05,1.8413636363636363,0.84,99.44
2022-05-11,Nagaland,580,3,578,7577,2144,1830,7.65,0,2.2,718737,6046,714732,97.45,83.18,3.444090909090909,0.84,99.44
2022-05-12,Nagaland,1095,15,1090,13875,926,733,7.89,0,2.2,719832,6061,715822,42.09,33.32,6.306818181818182,0.84,99.44
2022-05-13,Nagaland,1136,6,1132,14606,17,14,7.78,0,2.2,720968,6067,716954,0.77,0.64,6.639090909090909,0.84,99.44
2022-05-14,Nagaland,1011,4,1002,12252,4544,3259,8.25,5,2.2,721979,6071,717956,206.55,148.14,5.569090909090909,0.84,99.44
2022-05-15,Nagaland,1035,13,1028,12956,4246,139,7.99,0,2.2,723014,6084,718984,193.0,6.32,5.889090909090909,0.84,99.44
2022-05-16,Nagaland,491,3,489,5909,1607,1307,8.31,0,2.2,723505,6087,719473,73.05,59.41,2.685909090909091,0.84,99.44
2022-05-17,Nagaland,1320,14,1320,16268,4327,2375,8.11,0,2.2,724825,6101,720793,196.68,107.95,7.3945454545454545,0.84,99.44
2022-05-18,Nagaland,1177,16,1175,14942,3627,673,7.88,0,2.2,726002,6117,721968,164.86,30.59,6.791818181818182,0.84,99.44
2022-05-19,Nagaland,400,2,391,4935,331,49,8.11,7,2.2,726402,6119,722359,15.05,2.23,2.243181818181818,0.84,99.44
2022-05-20,Nagaland,510,5,503,6128,308,174,8.32,2,2.2,726912,6124,722862,14.0,7.91,2.7854545454545456,0.84,99.44
2022-05-21,Nagaland,1180,14,1176,14280,4350,1974,8.26,0,2.2,728092,6138,724038,197.73,89.73,6.490909090909091,0.84,99.44
2022-05-22,Nagaland,1086,15,1082,13186,938,929,8.24,0,2.2,729178,6153,725120,42.64,42.23,5.993636363636363,0.84,99.44
2022-05-23,Nagaland,994,5,989,12319,3657,1841,8.07,0,2.2,730172,6158,726109,166.23,83.68,5.599545454545455,0.84,99.44
2022-05-24,Nagaland,658,4,656,8457,4588,4196,7.78,0,2.2,730830,6162,726765,208.55,190.73,3.8440909090909092,0.84,99.44
2022-05-25,Nagaland,1532,16,1524,18793,4640,2756,8.15,0,2.2,732362,6178,728289,210.91,125.27,8.542272727272728,0.84,99.44
2022-05-26,Nagaland,843,6,839,10633,2041,1953,7.93,0,2.2,733205,6184,729128,92.77,88.77,4.833181818181818,0.84,99.44
2022-05-27,Nagaland,934,13,932,11512,430,149,8.11,0,2.2,734139,6197,730060,19.55,6.77,5.2327272727272724,0.84,99.44
2022-05-28,Nagaland,251,1,245,3014,953,496,8.33,5,2.2,734390,6198,730305,43.32,22.55,1.37,0.84,99.44
2022-05-29,Nagaland,543,5,541,7212,250,204,7.53,0,2.2,734933,6203,730846,11.36,9.27,3.2781818181818183,0.84,99.44
2022-05-30,Nagaland,299,3,294,4388,792,760,6.81,2,2.2,735232,6206,731140,36.0,34.55,1.9945454545454546,0.84,99.44
2022-05-31,Nagaland,468,2,468,5826,2036,1974,8.03,0,2.2,735700,6208,731608,92.55,89.73,2.648181818181818,0.84,99.44
2022-06-01,Nagaland,144,1,142,1612,2725,1577,8.93,1,2.2,735844,6209,731750,123.86,71.68,0.7327272727272728,0.84,99.44
2022-06-02,Nagaland,1484,4,1480,18255,967,362,8.13,0,2.2,737328,6213,733230,43.95,16.45,8.297727272727272,0.84,99.44
2022-06-03,Nagaland,616,5,607,7593,1832,1429,8.11,4,2.2,737944,6218,733837,83.27,64.95,3.451363636363636,0.84,99.44
2022-06-04,Nagaland,773,6,768,9241,4311,429,8.36,0,2.2,738717,6224,734605,195.95,19.5,4.200454545454545,0.84,99.44
2022-06-05,Nagaland,1548,20,1546,19496,3270,1640,7.94,0,2.2,740265,6244,736151,148.64,74.55,8.861818181818181,0.84,99.44
2022-06-06,Nagaland,1086,4,1086,13516,3707,475,8.03,0,2.2,741351,6248,737237,168.5,21.59,6.143636363636364,0.84,99.45
2022-06-07,Nagaland,720,2,713,8911,747,410,8.08,5,2.2,742071,6250,737950,33.95,18.64,4.050454545454546,0.84,99.44
2022-06-08,Nagaland,569,5,568,6761,1962,137,8.42,0,2.2,742640,6255,738518,89.18,6.23,3.0731818181818182,0.84,99.44
2022-06-09,Nagaland,1309,14,1308,16315,577,391,8.02,0,2.2,743949,6269,739826,26.23,17.77,7.415909090909091,0.84,99.45
2022-06-10,Nagaland,1185,8,1184,14664,3398,1256,8.08,0,2.2,745134,6277,741010,154.45,57.09,6.665454545454545,0.84,99.45
2022-06-11,Nagaland,1262,6,1260,16295,621,621,7.74,0,2.2,746396,6283,742270,28.23,28.23,7.406818181818182,0.84,99.45
2022-06-12,Nagaland,632,7,630,8252,2145,611,7.66,0,2.2,747028,6290,742900,97.5,27.77,3.750909090909091,0.84,99.45
2022-06-13,Nagaland,1459,14,1456,18203,681,452,8.02,0,2.2,748487,6304,744356,30.95,20.55,8.274090909090908,0.84,99.45
2022-06-14,Nagaland,871,10,866,11288,669,664,7.72,0,2.2,749358,6314,745222,30.41,30.18,5.130909090909091,0.84,99.45
2022-06-15,Nagaland,462,6,454,6417,1719,132,7.2,2,2.2,749820,6320,745676,78.14,6.0,2.916818181818182,0.84,99.45
2022-06-16,Nagaland,1008,3,1007,12488,1683,823,8.07,0,2.2,750828,6323,746683,76.5,37.41,5.676363636363637,0.84,99.45
2022-06-17,Nagaland,1014,10,1009,12629,3578,3356,8.03,0,2.2,751842,6333,747692,162.64,152.55,5.740454545454545,0.84,99.45
2022-06-18,Nagaland,1322,12,1316,16502,3166,2401,8.01,0,2.2,753164,6345,749008,143.91,109.14,7.500909090909091,0.84,99.45
2022-06-19,Nagaland,240,2,233,3007,1589,818,7.98,5,2.2,753404,6347,749241,72.23,37.18,1.3668181818181817,0.84,99.45
2022-06-20,Nagaland,686,2,678,8638,4054,1634,7.94,6,2.2,754090,6349,749919,184.27,74.27,3.9263636363636363,0.84,99.45
2022-06-21,Nagaland,91,0,84,1121,3347,2103,8.12,7,2.2,754181,6349,750003,152.14,95.59,0.5095454545454545,0.84,99.45
2022-06-22,Nagaland,261,1,253,2899,3334,2752,9.0,7,2.2,754442,6350,750256,151.55,125.09,1.3177272727272726,0.84,99.45
2022-06-23,Nagaland,1043,11,1042,12721,3327,2303,8.2,0,2.2,755485,6361,751298,151.23,104.68,5.782272727272727,0.84,99.45
2022-06-24,Nagaland,900,7,892,11573,1743,662,7.78,1,2.2,756385,6368,752190,79.23,30.09,5.260454545454546,0.84,99.45
2022-06-25,Nagaland,570,2,566,7109,2986,329,8.02,2,2.2,756955,6370,752756,135.73,14.95,3.2313636363636364,0.84,99.45
2022-06-26,Nagaland,580,7,577,7033,4535,322,8.25,0,2.2,757535,6377,753333,206.14,14.64,3.196818181818182,0.84,99.45
2022-06-27,Nagaland,111,0,111,1350,1589,365,8.22,0,2.2,757646,6377,753444,72.23,16.59,0.6136363636363636,0.84,99.45
2022-06-28,Nagaland,1456,14,1456,17917,259,14,8.13,0,2.2,759102,6391,754900,11.77,0.64,8.14409090909091,0.84,99.45
2022-06-29,Nagaland,1593,14,1590,19915,3791,994,8.0,0,2.2,760695,6405,756490,172.32,45.18,9.052272727272728,0.84,99.45
2022-06-30,Nagaland,669,9,665,8091,4364,648,8.27,0,2.2,761364,6414,757155,198.36,29.45,3.6777272727272727,0.84,99.45
2022-07-01,Nagaland,1110,3,1109,14276,4085,2973,7.78,0,2.2,762474,6417,758264,185.68,135.14,6.489090909090909,0.84,99.45
2022-07-02,Nagaland,1561,6,1561,19477,518,80,8.01,0,2.2,764035,6423,759825,23.55,3.64,8.853181818181818,0.84,99.45
2022-07-03,Nagaland,941,10,933,11778,1245,407,7.99,0,2.2,764976,6433,760758,56.59,18.5,5.3536363636363635,0.84,99.45
2022-07-04,Nagaland,534,3,527,6642,4511,72,8.04,4,2.2,765510,6436,761285,205.05,3.27,3.019090909090909,0.84,99.45
2022-07-05,Nagaland,1126,4,1121,13879,2397,2256,8.11,1,2.2,766636,6440,762406,108.95,102.55,6.308636363636364,0.84,99.45
2022-07-06,Nagaland,115,1,115,1901,3955,1323,6.05,0,2.2,766751,6441,762521,179.77,60.14,0.8640909090909091,0.84,99.45
2022-07-07,Nagaland,866,10,861,10984,4246,4057,7.88,0,2.2,767617,6451,763382,193.0,184.41,4.992727272727273,0.84,99.45
2022-07-08,Nagaland,1130,11,1123,14562,2548,2068,7.76,0,2.2,768747,6462,764505,115.82,94.0,6.619090909090909,0.84,99.45
2022-07-09,Nagaland,600,6,600,7664,3771,2078,7.83,0,2.2,769347,6468,765105,171.41,94.45,3.4836363636363634,0.84,99.45
2022-07-10,Nagaland,1110,7,1110,13815,4836,2255,8.03,0,2.2,770457,6475,766215,219.82,102.5,6.279545454545454,0.84,99.45
2022-07-11,Nagaland,981,4,979,12409,2407,1270,7.91,0,2.2,771438,6479,767194,109.41,57.73,5.640454545454546,0.84,99.45
2022-07-12,Nagaland,1317,18,1314,16226,4967,4424,8.12,0,2.2,772755,6497,768508,225.77,201.09,7.375454545454545,0.84,99.45
2022-07-13,Nagaland,1460,13,1459,17832,1158,722,8.19,0,2.2,774215,6510,769967,52.64,32.82,8.105454545454545,0.84,99.45
2022-07-14,Nagaland,215,2,206,2403,1901,1065,8.95,7,2.2,774430,6512,770173,86.41,48.41,1.0922727272727273,0.84,99.45
2022-07-15,Nagaland,1223,18,1219,15472,2360,289,7.9,0,2.2,775653,6530,771392,107.27,13.14,7.032727272727273,0.84,99.45
2022-07-16,Nagaland,57,0,49,626,325,41,9.11,8,2.2,775710,6530,771441,14.77,1.86,0.28454545454545455,0.84,99.45
2022-07-17,Nagaland,543,5,535,7193,2721,1875,7.55,3,2.2,776253,6535,771976,123.68,85.23,3.2695454545454545,0.84,99.45
2022-07-18,Nagaland,1517,6,1513,19188,4342,2203,7.91,0,2.2,777770,6541,773489,197.36,100.14,8.721818181818183,0.84,99.45
2022-07-19,Nagaland,1388,6,1385,17625,2721,750,7.88,0,2.2,779158,6547,774874,123.68,34.09,8.011363636363637,0.84,99.45
2022-07-20,Nagaland,277,1,269,3712,2657,1349,7.46,7,2.2,779435,6548,775143,120.77,61.32,1.6872727272727273,0.84,99.45
2022-07-21,Nagaland,1278,18,1272,16036,1035,900,7.97,0,2.2,780713,6566,776415,47.05,40.91,7.289090909090909,0.84,99.45
2022-07-22,Nagaland,1294,15,1291,16337,184,88,7.92,0,2.2,782007,6581,777706,8.36,4.0,7.425909090909091,0.84,99.45
2022-07-23,Nagaland,263,0,259,3138,3934,2523,8.38,4,2.2,782270,6581,777965,178.82,114.68,1.4263636363636363,0.84,99.45
2022-07-24,Nagaland,1005,13,1001,12752,439,369,7.88,0,2.2,783275,6594,778966,19.95,16.77,5.796363636363636,0.84,99.45
2022-07-25,Nagaland,744,8,743,9503,3808,2953,7.83,0,2.2,784019,6602,779709,173.09,134.23,4.319545454545454,0.84,99.45
2022-07-26,Nagaland,1207,3,1198,15259,556,63,7.91,6,2.2,785226,6605,780907,25.27,2.86,6.935909090909091,0.84,99.45
2022-07-27,Nagaland,376,4,369,4115,537,376,9.14,3,2.2,785602,6609,781276,24.41,17.09,1.8704545454545454,0.84,99.45
2022-07-28,Nagaland,1241,7,1236,15791,3824,2974,7.86,0,2.2,786843,6616,782512,173.82,135.18,7.177727272727273,0.84,99.45
2022-07-29,Nagaland,304,3,297,3964,821,758,7.67,4,2.2,787147,6619,782809,37.32,34.45,1.8018181818181818,0.84,99.45
2022-07-30,Nagaland,645,4,644,7913,2246,238,8.15,0,2.2,787792,6623,783453,102.09,10.82,3.5968181818181817,0.84,99.45
2022-07-31,Nagaland,1423,14,1422,17822,358,173,7.98,0,2.2,789215,6637,784875,16.27,7.86,8.100909090909092,0.84,99.45
2022-08-01,Nagaland,642,5,637,8108,4017,2786,7.92,0,2.2,789857,6642,785512,182.59,126.64,3.6854545454545455,0.84,99.45
2022-08-02,Nagaland,1387,16,1386,17663,4279,2232,7.85,0,2.2,791244,6658,786898,194.5,101.45,8.028636363636364,0.84,99.45
2022-08-03,Nagaland,1358,17,1351,16824,603,587,8.07,0,2.2,792602,6675,788249,27.41,26.68,7.647272727272727,0.84,99.45
2022-08-04,Nagaland,223,2,218,3042,4327,2446,7.33,3,2.2,792825,6677,788467,196.68,111.18,1.3827272727272728,0.84,99.45
2022-08-05,Nagaland,1458,20,1458,18216,126,1,8.0,0,2.2,794283,6697,789925,5.73,0.05,8.28,0.84,99.45
2022-08-06,Nagaland,447,4,438,5137,2919,2593,8.7,5,2.2,794730,6701,790363,132.68,117.86,2.335,0.84,99.45
2022-08-07,Nagaland,820,10,820,10624,2148,287,7.72,0,2.2,795550,6711,791183,97.64,13.05,4.829090909090909,0.84,99.45
2022-08-08,Nagaland,864,7,858,10913,3676,673,7.92,0,2.2,796414,6718,792041,167.09,30.59,4.960454545454546,0.84,99.45
2022-08-09,Nagaland,1440,13,1434,17661,293,57,8.15,0,2.2,797854,6731,793475,13.32,2.59,8.027727272727272,0.84,99.45
2022-08-10,Nagaland,803,7,800,9709,1127,275,8.27,0,2.2,798657,6738,794275,51.23,12.5,4.413181818181818,0.84,99.45
2022-08-11,Nagaland,1365,14,1359,16792,4736,3760,8.13,0,2.2,800022,6752,795634,215.27,170.91,7.632727272727273,0.84,99.45
2022-08-12,Nagaland,1281,7,1280,16002,4813,359,8.01,0,2.2,801303,6759,796914,218.77,16.32,7.2736363636363635,0.84,99.45
2022-08-13,Nagaland,1227,9,1227,15052,1871,1696,8.15,0,2.2,802530,6768,798141,85.05,77.09,6.841818181818182,0.84,99.45
2022-08-14,Nagaland,1077,8,1070,13518,4598,2491,7.97,0,2.2,803607,6776,799211,209.0,113.23,6.1445454545454545,0.84,99.45
2022-08-15,Nagaland,488,6,483,5892,3563,2559,8.28,0,2.2,804095,6782,799694,161.95,116.32,2.678181818181818,0.84,99.45
2022-08-16,Nagaland,851,9,843,10759,3336,2487,7.91,0,2.2,804946,6791,800537,151.64,113.05,4.890454545454546,0.84,99.45
2022-08-17,Nagaland,87,0,84,1618,4424,4123,5.38,3,2.2,805033,6791,800621,201.09,187.41,0.7354545454545455,0.84,99.45
2022-08-18,Nagaland,571,2,571,7255,909,783,7.87,0,2.2,805604,6793,801192,41.32,35.59,3.297727272727273,0.84,99.45
2022-08-19,Nagaland,600,5,594,7119,3460,2505,8.43,1,2.2,806204,6798,801786,157.27,113.86,3.235909090909091,0.84,99.45
2022-08-20,Nagaland,394,5,391,4986,4465,293,7.9,0,2.2,806598,6803,802177,202.95,13.32,2.2663636363636366,0.84,99.45
2022-08-21,Nagaland,1043,4,1042,13614,4612,820,7.66,0,2.2,807641,6807,803219,209.64,37.27,6.1881818181818184,0.84,99.45
2022-08-22,Nagaland,389,4,383,4475,4433,3043,8.69,2,2.2,808030,6811,803602,201.5,138.32,2.034090909090909,0.84,99.45
2022-08-23,Nagaland,1090,11,1081,13902,3091,697,7.84,0,2.2,809120,6822,804683,140.5,31.68,6.319090909090909,0.84,99.45
2022-08-24,Nagaland,620,6,614,7927,3049,2161,7.82,0,2.2,809740,6828,805297,138.59,98.23,3.603181818181818,0.84,99.45
2022-08-25,Nagaland,820,6,815,10381,2986,2137,7.9,0,2.2,810560,6834,806112,135.73,97.14,4.718636363636364,0.84,99.45
2022-08-26,Nagaland,423,5,416,5355,3822,2603,7.9,2,2.2,810983,6839,806528,173.73,118.32,2.434090909090909,0.84,99.45
2022-08-27,Nagaland,1505,12,1498,18540,3863,1843,8.12,0,2.2,812488,6851,808026,175.59,83.77,8.427272727272728,0.84,99.45
2022-08-28,Nagaland,836,4,829,10552,1406,208,7.92,3,2.2,813324,6855,808855,63.91,9.45,4.796363636363636,0.84,99.45
2022-08-29,Nagaland,989,8,985,12613,3517,3350,7.84,0,2.2,814313,6863,809840,159.86,152.27,5.733181818181818,0.84,99.45
2022-08-30,Nagaland,1500,10,1493,18869,1815,70,7.95,0,2.2,815813,6873,811333,82.5,3.18,8.576818181818181,0.84,99.45
2022-08-31,Nagaland,1445,10,1444,18070,556,203,8.0,0,2.2,817258,6883,812777,25.27,9.23,8.213636363636363,0.84,99.45
2022-09-01,Nagaland,918,8,915,11468,3116,3092,8.0,0,2.2,818176,6891,813692,141.64,140.55,5.212727272727273,0.84,99.45
2022-09-02,Nagaland,516,6,510,6472,1637,595,7.97,0,2.2,818692,6897,814202,74.41,27.05,2.941818181818182,0.84,99.45
2022-09-03,Nagaland,503,2,495,6327,934,136,7.95,6,2.2,819195,6899,814697,42.45,6.18,2.875909090909091,0.84,99.45
2022-09-04,Nagaland,1167,15,1159,14456,4780,4551,8.07,0,2.2,820362,6914,815856,217.27,206.86,6.570909090909091,0.84,99.45
2022-09-05,Nagaland,399,5,395,5342,4603,4403,7.47,0,2.2,820761,6919,816251,209.23,200.14,2.428181818181818,0.84,99.45
2022-09-06,Nagaland,858,6,852,10641,536,384,8.06,0,2.2,821619,6925,817103,24.36,17.45,4.836818181818182,0.84,99.45
2022-09-07,Nagaland,590,5,589,7474,4382,4340,7.89,0,2.2,822209,6930,817692,199.18,197.27,3.3972727272727274,0.84,99.45
2022-09-08,Nagaland,470,2,469,6272,3042,1072,7.49,0,2.2,822679,6932,818161,138.27,48.73,2.850909090909091,0.84,99.45
2022-09-09,Nagaland,920,2,920,11024,3371,3028,8.35,0,2.2,823599,6934,819081,153.23,137.64,5.010909090909091,0.84,99.45
2022-09-10,Nagaland,170,0,166,2462,1878,1196,6.9,4,2.2,823769,6934,819247,85.36,54.36,1.1190909090909091,0.84,99.45
2022-09-11,Nagaland,416,3,408,5263,1059,532,7.9,5,2.2,824185,6937,819655,48.14,24.18,2.392272727272727,0.84,99.45
2022-09-12,Nagaland,805,10,803,9514,2959,1498,8.46,0,2.2,824990,6947,820458,134.5,68.09,4.324545454545454,0.84,99.45
2022-09-13,Nagaland,558,2,557,6929,1692,1436,8.05,0,2.2,825548,6949,821015,76.91,65.27,3.1495454545454544,0.84,99.45
2022-09-14,Nagaland,224,2,216,1953,154,60,11.47,6,2.2,825772,6951,821231,7.0,2.73,0.8877272727272727,0.84,99.45
2022-09-15,Nagaland,558,6,552,7002,1028,40,7.97,0,2.2,826330,6957,821783,46.73,1.82,3.1827272727272726,0.84,99.45
2022-09-16,Nagaland,321,3,313,3836,4113,3041,8.37,5,2.2,826651,6960,822096,186.95,138.23,1.7436363636363637,0.84,99.45
2022-09-17,Nagaland,1148,5,1141,14292,2445,1463,8.03,2,2.2,827799,6965,823237,111.14,66.5,6.496363636363636,0.84,99.45
2022-09-18,Nagaland,885,6,881,11103,4839,1614,7.97,0,2.2,828684,6971,824118,219.95,73.36,5.046818181818182,0.84,99.45
2022-09-19,Nagaland,270,2,269,3132,3393,3083,8.62,0,2.2,828954,6973,824387,154.23,140.14,1.4236363636363636,0.84,99.45
2022-09-20,Nagaland,731,4,726,9015,3321,877,8.11,1,2.2,829685,6977,825113,150.95,39.86,4.097727272727273,0.84,99.45
2022-09-21,Nagaland,965,8,960,12351,3523,1161,7.81,0,2.2,830650,6985,826073,160.14,52.77,5.614090909090909,0.84,99.45
2022-09-22,Nagaland,1042,15,1036,13256,2351,942,7.86,0,2.2,831692,7000,827109,106.86,42.82,6.025454545454545,0.84,99.45
2022-09-23,Nagaland,1368,7,1367,17417,4046,3145,7.85,0,2.2,833060,7007,828476,183.91,142.95,7.916818181818182,0.84,99.45
2022-09-24,Nagaland,434,5,428,5403,3838,3826,8.03,1,2.2,833494,7012,828904,174.45,173.91,2.455909090909091,0.84,99.45
2022-09-25,Nagaland,823,3,821,10287,4743,146,8.0,0,2.2,834317,7015,829725,215.59,6.64,4.675909090909091,0.84,99.45
2022-09-26,Nagaland,1366,13,1366,17148,2654,951,7.97,0,2.2,835683,7028,831091,120.64,43.23,7.794545454545455,0.84,99.45
2022-09-27,Nagaland,411,2,402,5274,113,18,7.79,7,2.2,836094,7030,831493,5.14,0.82,2.3972727272727274,0.84,99.45
2022-09-28,Nagaland,706,4,703,8402,1957,1451,8.4,0,2.2,836800,7034,832196,88.95,65.95,3.819090909090909,0.84,99.45
2022-09-29,Nagaland,695,8,687,8793,1976,153,7.9,0,2.2,837495,7042,832883,89.82,6.95,3.9968181818181816,0.84,99.45
2022-09-30,Nagaland,67,0,62,1174,4352,3841,5.71,5,2.2,837562,7042,832945,197.82,174.59,0.5336363636363637,0.84,99.45
2022-10-01,Nagaland,1433,21,1433,17903,2283,652,8.0,0,2.2,838995,7063,834378,103.77,29.64,8.137727272727274,0.84,99.45
2022-10-02,Nagaland,771,5,765,9810,112,17,7.86,1,2.2,839766,7068,835143,5.09,0.77,4.459090909090909,0.84,99.45
2022-10-03,Nagaland,263,2,258,3246,2545,1856,8.1,3,2.2,840029,7070,835401,115.68,84.36,1.4754545454545454,0.84,99.45
2022-10-04,Nagaland,170,0,163,2353,1238,382,7.22,7,2.2,840199,7070,835564,56.27,17.36,1.0695454545454546,0.84,99.45
2022-10-05,Nagaland,1220,14,1211,15197,3095,978,8.03,0,2.2,841419,7084,836775,140.68,44.45,6.907727272727273,0.84,99.45
2022-10-06,Nagaland,834,9,829,10206,323,109,8.17,0,2.2,842253,7093,837604,14.68,4.95,4.639090909090909,0.84,99.45
2022-10-07,Nagaland,471,4,470,5467,1591,152,8.62,0,2.2,842724,7097,838074,72.32,6.91,2.485,0.84,99.45
2022-10-08,Nagaland,214,2,213,2763,691,126,7.75,0,2.2,842938,7099,838287,31.41,5.73,1.2559090909090909,0.84,99.45
2022-10-09,Nagaland,209,1,205,2897,117,88,7.21,3,2.2,843147,7100,838492,5.32,4.0,1.3168181818181819,0.84,99.45
2022-10-10,Nagaland,1514,5,1509,18896,2721,767,8.01,0,2.2,844661,7105,840001,123.68,34.86,8.58909090909091,0.84,99.45
2022-10-11,Nagaland,743,4,740,9344,159,85,7.95,0,2.2,845404,7109,840741,7.23,3.86,4.247272727272727,0.84,99.45
2022-10-12,Nagaland,1462,21,1454,18066,1428,1373,8.09,0,2.2,846866,7130,842195,64.91,62.41,8.211818181818181,0.84,99.45
2022-10-13,Nagaland,1015,7,1013,13057,2731,2028,7.77,0,2.2,847881,7137,843208,124.14,92.18,5.935,0.84,99.45
2022-10-14,Nagaland,1217,6,1212,14957,2544,1742,8.14,0,2.2,849098,7143,844420,115.64,79.18,6.798636363636364,0.84,99.45
2022-10-15,Nagaland,1140,3,1133,13726,2274,1900,8.31,4,2.2,850238,7146,845553,103.36,86.36,6.239090909090909,0.84,99.45
2022-10-16,Nagaland,1393,12,1385,17495,2256,902,7.96,0,2.2,851631,7158,846938,102.55,41.0,7.952272727272727,0.84,99.45
2022-10-17,Nagaland,336,1,328,4023,4949,3465,8.35,7,2.2,851967,7159,847266,224.95,157.5,1.8286363636363636,0.84,99.45
2022-10-18,Nagaland,1547,10,1545,19523,3901,1552,7.92,0,2.2,853514,7169,848811,177.32,70.55,8.87409090909091,0.84,99.45
2022-10-19,Nagaland,1451,9,1445,17867,1265,1151,8.12,0,2.2,854965,7178,850256,57.5,52.32,8.121363636363636,0.84,99.45
2022-10-20,Nagaland,1117,5,1115,13524,1061,426,8.26,0,2.2,856082,7183,851371,48.23,19.36,6.147272727272727,0.84,99.45
2022-10-21,Nagaland,467,4,466,6242,3479,2041,7.48,0,2.2,856549,7187,851837,158.14,92.77,2.8372727272727274,0.84,99.45
2022-10-22,Nagaland,1556,9,1551,19910,3447,2781,7.82,0,2.2,858105,7196,853388,156.68,126.41,9.05,0.84,99.45
2022-10-23,Nagaland,1265,18,1260,15690,2377,1686,8.06,0,2.2,859370,7214,854648,108.05,76.64,7.131818181818182,0.84,99.45
2022-10-24,Nagaland,1539,15,1532,19343,731,196,7.96,0,2.2,860909,7229,856180,33.23,8.91,8.792272727272728,0.84,99.45
2022-10-25,Nagaland,427,5,422,5333,4375,3428,8.01,0,2.2,861336,7234,856602,198.86,155.82,2.4240909090909093,0.84,99.45
2022-10-26,Nagaland,1330,18,1329,16541,4285,3453,8.04,0,2.2,862666,7252,857931,194.77,156.95,7.518636363636364,0.84,99.45
2022-10-27,Nagaland,89,0,87,1116,630,543,7.97,2,2.2,862755,7252,858018,28.64,24.68,0.5072727272727273,0.84,99.45
2022-10-28,Nagaland,1551,18,1545,19306,2837,2771,8.03,0,2.2,864306,7270,859563,128.95,125.95,8.775454545454545,0.84,99.45
2022-10-29,Nagaland,1204,7,1204,14897,4836,812,8.08,0,2.2,865510,7277,860767,219.82,36.91,6.7713636363636365,0.84,99.45
2022-10-30,Nagaland,1135,11,1135,14386,1764,428,7.89,0,2.2,866645,7288,861902,80.18,19.45,6.539090909090909,0.84,99.45
2022-10-31,Nagaland,1300,19,1295,16151,4050,2352,8.05,0,2.2,867945,7307,863197,184.09,106.91,7.341363636363637,0.84,99.45
2022-11-01,Nagaland,1502,17,1501,18750,2332,133,8.01,0,2.2,869447,7324,864698,106.0,6.05,8.522727272727273,0.84,99.45
2022-11-02,Nagaland,1158,8,1155,14342,2315,768,8.07,0,2.2,870605,7332,865853,105.23,34.91,6.5190909090909095,0.84,99.45
2022-11-03,Nagaland,1589,13,1589,19617,2009,1893,8.1,0,2.2,872194,7345,867442,91.32,86.05,8.916818181818181,0.84,99.46
2022-11-04,Nagaland,296,3,293,3651,4315,2566,8.11,0,2.2,872490,7348,867735,196.14,116.64,1.6595454545454544,0.84,99.46
2022-11-05,Nagaland,1395,14,1386,18016,3791,897,7.74,0,2.2,873885,7362,869121,172.32,40.77,8.18909090909091,0.84,99.45
2022-11-06,Nagaland,1057,5,1052,13121,22,13,8.06,0,2.2,874942,7367,870173,1.0,0.59,5.964090909090909,0.84,99.45
2022-11-07,Nagaland,628,9,625,8038,361,222,7.81,0,2.2,875570,7376,870798,16.41,10.09,3.653636363636364,0.84,99.45
2022-11-08,Nagaland,207,2,204,2788,1276,1117,7.42,1,2.2,875777,7378,871002,58.0,50.77,1.2672727272727273,0.84,99.45
2022-11-09,Nagaland,1573,11,1564,19510,2803,1956,8.06,0,2.2,877350,7389,872566,127.41,88.91,8.868181818181819,0.84,99.45
2022-11-10,Nagaland,697,9,689,9065,93,45,7.69,0,2.2,878047,7398,873255,4.23,2.05,4.120454545454545,0.84,99.45
2022-11-11,Nagaland,1033,4,1033,13335,1418,644,7.75,0,2.2,879080,7402,874288,64.45,29.27,6.0613636363636365,0.84,99.45
2022-11-12,Nagaland,761,3,759,9573,2988,2524,7.95,0,2.2,879841,7405,875047,135.82,114.73,4.3513636363636365,0.84,99.46
2022-11-13,Nagaland,1414,14,1409,17965,2096,1930,7.87,0,2.2,881255,7419,876456,95.27,87.73,8.165909090909091,0.84,99.46
2022-11-14,Nagaland,1129,5,1127,13773,4507,1246,8.2,0,2.2,882384,7424,877583,204.86,56.64,6.260454545454546,0.84,99.46
2022-11-15,Nagaland,989,11,989,11904,666,157,8.31,0,2.2,883373,7435,878572,30.27,7.14,5.410909090909091,0.84,99.46
2022-11-16,Nagaland,1282,18,1274,16128,2346,1603,7.95,0,2.2,884655,7453,879846,106.64,72.86,7.330909090909091,0.84,99.46
2022-11-17,Nagaland,132,1,129,1485,2939,1363,8.89,2,2.2,884787,7454,879975,133.59,61.95,0.675,0.84,99.46
2022-11-18,Nagaland,973,9,967,12137,3887,2776,8.02,0,2.2,885760,7463,880942,176.68,126.18,5.516818181818182,0.84,99.46
2022-11-19,Nagaland,1025,13,1025,12979,1683,717,7.9,0,2.2,886785,7476,881967,76.5,32.59,5.899545454545454,0.84,99.46
2022-11-20,Nagaland,1075,9,1070,13305,3018,1088,8.08,0,2.2,887860,7485,883037,137.18,49.45,6.047727272727273,0.84,99.46
2022-11-21,Nagaland,555,6,554,7144,1896,1893,7.77,0,2.2,888415,7491,883591,86.18,86.05,3.247272727272727,0.84,99.46
2022-11-22,Nagaland,393,2,388,4605,4647,4058,8.53,3,2.2,888808,7493,883979,211.23,184.45,2.0931818181818183,0.84,99.46
2022-11-23,Nagaland,226,0,221,2946,2846,373,7.67,5,2.2,889034,7493,884200,129.36,16.95,1.339090909090909,0.84,99.46
2022-11-24,Nagaland,676,2,674,9000,1176,556,7.51,0,2.2,889710,7495,884874,53.45,25.27,4.090909090909091,0.84,99.46
2022-11-25,Nagaland,767,7,766,9066,4921,4242,8.46,0,2.2,890477,7502,885640,223.68,192.82,4.120909090909091,0.84,99.46
2022-11-26,Nagaland,742,6,739,9908,587,46,7.49,0,2.2,891219,7508,886379,26.68,2.09,4.503636363636364,0.84,99.46
2022-11-27,Nagaland,988,4,988,12268,4418,4192,8.05,0,2.2,892207,7512,887367,200.82,190.55,5.576363636363636,0.84,99.46
2022-11-28,Nagaland,315,1,315,3972,2283,1062,7.93,0,2.2,892522,7513,887682,103.77,48.27,1.8054545454545454,0.84,99.46
2022-11-29,Nagaland,374,4,365,4441,2717,375,8.42,5,2.2,892896,7517,888047,123.5,17.05,2.0186363636363636,0.84,99.46
2022-11-30,Nagaland,1463,15,1456,18383,92,75,7.96,0,2.2,894359,7532,889503,4.18,3.41,8.35590909090909,0.84,99.46
2022-12-01,Nagaland,1245,9,1241,15687,2929,638,7.94,0,2.2,895604,7541,890744,133.14,29.0,7.130454545454546,0.84,99.46
2022-12-02,Nagaland,272,3,270,3158,663,374,8.61,0,2.2,895876,7544,891014,30.14,17.0,1.4354545454545455,0.84,99.46
2022-12-03,Nagaland,1068,12,1067,13103,2131,1416,8.15,0,2.2,896944,7556,892081,96.86,64.36,5.955909090909091,0.84,99.46
2022-12-04,Nagaland,653,8,652,8196,840,454,7.97,0,2.2,897597,7564,892733,38.18,20.64,3.7254545454545456,0.84,99.46
2022-12-05,Nagaland,200,2,198,2271,984,776,8.81,0,2.2,897797,7566,892931,44.73,35.27,1.0322727272727272,0.84,99.46
2022-12-06,Nagaland,228,2,225,3281,2506,214,6.95,1,2.2,898025,7568,893156,113.91,9.73,1.4913636363636364,0.84,99.46
2022-12-07,Nagaland,1433,13,1429,17838,2902,2582,8.03,0,2.2,899458,7581,894585,131.91,117.36,8.108181818181817,0.84,99.46
2022-12-08,Nagaland,300,1,295,3905,2311,900,7.68,4,2.2,899758,7582,894880,105.05,40.91,1.775,0.84,99.46
2022-12-09,Nagaland,755,6,748,9248,2536,1225,8.16,1,2.2,900513,7588,895628,115.27,55.68,4.203636363636364,0.84,99.46
2022-12-10,Nagaland,14,0,14,535,4217,70,2.62,0,2.2,900527,7588,895642,191.68,3.18,0.2431818181818182,0.84,99.46
2022-12-11,Nagaland,381,4,377,4650,700,192,8.19,0,2.2,900908,7592,896019,31.82,8.73,2.1136363636363638,0.84,99.46
2022-12-12,Nagaland,556,4,554,6656,928,322,8.35,0,2.2,901464,7596,896573,42.18,14.64,3.0254545454545454,0.84,99.46
2022-12-13,Nagaland,353,5,345,4335,3480,1697,8.14,3,2.2,901817,7601,896918,158.18,77.14,1.9704545454545455,0.84,99.46
2022-12-14,Nagaland,1343,17,1335,17145,3017,2719,7.83,0,2.2,903160,7618,898253,137.14,123.59,7.793181818181818,0.84,99.46
2022-12-15,Nagaland,796,2,791,10482,1393,1046,7.59,3,2.2,903956,7620,899044,63.32,47.55,4.764545454545455,0.84,99.46
2022-12-16,Nagaland,1114,12,1106,14004,1672,1468,7.95,0,2.2,905070,7632,900150,76.0,66.73,6.365454545454545,0.84,99.46
2022-12-17,Nagaland,1043,13,1040,13247,451,430,7.87,0,2.2,906113,7645,901190,20.5,19.55,6.0213636363636365,0.84,99.46
2022-12-18,Nagaland,396,3,395,4953,2983,1349,8.0,0,2.2,906509,7648,901585,135.59,61.32,2.2513636363636365,0.84,99.46
2022-12-19,Nagaland,733,5,733,9333,4006,2350,7.85,0,2.2,907242,7653,902318,182.09,106.82,4.242272727272727,0.84,99.46
2022-12-20,Nagaland,1066,6,1060,13503,3116,2685,7.89,0,2.2,908308,7659,903378,141.64,122.05,6.137727272727273,0.84,99.46
2022-12-21,Nagaland,1351,15,1343,16970,926,729,7.96,0,2.2,909659,7674,904721,42.09,33.14,7.713636363636364,0.84,99.46
2022-12-22,Nagaland,649,5,641,7894,1016,403,8.22,3,2.2,910308,7679,905362,46.18,18.32,3.5881818181818184,0.84,99.46
2022-12-23,Nagaland,1294,16,1292,16321,4552,4238,7.93,0,2.2,911602,7695,906654,206.91,192.64,7.418636363636364,0.84,99.46
2022-12-24,Nagaland,1262,17,1256,15911,4314,715,7.93,0,2.2,912864,7712,907910,196.09,32.5,7.232272727272727,0.84,99.46
2022-12-25,Nagaland,445,4,443,5614,3087,925,7.93,0,2.2,913309,7716,908353,140.32,42.05,2.5518181818181818,0.84,99.46
2022-12-26,Nagaland,678,9,675,8407,4554,2456,8.06,0,2.2,913987,7725,909028,207.0,111.64,3.8213636363636363,0.85,99.46
2022-12-27,Nagaland,1139,12,1137,14168,1473,161,8.04,0,2.2,915126,7737,910165,66.95,7.32,6.44,0.85,99.46
2022-12-28,Nagaland,660,9,651,8189,1827,1458,8.06,0,2.2,915786,7746,910816,83.05,66.27,3.722272727272727,0.85,99.46
2022-12-29,Nagaland,113,0,105,922,3349,1934,12.26,8,2.2,915899,7746,910921,152.23,87.91,0.41909090909090907,0.85,99.46
2022-12-30,Nagaland,932,10,926,11919,660,408,7.82,0,2.2,916831,7756,911847,30.0,18.55,5.417727272727273,0.85,99.46
2022-12-31,Nagaland,787,2,783,10012,1165,951,7.86,2,2.2,917618,7758,912630,52.95,43.23,4.550909090909091,0.85,99.46
2020-01-01,Odisha,58,0,57,1034,983,788,5.61,1,46.8,58,0,57,2.1,1.68,0.022094017094017093,0.0,98.28
2020-01-02,Odisha,706,9,703,8466,4713,1799,8.34,0,46.8,764,9,760,10.07,3.84,0.1808974358974359,1.18,99.48
2020-01-03,Odisha,1048,12,1042,13543,4714,3939,7.74,0,46.8,1812,21,1802,10.07,8.42,0.2893803418803419,1.16,99.45
2020-01-04,Odisha,156,1,150,1574,4826,3729,9.91,5,46.8,1968,22,1952,10.31,7.97,0.03363247863247863,1.12,99.19
2020-01-05,Odisha,657,8,648,8420,156,97,7.8,1,46.8,2625,30,2600,0.33,0.21,0.1799145299145299,1.14,99.05
2020-01-06,Odisha,1433,7,1427,17862,1759,509,8.02,0,46.8,4058,37,4027,3.76,1.09,0.38166666666666665,0.91,99.24
2020-01-07,Odisha,1408,6,1407,17724,3640,588,7.94,0,46.8,5466,43,5434,7.78,1.26,0.3787179487179487,0.79,99.41
2020-01-08,Odisha,1018,4,1015,12812,603,533,7.95,0,46.8,6484,47,6449,1.29,1.14,0.27376068376068374,0.72,99.46
2020-01-09,Odisha,374,4,368,4287,3060,2839,8.72,2,46.8,6858,51,6817,6.54,6.07,0.09160256410256411,0.74,99.4
2020-01-10,Odisha,475,2,469,6443,3448,952,7.37,4,46.8,7333,53,7286,7.37,2.03,0.13767094017094017,0.72,99.36
2020-01-11,Odisha,365,1,360,4459,4346,4093,8.19,4,46.8,7698,54,7646,9.29,8.75,0.09527777777777778,0.7,99.32
2020-01-12,Odisha,556,6,554,6301,3306,1507,8.82,0,46.8,8254,60,8200,7.06,3.22,0.13463675213675214,0.73,99.35
2020-01-13,Odisha,1501,10,1498,18600,4320,2349,8.07,0,46.8,9755,70,9698,9.23,5.02,0.3974358974358974,0.72,99.42
2020-01-14,Odisha,892,3,883,11152,4352,4236,8.0,6,46.8,10647,73,10581,9.3,9.05,0.2382905982905983,0.69,99.38
2020-01-15,Odisha,876,4,867,10826,1799,216,8.09,5,46.8,11523,77,11448,3.84,0.46,0.2313247863247863,0.67,99.35
2020-01-16,Odisha,947,8,944,11894,3632,2360,7.96,0,46.8,12470,85,12392,7.76,5.04,0.25414529914529915,0.68,99.37
2020-01-17,Odisha,734,3,729,9240,4318,1124,7.94,2,46.8,13204,88,13121,9.23,2.4,0.19743589743589743,0.67,99.37
2020-01-18,Odisha,1453,9,1445,17973,931,1,8.08,0,46.8,14657,97,14566,1.99,0.0,0.38403846153846155,0.66,99.38
2020-01-19,Odisha,1105,13,1098,13940,877,104,7.93,0,46.8,15762,110,15664,1.87,0.22,0.29786324786324786,0.7,99.38
2020-01-20,Odisha,237,2,232,2653,4501,2647,8.93,3,46.8,15999,112,15896,9.62,5.66,0.05668803418803419,0.7,99.36
2020-01-21,Odisha,250,3,243,3185,691,425,7.85,4,46.8,16249,115,16139,1.48,0.91,0.06805555555555555,0.71,99.32
2020-01-22,Odisha,655,2,646,8651,4489,338,7.57,7,46.8,16904,117,16785,9.59,0.72,0.18485042735042734,0.69,99.3
2020-01-23,Odisha,1165,15,1159,14705,1855,87,7.92,0,46.8,18069,132,17944,3.96,0.19,0.3142094017094017,0.73,99.31
2020-01-24,Odisha,1442,8,1434,18447,1270,1072,7.82,0,46.8,19511,140,19378,2.71,2.29,0.39416666666666667,0.72,99.32
2020-01-25,Odisha,686,4,679,8589,2388,21,7.99,3,46.8,20197,144,20057,5.1,0.04,0.18352564102564103,0.71,99.31
2020-01-26,Odisha,101,0,93,1242,162,122,8.13,8,46.8,20298,144,20150,0.35,0.26,0.02653846153846154,0.71,99.27
2020-01-27,Odisha,1119,15,1119,13490,1637,1156,8.3,0,46.8,21417,159,21269,3.5,2.47,0.2882478632478632,0.74,99.31
2020-01-28,Odisha,1544,6,1543,19601,4637,2786,7.88,0,46.8,22961,165,22812,9.91,5.95,0.4188247863247863,0.72,99.35
2020-01-29,Odisha,179,2,170,2313,3385,1969,7.74,7,46.8,23140,167,22982,7.23,4.21,0.049423076923076924,0.72,99.32
2020-01-30,Odisha,626,8,626,8287,493,136,7.55,0,46.8,23766,175,23608,1.05,0.29,0.17707264957264957,0.74,99.34
2020-01-31,Odisha,1227,6,1218,15653,3209,1868,7.84,3,46.8,24993,181,24826,6.86,3.99,0.334465811965812,0.72,99.33
2020-02-01,Odisha,884,8,878,10753,4078,3249,8.22,0,46.8,25877,189,25704,8.71,6.94,0.22976495726495727,0.73,99.33
2020-02-02,Odisha,472,4,465,5537,2055,57,8.52,3,46.8,26349,193,26169,4.39,0.12,0.1183119658119658,0.73,99.32
2020-02-03,Odisha,1117,4,1111,13967,1476,379,8.0,2,46.8,27466,197,27280,3.15,0.81,0.29844017094017095,0.72,99.32
2020-02-04,Odisha,1534,8,1526,19417,4582,1155,7.9,0,46.8,29000,205,28806,9.79,2.47,0.4148931623931624,0.71,99.33
2020-02-05,Odisha,751,8,747,9366,4794,592,8.02,0,46.8,29751,213,29553,10.24,1.26,0.20012820512820512,0.72,99.33
2020-02-06,Odisha,1042,6,1038,13301,698,637,7.83,0,46.8,30793,219,30591,1.49,1.36,0.28420940170940173,0.71,99.34
2020-02-07,Odisha,346,2,344,4622,1647,751,7.49,0,46.8,31139,221,30935,3.52,1.6,0.09876068376068375,0.71,99.34
2020-02-08,Odisha,192,2,185,2495,2250,1367,7.7,5,46.8,31331,223,31120,4.81,2.92,0.05331196581196581,0.71,99.33
2020-02-09,Odisha,1414,19,1414,17534,1993,1590,8.06,0,46.8,32745,242,32534,4.26,3.4,0.3746581196581197,0.74,99.36
2020-02-10,Odisha,401,5,393,4860,3533,2226,8.25,3,46.8,33146,247,32927,7.55,4.76,0.10384615384615385,0.75,99.34
2020-02-11,Odisha,71,0,66,835,3340,2492,8.5,5,46.8,33217,247,32993,7.14,5.32,0.01784188034188034,0.74,99.33
2020-02-12,Odisha,913,13,905,11392,3274,2892,8.01,0,46.8,34130,260,33898,7.0,6.18,0.24341880341880343,0.76,99.32
2020-02-13,Odisha,226,3,222,2816,448,387,8.03,1,46.8,34356,263,34120,0.96,0.83,0.06017094017094017,0.77,99.31
2020-02-14,Odisha,161,2,154,1972,2848,1490,8.16,5,46.8,34517,265,34274,6.09,3.18,0.04213675213675214,0.77,99.3
2020-02-15,Odisha,705,4,696,8750,4144,2190,8.06,5,46.8,35222,269,34970,8.85,4.68,0.18696581196581197,0.76,99.28
2020-02-16,Odisha,1276,16,1272,15904,3038,1696,8.02,0,46.8,36498,285,36242,6.49,3.62,0.3398290598290598,0.78,99.3
2020-02-17,Odisha,374,1,374,5090,4520,4239,7.35,0,46.8,36872,286,36616,9.66,9.06,0.10876068376068376,0.78,99.31
2020-02-18,Odisha,881,4,876,11187,269,81,7.88,1,46.8,37753,290,37492,0.57,0.17,0.23903846153846153,0.77,99.31
2020-02-19,Odisha,1151,9,1147,14576,4269,4247,7.9,0,46.8,38904,299,38639,9.12,9.07,0.31145299145299143,0.77,99.32
2020-02-20,Odisha,658,6,650,8194,3774,1517,8.03,2,46.8,39562,305,39289,8.06,3.24,0.1750854700854701,0.77,99.31
2020-02-21,Odisha,1259,4,1252,15730,3879,827,8.0,3,46.8,40821,309,40541,8.29,1.77,0.33611111111111114,0.76,99.31
2020-02-22,Odisha,269,1,263,3221,4585,2490,8.35,5,46.8,41090,310,40804,9.8,5.32,0.06882478632478632,0.75,99.3
2020-02-23,Odisha,495,1,494,6528,4878,2358,7.58,0,46.8,41585,311,41298,10.42,5.04,0.13948717948717948,0.75,99.31
2020-02-24,Odisha,85,1,78,1081,2386,41,7.86,6,46.8,41670,312,41376,5.1,0.09,0.023098290598290598,0.75,99.29
2020-02-25,Odisha,1284,15,1282,15924,2263,1594,8.06,0,46.8,42954,327,42658,4.84,3.41,0.34025641025641024,0.76,99.31
2020-02-26,Odisha,1186,17,1182,14798,4868,790,8.01,0,46.8,44140,344,43840,10.4,1.69,0.3161965811965812,0.78,99.32
2020-02-27,Odisha,1167,7,1162,15044,4085,2156,7.76,0,46.8,45307,351,45002,8.73,4.61,0.32145299145299144,0.77,99.33
2020-02-28,Odisha,1571,8,1570,19955,3104,1165,7.87,0,46.8,46878,359,46572,6.63,2.49,0.4263888888888889,0.77,99.35
2020-02-29,Odisha,761,5,756,9569,3789,3443,7.95,0,46.8,47639,364,47328,8.1,7.36,0.20446581196581196,0.76,99.35
2020-03-01,Odisha,419,3,417,5264,4412,1904,7.96,0,46.8,48058,367,47745,9.43,4.07,0.11247863247863248,0.76,99.35
2020-03-02,Odisha,122,1,119,1537,1069,260,7.94,2,46.8,48180,368,47864,2.28,0.56,0.03284188034188034,0.76,99.34
2020-03-03,Odisha,787,5,779,9468,3030,1826,8.31,3,46.8,48967,373,48643,6.47,3.9,0.2023076923076923,0.76,99.34
2020-03-04,Odisha,774,10,767,9483,3608,2004,8.16,0,46.8,49741,383,49410,7.71,4.28,0.20262820512820512,0.77,99.33
2020-03-05,Odisha,58,0,49,579,2227,319,10.02,9,46.8,49799,383,49459,4.76,0.68,0.012371794871794873,0.77,99.32
2020-03-06,Odisha,1153,6,1151,14843,1642,1420,7.77,0,46.8,50952,389,50610,3.51,3.03,0.31715811965811963,0.76,99.33
2020-03-07,Odisha,852,10,852,10220,4831,1836,8.34,0,46.8,51804,399,51462,10.32,3.92,0.21837606837606838,0.77,99.34
2020-03-08,Odisha,326,2,318,4273,1626,1011,7.63,6,46.8,52130,401,51780,3.47,2.16,0.0913034188034188,0.77,99.33
2020-03-09,Odisha,1528,9,1520,18950,4929,2127,8.06,0,46.8,53658,410,53300,10.53,4.54,0.4049145299145299,0.76,99.33
2020-03-10,Odisha,1156,13,1153,14725,2440,1982,7.85,0,46.8,54814,423,54453,5.21,4.24,0.31463675213675213,0.77,99.34
2020-03-11,Odisha,156,1,147,1848,512,320,8.44,8,46.8,54970,424,54600,1.09,0.68,0.03948717948717949,0.77,99.33
2020-03-12,Odisha,838,6,833,10838,548,98,7.73,0,46.8,55808,430,55433,1.17,0.21,0.23158119658119658,0.77,99.33
2020-03-13,Odisha,1056,12,1049,13406,4877,3911,7.88,0,46.8,56864,442,56482,10.42,8.36,0.28645299145299147,0.78,99.33
2020-03-14,Odisha,1312,7,1306,16460,2599,489,7.97,0,46.8,58176,449,57788,5.55,1.04,0.35170940170940174,0.77,99.33
2020-03-15,Odisha,625,7,616,7430,3162,2665,8.41,2,46.8,58801,456,58404,6.76,5.69,0.15876068376068375,0.78,99.32
2020-03-16,Odisha,1263,14,1255,15644,4408,87,8.07,0,46.8,60064,470,59659,9.42,0.19,0.3342735042735043,0.78,99.33
2020-03-17,Odisha,178,2,173,2012,3282,1953,8.85,3,46.8,60242,472,59832,7.01,4.17,0.04299145299145299,0.78,99.32
2020-03-18,Odisha,1073,8,1071,13687,1668,798,7.84,0,46.8,61315,480,60903,3.56,1.71,0.292457264957265,0.78,99.33
2020-03-19,Odisha,1110,4,1102,13610,2864,2488,8.16,4,46.8,62425,484,62005,6.12,5.32,0.29081196581196583,0.78,99.33
2020-03-20,Odisha,1188,8,1182,14708,1133,936,8.08,0,46.8,63613,492,63187,2.42,2.0,0.31427350427350426,0.77,99.33
2020-03-21,Odisha,1162,13,1156,13995,1908,703,8.3,0,46.8,64775,505,64343,4.08,1.5,0.29903846153846153,0.78,99.33
2020-03-22,Odisha,637,3,630,8018,188,122,7.94,4,46.8,65412,508,64973,0.4,0.26,0.17132478632478632,0.78,99.33
2020-03-23,Odisha,1052,14,1044,12996,315,172,8.09,0,46.8,66464,522,66017,0.67,0.37,0.2776923076923077,0.79,99.33
2020-03-24,Odisha,75,0,74,1431,2680,414,5.24,1,46.8,66539,522,66091,5.73,0.88,0.030576923076923078,0.78,99.33
2020-03-25,Odisha,931,12,929,11860,4329,1949,7.85,0,46.8,67470,534,67020,9.25,4.16,0.2534188034188034,0.79,99.33
2020-03-26,Odisha,811,6,809,9952,4066,1000,8.15,0,46.8,68281,540,67829,8.69,2.14,0.21264957264957265,0.79,99.34
2020-03-27,Odisha,1202,11,1198,14756,1024,341,8.15,0,46.8,69483,551,69027,2.19,0.73,0.3152991452991453,0.79,99.34
2020-03-28,Odisha,1289,5,1280,16273,3445,3185,7.92,4,46.8,70772,556,70307,7.36,6.81,0.3477136752136752,0.79,99.34
2020-03-29,Odisha,1584,14,1584,19970,2002,1889,7.93,0,46.8,72356,570,71891,4.28,4.04,0.4267094017094017,0.79,99.36
2020-03-30,Odisha,891,2,891,11241,1733,841,7.93,0,46.8,73247,572,72782,3.7,1.8,0.2401923076923077,0.78,99.37
2020-03-31,Odisha,1583,10,1579,19662,3441,202,8.05,0,46.8,74830,582,74361,7.35,0.43,0.42012820512820515,0.78,99.37
2020-04-01,Odisha,358,4,351,4455,1840,1281,8.04,3,46.8,75188,586,74712,3.93,2.74,0.09519230769230769,0.78,99.37
2020-04-02,Odisha,1292,8,1291,15748,210,44,8.2,0,46.8,76480,594,76003,0.45,0.09,0.3364957264957265,0.78,99.38
2020-04-03,Odisha,1383,15,1378,17221,2472,1960,8.03,0,46.8,77863,609,77381,5.28,4.19,0.3679700854700855,0.78,99.38
2020-04-04,Odisha,873,9,872,11273,4905,1543,7.74,0,46.8,78736,618,78253,10.48,3.3,0.24087606837606837,0.78,99.39
2020-04-05,Odisha,525,5,519,6630,4952,4735,7.92,1,46.8,79261,623,78772,10.58,10.12,0.14166666666666666,0.79,99.38
2020-04-06,Odisha,193,0,186,2540,201,38,7.6,7,46.8,79454,623,78958,0.43,0.08,0.054273504273504275,0.78,99.38
2020-04-07,Odisha,1065,4,1056,13461,4507,1460,7.91,5,46.8,80519,627,80014,9.63,3.12,0.28762820512820514,0.78,99.37
2020-04-08,Odisha,1082,15,1076,13708,4911,1895,7.89,0,46.8,81601,642,81090,10.49,4.05,0.2929059829059829,0.79,99.37
2020-04-09,Odisha,1302,5,1297,16557,4470,4224,7.86,0,46.8,82903,647,82387,9.55,9.03,0.35378205128205126,0.78,99.38
2020-04-10,Odisha,1310,12,1305,16142,3006,1804,8.12,0,46.8,84213,659,83692,6.42,3.85,0.3449145299145299,0.78,99.38
2020-04-11,Odisha,1498,16,1498,18956,4285,1565,7.9,0,46.8,85711,675,85190,9.16,3.34,0.405042735042735,0.79,99.39
2020-04-12,Odisha,1054,15,1051,13037,2615,798,8.08,0,46.8,86765,690,86241,5.59,1.71,0.2785683760683761,0.8,99.4
2020-04-13,Odisha,574,8,572,6636,4767,2039,8.65,0,46.8,87339,698,86813,10.19,4.36,0.1417948717948718,0.8,99.4
2020-04-14,Odisha,1503,7,1497,18716,814,405,8.03,0,46.8,88842,705,88310,1.74,0.87,0.3999145299145299,0.79,99.4
2020-04-15,Odisha,263,3,256,3513,2619,136,7.49,4,46.8,89105,708,88566,5.6,0.29,0.07506410256410256,0.79,99.4
2020-04-16,Odisha,130,1,128,1782,3604,1476,7.3,1,46.8,89235,709,88694,7.7,3.15,0.03807692307692308,0.79,99.39
2020-04-17,Odisha,1043,4,1036,13216,3047,1588,7.89,3,46.8,90278,713,89730,6.51,3.39,0.28239316239316237,0.79,99.39
2020-04-18,Odisha,1271,19,1266,16120,4620,1851,7.88,0,46.8,91549,732,90996,9.87,3.96,0.34444444444444444,0.8,99.4
2020-04-19,Odisha,16,0,16,710,3833,1212,2.25,0,46.8,91565,732,91012,8.19,2.59,0.01517094017094017,0.8,99.4
2020-04-20,Odisha,599,4,591,7319,1041,353,8.18,4,46.8,92164,736,91603,2.22,0.75,0.15638888888888888,0.8,99.39
2020-04-21,Odisha,505,1,499,6521,4528,1952,7.74,5,46.8,92669,737,92102,9.68,4.17,0.13933760683760685,0.8,99.39
2020-04-22,Odisha,821,11,817,9840,1464,213,8.34,0,46.8,93490,748,92919,3.13,0.46,0.21025641025641026,0.8,99.39
2020-04-23,Odisha,217,1,210,2329,4012,1643,9.32,6,46.8,93707,749,93129,8.57,3.51,0.04976495726495726,0.8,99.38
2020-04-24,Odisha,965,14,958,11861,4342,1771,8.14,0,46.8,94672,763,94087,9.28,3.78,0.25344017094017096,0.81,99.38
2020-04-25,Odisha,1017,3,1014,12447,2473,2313,8.17,0,46.8,95689,766,95101,5.28,4.94,0.26596153846153847,0.8,99.39
2020-04-26,Odisha,228,1,227,2960,4768,1301,7.7,0,46.8,95917,767,95328,10.19,2.78,0.06324786324786325,0.8,99.39
2020-04-27,Odisha,1455,7,1450,18422,3065,249,7.9,0,46.8,97372,774,96778,6.55,0.53,0.39363247863247863,0.79,99.39
2020-04-28,Odisha,1038,8,1033,13122,4677,4104,7.91,0,46.8,98410,782,97811,9.99,8.77,0.2803846153846154,0.79,99.39
2020-04-29,Odisha,351,1,345,4744,1749,659,7.4,5,46.8,98761,783,98156,3.74,1.41,0.10136752136752136,0.79,99.39
2020-04-30,Odisha,1072,5,1063,13199,683,403,8.12,4,46.8,99833,788,99219,1.46,0.86,0.28202991452991455,0.79,99.38
2020-05-01,Odisha,1407,19,1405,17502,2953,1460,8.04,0,46.8,101240,807,100624,6.31,3.12,0.373974358974359,0.8,99.39
2020-05-02,Odisha,463,4,462,5982,1258,573,7.74,0,46.8,101703,811,101086,2.69,1.22,0.12782051282051282,0.8,99.39
2020-05-03,Odisha,132,1,130,1527,3784,160,8.64,1,46.8,101835,812,101216,8.09,0.34,0.03262820512820513,0.8,99.39
2020-05-04,Odisha,569,5,562,7165,4949,3898,7.94,2,46.8,102404,817,101778,10.57,8.33,0.1530982905982906,0.8,99.39
2020-05-05,Odisha,1296,6,1294,16129,2298,44,8.04,0,46.8,103700,823,103072,4.91,0.09,0.34463675213675216,0.79,99.39
2020-05-06,Odisha,1157,4,1157,14388,3145,2525,8.04,0,46.8,104857,827,104229,6.72,5.4,0.30743589743589744,0.79,99.4
2020-05-07,Odisha,971,5,971,11786,3590,2688,8.24,0,46.8,105828,832,105200,7.67,5.74,0.25183760683760686,0.79,99.41
2020-05-08,Odisha,1534,5,1528,19502,4114,2117,7.87,1,46.8,107362,837,106728,8.79,4.52,0.4167094017094017,0.78,99.41
2020-05-09,Odisha,1440,20,1431,18002,731,720,8.0,0,46.8,108802,857,108159,1.56,1.54,0.38465811965811963,0.79,99.41
2020-05-10,Odisha,539,6,539,6512,894,849,8.28,0,46.8,109341,863,108698,1.91,1.81,0.13914529914529913,0.79,99.41
2020-05-11,Odisha,1306,12,1301,16249,132,65,8.04,0,46.8,110647,875,109999,0.28,0.14,0.3472008547008547,0.79,99.41
2020-05-12,Odisha,1347,17,1344,16775,966,633,8.03,0,46.8,111994,892,111343,2.06,1.35,0.35844017094017094,0.8,99.42
2020-05-13,Odisha,1544,12,1539,19401,3175,327,7.96,0,46.8,113538,904,112882,6.78,0.7,0.41455128205128206,0.8,99.42
2020-05-14,Odisha,683,7,674,8706,4886,2275,7.85,2,46.8,114221,911,113556,10.44,4.86,0.18602564102564104,0.8,99.42
2020-05-15,Odisha,738,2,729,9182,803,749,8.04,7,46.8,114959,913,114285,1.72,1.6,0.1961965811965812,0.79,99.41
2020-05-16,Odisha,1270,15,1269,15928,1292,589,7.97,0,46.8,116229,928,115554,2.76,1.26,0.34034188034188034,0.8,99.42
2020-05-17,Odisha,522,7,516,6091,2717,1606,8.57,0,46.8,116751,935,116070,5.81,3.43,0.13014957264957264,0.8,99.42
2020-05-18,Odisha,1331,17,1328,17196,3572,1071,7.74,0,46.8,118082,952,117398,7.63,2.29,0.36743589743589744,0.81,99.42
2020-05-19,Odisha,863,6,859,11122,4355,4306,7.76,0,46.8,118945,958,118257,9.31,9.2,0.23764957264957265,0.81,99.42
2020-05-20,Odisha,67,0,64,1121,2505,885,5.98,3,46.8,119012,958,118321,5.35,1.89,0.023952991452991453,0.8,99.42
2020-05-21,Odisha,1432,21,1431,17667,2990,1109,8.11,0,46.8,120444,979,119752,6.39,2.37,0.3775,0.81,99.43
2020-05-22,Odisha,347,2,347,5044,3059,175,6.88,0,46.8,120791,981,120099,6.54,0.37,0.10777777777777778,0.81,99.43
2020-05-23,Odisha,1012,14,1004,12548,3550,1854,8.07,0,46.8,121803,995,121103,7.59,3.96,0.2681196581196581,0.82,99.43
2020-05-24,Odisha,982,7,979,12322,2077,1992,7.97,0,46.8,122785,1002,122082,4.44,4.26,0.2632905982905983,0.82,99.43
2020-05-25,Odisha,1118,4,1115,14250,3706,1139,7.85,0,46.8,123903,1006,123197,7.92,2.43,0.30448717948717946,0.81,99.43
2020-05-26,Odisha,174,2,168,2022,1245,749,8.61,4,46.8,124077,1008,123365,2.66,1.6,0.04320512820512821,0.81,99.43
2020-05-27,Odisha,720,9,715,9103,3459,24,7.91,0,46.8,124797,1017,124080,7.39,0.05,0.194508547008547,0.81,99.43
2020-05-28,Odisha,544,7,537,6937,3721,2794,7.84,0,46.8,125341,1024,124617,7.95,5.97,0.14822649572649574,0.82,99.42
2020-05-29,Odisha,1239,16,1236,15503,4003,2305,7.99,0,46.8,126580,1040,125853,8.55,4.93,0.33126068376068374,0.82,99.43
2020-05-30,Odisha,1518,16,1517,18848,4265,1037,8.05,0,46.8,128098,1056,127370,9.11,2.22,0.40273504273504274,0.82,99.43
2020-05-31,Odisha,1518,12,1514,18763,910,782,8.09,0,46.8,129616,1068,128884,1.94,1.67,0.4009188034188034,0.82,99.44
2020-06-01,Odisha,89,0,83,1602,3523,3504,5.56,6,46.8,129705,1068,128967,7.53,7.49,0.03423076923076923,0.82,99.43
2020-06-02,Odisha,798,7,793,10283,852,586,7.76,0,46.8,130503,1075,129760,1.82,1.25,0.21972222222222224,0.82,99.43
2020-06-03,Odisha,910,6,903,10901,3697,1550,8.35,1,46.8,131413,1081,130663,7.9,3.31,0.23292735042735044,0.82,99.43
2020-06-04,Odisha,542,3,535,7017,3740,1533,7.72,4,46.8,131955,1084,131198,7.99,3.28,0.14993589743589744,0.82,99.43
2020-06-05,Odisha,658,8,658,8408,4603,2927,7.83,0,46.8,132613,1092,131856,9.84,6.25,0.17965811965811965,0.82,99.43
2020-06-06,Odisha,950,11,947,11611,3510,1248,8.18,0,46.8,133563,1103,132803,7.5,2.67,0.2480982905982906,0.83,99.43
2020-06-07,Odisha,1296,16,1292,15944,4547,3693,8.13,0,46.8,134859,1119,134095,9.72,7.89,0.34068376068376066,0.83,99.43
2020-06-08,Odisha,670,9,670,8777,2447,11,7.63,0,46.8,135529,1128,134765,5.23,0.02,0.18754273504273505,0.83,99.44
2020-06-09,Odisha,314,2,312,3653,2424,1699,8.6,0,46.8,135843,1130,135077,5.18,3.63,0.07805555555555556,0.83,99.44
2020-06-10,Odisha,1575,16,1572,19640,4552,2683,8.02,0,46.8,137418,1146,136649,9.73,5.73,0.41965811965811967,0.83,99.44
2020-06-11,Odisha,101,0,94,1312,1796,1024,7.7,7,46.8,137519,1146,136743,3.84,2.19,0.028034188034188036,0.83,99.44
2020-06-12,Odisha,1287,7,1282,16046,4812,4355,8.02,0,46.8,138806,1153,138025,10.28,9.31,0.34286324786324784,0.83,99.44
2020-06-13,Odisha,124,0,116,1400,4004,102,8.86,8,46.8,138930,1153,138141,8.56,0.22,0.029914529914529916,0.83,99.43
2020-06-14,Odisha,1060,3,1059,13244,563,563,8.0,0,46.8,139990,1156,139200,1.2,1.2,0.282991452991453,0.83,99.44
2020-06-15,Odisha,416,1,416,4914,3162,1165,8.47,0,46.8,140406,1157,139616,6.76,2.49,0.105,0.82,99.44
2020-06-16,Odisha,678,3,670,8610,1508,437,7.87,5,46.8,141084,1160,140286,3.22,0.93,0.183974358974359,0.82,99.43
2020-06-17,Odisha,1586,17,1582,19850,2641,1268,7.99,0,46.8,142670,1177,141868,5.64,2.71,0.42414529914529914,0.82,99.44
2020-06-18,Odisha,337,1,334,4095,4983,3331,8.23,2,46.8,143007,1178,142202,10.65,7.12,0.0875,0.82,99.44
2020-06-19,Odisha,1195,9,1189,14651,408,126,8.16,0,46.8,144202,1187,143391,0.87,0.27,0.31305555555555553,0.82,99.44
2020-06-20,Odisha,1380,9,1378,17334,3563,498,7.96,0,46.8,145582,1196,144769,7.61,1.06,0.37038461538461537,0.82,99.44
2020-06-21,Odisha,59,0,54,799,4779,4652,7.38,5,46.8,145641,1196,144823,10.21,9.94,0.017072649572649572,0.82,99.44
2020-06-22,Odisha,1508,5,1502,18719,4517,2645,8.06,1,46.8,147149,1201,146325,9.65,5.65,0.39997863247863247,0.82,99.44
2020-06-23,Odisha,1036,11,1036,13442,4798,625,7.71,0,46.8,148185,1212,147361,10.25,1.34,0.2872222222222222,0.82,99.44
2020-06-24,Odisha,327,2,325,3987,1464,235,8.2,0,46.8,148512,1214,147686,3.13,0.5,0.08519230769230769,0.82,99.44
2020-06-25,Odisha,964,10,960,12228,1728,584,7.88,0,46.8,149476,1224,148646,3.69,1.25,0.2612820512820513,0.82,99.44
2020-06-26,Odisha,174,1,173,2398,4442,267,7.26,0,46.8,149650,1225,148819,9.49,0.57,0.05123931623931624,0.82,99.44
2020-06-27,Odisha,1270,14,1270,15742,3323,2987,8.07,0,46.8,150920,1239,150089,7.1,6.38,0.33636752136752135,0.82,99.45
2020-06-28,Odisha,622,7,618,7277,3365,605,8.55,0,46.8,151542,1246,150707,7.19,1.29,0.155491452991453,0.82,99.45
2020-06-29,Odisha,1165,11,1156,14535,2370,1774,8.02,0,46.8,152707,1257,151863,5.06,3.79,0.3105769230769231,0.82,99.45
2020-06-30,Odisha,1263,8,1260,15707,3284,2750,8.04,0,46.8,153970,1265,153123,7.02,5.88,0.3356196581196581,0.82,99.45
2020-07-01,Odisha,162,2,155,2168,1896,1402,7.47,5,46.8,154132,1267,153278,4.05,3.0,0.04632478632478632,0.82,99.45
2020-07-02,Odisha,884,3,884,11316,3994,2906,7.81,0,46.8,155016,1270,154162,8.53,6.21,0.2417948717948718,0.82,99.45
2020-07-03,Odisha,841,9,836,10399,4108,2482,8.09,0,46.8,155857,1279,154998,8.78,5.3,0.2222008547008547,0.82,99.45
2020-07-04,Odisha,837,10,828,10573,2081,1687,7.92,0,46.8,156694,1289,155826,4.45,3.6,0.2259188034188034,0.82,99.45
2020-07-05,Odisha,98,0,90,1095,2104,2099,8.95,8,46.8,156792,1289,155916,4.5,4.49,0.023397435897435898,0.82,99.44
2020-07-06,Odisha,1024,9,1015,12753,4675,1055,8.03,0,46.8,157816,1298,156931,9.99,2.25,0.2725,0.82,99.44
2020-07-07,Odisha,61,0,55,742,2770,175,8.22,6,46.8,157877,1298,156986,5.92,0.37,0.015854700854700855,0.82,99.44
2020-07-08,Odisha,302,4,293,3747,4003,3577,8.06,5,46.8,158179,1302,157279,8.55,7.64,0.08006410256410257,0.82,99.43
2020-07-09,Odisha,547,4,542,6840,1829,974,8.0,1,46.8,158726,1306,157821,3.91,2.08,0.14615384615384616,0.82,99.43
2020-07-10,Odisha,70,0,62,1029,1469,1011,6.8,8,46.8,158796,1306,157883,3.14,2.16,0.021987179487179487,0.82,99.43
2020-07-11,Odisha,79,1,70,812,168,105,9.73,8,46.8,158875,1307,157953,0.36,0.22,0.017350427350427352,0.82,99.42
2020-07-12,Odisha,927,6,925,11546,78,34,8.03,0,46.8,159802,1313,158878,0.17,0.07,0.2467094017094017,0.82,99.42
2020-07-13,Odisha,1358,5,1358,17184,1308,391,7.9,0,46.8,161160,1318,160236,2.79,0.84,0.3671794871794872,0.82,99.43
2020-07-14,Odisha,1483,13,1476,18512,4712,2701,8.01,0,46.8,162643,1331,161712,10.07,5.77,0.39555555555555555,0.82,99.43
2020-07-15,Odisha,1335,9,1327,16746,3871,1113,7.97,0,46.8,163978,1340,163039,8.27,2.38,0.3578205128205128,0.82,99.43
2020-07-16,Odisha,1244,9,1241,15558,4614,2307,8.0,0,46.8,165222,1349,164280,9.86,4.93,0.3324358974358974,0.82,99.43
2020-07-17,Odisha,616,4,613,8049,4887,1178,7.65,0,46.8,165838,1353,164893,10.44,2.52,0.17198717948717948,0.82,99.43
2020-07-18,Odisha,957,13,956,11949,4059,3975,8.01,0,46.8,166795,1366,165849,8.67,8.49,0.2553205128205128,0.82,99.43
2020-07-19,Odisha,15,0,12,764,1490,1086,1.96,3,46.8,166810,1366,165861,3.18,2.32,0.016324786324786324,0.82,99.43
2020-07-20,Odisha,504,6,498,6636,2147,1571,7.59,0,46.8,167314,1372,166359,4.59,3.36,0.1417948717948718,0.82,99.43
2020-07-21,Odisha,215,2,208,2673,3539,937,8.04,5,46.8,167529,1374,166567,7.56,2.0,0.057115384615384616,0.82,99.43
2020-07-22,Odisha,915,13,913,11090,2123,763,8.25,0,46.8,168444,1387,167480,4.54,1.63,0.23696581196581196,0.82,99.43
2020-07-23,Odisha,139,0,134,1229,1573,218,11.31,5,46.8,168583,1387,167614,3.36,0.47,0.02626068376068376,0.82,99.43
2020-07-24,Odisha,417,3,417,5101,1923,1758,8.17,0,46.8,169000,1390,168031,4.11,3.76,0.1089957264957265,0.82,99.43
2020-07-25,Odisha,1022,8,1021,12852,3210,494,7.95,0,46.8,170022,1398,169052,6.86,1.06,0.2746153846153846,0.82,99.43
2020-07-26,Odisha,878,8,873,11215,3298,2285,7.83,0,46.8,170900,1406,169925,7.05,4.88,0.23963675213675215,0.82,99.43
2020-07-27,Odisha,1266,6,1264,16076,1721,612,7.88,0,46.8,172166,1412,171189,3.68,1.31,0.3435042735042735,0.82,99.43
2020-07-28,Odisha,1099,4,1095,13785,3099,471,7.97,0,46.8,173265,1416,172284,6.62,1.01,0.29455128205128206,0.82,99.43
2020-07-29,Odisha,1234,13,1227,15457,1459,1224,7.98,0,46.8,174499,1429,173511,3.12,2.62,0.3302777777777778,0.82,99.43
2020-07-30,Odisha,642,5,642,8484,3832,1993,7.57,0,46.8,175141,1434,174153,8.19,4.26,0.18128205128205127,0.82,99.44
2020-07-31,Odisha,1502,14,1495,18680,4603,4384,8.04,0,46.8,176643,1448,175648,9.84,9.37,0.39914529914529917,0.82,99.44
2020-08-01,Odisha,1546,8,1546,19349,1911,632,7.99,0,46.8,178189,1456,177194,4.08,1.35,0.41344017094017094,0.82,99.44
2020-08-02,Odisha,1171,4,1168,14036,2782,17,8.34,0,46.8,179360,1460,178362,5.94,0.04,0.29991452991452994,0.81,99.44
2020-08-03,Odisha,1573,21,1573,19908,163,162,7.9,0,46.8,180933,1481,179935,0.35,0.35,0.42538461538461536,0.82,99.45
2020-08-04,Odisha,541,7,534,6858,10,3,7.89,0,46.8,181474,1488,180469,0.02,0.01,0.14653846153846153,0.82,99.45
2020-08-05,Odisha,1290,14,1281,16421,3680,276,7.86,0,46.8,182764,1502,181750,7.86,0.59,0.3508760683760684,0.82,99.45
2020-08-06,Odisha,368,4,363,4614,1375,391,7.98,1,46.8,183132,1506,182113,2.94,0.84,0.0985897435897436,0.82,99.44
2020-08-07,Odisha,1344,15,1335,16722,617,201,8.04,0,46.8,184476,1521,183448,1.32,0.43,0.3573076923076923,0.82,99.44
2020-08-08,Odisha,1258,16,1254,15227,2728,704,8.26,0,46.8,185734,1537,184702,5.83,1.5,0.3253632478632479,0.83,99.44
2020-08-09,Odisha,831,12,831,10181,644,431,8.16,0,46.8,186565,1549,185533,1.38,0.92,0.21754273504273505,0.83,99.45
2020-08-10,Odisha,121,0,115,1455,1353,1011,8.32,6,46.8,186686,1549,185648,2.89,2.16,0.03108974358974359,0.83,99.44
2020-08-11,Odisha,734,3,732,9191,4306,2059,7.99,0,46.8,187420,1552,186380,9.2,4.4,0.1963888888888889,0.83,99.45
2020-08-12,Odisha,958,13,950,11917,496,115,8.04,0,46.8,188378,1565,187330,1.06,0.25,0.25463675213675213,0.83,99.44
2020-08-13,Odisha,1315,7,1308,16194,483,227,8.12,0,46.8,189693,1572,188638,1.03,0.49,0.34602564102564104,0.83,99.44
2020-08-14,Odisha,129,1,122,2210,2574,1512,5.84,6,46.8,189822,1573,188760,5.5,3.23,0.04722222222222222,0.83,99.44
2020-08-15,Odisha,1491,13,1485,18634,3980,476,8.0,0,46.8,191313,1586,190245,8.5,1.02,0.39816239316239316,0.83,99.44
2020-08-16,Odisha,777,7,776,9624,3789,1747,8.07,0,46.8,192090,1593,191021,8.1,3.73,0.20564102564102565,0.83,99.44
2020-08-17,Odisha,312,2,308,3724,1787,1620,8.38,2,46.8,192402,1595,191329,3.82,3.46,0.07957264957264958,0.83,99.44
2020-08-18,Odisha,110,0,108,1574,2583,948,6.99,2,46.8,192512,1595,191437,5.52,2.03,0.03363247863247863,0.83,99.44
2020-08-19,Odisha,1545,18,1539,19189,2709,961,8.05,0,46.8,194057,1613,192976,5.79,2.05,0.41002136752136753,0.83,99.44
2020-08-20,Odisha,1617,19,1609,19836,2232,2180,8.15,0,46.8,195674,1632,194585,4.77,4.66,0.4238461538461539,0.83,99.44
2020-08-21,Odisha,390,1,381,5080,844,559,7.68,8,46.8,196064,1633,194966,1.8,1.19,0.10854700854700855,0.83,99.44
2020-08-22,Odisha,940,13,939,11478,3085,992,8.19,0,46.8,197004,1646,195905,6.59,2.12,0.24525641025641026,0.84,99.44
2020-08-23,Odisha,1486,11,1485,18099,2528,1175,8.21,0,46.8,198490,1657,197390,5.4,2.51,0.3867307692307692,0.83,99.45
2020-08-24,Odisha,1032,3,1027,12550,3459,3161,8.22,2,46.8,199522,1660,198417,7.39,6.75,0.26816239316239315,0.83,99.45
2020-08-25,Odisha,1356,16,1348,16999,1773,423,7.98,0,46.8,200878,1676,199765,3.79,0.9,0.36322649572649574,0.83,99.45
2020-08-26,Odisha,707,10,701,8844,3387,2603,7.99,0,46.8,201585,1686,200466,7.24,5.56,0.18897435897435896,0.84,99.44
2020-08-27,Odisha,1558,18,1556,19630,3070,2978,7.94,0,46.8,203143,1704,202022,6.56,6.36,0.41944444444444445,0.84,99.45
2020-08-28,Odisha,1587,5,1582,19769,4479,3303,8.03,0,46.8,204730,1709,203604,9.57,7.06,0.42241452991452993,0.83,99.45
2020-08-29,Odisha,1484,5,1477,18548,2593,1002,8.0,2,46.8,206214,1714,205081,5.54,2.14,0.39632478632478635,0.83,99.45
2020-08-30,Odisha,1391,8,1384,17254,1183,142,8.06,0,46.8,207605,1722,206465,2.53,0.3,0.36867521367521366,0.83,99.45
2020-08-31,Odisha,552,4,551,7190,4584,2146,7.68,0,46.8,208157,1726,207016,9.79,4.59,0.15363247863247864,0.83,99.45
2020-09-01,Odisha,1625,12,1621,19960,1035,1030,8.14,0,46.8,209782,1738,208637,2.21,2.2,0.4264957264957265,0.83,99.45
2020-09-02,Odisha,204,2,196,2342,4048,2132,8.71,6,46.8,209986,1740,208833,8.65,4.56,0.05004273504273504,0.83,99.45
2020-09-03,Odisha,1074,12,1073,13844,1079,127,7.76,0,46.8,211060,1752,209906,2.31,0.27,0.29581196581196584,0.83,99.45
2020-09-04,Odisha,108,1,108,1348,2075,879,8.01,0,46.8,211168,1753,210014,4.43,1.88,0.028803418803418804,0.83,99.45
2020-09-05,Odisha,221,1,221,2915,4452,2451,7.58,0,46.8,211389,1754,210235,9.51,5.24,0.06228632478632479,0.83,99.45
2020-09-06,Odisha,816,6,810,9942,4892,2426,8.21,0,46.8,212205,1760,211045,10.45,5.18,0.21243589743589744,0.83,99.45
2020-09-07,Odisha,103,1,97,1008,2748,2389,10.22,5,46.8,212308,1761,211142,5.87,5.1,0.021538461538461538,0.83,99.45
2020-09-08,Odisha,1566,22,1557,19348,608,423,8.09,0,46.8,213874,1783,212699,1.3,0.9,0.41341880341880344,0.83,99.45
2020-09-09,Odisha,489,4,481,6513,3653,3552,7.51,4,46.8,214363,1787,213180,7.81,7.59,0.13916666666666666,0.83,99.45
2020-09-10,Odisha,614,4,611,7688,3897,3811,7.99,0,46.8,214977,1791,213791,8.33,8.14,0.16427350427350426,0.83,99.45
2020-09-11,Odisha,382,4,380,4828,1881,475,7.91,0,46.8,215359,1795,214171,4.02,1.01,0.10316239316239316,0.83,99.45
2020-09-12,Odisha,1088,12,1079,14133,2311,1625,7.7,0,46.8,216447,1807,215250,4.94,3.47,0.3019871794871795,0.83,99.45
2020-09-13,Odisha,1305,14,1305,16215,2617,1023,8.05,0,46.8,217752,1821,216555,5.59,2.19,0.34647435897435896,0.84,99.45
2020-09-14,Odisha,941,4,933,11914,243,166,7.9,4,46.8,218693,1825,217488,0.52,0.35,0.2545726495726496,0.83,99.45
2020-09-15,Odisha,167,0,167,2048,3486,3421,8.15,0,46.8,218860,1825,217655,7.45,7.31,0.04376068376068376,0.83,99.45
2020-09-16,Odisha,935,6,930,11409,3362,2595,8.2,0,46.8,219795,1831,218585,7.18,5.54,0.24378205128205127,0.83,99.45
2020-09-17,Odisha,372,5,368,4565,4386,383,8.15,0,46.8,220167,1836,218953,9.37,0.82,0.09754273504273504,0.83,99.45
2020-09-18,Odisha,1258,17,1252,16215,3091,2919,7.76,0,46.8,221425,1853,220205,6.6,6.24,0.34647435897435896,0.84,99.45
2020-09-19,Odisha,480,3,475,5814,3350,552,8.26,2,46.8,221905,1856,220680,7.16,1.18,0.12423076923076923,0.84,99.45
2020-09-20,Odisha,1063,13,1057,13148,3182,2974,8.08,0,46.8,222968,1869,221737,6.8,6.35,0.28094017094017093,0.84,99.45
2020-09-21,Odisha,577,6,572,7018,4449,949,8.22,0,46.8,223545,1875,222309,9.51,2.03,0.14995726495726497,0.84,99.45
2020-09-22,Odisha,70,0,64,738,4731,3782,9.49,6,46.8,223615,1875,222373,10.11,8.08,0.015769230769230768,0.84,99.44
2020-09-23,Odisha,586,3,586,7123,1404,718,8.23,0,46.8,224201,1878,222959,3.0,1.53,0.1522008547008547,0.84,99.45
2020-09-24,Odisha,1384,4,1383,17030,765,735,8.13,0,46.8,225585,1882,224342,1.63,1.57,0.3638888888888889,0.83,99.45
2020-09-25,Odisha,886,8,885,10813,3892,1659,8.19,0,46.8,226471,1890,225227,8.32,3.54,0.23104700854700855,0.83,99.45
2020-09-26,Odisha,681,2,675,7936,3230,695,8.58,4,46.8,227152,1892,225902,6.9,1.49,0.1695726495726496,0.83,99.45
2020-09-27,Odisha,971,13,968,11674,2285,820,8.32,0,46.8,228123,1905,226870,4.88,1.75,0.24944444444444444,0.84,99.45
2020-09-28,Odisha,1445,9,1445,18318,4757,3996,7.89,0,46.8,229568,1914,228315,10.16,8.54,0.3914102564102564,0.83,99.45
2020-09-29,Odisha,1539,11,1535,19787,2936,222,7.78,0,46.8,231107,1925,229850,6.27,0.47,0.4227991452991453,0.83,99.46
2020-09-30,Odisha,960,11,955,11585,1728,1723,8.29,0,46.8,232067,1936,230805,3.69,3.68,0.24754273504273505,0.83,99.46
2020-10-01,Odisha,1247,8,1245,15627,3238,2580,7.98,0,46.8,233314,1944,232050,6.92,5.51,0.3339102564102564,0.83,99.46
2020-10-02,Odisha,1440,13,1434,18158,697,395,7.93,0,46.8,234754,1957,233484,1.49,0.84,0.387991452991453,0.83,99.46
2020-10-03,Odisha,1097,12,1095,13383,3952,1969,8.2,0,46.8,235851,1969,234579,8.44,4.21,0.2859615384615385,0.83,99.46
2020-10-04,Odisha,286,3,277,3674,663,621,7.78,6,46.8,236137,1972,234856,1.42,1.33,0.0785042735042735,0.84,99.46
2020-10-05,Odisha,829,4,829,10450,1495,1075,7.93,0,46.8,236966,1976,235685,3.19,2.3,0.2232905982905983,0.83,99.46
2020-10-06,Odisha,140,1,131,1542,2609,1120,9.08,8,46.8,237106,1977,235816,5.57,2.39,0.03294871794871795,0.83,99.46
2020-10-07,Odisha,748,8,747,9737,4517,3988,7.68,0,46.8,237854,1985,236563,9.65,8.52,0.20805555555555555,0.83,99.46
2020-10-08,Odisha,999,7,997,12154,4504,522,8.22,0,46.8,238853,1992,237560,9.62,1.12,0.2597008547008547,0.83,99.46
2020-10-09,Odisha,966,10,963,12638,3794,1841,7.64,0,46.8,239819,2002,238523,8.11,3.93,0.270042735042735,0.83,99.46
2020-10-10,Odisha,1144,16,1136,13738,628,362,8.33,0,46.8,240963,2018,239659,1.34,0.77,0.29354700854700855,0.84,99.46
2020-10-11,Odisha,1435,20,1435,17945,946,607,8.0,0,46.8,242398,2038,241094,2.02,1.3,0.38344017094017097,0.84,99.46
2020-10-12,Odisha,179,1,177,2162,1962,274,8.28,1,46.8,242577,2039,241271,4.19,0.59,0.046196581196581196,0.84,99.46
2020-10-13,Odisha,494,1,490,6355,858,729,7.77,3,46.8,243071,2040,241761,1.83,1.56,0.13579059829059828,0.84,99.46
2020-10-14,Odisha,1347,20,1342,17131,2095,1448,7.86,0,46.8,244418,2060,243103,4.48,3.09,0.36604700854700856,0.84,99.46
2020-10-15,Odisha,144,0,135,1280,538,22,11.25,9,46.8,244562,2060,243238,1.15,0.05,0.02735042735042735,0.84,99.46
2020-10-16,Odisha,1562,6,1557,19739,2888,1546,7.91,0,46.8,246124,2066,244795,6.17,3.3,0.4217735042735043,0.84,99.46
2020-10-17,Odisha,103,1,100,1120,4001,2612,9.2,2,46.8,246227,2067,244895,8.55,5.58,0.023931623931623933,0.84,99.46
2020-10-18,Odisha,1576,19,1568,19939,725,141,7.9,0,46.8,247803,2086,246463,1.55,0.3,0.42604700854700855,0.84,99.46
2020-10-19,Odisha,84,0,80,788,1814,750,10.66,4,46.8,247887,2086,246543,3.88,1.6,0.016837606837606836,0.84,99.46
2020-10-20,Odisha,494,3,493,6280,4918,486,7.87,0,46.8,248381,2089,247036,10.51,1.04,0.13418803418803418,0.84,99.46
2020-10-21,Odisha,668,9,662,8180,2937,1024,8.17,0,46.8,249049,2098,247698,6.28,2.19,0.17478632478632478,0.84,99.46
2020-10-22,Odisha,90,0,88,1182,2793,2118,7.61,2,46.8,249139,2098,247786,5.97,4.53,0.025256410256410258,0.84,99.46
2020-10-23,Odisha,285,2,281,3480,1181,201,8.19,2,46.8,249424,2100,248067,2.52,0.43,0.07435897435897436,0.84,99.46
2020-10-24,Odisha,1339,6,1330,16661,3331,1994,8.04,3,46.8,250763,2106,249397,7.12,4.26,0.3560042735042735,0.84,99.46
2020-10-25,Odisha,1410,15,1402,18023,213,92,7.82,0,46.8,252173,2121,250799,0.46,0.2,0.3851068376068376,0.84,99.46
2020-10-26,Odisha,262,1,259,3225,571,229,8.12,2,46.8,252435,2122,251058,1.22,0.49,0.06891025641025642,0.84,99.45
2020-10-27,Odisha,1455,10,1448,18159,4068,551,8.01,0,46.8,253890,2132,252506,8.69,1.18,0.3880128205128205,0.84,99.45
2020-10-28,Odisha,945,11,938,11741,2281,209,8.05,0,46.8,254835,2143,253444,4.87,0.45,0.25087606837606835,0.84,99.45
2020-10-29,Odisha,1560,10,1552,19752,4138,685,7.9,0,46.8,256395,2153,254996,8.84,1.46,0.42205128205128206,0.84,99.45
2020-10-30,Odisha,40,0,40,977,3730,139,4.09,0,46.8,256435,2153,255036,7.97,0.3,0.020876068376068375,0.84,99.45
2020-10-31,Odisha,461,5,452,5662,3266,2799,8.14,4,46.8,256896,2158,255488,6.98,5.98,0.12098290598290598,0.84,99.45
2020-11-01,Odisha,721,7,721,9342,438,72,7.72,0,46.8,257617,2165,256209,0.94,0.15,0.1996153846153846,0.84,99.45
2020-11-02,Odisha,1262,10,1257,15848,4305,1774,7.96,0,46.8,258879,2175,257466,9.2,3.79,0.33863247863247864,0.84,99.45
2020-11-03,Odisha,1565,7,1557,19680,1721,801,7.95,1,46.8,260444,2182,259023,3.68,1.71,0.4205128205128205,0.84,99.45
2020-11-04,Odisha,817,4,810,9967,4491,1785,8.2,3,46.8,261261,2186,259833,9.6,3.81,0.21297008547008547,0.84,99.45
2020-11-05,Odisha,59,0,50,747,4923,952,7.9,9,46.8,261320,2186,259883,10.52,2.03,0.01596153846153846,0.84,99.45
2020-11-06,Odisha,1609,17,1605,19985,4700,1581,8.05,0,46.8,262929,2203,261488,10.04,3.38,0.4270299145299145,0.84,99.45
2020-11-07,Odisha,1331,13,1330,16152,4849,4476,8.24,0,46.8,264260,2216,262818,10.36,9.56,0.34512820512820513,0.84,99.45
2020-11-08,Odisha,729,2,725,9424,1565,1124,7.74,2,46.8,264989,2218,263543,3.34,2.4,0.20136752136752137,0.84,99.45
2020-11-09,Odisha,296,3,288,4075,4564,542,7.26,5,46.8,265285,2221,263831,9.75,1.16,0.08707264957264957,0.84,99.45
2020-11-10,Odisha,1243,6,1243,15375,2605,1660,8.08,0,46.8,266528,2227,265074,5.57,3.55,0.328525641025641,0.84,99.45
2020-11-11,Odisha,1416,20,1413,17451,4957,1593,8.11,0,46.8,267944,2247,266487,10.59,3.4,0.37288461538461537,0.84,99.46
2020-11-12,Odisha,39,0,32,540,1527,914,7.22,7,46.8,267983,2247,266519,3.26,1.95,0.011538461538461539,0.84,99.45
2020-11-13,Odisha,1510,20,1504,18504,1862,1446,8.16,0,46.8,269493,2267,268023,3.98,3.09,0.3953846153846154,0.84,99.45
2020-11-14,Odisha,455,3,453,5733,460,46,7.94,0,46.8,269948,2270,268476,0.98,0.1,0.1225,0.84,99.45
2020-11-15,Odisha,1263,16,1255,15786,2899,1430,8.0,0,46.8,271211,2286,269731,6.19,3.06,0.3373076923076923,0.84,99.45
2020-11-16,Odisha,280,1,272,4087,2550,1179,6.85,7,46.8,271491,2287,270003,5.45,2.52,0.08732905982905984,0.84,99.45
2020-11-17,Odisha,570,4,563,7793,1598,566,7.31,3,46.8,272061,2291,270566,3.41,1.21,0.16651709401709403,0.84,99.45
2020-11-18,Odisha,1016,7,1016,13069,4225,97,7.77,0,46.8,273077,2298,271582,9.03,0.21,0.2792521367521367,0.84,99.45
2020-11-19,Odisha,848,6,842,10339,1459,527,8.2,0,46.8,273925,2304,272424,3.12,1.13,0.2209188034188034,0.84,99.45
2020-11-20,Odisha,415,2,412,5195,972,829,7.99,1,46.8,274340,2306,272836,2.08,1.77,0.1110042735042735,0.84,99.45
2020-11-21,Odisha,536,7,530,6730,3227,318,7.96,0,46.8,274876,2313,273366,6.9,0.68,0.1438034188034188,0.84,99.45
2020-11-22,Odisha,1133,11,1128,14056,3089,2446,8.06,0,46.8,276009,2324,274494,6.6,5.23,0.30034188034188036,0.84,99.45
2020-11-23,Odisha,604,4,603,7786,851,508,7.76,0,46.8,276613,2328,275097,1.82,1.09,0.16636752136752136,0.84,99.45
2020-11-24,Odisha,845,10,845,10217,460,388,8.27,0,46.8,277458,2338,275942,0.98,0.83,0.21831196581196582,0.84,99.45
2020-11-25,Odisha,385,5,380,4407,4722,1531,8.74,0,46.8,277843,2343,276322,10.09,3.27,0.09416666666666666,0.84,99.45
2020-11-26,Odisha,191,1,184,2560,1001,458,7.46,6,46.8,278034,2344,276506,2.14,0.98,0.0547008547008547,0.84,99.45
2020-11-27,Odisha,190,0,187,2322,3781,3488,8.18,3,46.8,278224,2344,276693,8.08,7.45,0.04961538461538462,0.84,99.45
2020-11-28,Odisha,387,3,387,4610,1660,1392,8.39,0,46.8,278611,2347,277080,3.55,2.97,0.0985042735042735,0.84,99.45
2020-11-29,Odisha,1402,13,1394,17864,348,87,7.85,0,46.8,280013,2360,278474,0.74,0.19,0.3817094017094017,0.84,99.45
2020-11-30,Odisha,287,3,280,3557,57,17,8.07,4,46.8,280300,2363,278754,0.12,0.04,0.07600427350427351,0.84,99.45
2020-12-01,Odisha,77,0,68,953,2895,856,8.08,9,46.8,280377,2363,278822,6.19,1.83,0.020363247863247863,0.84,99.45
2020-12-02,Odisha,288,1,286,3592,4206,978,8.02,1,46.8,280665,2364,279108,8.99,2.09,0.07675213675213675,0.84,99.45
2020-12-03,Odisha,960,14,957,12126,280,137,7.92,0,46.8,281625,2378,280065,0.6,0.29,0.2591025641025641,0.84,99.45
2020-12-04,Odisha,529,2,523,6907,4949,2053,7.66,4,46.8,282154,2380,280588,10.57,4.39,0.14758547008547007,0.84,99.44
2020-12-05,Odisha,978,9,978,12254,682,282,7.98,0,46.8,283132,2389,281566,1.46,0.6,0.2618376068376068,0.84,99.45
2020-12-06,Odisha,1153,11,1150,14557,4308,1559,7.92,0,46.8,284285,2400,282716,9.21,3.33,0.31104700854700856,0.84,99.45
2020-12-07,Odisha,1068,7,1067,13068,3290,1918,8.17,0,46.8,285353,2407,283783,7.03,4.1,0.2792307692307692,0.84,99.45
2020-12-08,Odisha,1137,6,1130,14047,1329,1300,8.09,1,46.8,286490,2413,284913,2.84,2.78,0.30014957264957265,0.84,99.45
2020-12-09,Odisha,898,12,898,11200,3782,2836,8.02,0,46.8,287388,2425,285811,8.08,6.06,0.23931623931623933,0.84,99.45
2020-12-10,Odisha,270,1,268,3290,1052,967,8.21,1,46.8,287658,2426,286079,2.25,2.07,0.0702991452991453,0.84,99.45
2020-12-11,Odisha,85,0,80,1596,2457,1236,5.33,5,46.8,287743,2426,286159,5.25,2.64,0.034102564102564105,0.84,99.45
2020-12-12,Odisha,97,1,90,1142,403,309,8.49,6,46.8,287840,2427,286249,0.86,0.66,0.024401709401709402,0.84,99.45
2020-12-13,Odisha,426,6,423,5268,4567,2722,8.09,0,46.8,288266,2433,286672,9.76,5.82,0.11256410256410257,0.84,99.45
2020-12-14,Odisha,310,3,302,3982,4855,103,7.79,5,46.8,288576,2436,286974,10.37,0.22,0.08508547008547009,0.84,99.44
2020-12-15,Odisha,618,6,611,7723,267,59,8.0,1,46.8,289194,2442,287585,0.57,0.13,0.16502136752136753,0.84,99.44
2020-12-16,Odisha,871,2,862,10607,1762,1295,8.21,7,46.8,290065,2444,288447,3.76,2.77,0.22664529914529916,0.84,99.44
2020-12-17,Odisha,785,11,776,10006,4590,4150,7.85,0,46.8,290850,2455,289223,9.81,8.87,0.2138034188034188,0.84,99.44
2020-12-18,Odisha,752,10,745,9590,4183,2909,7.84,0,46.8,291602,2465,289968,8.94,6.22,0.2049145299145299,0.85,99.44
2020-12-19,Odisha,1090,14,1082,13542,3631,174,8.05,0,46.8,292692,2479,291050,7.76,0.37,0.28935897435897434,0.85,99.44
2020-12-20,Odisha,1088,10,1085,13600,3417,2028,8.0,0,46.8,293780,2489,292135,7.3,4.33,0.2905982905982906,0.85,99.44
2020-12-21,Odisha,1015,5,1006,12769,1978,1099,7.95,4,46.8,294795,2494,293141,4.23,2.35,0.27284188034188034,0.85,99.44
2020-12-22,Odisha,1194,14,1192,14473,2885,695,8.25,0,46.8,295989,2508,294333,6.16,1.49,0.30925213675213675,0.85,99.44
2020-12-23,Odisha,134,0,133,1676,2582,997,8.0,1,46.8,296123,2508,294466,5.52,2.13,0.035811965811965815,0.85,99.44
2020-12-24,Odisha,1097,8,1088,13473,4607,858,8.14,1,46.8,297220,2516,295554,9.84,1.83,0.2878846153846154,0.85,99.44
2020-12-25,Odisha,1465,5,1457,17997,55,26,8.14,3,46.8,298685,2521,297011,0.12,0.06,0.38455128205128203,0.84,99.44
2020-12-26,Odisha,267,1,264,3666,2860,1155,7.28,2,46.8,298952,2522,297275,6.11,2.47,0.07833333333333334,0.84,99.44
2020-12-27,Odisha,1143,5,1135,14652,3740,546,7.8,3,46.8,300095,2527,298410,7.99,1.17,0.3130769230769231,0.84,99.44
2020-12-28,Odisha,1540,20,1535,19082,2955,1235,8.07,0,46.8,301635,2547,299945,6.31,2.64,0.40773504273504274,0.84,99.44
2020-12-29,Odisha,208,2,203,2676,3883,1612,7.77,3,46.8,301843,2549,300148,8.3,3.44,0.057179487179487176,0.84,99.44
2020-12-30,Odisha,74,0,71,1384,2729,2019,5.35,3,46.8,301917,2549,300219,5.83,4.31,0.029572649572649573,0.84,99.44
2020-12-31,Odisha,1469,20,1464,18425,447,217,7.97,0,46.8,303386,2569,301683,0.96,0.46,0.3936965811965812,0.85,99.44
2021-01-01,Odisha,690,3,690,8169,1791,911,8.45,0,46.8,304076,2572,302373,3.83,1.95,0.17455128205128206,0.85,99.44
2021-01-02,Odisha,490,2,490,5955,1307,538,8.23,0,46.8,304566,2574,302863,2.79,1.15,0.12724358974358974,0.85,99.44
2021-01-03,Odisha,703,2,700,8751,691,385,8.03,1,46.8,305269,2576,303563,1.48,0.82,0.1869871794871795,0.84,99.44
2021-01-04,Odisha,1452,7,1443,17868,4613,2085,8.13,2,46.8,306721,2583,305006,9.86,4.46,0.3817948717948718,0.84,99.44
2021-01-05,Odisha,1006,7,1002,12771,323,11,7.88,0,46.8,307727,2590,306008,0.69,0.02,0.2728846153846154,0.84,99.44
2021-01-06,Odisha,258,2,257,3807,2379,475,6.78,0,46.8,307985,2592,306265,5.08,1.01,0.08134615384615385,0.84,99.44
2021-01-07,Odisha,710,2,708,8934,2084,947,7.95,0,46.8,308695,2594,306973,4.45,2.02,0.1908974358974359,0.84,99.44
2021-01-08,Odisha,384,4,383,4978,1758,626,7.71,0,46.8,309079,2598,307356,3.76,1.34,0.10636752136752137,0.84,99.44
2021-01-09,Odisha,79,0,78,868,66,64,9.1,1,46.8,309158,2598,307434,0.14,0.14,0.018547008547008546,0.84,99.44
2021-01-10,Odisha,1141,11,1140,14445,2262,375,7.9,0,46.8,310299,2609,308574,4.83,0.8,0.30865384615384617,0.84,99.44
2021-01-11,Odisha,1159,14,1156,14628,487,238,7.92,0,46.8,311458,2623,309730,1.04,0.51,0.31256410256410255,0.84,99.45
2021-01-12,Odisha,1324,15,1320,16698,4938,881,7.93,0,46.8,312782,2638,311050,10.55,1.88,0.3567948717948718,0.84,99.45
2021-01-13,Odisha,1421,9,1412,17617,762,542,8.07,0,46.8,314203,2647,312462,1.63,1.16,0.37643162393162394,0.84,99.45
2021-01-14,Odisha,1393,13,1391,17650,1589,1384,7.89,0,46.8,315596,2660,313853,3.4,2.96,0.37713675213675213,0.84,99.45
2021-01-15,Odisha,1578,23,1571,19842,4942,1137,7.95,0,46.8,317174,2683,315424,10.56,2.43,0.423974358974359,0.85,99.45
2021-01-16,Odisha,375,3,374,4592,3452,989,8.17,0,46.8,317549,2686,315798,7.38,2.11,0.09811965811965812,0.85,99.45
2021-01-17,Odisha,453,6,450,5765,4505,2661,7.86,0,46.8,318002,2692,316248,9.63,5.69,0.12318376068376069,0.85,99.45
2021-01-18,Odisha,1207,8,1203,14621,1562,1218,8.26,0,46.8,319209,2700,317451,3.34,2.6,0.3124145299145299,0.85,99.45
2021-01-19,Odisha,996,6,992,12734,2633,1919,7.82,0,46.8,320205,2706,318443,5.63,4.1,0.2720940170940171,0.85,99.45
2021-01-20,Odisha,422,1,419,4747,805,393,8.89,2,46.8,320627,2707,318862,1.72,0.84,0.10143162393162393,0.84,99.45
2021-01-21,Odisha,1517,14,1513,18973,4726,1008,8.0,0,46.8,322144,2721,320375,10.1,2.15,0.4054059829059829,0.84,99.45
2021-01-22,Odisha,258,2,252,3402,1350,916,7.58,4,46.8,322402,2723,320627,2.88,1.96,0.0726923076923077,0.84,99.45
2021-01-23,Odisha,733,2,730,8701,2892,2614,8.42,1,46.8,323135,2725,321357,6.18,5.59,0.18591880341880343,0.84,99.45
2021-01-24,Odisha,343,2,343,3623,4129,3260,9.47,0,46.8,323478,2727,321700,8.82,6.97,0.07741452991452992,0.84,99.45
2021-01-25,Odisha,667,2,667,8391,3740,895,7.95,0,46.8,324145,2729,322367,7.99,1.91,0.1792948717948718,0.84,99.45
2021-01-26,Odisha,1287,13,1279,15972,3756,2604,8.06,0,46.8,325432,2742,323646,8.03,5.56,0.3412820512820513,0.84,99.45
2021-01-27,Odisha,83,0,79,1156,3648,1016,7.18,4,46.8,325515,2742,323725,7.79,2.17,0.024700854700854702,0.84,99.45
2021-01-28,Odisha,1422,17,1418,17945,2465,1375,7.92,0,46.8,326937,2759,325143,5.27,2.94,0.38344017094017097,0.84,99.45
2021-01-29,Odisha,1290,5,1288,16047,1205,260,8.04,0,46.8,328227,2764,326431,2.57,0.56,0.3428846153846154,0.84,99.45
2021-01-30,Odisha,790,7,790,10009,4313,937,7.89,0,46.8,329017,2771,327221,9.22,2.0,0.21386752136752138,0.84,99.45
2021-01-31,Odisha,147,0,145,2239,1547,319,6.57,2,46.8,329164,2771,327366,3.31,0.68,0.04784188034188034,0.84,99.45
2021-02-01,Odisha,854,4,854,10967,4640,890,7.79,0,46.8,330018,2775,328220,9.91,1.9,0.23433760683760685,0.84,99.46
2021-02-02,Odisha,1539,6,1538,19248,2187,1952,8.0,0,46.8,331557,2781,329758,4.67,4.17,0.4112820512820513,0.84,99.46
2021-02-03,Odisha,979,12,978,12117,4285,1105,8.08,0,46.8,332536,2793,330736,9.16,2.36,0.2589102564102564,0.84,99.46
2021-02-04,Odisha,1119,16,1119,14143,250,146,7.91,0,46.8,333655,2809,331855,0.53,0.31,0.3022008547008547,0.84,99.46
2021-02-05,Odisha,1047,15,1045,13097,2739,1767,7.99,0,46.8,334702,2824,332900,5.85,3.78,0.27985042735042737,0.84,99.46
2021-02-06,Odisha,546,5,546,7010,560,291,7.79,0,46.8,335248,2829,333446,1.2,0.62,0.14978632478632478,0.84,99.46
2021-02-07,Odisha,1566,12,1557,19036,4284,1870,8.23,0,46.8,336814,2841,335003,9.15,4.0,0.40675213675213673,0.84,99.46
2021-02-08,Odisha,1072,5,1065,13038,3822,3600,8.22,2,46.8,337886,2846,336068,8.17,7.69,0.2785897435897436,0.84,99.46
2021-02-09,Odisha,1288,12,1279,15981,2620,2447,8.06,0,46.8,339174,2858,337347,5.6,5.23,0.34147435897435896,0.84,99.46
2021-02-10,Odisha,871,11,864,10271,3737,1515,8.48,0,46.8,340045,2869,338211,7.99,3.24,0.21946581196581197,0.84,99.46
2021-02-11,Odisha,583,2,575,7151,3065,763,8.15,6,46.8,340628,2871,338786,6.55,1.63,0.1527991452991453,0.84,99.46
2021-02-12,Odisha,57,0,48,750,2172,50,7.6,9,46.8,340685,2871,338834,4.64,0.11,0.016025641025641024,0.84,99.46
2021-02-13,Odisha,709,6,706,9014,949,715,7.87,0,46.8,341394,2877,339540,2.03,1.53,0.1926068376068376,0.84,99.46
2021-02-14,Odisha,1120,3,1114,14299,968,15,7.83,3,46.8,342514,2880,340654,2.07,0.03,0.305534188034188,0.84,99.46
2021-02-15,Odisha,853,4,847,10722,2167,1259,7.96,2,46.8,343367,2884,341501,4.63,2.69,0.2291025641025641,0.84,99.46
2021-02-16,Odisha,281,2,279,3786,1295,963,7.42,0,46.8,343648,2886,341780,2.77,2.06,0.0808974358974359,0.84,99.46
2021-02-17,Odisha,863,3,857,10617,4360,2121,8.13,3,46.8,344511,2889,342637,9.32,4.53,0.22685897435897437,0.84,99.46
2021-02-18,Odisha,592,8,584,6950,4928,3189,8.52,0,46.8,345103,2897,343221,10.53,6.81,0.1485042735042735,0.84,99.45
2021-02-19,Odisha,152,1,151,2046,1995,1641,7.43,0,46.8,345255,2898,343372,4.26,3.51,0.04371794871794872,0.84,99.45
2021-02-20,Odisha,252,3,246,3253,4817,4585,7.75,3,46.8,345507,2901,343618,10.29,9.8,0.06950854700854701,0.84,99.45
2021-02-21,Odisha,644,9,639,7844,2352,144,8.21,0,46.8,346151,2910,344257,5.03,0.31,0.16760683760683762,0.84,99.45
2021-02-22,Odisha,858,4,854,10416,3029,2993,8.24,0,46.8,347009,2914,345111,6.47,6.4,0.22256410256410256,0.84,99.45
2021-02-23,Odisha,317,2,312,4070,2689,1584,7.79,3,46.8,347326,2916,345423,5.75,3.38,0.08696581196581196,0.84,99.45
2021-02-24,Odisha,1264,17,1257,15774,1961,1835,8.01,0,46.8,348590,2933,346680,4.19,3.92,0.33705128205128204,0.84,99.45
2021-02-25,Odisha,449,2,448,5846,2895,1042,7.68,0,46.8,349039,2935,347128,6.19,2.23,0.12491452991452992,0.84,99.45
2021-02-26,Odisha,1080,6,1078,13627,2455,1373,7.93,0,46.8,350119,2941,348206,5.25,2.93,0.29117521367521365,0.84,99.45
2021-02-27,Odisha,452,5,450,5671,2114,1202,7.97,0,46.8,350571,2946,348656,4.52,2.57,0.12117521367521368,0.84,99.45
2021-02-28,Odisha,395,2,388,4769,4564,4102,8.28,5,46.8,350966,2948,349044,9.75,8.76,0.1019017094017094,0.84,99.45
2021-03-01,Odisha,908,12,906,11664,4105,2941,7.78,0,46.8,351874,2960,349950,8.77,6.28,0.24923076923076923,0.84,99.45
2021-03-02,Odisha,529,7,525,6513,4867,3951,8.12,0,46.8,352403,2967,350475,10.4,8.44,0.13916666666666666,0.84,99.45
2021-03-03,Odisha,442,2,439,5209,202,14,8.49,1,46.8,352845,2969,350914,0.43,0.03,0.1113034188034188,0.84,99.45
2021-03-04,Odisha,498,1,494,5953,3818,622,8.37,3,46.8,353343,2970,351408,8.16,1.33,0.1272008547008547,0.84,99.45
2021-03-05,Odisha,913,4,912,11389,4381,3517,8.02,0,46.8,354256,2974,352320,9.36,7.51,0.24335470085470085,0.84,99.45
2021-03-06,Odisha,1326,9,1321,16437,1931,515,8.07,0,46.8,355582,2983,353641,4.13,1.1,0.3512179487179487,0.84,99.45
2021-03-07,Odisha,829,11,825,10245,4598,660,8.09,0,46.8,356411,2994,354466,9.82,1.41,0.2189102564102564,0.84,99.45
2021-03-08,Odisha,959,13,956,12037,2204,1257,7.97,0,46.8,357370,3007,355422,4.71,2.69,0.2572008547008547,0.84,99.45
2021-03-09,Odisha,88,0,84,1122,4769,4707,7.84,4,46.8,357458,3007,355506,10.19,10.06,0.023974358974358973,0.84,99.45
2021-03-10,Odisha,1527,11,1526,19129,4016,1056,7.98,0,46.8,358985,3018,357032,8.58,2.26,0.40873931623931625,0.84,99.46
2021-03-11,Odisha,1276,16,1267,16054,3188,1476,7.95,0,46.8,360261,3034,358299,6.81,3.15,0.34303418803418806,0.84,99.46
2021-03-12,Odisha,574,8,566,7432,1900,682,7.72,0,46.8,360835,3042,358865,4.06,1.46,0.1588034188034188,0.84,99.45
2021-03-13,Odisha,1345,11,1337,16732,4355,1679,8.04,0,46.8,362180,3053,360202,9.31,3.59,0.35752136752136754,0.84,99.45
2021-03-14,Odisha,1345,5,1336,17081,2157,1496,7.87,4,46.8,363525,3058,361538,4.61,3.2,0.3649786324786325,0.84,99.45
2021-03-15,Odisha,403,2,397,4604,541,275,8.75,4,46.8,363928,3060,361935,1.16,0.59,0.09837606837606838,0.84,99.45
2021-03-16,Odisha,338,4,330,4266,3640,2278,7.92,4,46.8,364266,3064,362265,7.78,4.87,0.09115384615384615,0.84,99.45
2021-03-17,Odisha,293,1,288,3714,1894,1164,7.89,4,46.8,364559,3065,362553,4.05,2.49,0.07935897435897436,0.84,99.45
2021-03-18,Odisha,1352,14,1352,17431,3880,2914,7.76,0,46.8,365911,3079,363905,8.29,6.23,0.37245726495726494,0.84,99.45
2021-03-19,Odisha,1254,7,1247,15816,537,279,7.93,0,46.8,367165,3086,365152,1.15,0.6,0.33794871794871795,0.84,99.45
2021-03-20,Odisha,854,2,851,10349,1257,833,8.25,1,46.8,368019,3088,366003,2.69,1.78,0.22113247863247865,0.84,99.45
2021-03-21,Odisha,929,11,920,11763,2594,2425,7.9,0,46.8,368948,3099,366923,5.54,5.18,0.25134615384615383,0.84,99.45
2021-03-22,Odisha,185,2,180,2169,954,259,8.53,3,46.8,369133,3101,367103,2.04,0.55,0.04634615384615385,0.84,99.45
2021-03-23,Odisha,1201,16,1200,14735,2229,1758,8.15,0,46.8,370334,3117,368303,4.76,3.76,0.31485042735042734,0.84,99.45
2021-03-24,Odisha,1121,13,1121,13976,686,102,8.02,0,46.8,371455,3130,369424,1.47,0.22,0.29863247863247866,0.84,99.45
2021-03-25,Odisha,496,7,489,6368,4452,1454,7.79,0,46.8,371951,3137,369913,9.51,3.11,0.13606837606837607,0.84,99.45
2021-03-26,Odisha,1270,10,1267,16657,882,713,7.62,0,46.8,373221,3147,371180,1.88,1.52,0.35591880341880344,0.84,99.45
2021-03-27,Odisha,1400,10,1391,17274,4157,2481,8.1,0,46.8,374621,3157,372571,8.88,5.3,0.3691025641025641,0.84,99.45
2021-03-28,Odisha,644,7,642,8063,3823,761,7.99,0,46.8,375265,3164,373213,8.17,1.63,0.17228632478632477,0.84,99.45
2021-03-29,Odisha,1443,21,1440,17826,4982,1352,8.09,0,46.8,376708,3185,374653,10.65,2.89,0.3808974358974359,0.85,99.45
2021-03-30,Odisha,1475,4,1474,18252,1971,1489,8.08,0,46.8,378183,3189,376127,4.21,3.18,0.39,0.84,99.46
2021-03-31,Odisha,1024,3,1021,12838,1360,1289,7.98,0,46.8,379207,3192,377148,2.91,2.75,0.27431623931623933,0.84,99.46
2021-04-01,Odisha,683,7,678,8325,515,158,8.2,0,46.8,379890,3199,377826,1.1,0.34,0.1778846153846154,0.84,99.46
2021-04-02,Odisha,822,4,816,10224,3950,2459,8.04,2,46.8,380712,3203,378642,8.44,5.25,0.21846153846153846,0.84,99.46
2021-04-03,Odisha,1251,6,1247,15702,3110,2277,7.97,0,46.8,381963,3209,379889,6.65,4.87,0.3355128205128205,0.84,99.46
2021-04-04,Odisha,932,12,925,11745,4858,2817,7.94,0,46.8,382895,3221,380814,10.38,6.02,0.25096153846153846,0.84,99.46
2021-04-05,Odisha,331,3,328,4359,1973,132,7.59,0,46.8,383226,3224,381142,4.22,0.28,0.09314102564102564,0.84,99.46
2021-04-06,Odisha,387,1,382,4612,4837,1241,8.39,4,46.8,383613,3225,381524,10.34,2.65,0.09854700854700854,0.84,99.46
2021-04-07,Odisha,180,0,174,2414,3287,989,7.46,6,46.8,383793,3225,381698,7.02,2.11,0.05158119658119658,0.84,99.45
2021-04-08,Odisha,1251,5,1249,15780,555,403,7.93,0,46.8,385044,3230,382947,1.19,0.86,0.3371794871794872,0.84,99.46
2021-04-09,Odisha,132,0,132,1973,716,527,6.69,0,46.8,385176,3230,383079,1.53,1.13,0.04215811965811966,0.84,99.46
2021-04-10,Odisha,243,3,237,3291,3888,2157,7.38,3,46.8,385419,3233,383316,8.31,4.61,0.07032051282051283,0.84,99.45
2021-04-11,Odisha,675,5,668,8525,4435,3298,7.92,2,46.8,386094,3238,383984,9.48,7.05,0.18215811965811965,0.84,99.45
2021-04-12,Odisha,465,6,458,6309,506,460,7.37,1,46.8,386559,3244,384442,1.08,0.98,0.1348076923076923,0.84,99.45
2021-04-13,Odisha,645,7,645,8338,926,449,7.74,0,46.8,387204,3251,385087,1.98,0.96,0.17816239316239316,0.84,99.45
2021-04-14,Odisha,1315,13,1310,16233,3649,3633,8.1,0,46.8,388519,3264,386397,7.8,7.76,0.34685897435897434,0.84,99.45
2021-04-15,Odisha,1208,5,1208,15040,1003,900,8.03,0,46.8,389727,3269,387605,2.14,1.92,0.3213675213675214,0.84,99.46
2021-04-16,Odisha,601,4,592,7519,975,858,7.99,5,46.8,390328,3273,388197,2.08,1.83,0.16066239316239317,0.84,99.45
2021-04-17,Odisha,599,8,591,7402,1143,451,8.09,0,46.8,390927,3281,388788,2.44,0.96,0.15816239316239317,0.84,99.45
2021-04-18,Odisha,1155,9,1146,14189,1244,1161,8.14,0,46.8,392082,3290,389934,2.66,2.48,0.3031837606837607,0.84,99.45
2021-04-19,Odisha,656,3,648,8258,4697,4094,7.94,5,46.8,392738,3293,390582,10.04,8.75,0.17645299145299145,0.84,99.45
2021-04-20,Odisha,251,2,243,2927,4873,4135,8.58,6,46.8,392989,3295,390825,10.41,8.84,0.06254273504273504,0.84,99.45
2021-04-21,Odisha,1043,8,1037,12982,2402,1022,8.03,0,46.8,394032,3303,391862,5.13,2.18,0.2773931623931624,0.84,99.45
2021-04-22,Odisha,1319,8,1313,16602,724,170,7.94,0,46.8,395351,3311,393175,1.55,0.36,0.35474358974358977,0.84,99.45
2021-04-23,Odisha,1187,17,1183,15196,3985,3356,7.81,0,46.8,396538,3328,394358,8.51,7.17,0.3247008547008547,0.84,99.45
2021-04-24,Odisha,1181,12,1175,15303,3900,2135,7.72,0,46.8,397719,3340,395533,8.33,4.56,0.3269871794871795,0.84,99.45
2021-04-25,Odisha,1226,10,1220,15632,4258,4119,7.84,0,46.8,398945,3350,396753,9.1,8.8,0.334017094017094,0.84,99.45
2021-04-26,Odisha,782,8,781,9441,1718,723,8.28,0,46.8,399727,3358,397534,3.67,1.54,0.20173076923076924,0.84,99.45
2021-04-27,Odisha,38,0,32,557,999,74,6.82,6,46.8,399765,3358,397566,2.13,0.16,0.011901709401709402,0.84,99.45
2021-04-28,Odisha,1163,14,1158,14163,3420,2969,8.21,0,46.8,400928,3372,398724,7.31,6.34,0.30262820512820515,0.84,99.45
2021-04-29,Odisha,635,8,630,8267,1918,1550,7.68,0,46.8,401563,3380,399354,4.1,3.31,0.17664529914529914,0.84,99.45
2021-04-30,Odisha,854,12,851,10631,2756,2669,8.03,0,46.8,402417,3392,400205,5.89,5.7,0.22715811965811966,0.84,99.45
2021-05-01,Odisha,779,6,779,9624,900,723,8.09,0,46.8,403196,3398,400984,1.92,1.54,0.20564102564102565,0.84,99.45
2021-05-02,Odisha,424,4,420,5437,1912,820,7.8,0,46.8,403620,3402,401404,4.09,1.75,0.11617521367521368,0.84,99.45
2021-05-03,Odisha,659,5,656,8039,3141,1316,8.2,0,46.8,404279,3407,402060,6.71,2.81,0.17177350427350427,0.84,99.45
2021-05-04,Odisha,1014,12,1010,12575,407,84,8.06,0,46.8,405293,3419,403070,0.87,0.18,0.2686965811965812,0.84,99.45
2021-05-05,Odisha,1416,16,1408,17866,1310,336,7.93,0,46.8,406709,3435,404478,2.8,0.72,0.38175213675213676,0.84,99.45
2021-05-06,Odisha,351,4,344,4775,3706,1429,7.35,3,46.8,407060,3439,404822,7.92,3.05,0.10202991452991453,0.84,99.45
2021-05-07,Odisha,365,2,356,4514,4124,322,8.09,7,46.8,407425,3441,405178,8.81,0.69,0.09645299145299145,0.84,99.45
2021-05-08,Odisha,672,6,664,8573,4600,4408,7.84,2,46.8,408097,3447,405842,9.83,9.42,0.1831837606837607,0.84,99.45
2021-05-09,Odisha,1307,9,1302,16328,4395,105,8.0,0,46.8,409404,3456,407144,9.39,0.22,0.3488888888888889,0.84,99.45
2021-05-10,Odisha,1243,11,1240,15574,4099,2929,7.98,0,46.8,410647,3467,408384,8.76,6.26,0.3327777777777778,0.84,99.45
2021-05-11,Odisha,715,2,712,8845,4229,3644,8.08,1,46.8,411362,3469,409096,9.04,7.79,0.1889957264957265,0.84,99.45
2021-05-12,Odisha,216,2,216,2868,4707,1839,7.53,0,46.8,411578,3471,409312,10.06,3.93,0.06128205128205128,0.84,99.45
2021-05-13,Odisha,448,3,447,6395,4854,1882,7.01,0,46.8,412026,3474,409759,10.37,4.02,0.13664529914529913,0.84,99.45
2021-05-14,Odisha,351,1,345,4505,633,36,7.79,5,46.8,412377,3475,410104,1.35,0.08,0.09626068376068377,0.84,99.45
2021-05-15,Odisha,802,4,800,9688,1193,300,8.28,0,46.8,413179,3479,410904,2.55,0.64,0.207008547008547,0.84,99.45
2021-05-16,Odisha,181,1,175,2373,3021,1521,7.63,5,46.8,413360,3480,411079,6.46,3.25,0.05070512820512821,0.84,99.45
2021-05-17,Odisha,1036,4,1027,13045,101,56,7.94,5,46.8,414396,3484,412106,0.22,0.12,0.27873931623931625,0.84,99.45
2021-05-18,Odisha,1263,14,1254,15460,1426,1335,8.17,0,46.8,415659,3498,413360,3.05,2.85,0.33034188034188033,0.84,99.45
2021-05-19,Odisha,969,7,965,12320,566,421,7.87,0,46.8,416628,3505,414325,1.21,0.9,0.26324786324786326,0.84,99.45
2021-05-20,Odisha,1306,13,1299,15726,2789,2499,8.3,0,46.8,417934,3518,415624,5.96,5.34,0.33602564102564103,0.84,99.45
2021-05-21,Odisha,1172,7,1167,14719,4419,459,7.96,0,46.8,419106,3525,416791,9.44,0.98,0.314508547008547,0.84,99.45
2021-05-22,Odisha,133,1,127,1738,3938,3189,7.65,5,46.8,419239,3526,416918,8.41,6.81,0.03713675213675214,0.84,99.45
2021-05-23,Odisha,302,1,301,3678,2598,1994,8.21,0,46.8,419541,3527,417219,5.55,4.26,0.07858974358974359,0.84,99.45
2021-05-24,Odisha,424,3,420,5194,3736,1818,8.16,1,46.8,419965,3530,417639,7.98,3.88,0.11098290598290599,0.84,99.45
2021-05-25,Odisha,978,10,974,12287,3080,1462,7.96,0,46.8,420943,3540,418613,6.58,3.12,0.26254273504273506,0.84,99.45
2021-05-26,Odisha,882,7,874,10823,4382,456,8.15,1,46.8,421825,3547,419487,9.36,0.97,0.23126068376068376,0.84,99.45
2021-05-27,Odisha,823,8,816,10953,382,314,7.51,0,46.8,422648,3555,420303,0.82,0.67,0.23403846153846153,0.84,99.45
2021-05-28,Odisha,795,9,789,9329,551,307,8.52,0,46.8,423443,3564,421092,1.18,0.66,0.19933760683760685,0.84,99.44
2021-05-29,Odisha,368,2,363,4689,541,466,7.85,3,46.8,423811,3566,421455,1.16,1.0,0.10019230769230769,0.84,99.44
2021-05-30,Odisha,505,3,501,6512,73,59,7.75,1,46.8,424316,3569,421956,0.16,0.13,0.13914529914529913,0.84,99.44
2021-05-31,Odisha,869,5,860,10910,2514,912,7.97,4,46.8,425185,3574,422816,5.37,1.95,0.23311965811965812,0.84,99.44
2021-06-01,Odisha,711,4,702,9084,2390,1892,7.83,5,46.8,425896,3578,423518,5.11,4.04,0.1941025641025641,0.84,99.44
2021-06-02,Odisha,1427,11,1423,17884,384,185,7.98,0,46.8,427323,3589,424941,0.82,0.4,0.38213675213675213,0.84,99.44
2021-06-03,Odisha,771,7,767,9279,4402,2989,8.31,0,46.8,428094,3596,425708,9.41,6.39,0.19826923076923078,0.84,99.44
2021-06-04,Odisha,485,2,484,5945,234,83,8.16,0,46.8,428579,3598,426192,0.5,0.18,0.12702991452991452,0.84,99.44
2021-06-05,Odisha,712,4,704,8885,3684,405,8.01,4,46.8,429291,3602,426896,7.87,0.87,0.18985042735042734,0.84,99.44
2021-06-06,Odisha,169,1,169,2224,420,248,7.6,0,46.8,429460,3603,427065,0.9,0.53,0.04752136752136752,0.84,99.44
2021-06-07,Odisha,1560,13,1555,19643,3989,1839,7.94,0,46.8,431020,3616,428620,8.52,3.93,0.4197222222222222,0.84,99.44
2021-06-08,Odisha,698,8,691,8574,1827,454,8.14,0,46.8,431718,3624,429311,3.9,0.97,0.18320512820512821,0.84,99.44
2021-06-09,Odisha,1505,18,1505,18778,1269,247,8.01,0,46.8,433223,3642,430816,2.71,0.53,0.40123931623931625,0.84,99.44
2021-06-10,Odisha,781,8,773,9966,2920,2657,7.84,0,46.8,434004,3650,431589,6.24,5.68,0.21294871794871795,0.84,99.44
2021-06-11,Odisha,311,2,303,3747,2194,1363,8.3,6,46.8,434315,3652,431892,4.69,2.91,0.08006410256410257,0.84,99.44
2021-06-12,Odisha,672,3,664,8406,4369,1731,7.99,5,46.8,434987,3655,432556,9.34,3.7,0.17961538461538462,0.84,99.44
2021-06-13,Odisha,298,2,294,3760,3691,3675,7.93,2,46.8,435285,3657,432850,7.89,7.85,0.08034188034188035,0.84,99.44
2021-06-14,Odisha,336,4,334,4538,3859,2537,7.4,0,46.8,435621,3661,433184,8.25,5.42,0.09696581196581197,0.84,99.44
2021-06-15,Odisha,146,0,142,1391,1382,407,10.5,4,46.8,435767,3661,433326,2.95,0.87,0.029722222222222223,0.84,99.44
2021-06-16,Odisha,110,1,106,1281,2290,2093,8.59,3,46.8,435877,3662,433432,4.89,4.47,0.02737179487179487,0.84,99.44
2021-06-17,Odisha,635,6,631,7786,1603,1009,8.16,0,46.8,436512,3668,434063,3.43,2.16,0.16636752136752136,0.84,99.44
2021-06-18,Odisha,1319,4,1310,16375,1763,842,8.05,5,46.8,437831,3672,435373,3.77,1.8,0.34989316239316237,0.84,99.44
2021-06-19,Odisha,1062,8,1055,13003,3305,1898,8.17,0,46.8,438893,3680,436428,7.06,4.06,0.27784188034188034,0.84,99.44
2021-06-20,Odisha,1045,10,1041,13448,1422,713,7.77,0,46.8,439938,3690,437469,3.04,1.52,0.2873504273504274,0.84,99.44
2021-06-21,Odisha,674,7,670,8535,2390,362,7.9,0,46.8,440612,3697,438139,5.11,0.77,0.18237179487179486,0.84,99.44
2021-06-22,Odisha,732,6,723,9344,3033,832,7.83,3,46.8,441344,3703,438862,6.48,1.78,0.19965811965811966,0.84,99.44
2021-06-23,Odisha,1382,5,1378,16823,4238,1290,8.21,0,46.8,442726,3708,440240,9.06,2.76,0.35946581196581195,0.84,99.44
2021-06-24,Odisha,585,6,580,7718,571,316,7.58,0,46.8,443311,3714,440820,1.22,0.68,0.16491452991452993,0.84,99.44
2021-06-25,Odisha,352,4,348,4677,3397,1544,7.53,0,46.8,443663,3718,441168,7.26,3.3,0.09993589743589744,0.84,99.44
2021-06-26,Odisha,636,6,630,7974,1933,416,7.98,0,46.8,444299,3724,441798,4.13,0.89,0.17038461538461538,0.84,99.44
2021-06-27,Odisha,937,5,931,11196,2414,1496,8.37,1,46.8,445236,3729,442729,5.16,3.2,0.23923076923076922,0.84,99.44
2021-06-28,Odisha,811,8,807,10138,3711,2227,8.0,0,46.8,446047,3737,443536,7.93,4.76,0.21662393162393162,0.84,99.44
2021-06-29,Odisha,1013,4,1006,12714,3050,322,7.97,3,46.8,447060,3741,444542,6.52,0.69,0.27166666666666667,0.84,99.44
2021-06-30,Odisha,1434,6,1432,17478,4349,2451,8.2,0,46.8,448494,3747,445974,9.29,5.24,0.37346153846153846,0.84,99.44
2021-07-01,Odisha,839,6,832,10264,4451,2628,8.17,1,46.8,449333,3753,446806,9.51,5.62,0.2193162393162393,0.84,99.44
2021-07-02,Odisha,862,10,859,10688,460,236,8.07,0,46.8,450195,3763,447665,0.98,0.5,0.2283760683760684,0.84,99.44
2021-07-03,Odisha,579,6,571,7162,4991,4373,8.08,2,46.8,450774,3769,448236,10.66,9.34,0.15303418803418803,0.84,99.44
2021-07-04,Odisha,644,5,636,8272,1799,181,7.79,3,46.8,451418,3774,448872,3.84,0.39,0.17675213675213675,0.84,99.44
2021-07-05,Odisha,905,5,901,11503,2586,1645,7.87,0,46.8,452323,3779,449773,5.53,3.51,0.2457905982905983,0.84,99.44
2021-07-06,Odisha,1319,13,1317,15957,1050,570,8.27,0,46.8,453642,3792,451090,2.24,1.22,0.3409615384615385,0.84,99.44
2021-07-07,Odisha,436,5,433,5455,4798,1928,7.99,0,46.8,454078,3797,451523,10.25,4.12,0.11655982905982906,0.84,99.44
2021-07-08,Odisha,1497,9,1494,18231,82,79,8.21,0,46.8,455575,3806,453017,0.18,0.17,0.38955128205128203,0.84,99.44
2021-07-09,Odisha,447,6,445,6141,3912,2805,7.28,0,46.8,456022,3812,453462,8.36,5.99,0.13121794871794873,0.84,99.44
2021-07-10,Odisha,1102,15,1099,13879,4436,2626,7.94,0,46.8,457124,3827,454561,9.48,5.61,0.2965598290598291,0.84,99.44
2021-07-11,Odisha,798,5,796,9809,1575,1284,8.14,0,46.8,457922,3832,455357,3.37,2.74,0.2095940170940171,0.84,99.44
2021-07-12,Odisha,1522,16,1522,18944,2533,770,8.03,0,46.8,459444,3848,456879,5.41,1.65,0.4047863247863248,0.84,99.44
2021-07-13,Odisha,1580,21,1572,19625,2475,1121,8.05,0,46.8,461024,3869,458451,5.29,2.4,0.41933760683760685,0.84,99.44
2021-07-14,Odisha,1076,11,1070,13817,1517,1422,7.79,0,46.8,462100,3880,459521,3.24,3.04,0.29523504273504275,0.84,99.44
2021-07-15,Odisha,696,2,691,8832,4769,4687,7.88,3,46.8,462796,3882,460212,10.19,10.01,0.18871794871794872,0.84,99.44
2021-07-16,Odisha,617,6,612,7808,1157,657,7.9,0,46.8,463413,3888,460824,2.47,1.4,0.16683760683760684,0.84,99.44
2021-07-17,Odisha,754,7,752,9701,4388,929,7.77,0,46.8,464167,3895,461576,9.38,1.99,0.20728632478632478,0.84,99.44
2021-07-18,Odisha,557,4,552,6585,495,146,8.46,1,46.8,464724,3899,462128,1.06,0.31,0.1407051282051282,0.84,99.44
2021-07-19,Odisha,548,3,545,6948,3045,2193,7.89,0,46.8,465272,3902,462673,6.51,4.69,0.14846153846153845,0.84,99.44
2021-07-20,Odisha,1553,15,1551,19664,2362,319,7.9,0,46.8,466825,3917,464224,5.05,0.68,0.42017094017094014,0.84,99.44
2021-07-21,Odisha,817,9,812,10243,1584,966,7.98,0,46.8,467642,3926,465036,3.38,2.06,0.21886752136752136,0.84,99.44
2021-07-22,Odisha,790,2,782,9914,1485,743,7.97,6,46.8,468432,3928,465818,3.17,1.59,0.21183760683760683,0.84,99.44
2021-07-23,Odisha,1563,18,1563,19674,775,281,7.94,0,46.8,469995,3946,467381,1.66,0.6,0.4203846153846154,0.84,99.44
2021-07-24,Odisha,689,3,680,8422,454,245,8.18,6,46.8,470684,3949,468061,0.97,0.52,0.17995726495726497,0.84,99.44
2021-07-25,Odisha,1548,6,1542,19586,3411,3340,7.9,0,46.8,472232,3955,469603,7.29,7.14,0.4185042735042735,0.84,99.44
2021-07-26,Odisha,1027,9,1023,12296,3008,1028,8.35,0,46.8,473259,3964,470626,6.43,2.2,0.2627350427350427,0.84,99.44
2021-07-27,Odisha,616,4,614,8045,1724,800,7.66,0,46.8,473875,3968,471240,3.68,1.71,0.1719017094017094,0.84,99.44
2021-07-28,Odisha,643,7,635,7951,1812,660,8.09,1,46.8,474518,3975,471875,3.87,1.41,0.1698931623931624,0.84,99.44
2021-07-29,Odisha,1155,9,1151,14540,3973,3493,7.94,0,46.8,475673,3984,473026,8.49,7.46,0.3106837606837607,0.84,99.44
2021-07-30,Odisha,1596,6,1590,19646,2904,2178,8.12,0,46.8,477269,3990,474616,6.21,4.65,0.41978632478632477,0.84,99.44
2021-07-31,Odisha,1034,7,1026,13031,61,24,7.93,1,46.8,478303,3997,475642,0.13,0.05,0.27844017094017093,0.84,99.44
2021-08-01,Odisha,442,1,433,6054,4233,1041,7.3,8,46.8,478745,3998,476075,9.04,2.22,0.12935897435897437,0.84,99.44
2021-08-02,Odisha,1353,9,1347,17179,3986,878,7.88,0,46.8,480098,4007,477422,8.52,1.88,0.36707264957264957,0.83,99.44
2021-08-03,Odisha,697,7,692,8532,669,65,8.17,0,46.8,480795,4014,478114,1.43,0.14,0.1823076923076923,0.83,99.44
2021-08-04,Odisha,1237,9,1229,15453,823,275,8.0,0,46.8,482032,4023,479343,1.76,0.59,0.3301923076923077,0.83,99.44
2021-08-05,Odisha,946,5,937,11966,2996,1773,7.91,4,46.8,482978,4028,480280,6.4,3.79,0.2556837606837607,0.83,99.44
2021-08-06,Odisha,68,0,63,1188,642,255,5.72,5,46.8,483046,4028,480343,1.37,0.54,0.025384615384615384,0.83,99.44
2021-08-07,Odisha,1316,14,1307,16547,732,481,7.95,0,46.8,484362,4042,481650,1.56,1.03,0.35356837606837604,0.83,99.44
2021-08-08,Odisha,1260,16,1254,15873,2734,988,7.94,0,46.8,485622,4058,482904,5.84,2.11,0.33916666666666667,0.84,99.44
2021-08-09,Odisha,1023,5,1017,12759,2324,2070,8.02,1,46.8,486645,4063,483921,4.97,4.42,0.2726282051282051,0.83,99.44
2021-08-10,Odisha,621,6,612,8254,618,190,7.52,3,46.8,487266,4069,484533,1.32,0.41,0.17636752136752137,0.84,99.44
2021-08-11,Odisha,564,8,564,7228,2632,1129,7.8,0,46.8,487830,4077,485097,5.62,2.41,0.15444444444444444,0.84,99.44
2021-08-12,Odisha,1382,18,1376,17138,166,78,8.06,0,46.8,489212,4095,486473,0.35,0.17,0.3661965811965812,0.84,99.44
2021-08-13,Odisha,109,0,103,1518,2215,1797,7.18,6,46.8,489321,4095,486576,4.73,3.84,0.032435897435897434,0.84,99.44
2021-08-14,Odisha,445,5,445,5615,1746,442,7.93,0,46.8,489766,4100,487021,3.73,0.94,0.11997863247863248,0.84,99.44
2021-08-15,Odisha,561,5,557,7171,3158,1649,7.82,0,46.8,490327,4105,487578,6.75,3.52,0.15322649572649572,0.84,99.44
2021-08-16,Odisha,979,7,977,12818,1145,320,7.64,0,46.8,491306,4112,488555,2.45,0.68,0.2738888888888889,0.84,99.44
2021-08-17,Odisha,887,7,879,11329,403,140,7.83,1,46.8,492193,4119,489434,0.86,0.3,0.24207264957264957,0.84,99.44
2021-08-18,Odisha,318,2,313,4087,1455,1326,7.78,3,46.8,492511,4121,489747,3.11,2.83,0.08732905982905984,0.84,99.44
2021-08-19,Odisha,1518,18,1518,18822,3048,2586,8.07,0,46.8,494029,4139,491265,6.51,5.53,0.4021794871794872,0.84,99.44
2021-08-20,Odisha,689,5,684,8755,3291,483,7.87,0,46.8,494718,4144,491949,7.03,1.03,0.18707264957264957,0.84,99.44
2021-08-21,Odisha,1050,3,1043,13504,1840,1353,7.78,4,46.8,495768,4147,492992,3.93,2.89,0.28854700854700854,0.84,99.44
2021-08-22,Odisha,1045,9,1039,13189,4382,566,7.92,0,46.8,496813,4156,494031,9.36,1.21,0.28181623931623934,0.84,99.44
2021-08-23,Odisha,822,9,817,10637,3364,1402,7.73,0,46.8,497635,4165,494848,7.19,3.0,0.2272863247863248,0.84,99.44
2021-08-24,Odisha,962,3,962,12032,1903,996,8.0,0,46.8,498597,4168,495810,4.07,2.13,0.2570940170940171,0.84,99.44
2021-08-25,Odisha,195,1,192,2110,3121,333,9.24,2,46.8,498792,4169,496002,6.67,0.71,0.045085470085470085,0.84,99.44
2021-08-26,Odisha,1064,4,1061,13394,4050,751,7.94,0,46.8,499856,4173,497063,8.65,1.6,0.2861965811965812,0.83,99.44
2021-08-27,Odisha,870,2,867,11076,78,11,7.85,1,46.8,500726,4175,497930,0.17,0.02,0.23666666666666666,0.83,99.44
2021-08-28,Odisha,1574,22,1568,19798,823,688,7.95,0,46.8,502300,4197,499498,1.76,1.47,0.423034188034188,0.84,99.44
2021-08-29,Odisha,375,2,370,4777,3917,3106,7.85,3,46.8,502675,4199,499868,8.37,6.64,0.10207264957264957,0.84,99.44
2021-08-30,Odisha,1481,14,1478,18116,2009,1668,8.18,0,46.8,504156,4213,501346,4.29,3.56,0.3870940170940171,0.84,99.44
2021-08-31,Odisha,182,2,182,2324,2051,1400,7.83,0,46.8,504338,4215,501528,4.38,2.99,0.04965811965811966,0.84,99.44
2021-09-01,Odisha,45,0,38,667,3374,923,6.75,7,46.8,504383,4215,501566,7.21,1.97,0.014252136752136753,0.84,99.44
2021-09-02,Odisha,1009,9,1005,12751,3916,2462,7.91,0,46.8,505392,4224,502571,8.37,5.26,0.27245726495726497,0.84,99.44
2021-09-03,Odisha,1308,13,1302,16018,365,148,8.17,0,46.8,506700,4237,503873,0.78,0.32,0.34226495726495726,0.84,99.44
2021-09-04,Odisha,1557,17,1556,19475,557,152,7.99,0,46.8,508257,4254,505429,1.19,0.32,0.41613247863247865,0.84,99.44
2021-09-05,Odisha,978,12,974,12446,4116,2137,7.86,0,46.8,509235,4266,506403,8.79,4.57,0.2659401709401709,0.84,99.44
2021-09-06,Odisha,198,1,197,2412,1342,96,8.21,0,46.8,509433,4267,506600,2.87,0.21,0.05153846153846154,0.84,99.44
2021-09-07,Odisha,960,11,953,11655,2496,654,8.24,0,46.8,510393,4278,507553,5.33,1.4,0.24903846153846154,0.84,99.44
2021-09-08,Odisha,1452,5,1446,18523,997,172,7.84,1,46.8,511845,4283,508999,2.13,0.37,0.3957905982905983,0.84,99.44
2021-09-09,Odisha,155,1,148,2358,3909,603,6.57,6,46.8,512000,4284,509147,8.35,1.29,0.05038461538461538,0.84,99.44
2021-09-10,Odisha,222,1,217,2480,665,474,8.95,4,46.8,512222,4285,509364,1.42,1.01,0.05299145299145299,0.84,99.44
2021-09-11,Odisha,236,3,233,3058,2345,957,7.72,0,46.8,512458,4288,509597,5.01,2.04,0.06534188034188035,0.84,99.44
2021-09-12,Odisha,380,2,374,4356,4423,1145,8.72,4,46.8,512838,4290,509971,9.45,2.45,0.09307692307692307,0.84,99.44
2021-09-13,Odisha,1415,6,1413,17831,2192,1647,7.94,0,46.8,514253,4296,511384,4.68,3.52,0.3810042735042735,0.84,99.44
2021-09-14,Odisha,351,2,346,4677,1474,1438,7.5,3,46.8,514604,4298,511730,3.15,3.07,0.09993589743589744,0.84,99.44
2021-09-15,Odisha,914,5,909,11492,3142,787,7.95,0,46.8,515518,4303,512639,6.71,1.68,0.24555555555555555,0.83,99.44
2021-09-16,Odisha,1490,13,1487,19255,465,16,7.74,0,46.8,517008,4316,514126,0.99,0.03,0.4114316239316239,0.83,99.44
2021-09-17,Odisha,806,5,806,10020,3675,2677,8.04,0,46.8,517814,4321,514932,7.85,5.72,0.2141025641025641,0.83,99.44
2021-09-18,Odisha,416,2,414,5271,1726,444,7.89,0,46.8,518230,4323,515346,3.69,0.95,0.11262820512820512,0.83,99.44
2021-09-19,Odisha,111,1,105,1492,268,1,7.44,5,46.8,518341,4324,515451,0.57,0.0,0.03188034188034188,0.83,99.44
2021-09-20,Odisha,419,2,419,5011,650,530,8.36,0,46.8,518760,4326,515870,1.39,1.13,0.10707264957264957,0.83,99.44
2021-09-21,Odisha,724,5,718,9102,4119,897,7.95,1,46.8,519484,4331,516588,8.8,1.92,0.19448717948717947,0.83,99.44
2021-09-22,Odisha,312,3,310,3507,1532,158,8.9,0,46.8,519796,4334,516898,3.27,0.34,0.07493589743589743,0.83,99.44
2021-09-23,Odisha,974,12,967,11956,3581,1728,8.15,0,46.8,520770,4346,517865,7.65,3.69,0.2554700854700855,0.83,99.44
2021-09-24,Odisha,1121,7,1121,13815,3649,1721,8.11,0,46.8,521891,4353,518986,7.8,3.68,0.2951923076923077,0.83,99.44
2021-09-25,Odisha,1273,17,1268,15936,2997,2908,7.99,0,46.8,523164,4370,520254,6.4,6.21,0.3405128205128205,0.84,99.44
2021-09-26,Odisha,885,2,880,11292,3491,497,7.84,3,46.8,524049,4372,521134,7.46,1.06,0.24128205128205127,0.83,99.44
2021-09-27,Odisha,80,0,76,1119,4316,2342,7.15,4,46.8,524129,4372,521210,9.22,5.0,0.02391025641025641,0.83,99.44
2021-09-28,Odisha,462,3,462,5695,1755,423,8.11,0,46.8,524591,4375,521672,3.75,0.9,0.12168803418803419,0.83,99.44
2021-09-29,Odisha,1292,18,1283,15915,3646,608,8.12,0,46.8,525883,4393,522955,7.79,1.3,0.3400641025641026,0.84,99.44
2021-09-30,Odisha,193,2,193,2354,4507,2177,8.2,0,46.8,526076,4395,523148,9.63,4.65,0.0502991452991453,0.84,99.44
2021-10-01,Odisha,1505,13,1505,18580,878,802,8.1,0,46.8,527581,4408,524653,1.88,1.71,0.397008547008547,0.84,99.45
2021-10-02,Odisha,820,3,817,10251,375,37,8.0,0,46.8,528401,4411,525470,0.8,0.08,0.21903846153846154,0.83,99.45
2021-10-03,Odisha,1497,14,1488,18753,3682,1199,7.98,0,46.8,529898,4425,526958,7.87,2.56,0.4007051282051282,0.84,99.45
2021-10-04,Odisha,1014,13,1007,12680,1675,225,8.0,0,46.8,530912,4438,527965,3.58,0.48,0.2709401709401709,0.84,99.44
2021-10-05,Odisha,336,3,336,4341,4313,3888,7.74,0,46.8,531248,4441,528301,9.22,8.31,0.09275641025641025,0.84,99.45
2021-10-06,Odisha,1198,16,1194,15172,1870,781,7.9,0,46.8,532446,4457,529495,4.0,1.67,0.3241880341880342,0.84,99.45
2021-10-07,Odisha,313,3,313,4006,4924,1670,7.81,0,46.8,532759,4460,529808,10.52,3.57,0.0855982905982906,0.84,99.45
2021-10-08,Odisha,419,5,415,5257,4213,2267,7.97,0,46.8,533178,4465,530223,9.0,4.84,0.11232905982905983,0.84,99.45
2021-10-09,Odisha,1153,4,1147,14361,1439,303,8.03,2,46.8,534331,4469,531370,3.07,0.65,0.30685897435897436,0.84,99.45
2021-10-10,Odisha,805,6,803,10097,3247,576,7.97,0,46.8,535136,4475,532173,6.94,1.23,0.21574786324786324,0.84,99.45
2021-10-11,Odisha,336,3,327,4052,3763,1615,8.29,6,46.8,535472,4478,532500,8.04,3.45,0.08658119658119658,0.84,99.44
2021-10-12,Odisha,1045,3,1036,13108,54,23,7.97,6,46.8,536517,4481,533536,0.12,0.05,0.2800854700854701,0.84,99.44
2021-10-13,Odisha,230,2,227,2389,189,40,9.63,1,46.8,536747,4483,533763,0.4,0.09,0.05104700854700855,0.84,99.44
2021-10-14,Odisha,1213,15,1211,14946,1524,92,8.12,0,46.8,537960,4498,534974,3.26,0.2,0.31935897435897437,0.84,99.44
2021-10-15,Odisha,1320,7,1311,16477,892,704,8.01,2,46.8,539280,4505,536285,1.91,1.5,0.35207264957264955,0.84,99.44
2021-10-16,Odisha,1625,23,1620,19963,152,89,8.14,0,46.8,540905,4528,537905,0.32,0.19,0.42655982905982903,0.84,99.45
2021-10-17,Odisha,349,1,347,4314,4405,1822,8.09,1,46.8,541254,4529,538252,9.41,3.89,0.09217948717948718,0.84,99.45
2021-10-18,Odisha,679,8,673,8213,743,482,8.27,0,46.8,541933,4537,538925,1.59,1.03,0.175491452991453,0.84,99.44
2021-10-19,Odisha,1046,9,1039,12508,1518,1040,8.36,0,46.8,542979,4546,539964,3.24,2.22,0.26726495726495725,0.84,99.44
2021-10-20,Odisha,1299,13,1290,16135,2347,1239,8.05,0,46.8,544278,4559,541254,5.01,2.65,0.34476495726495726,0.84,99.44
2021-10-21,Odisha,450,4,447,5455,3961,1515,8.25,0,46.8,544728,4563,541701,8.46,3.24,0.11655982905982906,0.84,99.44
2021-10-22,Odisha,395,4,394,5314,4139,1761,7.43,0,46.8,545123,4567,542095,8.84,3.76,0.11354700854700854,0.84,99.44
2021-10-23,Odisha,803,8,799,9775,4759,3595,8.21,0,46.8,545926,4575,542894,10.17,7.68,0.20886752136752137,0.84,99.44
2021-10-24,Odisha,884,11,883,10704,4324,2437,8.26,0,46.8,546810,4586,543777,9.24,5.21,0.2287179487179487,0.84,99.45
2021-10-25,Odisha,1501,19,1496,18362,4167,1720,8.17,0,46.8,548311,4605,545273,8.9,3.68,0.39235042735042736,0.84,99.45
2021-10-26,Odisha,564,6,560,7451,1355,336,7.57,0,46.8,548875,4611,545833,2.9,0.72,0.1592094017094017,0.84,99.45
2021-10-27,Odisha,1010,6,1001,12556,312,298,8.04,3,46.8,549885,4617,546834,0.67,0.64,0.2682905982905983,0.84,99.45
2021-10-28,Odisha,273,1,264,3373,3779,1135,8.09,8,46.8,550158,4618,547098,8.07,2.43,0.07207264957264957,0.84,99.44
2021-10-29,Odisha,474,2,468,5922,1646,1464,8.0,4,46.8,550632,4620,547566,3.52,3.13,0.12653846153846154,0.84,99.44
2021-10-30,Odisha,344,1,343,4636,914,724,7.42,0,46.8,550976,4621,547909,1.95,1.55,0.09905982905982906,0.84,99.44
2021-10-31,Odisha,1110,8,1106,13846,3056,22,8.02,0,46.8,552086,4629,549015,6.53,0.05,0.29585470085470084,0.84,99.44
2021-11-01,Odisha,1470,13,1467,18773,2281,949,7.83,0,46.8,553556,4642,550482,4.87,2.03,0.40113247863247864,0.84,99.44
2021-11-02,Odisha,657,3,648,7806,3360,486,8.42,6,46.8,554213,4645,551130,7.18,1.04,0.1667948717948718,0.84,99.44
2021-11-03,Odisha,1421,7,1420,17340,2458,548,8.19,0,46.8,555634,4652,552550,5.25,1.17,0.37051282051282053,0.84,99.44
2021-11-04,Odisha,471,6,466,6059,1265,58,7.77,0,46.8,556105,4658,553016,2.7,0.12,0.12946581196581197,0.84,99.44
2021-11-05,Odisha,932,7,926,11689,1469,331,7.97,0,46.8,557037,4665,553942,3.14,0.71,0.24976495726495726,0.84,99.44
2021-11-06,Odisha,453,5,445,5977,1806,381,7.58,3,46.8,557490,4670,554387,3.86,0.81,0.12771367521367522,0.84,99.44
2021-11-07,Odisha,1525,4,1525,18790,3471,3411,8.12,0,46.8,559015,4674,555912,7.42,7.29,0.4014957264957265,0.84,99.44
2021-11-08,Odisha,1260,18,1252,15621,2519,226,8.07,0,46.8,560275,4692,557164,5.38,0.48,0.3337820512820513,0.84,99.44
2021-11-09,Odisha,293,3,293,3612,253,27,8.11,0,46.8,560568,4695,557457,0.54,0.06,0.07717948717948718,0.84,99.45
2021-11-10,Odisha,605,5,597,7597,968,498,7.96,3,46.8,561173,4700,558054,2.07,1.06,0.16232905982905982,0.84,99.44
2021-11-11,Odisha,950,5,945,12000,155,89,7.92,0,46.8,562123,4705,558999,0.33,0.19,0.2564102564102564,0.84,99.44
2021-11-12,Odisha,1040,12,1036,12990,4355,2820,8.01,0,46.8,563163,4717,560035,9.31,6.03,0.2775641025641026,0.84,99.44
2021-11-13,Odisha,1052,9,1044,13067,2229,746,8.05,0,46.8,564215,4726,561079,4.76,1.59,0.2792094017094017,0.84,99.44
2021-11-14,Odisha,945,6,942,12153,575,564,7.78,0,46.8,565160,4732,562021,1.23,1.21,0.2596794871794872,0.84,99.44
2021-11-15,Odisha,741,9,739,9253,4707,604,8.01,0,46.8,565901,4741,562760,10.06,1.29,0.19771367521367522,0.84,99.44
2021-11-16,Odisha,616,4,611,7791,52,28,7.91,1,46.8,566517,4745,563371,0.11,0.06,0.16647435897435897,0.84,99.44
2021-11-17,Odisha,1339,9,1335,16713,4777,52,8.01,0,46.8,567856,4754,564706,10.21,0.11,0.3571153846153846,0.84,99.45
2021-11-18,Odisha,1095,8,1091,13842,3423,624,7.91,0,46.8,568951,4762,565797,7.31,1.33,0.2957692307692308,0.84,99.45
2021-11-19,Odisha,1179,4,1175,15074,3017,2197,7.82,0,46.8,570130,4766,566972,6.45,4.69,0.3220940170940171,0.84,99.45
2021-11-20,Odisha,468,5,468,5621,1153,552,8.33,0,46.8,570598,4771,567440,2.46,1.18,0.1201068376068376,0.84,99.45
2021-11-21,Odisha,300,3,300,3627,1369,1008,8.27,0,46.8,570898,4774,567740,2.93,2.15,0.0775,0.84,99.45
2021-11-22,Odisha,1160,5,1154,14499,927,96,8.0,1,46.8,572058,4779,568894,1.98,0.21,0.3098076923076923,0.84,99.45
2021-11-23,Odisha,1130,13,1121,13914,3778,1078,8.12,0,46.8,573188,4792,570015,8.07,2.3,0.29730769230769233,0.84,99.45
2021-11-24,Odisha,1247,7,1244,15562,812,755,8.01,0,46.8,574435,4799,571259,1.74,1.61,0.3325213675213675,0.84,99.45
2021-11-25,Odisha,1251,18,1250,15690,3769,1931,7.97,0,46.8,575686,4817,572509,8.05,4.13,0.33525641025641023,0.84,99.45
2021-11-26,Odisha,467,6,459,5656,1308,180,8.26,2,46.8,576153,4823,572968,2.79,0.38,0.12085470085470086,0.84,99.45
2021-11-27,Odisha,582,2,581,7563,3867,1895,7.7,0,46.8,576735,4825,573549,8.26,4.05,0.1616025641025641,0.84,99.45
2021-11-28,Odisha,486,4,481,6093,4891,975,7.98,1,46.8,577221,4829,574030,10.45,2.08,0.1301923076923077,0.84,99.45
2021-11-29,Odisha,265,1,259,2918,4088,1771,9.08,5,46.8,577486,4830,574289,8.74,3.78,0.062350427350427354,0.84,99.45
2021-11-30,Odisha,767,4,761,9851,2366,981,7.79,2,46.8,578253,4834,575050,5.06,2.1,0.210491452991453,0.84,99.45
2021-12-01,Odisha,174,2,171,2450,2692,1170,7.1,1,46.8,578427,4836,575221,5.75,2.5,0.05235042735042735,0.84,99.45
2021-12-02,Odisha,1527,11,1525,18946,3128,721,8.06,0,46.8,579954,4847,576746,6.68,1.54,0.4048290598290598,0.84,99.45
2021-12-03,Odisha,1305,8,1301,16675,2141,1136,7.83,0,46.8,581259,4855,578047,4.57,2.43,0.3563034188034188,0.84,99.45
2021-12-04,Odisha,836,8,834,10370,324,113,8.06,0,46.8,582095,4863,578881,0.69,0.24,0.22158119658119657,0.84,99.45
2021-12-05,Odisha,727,5,723,8696,1010,999,8.36,0,46.8,582822,4868,579604,2.16,2.13,0.18581196581196582,0.84,99.45
2021-12-06,Odisha,848,6,848,10483,4443,1231,8.09,0,46.8,583670,4874,580452,9.49,2.63,0.2239957264957265,0.84,99.45
2021-12-07,Odisha,201,2,199,2970,4508,3844,6.77,0,46.8,583871,4876,580651,9.63,8.21,0.06346153846153846,0.84,99.45
2021-12-08,Odisha,767,3,761,9744,4076,3783,7.87,3,46.8,584638,4879,581412,8.71,8.08,0.2082051282051282,0.83,99.45
2021-12-09,Odisha,1545,9,1539,19099,4845,1643,8.09,0,46.8,586183,4888,582951,10.35,3.51,0.4080982905982906,0.83,99.45
2021-12-10,Odisha,508,7,502,6412,3258,2636,7.92,0,46.8,586691,4895,583453,6.96,5.63,0.137008547008547,0.83,99.45
2021-12-11,Odisha,1194,15,1186,14731,94,85,8.11,0,46.8,587885,4910,584639,0.2,0.18,0.3147649572649573,0.84,99.45
2021-12-12,Odisha,1551,19,1551,19352,141,28,8.01,0,46.8,589436,4929,586190,0.3,0.06,0.4135042735042735,0.84,99.45
2021-12-13,Odisha,174,1,167,1896,1255,907,9.18,6,46.8,589610,4930,586357,2.68,1.94,0.04051282051282051,0.84,99.45
2021-12-14,Odisha,937,9,928,11226,1588,1030,8.35,0,46.8,590547,4939,587285,3.39,2.2,0.23987179487179489,0.84,99.45
2021-12-15,Odisha,489,2,488,6002,3193,2749,8.15,0,46.8,591036,4941,587773,6.82,5.87,0.12824786324786325,0.84,99.45
2021-12-16,Odisha,1454,18,1446,18551,1590,101,7.84,0,46.8,592490,4959,589219,3.4,0.22,0.3963888888888889,0.84,99.45
2021-12-17,Odisha,207,1,207,2414,2906,90,8.57,0,46.8,592697,4960,589426,6.21,0.19,0.05158119658119658,0.84,99.45
2021-12-18,Odisha,1192,4,1187,14960,3010,1480,7.97,1,46.8,593889,4964,590613,6.43,3.16,0.31965811965811963,0.84,99.45
2021-12-19,Odisha,495,5,489,6331,4265,2855,7.82,1,46.8,594384,4969,591102,9.11,6.1,0.13527777777777777,0.84,99.45
2021-12-20,Odisha,1331,7,1322,16542,2681,1130,8.05,2,46.8,595715,4976,592424,5.73,2.41,0.35346153846153844,0.84,99.45
2021-12-21,Odisha,109,1,102,1660,4752,608,6.57,6,46.8,595824,4977,592526,10.15,1.3,0.03547008547008547,0.84,99.45
2021-12-22,Odisha,1435,17,1431,17599,4453,3099,8.15,0,46.8,597259,4994,593957,9.51,6.62,0.37604700854700857,0.84,99.45
2021-12-23,Odisha,1279,15,1275,15826,4788,3438,8.08,0,46.8,598538,5009,595232,10.23,7.35,0.33816239316239316,0.84,99.45
2021-12-24,Odisha,945,5,941,11409,1853,1747,8.28,0,46.8,599483,5014,596173,3.96,3.73,0.24378205128205127,0.84,99.45
2021-12-25,Odisha,1257,11,1252,15156,306,14,8.29,0,46.8,600740,5025,597425,0.65,0.03,0.32384615384615384,0.84,99.45
2021-12-26,Odisha,265,2,256,3426,1306,591,7.73,7,46.8,601005,5027,597681,2.79,1.26,0.0732051282051282,0.84,99.45
2021-12-27,Odisha,828,3,822,10419,3918,2854,7.95,3,46.8,601833,5030,598503,8.37,6.1,0.22262820512820514,0.84,99.45
2021-12-28,Odisha,72,0,71,525,3177,622,13.71,1,46.8,601905,5030,598574,6.79,1.33,0.011217948717948718,0.84,99.45
2021-12-29,Odisha,362,2,356,4615,3278,137,7.84,4,46.8,602267,5032,598930,7.0,0.29,0.09861111111111111,0.84,99.45
2021-12-30,Odisha,1172,16,1163,14145,3527,1458,8.29,0,46.8,603439,5048,600093,7.54,3.12,0.3022435897435897,0.84,99.45
2021-12-31,Odisha,431,4,428,5670,56,22,7.6,0,46.8,603870,5052,600521,0.12,0.05,0.12115384615384615,0.84,99.45
2022-01-01,Odisha,1535,8,1527,19356,1233,1168,7.93,0,46.8,605405,5060,602048,2.63,2.5,0.4135897435897436,0.84,99.45
2022-01-02,Odisha,101,0,99,1233,4142,1561,8.19,2,46.8,605506,5060,602147,8.85,3.34,0.026346153846153846,0.84,99.45
2022-01-03,Odisha,1005,14,1004,12489,4616,2052,8.05,0,46.8,606511,5074,603151,9.86,4.38,0.2668589743589744,0.84,99.45
2022-01-04,Odisha,1554,8,1553,19309,1096,181,8.05,0,46.8,608065,5082,604704,2.34,0.39,0.4125854700854701,0.84,99.45
2022-01-05,Odisha,395,3,389,4647,4837,3245,8.5,3,46.8,608460,5085,605093,10.34,6.93,0.0992948717948718,0.84,99.45
2022-01-06,Odisha,81,0,73,855,813,84,9.47,8,46.8,608541,5085,605166,1.74,0.18,0.01826923076923077,0.84,99.45
2022-01-07,Odisha,1581,18,1577,19958,1126,47,7.92,0,46.8,610122,5103,606743,2.41,0.1,0.4264529914529914,0.84,99.45
2022-01-08,Odisha,920,7,920,11595,1704,819,7.93,0,46.8,611042,5110,607663,3.64,1.75,0.24775641025641026,0.84,99.45
2022-01-09,Odisha,71,1,63,949,4329,4235,7.48,7,46.8,611113,5111,607726,9.25,9.05,0.020277777777777777,0.84,99.45
2022-01-10,Odisha,930,11,923,11432,2046,559,8.14,0,46.8,612043,5122,608649,4.37,1.19,0.24427350427350428,0.84,99.45
2022-01-11,Odisha,560,5,551,6618,450,208,8.46,4,46.8,612603,5127,609200,0.96,0.44,0.14141025641025642,0.84,99.44
2022-01-12,Odisha,617,3,617,7546,2679,1994,8.18,0,46.8,613220,5130,609817,5.72,4.26,0.16123931623931623,0.84,99.45
2022-01-13,Odisha,707,7,701,9233,4889,1643,7.66,0,46.8,613927,5137,610518,10.45,3.51,0.1972863247863248,0.84,99.44
2022-01-14,Odisha,541,2,537,6888,3871,2278,7.85,2,46.8,614468,5139,611055,8.27,4.87,0.14717948717948717,0.84,99.44
2022-01-15,Odisha,349,4,349,4844,4863,2333,7.2,0,46.8,614817,5143,611404,10.39,4.99,0.1035042735042735,0.84,99.44
2022-01-16,Odisha,1535,7,1535,19473,4767,1761,7.88,0,46.8,616352,5150,612939,10.19,3.76,0.4160897435897436,0.84,99.45
2022-01-17,Odisha,422,4,419,5143,4203,3469,8.21,0,46.8,616774,5154,613358,8.98,7.41,0.1098931623931624,0.84,99.45
2022-01-18,Odisha,1551,19,1551,19264,2634,146,8.05,0,46.8,618325,5173,614909,5.63,0.31,0.4116239316239316,0.84,99.45
2022-01-19,Odisha,636,5,632,8172,4876,4743,7.78,0,46.8,618961,5178,615541,10.42,10.13,0.17461538461538462,0.84,99.45
2022-01-20,Odisha,1114,3,1111,14276,3430,2891,7.8,0,46.8,620075,5181,616652,7.33,6.18,0.30504273504273505,0.84,99.45
2022-01-21,Odisha,126,1,119,2083,4596,3452,6.05,6,46.8,620201,5182,616771,9.82,7.38,0.044508547008547006,0.84,99.45
2022-01-22,Odisha,1187,8,1181,14992,3324,2240,7.92,0,46.8,621388,5190,617952,7.1,4.79,0.3203418803418803,0.84,99.45
2022-01-23,Odisha,1057,5,1052,13261,4204,1590,7.97,0,46.8,622445,5195,619004,8.98,3.4,0.2833547008547009,0.83,99.45
2022-01-24,Odisha,1153,15,1144,14437,4282,736,7.99,0,46.8,623598,5210,620148,9.15,1.57,0.308482905982906,0.84,99.45
2022-01-25,Odisha,881,9,877,11123,3994,3745,7.92,0,46.8,624479,5219,621025,8.53,8.0,0.23767094017094018,0.84,99.45
2022-01-26,Odisha,725,4,722,8995,3496,2105,8.06,0,46.8,625204,5223,621747,7.47,4.5,0.1922008547008547,0.84,99.45
2022-01-27,Odisha,160,2,159,2200,1402,132,7.27,0,46.8,625364,5225,621906,3.0,0.28,0.04700854700854701,0.84,99.45
2022-01-28,Odisha,1318,9,1310,16393,847,538,8.04,0,46.8,626682,5234,623216,1.81,1.15,0.3502777777777778,0.84,99.45
2022-01-29,Odisha,671,9,663,9021,1450,545,7.44,0,46.8,627353,5243,623879,3.1,1.16,0.19275641025641024,0.84,99.45
2022-01-30,Odisha,630,8,622,7913,1804,1770,7.96,0,46.8,627983,5251,624501,3.85,3.78,0.16908119658119658,0.84,99.45
2022-01-31,Odisha,972,12,970,12531,2833,2310,7.76,0,46.8,628955,5263,625471,6.05,4.94,0.2677564102564103,0.84,99.45
2022-02-01,Odisha,579,8,572,7210,1349,811,8.03,0,46.8,629534,5271,626043,2.88,1.73,0.15405982905982907,0.84,99.45
2022-02-02,Odisha,663,3,655,8697,3990,2022,7.62,5,46.8,630197,5274,626698,8.53,4.32,0.18583333333333332,0.84,99.44
2022-02-03,Odisha,866,8,860,11034,371,299,7.85,0,46.8,631063,5282,627558,0.79,0.64,0.23576923076923076,0.84,99.44
2022-02-04,Odisha,892,10,888,11051,3191,44,8.07,0,46.8,631955,5292,628446,6.82,0.09,0.23613247863247863,0.84,99.44
2022-02-05,Odisha,1243,6,1237,15519,3865,196,8.01,0,46.8,633198,5298,629683,8.26,0.42,0.3316025641025641,0.84,99.44
2022-02-06,Odisha,810,7,809,9935,4926,4662,8.15,0,46.8,634008,5305,630492,10.53,9.96,0.21228632478632478,0.84,99.45
2022-02-07,Odisha,1440,7,1434,18254,4800,571,7.89,0,46.8,635448,5312,631926,10.26,1.22,0.39004273504273507,0.84,99.45
2022-02-08,Odisha,1332,19,1332,16873,175,56,7.89,0,46.8,636780,5331,633258,0.37,0.12,0.360534188034188,0.84,99.45
2022-02-09,Odisha,1048,12,1044,13886,827,226,7.55,0,46.8,637828,5343,634302,1.77,0.48,0.2967094017094017,0.84,99.45
2022-02-10,Odisha,1133,7,1125,14137,1703,1433,8.01,1,46.8,638961,5350,635427,3.64,3.06,0.30207264957264957,0.84,99.45
2022-02-11,Odisha,1428,7,1426,17948,4258,1061,7.96,0,46.8,640389,5357,636853,9.1,2.27,0.3835042735042735,0.84,99.45
2022-02-12,Odisha,1240,10,1234,15628,1077,953,7.93,0,46.8,641629,5367,638087,2.3,2.04,0.33393162393162396,0.84,99.45
2022-02-13,Odisha,18,0,13,545,4771,1947,3.3,5,46.8,641647,5367,638100,10.19,4.16,0.011645299145299146,0.84,99.45
2022-02-14,Odisha,1465,6,1458,18291,4483,196,8.01,1,46.8,643112,5373,639558,9.58,0.42,0.3908333333333333,0.84,99.45
2022-02-15,Odisha,265,3,264,3674,4570,3530,7.21,0,46.8,643377,5376,639822,9.76,7.54,0.0785042735042735,0.84,99.45
2022-02-16,Odisha,184,2,180,2664,3488,107,6.91,2,46.8,643561,5378,640002,7.45,0.23,0.05692307692307692,0.84,99.45
2022-02-17,Odisha,941,12,936,11818,4143,1409,7.96,0,46.8,644502,5390,640938,8.85,3.01,0.2525213675213675,0.84,99.45
2022-02-18,Odisha,262,3,261,3620,4311,365,7.24,0,46.8,644764,5393,641199,9.21,0.78,0.07735042735042735,0.84,99.45
2022-02-19,Odisha,1179,4,1177,14943,763,259,7.89,0,46.8,645943,5397,642376,1.63,0.55,0.3192948717948718,0.84,99.45
2022-02-20,Odisha,1033,14,1024,12948,1805,712,7.98,0,46.8,646976,5411,643400,3.86,1.52,0.27666666666666667,0.84,99.45
2022-02-21,Odisha,386,4,379,4723,4125,2198,8.17,3,46.8,647362,5415,643779,8.81,4.7,0.10091880341880342,0.84,99.45
2022-02-22,Odisha,1347,19,1338,16591,3793,3777,8.12,0,46.8,648709,5434,645117,8.1,8.07,0.354508547008547,0.84,99.45
2022-02-23,Odisha,1462,10,1458,18306,4020,917,7.99,0,46.8,650171,5444,646575,8.59,1.96,0.39115384615384613,0.84,99.45
2022-02-24,Odisha,744,3,738,9273,3579,3037,8.02,3,46.8,650915,5447,647313,7.65,6.49,0.19814102564102565,0.84,99.45
2022-02-25,Odisha,971,12,962,12059,3365,3301,8.05,0,46.8,651886,5459,648275,7.19,7.05,0.25767094017094017,0.84,99.45
2022-02-26,Odisha,705,6,701,8828,694,37,7.99,0,46.8,652591,5465,648976,1.48,0.08,0.18863247863247865,0.84,99.45
2022-02-27,Odisha,126,1,124,1682,2691,1338,7.49,1,46.8,652717,5466,649100,5.75,2.86,0.03594017094017094,0.84,99.45
2022-02-28,Odisha,286,2,281,3752,1473,532,7.62,3,46.8,653003,5468,649381,3.15,1.14,0.08017094017094017,0.84,99.45
2022-03-01,Odisha,63,0,59,1145,1352,411,5.5,4,46.8,653066,5468,649440,2.89,0.88,0.024465811965811966,0.84,99.44
2022-03-02,Odisha,1270,15,1268,15436,1700,1271,8.23,0,46.8,654336,5483,650708,3.63,2.72,0.32982905982905986,0.84,99.45
2022-03-03,Odisha,1241,7,1232,15736,4387,473,7.89,2,46.8,655577,5490,651940,9.37,1.01,0.33623931623931624,0.84,99.45
2022-03-04,Odisha,245,3,238,3541,3396,291,6.92,4,46.8,655822,5493,652178,7.26,0.62,0.07566239316239316,0.84,99.44
2022-03-05,Odisha,1383,6,1374,17616,3569,2756,7.85,3,46.8,657205,5499,653552,7.63,5.89,0.3764102564102564,0.84,99.44
2022-03-06,Odisha,665,4,657,8275,3297,893,8.04,4,46.8,657870,5503,654209,7.04,1.91,0.17681623931623933,0.84,99.44
2022-03-07,Odisha,1589,19,1587,19695,2920,1498,8.07,0,46.8,659459,5522,655796,6.24,3.2,0.42083333333333334,0.84,99.44
2022-03-08,Odisha,202,2,200,2048,1631,349,9.86,0,46.8,659661,5524,655996,3.49,0.75,0.04376068376068376,0.84,99.44
2022-03-09,Odisha,154,2,145,1775,946,555,8.68,7,46.8,659815,5526,656141,2.02,1.19,0.037927350427350424,0.84,99.44
2022-03-10,Odisha,1470,19,1469,18546,2113,1749,7.93,0,46.8,661285,5545,657610,4.51,3.74,0.3962820512820513,0.84,99.44
2022-03-11,Odisha,1352,17,1347,16721,4990,4776,8.09,0,46.8,662637,5562,658957,10.66,10.21,0.35728632478632477,0.84,99.44
2022-03-12,Odisha,1371,4,1366,17275,4867,338,7.94,1,46.8,664008,5566,660323,10.4,0.72,0.36912393162393164,0.84,99.45
2022-03-13,Odisha,339,1,336,4468,3940,1941,7.59,2,46.8,664347,5567,660659,8.42,4.15,0.09547008547008547,0.84,99.44
2022-03-14,Odisha,1117,10,1113,13700,4985,1695,8.15,0,46.8,665464,5577,661772,10.65,3.62,0.29273504273504275,0.84,99.45
2022-03-15,Odisha,1496,11,1496,18550,1487,718,8.06,0,46.8,666960,5588,663268,3.18,1.53,0.39636752136752135,0.84,99.45
2022-03-16,Odisha,276,0,268,3362,3347,234,8.21,8,46.8,667236,5588,663536,7.15,0.5,0.07183760683760684,0.84,99.45
2022-03-17,Odisha,179,1,179,2262,1406,103,7.91,0,46.8,667415,5589,663715,3.0,0.22,0.04833333333333333,0.84,99.45
2022-03-18,Odisha,997,8,994,12430,257,229,8.02,0,46.8,668412,5597,664709,0.55,0.49,0.2655982905982906,0.84,99.45
2022-03-19,Odisha,845,2,836,10655,337,3,7.93,7,46.8,669257,5599,665545,0.72,0.01,0.22767094017094017,0.84,99.45
2022-03-20,Odisha,779,11,774,9781,2828,1584,7.96,0,46.8,670036,5610,666319,6.04,3.38,0.2089957264957265,0.84,99.45
2022-03-21,Odisha,268,1,261,3557,3990,1764,7.53,6,46.8,670304,5611,666580,8.53,3.77,0.07600427350427351,0.84,99.44
2022-03-22,Odisha,1124,9,1118,14230,1547,526,7.9,0,46.8,671428,5620,667698,3.31,1.12,0.30405982905982903,0.84,99.44
2022-03-23,Odisha,1113,4,1107,14076,4552,4543,7.91,2,46.8,672541,5624,668805,9.73,9.71,0.3007692307692308,0.84,99.44
2022-03-24,Odisha,1006,5,1004,12955,374,352,7.77,0,46.8,673547,5629,669809,0.8,0.75,0.27681623931623933,0.84,99.45
2022-03-25,Odisha,390,1,385,4794,4210,3528,8.14,4,46.8,673937,5630,670194,9.0,7.54,0.10243589743589744,0.84,99.44
2022-03-26,Odisha,333,4,330,4327,3508,388,7.7,0,46.8,674270,5634,670524,7.5,0.83,0.09245726495726496,0.84,99.44
2022-03-27,Odisha,1338,12,1333,16757,3369,730,7.98,0,46.8,675608,5646,671857,7.2,1.56,0.35805555555555557,0.84,99.44
2022-03-28,Odisha,643,6,639,7700,1514,1106,8.35,0,46.8,676251,5652,672496,3.24,2.36,0.16452991452991453,0.84,99.44
2022-03-29,Odisha,1074,12,1071,13257,4013,2228,8.1,0,46.8,677325,5664,673567,8.57,4.76,0.2832692307692308,0.84,99.45
2022-03-30,Odisha,405,3,402,5091,2354,1763,7.96,0,46.8,677730,5667,673969,5.03,3.77,0.10878205128205128,0.84,99.45
2022-03-31,Odisha,155,1,146,1460,1448,277,10.62,8,46.8,677885,5668,674115,3.09,0.59,0.031196581196581197,0.84,99.44
2022-04-01,Odisha,1479,14,1471,18247,3774,650,8.11,0,46.8,679364,5682,675586,8.06,1.39,0.3898931623931624,0.84,99.44
2022-04-02,Odisha,122,1,115,1257,1893,1116,9.71,6,46.8,679486,5683,675701,4.04,2.38,0.026858974358974358,0.84,99.44
2022-04-03,Odisha,848,3,845,10373,1061,55,8.18,0,46.8,680334,5686,676546,2.27,0.12,0.22164529914529915,0.84,99.44
2022-04-04,Odisha,202,1,202,2435,1865,76,8.3,0,46.8,680536,5687,676748,3.99,0.16,0.05202991452991453,0.84,99.44
2022-04-05,Odisha,666,3,660,8426,4862,3477,7.9,3,46.8,681202,5690,677408,10.39,7.43,0.18004273504273505,0.84,99.44
2022-04-06,Odisha,474,6,473,6038,3319,2549,7.85,0,46.8,681676,5696,677881,7.09,5.45,0.12901709401709402,0.84,99.44
2022-04-07,Odisha,1404,5,1404,17290,490,370,8.12,0,46.8,683080,5701,679285,1.05,0.79,0.36944444444444446,0.83,99.44
2022-04-08,Odisha,815,8,811,10241,1056,754,7.96,0,46.8,683895,5709,680096,2.26,1.61,0.21882478632478633,0.83,99.44
2022-04-09,Odisha,1463,8,1461,17938,2946,153,8.16,0,46.8,685358,5717,681557,6.29,0.33,0.3832905982905983,0.83,99.45
2022-04-10,Odisha,704,2,696,8812,1803,881,7.99,6,46.8,686062,5719,682253,3.85,1.88,0.1882905982905983,0.83,99.44
2022-04-11,Odisha,864,12,863,10613,2488,825,8.14,0,46.8,686926,5731,683116,5.32,1.76,0.22677350427350426,0.83,99.45
2022-04-12,Odisha,597,5,593,7075,1051,863,8.44,0,46.8,687523,5736,683709,2.25,1.84,0.15117521367521367,0.83,99.45
2022-04-13,Odisha,1082,8,1081,13672,4215,26,7.91,0,46.8,688605,5744,684790,9.01,0.06,0.2921367521367521,0.83,99.45
2022-04-14,Odisha,1090,9,1088,13201,4647,4438,8.26,0,46.8,689695,5753,685878,9.93,9.48,0.28207264957264955,0.83,99.45
2022-04-15,Odisha,1270,8,1265,15790,217,171,8.04,0,46.8,690965,5761,687143,0.46,0.37,0.3373931623931624,0.83,99.45
2022-04-16,Odisha,1418,6,1409,17448,2680,1158,8.13,3,46.8,692383,5767,688552,5.73,2.47,0.3728205128205128,0.83,99.45
2022-04-17,Odisha,306,4,299,3705,3911,2469,8.26,3,46.8,692689,5771,688851,8.36,5.28,0.07916666666666666,0.83,99.45
2022-04-18,Odisha,1277,8,1275,15620,3219,3007,8.18,0,46.8,693966,5779,690126,6.88,6.43,0.33376068376068374,0.83,99.45
2022-04-19,Odisha,679,2,673,8647,4716,3432,7.85,4,46.8,694645,5781,690799,10.08,7.33,0.18476495726495726,0.83,99.45
2022-04-20,Odisha,435,2,434,5190,2394,756,8.38,0,46.8,695080,5783,691233,5.12,1.62,0.11089743589743589,0.83,99.45
2022-04-21,Odisha,137,1,137,1398,4889,2811,9.8,0,46.8,695217,5784,691370,10.45,6.01,0.029871794871794873,0.83,99.45
2022-04-22,Odisha,780,9,778,9482,1654,39,8.23,0,46.8,695997,5793,692148,3.53,0.08,0.20260683760683762,0.83,99.45
2022-04-23,Odisha,353,3,347,4691,2688,1759,7.53,3,46.8,696350,5796,692495,5.74,3.76,0.10023504273504273,0.83,99.45
2022-04-24,Odisha,113,0,110,1817,1936,1915,6.22,3,46.8,696463,5796,692605,4.14,4.09,0.03882478632478632,0.83,99.45
2022-04-25,Odisha,1545,16,1545,19310,3905,2091,8.0,0,46.8,698008,5812,694150,8.34,4.47,0.4126068376068376,0.83,99.45
2022-04-26,Odisha,347,3,345,4168,836,719,8.33,0,46.8,698355,5815,694495,1.79,1.54,0.08905982905982907,0.83,99.45
2022-04-27,Odisha,495,6,494,6739,3634,496,7.35,0,46.8,698850,5821,694989,7.76,1.06,0.1439957264957265,0.83,99.45
2022-04-28,Odisha,263,2,263,2864,1062,870,9.18,0,46.8,699113,5823,695252,2.27,1.86,0.061196581196581196,0.83,99.45
2022-04-29,Odisha,77,0,71,1042,3588,2266,7.39,6,46.8,699190,5823,695323,7.67,4.84,0.022264957264957266,0.83,99.45
2022-04-30,Odisha,445,5,441,5506,3344,2447,8.08,0,46.8,699635,5828,695764,7.15,5.23,0.11764957264957265,0.83,99.45
2022-05-01,Odisha,882,10,880,11014,85,65,8.01,0,46.8,700517,5838,696644,0.18,0.14,0.23534188034188033,0.83,99.45
2022-05-02,Odisha,720,5,716,9049,774,247,7.96,0,46.8,701237,5843,697360,1.65,0.53,0.19335470085470086,0.83,99.45
2022-05-03,Odisha,1141,7,1141,14170,3725,309,8.05,0,46.8,702378,5850,698501,7.96,0.66,0.30277777777777776,0.83,99.45
2022-05-04,Odisha,223,2,215,2820,2415,1971,7.91,6,46.8,702601,5852,698716,5.16,4.21,0.06025641025641026,0.83,99.45
2022-05-05,Odisha,993,8,989,12599,129,90,7.88,0,46.8,703594,5860,699705,0.28,0.19,0.2692094017094017,0.83,99.45
2022-05-06,Odisha,850,8,846,10748,4692,3871,7.91,0,46.8,704444,5868,700551,10.03,8.27,0.22965811965811966,0.83,99.45
2022-05-07,Odisha,1014,11,1013,12425,3198,989,8.16,0,46.8,705458,5879,701564,6.83,2.11,0.265491452991453,0.83,99.45
2022-05-08,Odisha,608,8,608,7820,3217,551,7.77,0,46.8,706066,5887,702172,6.87,1.18,0.16709401709401708,0.83,99.45
2022-05-09,Odisha,550,7,544,7275,3394,258,7.56,0,46.8,706616,5894,702716,7.25,0.55,0.15544871794871795,0.83,99.45
2022-05-10,Odisha,459,6,454,5863,1883,260,7.83,0,46.8,707075,5900,703170,4.02,0.56,0.12527777777777777,0.83,99.45
2022-05-11,Odisha,98,0,97,1312,1084,765,7.47,1,46.8,707173,5900,703267,2.32,1.63,0.028034188034188036,0.83,99.45
2022-05-12,Odisha,534,2,530,6560,1670,135,8.14,2,46.8,707707,5902,703797,3.57,0.29,0.14017094017094017,0.83,99.45
2022-05-13,Odisha,253,2,252,3421,3125,1778,7.4,0,46.8,707960,5904,704049,6.68,3.8,0.0730982905982906,0.83,99.45
2022-05-14,Odisha,1459,5,1459,17961,2163,1911,8.12,0,46.8,709419,5909,705508,4.62,4.08,0.3837820512820513,0.83,99.45
2022-05-15,Odisha,287,1,278,3589,2451,1454,8.0,8,46.8,709706,5910,705786,5.24,3.11,0.07668803418803419,0.83,99.45
2022-05-16,Odisha,1238,12,1233,15380,1836,1297,8.05,0,46.8,710944,5922,707019,3.92,2.77,0.32863247863247863,0.83,99.45
2022-05-17,Odisha,734,3,730,9204,3296,1819,7.97,1,46.8,711678,5925,707749,7.04,3.89,0.19666666666666666,0.83,99.45
2022-05-18,Odisha,1192,14,1192,15045,2654,1151,7.92,0,46.8,712870,5939,708941,5.67,2.46,0.321474358974359,0.83,99.45
2022-05-19,Odisha,299,1,291,3665,1132,600,8.16,7,46.8,713169,5940,709232,2.42,1.28,0.07831196581196581,0.83,99.45
2022-05-20,Odisha,1524,4,1517,19576,383,47,7.79,3,46.8,714693,5944,710749,0.82,0.1,0.4182905982905983,0.83,99.45
2022-05-21,Odisha,1262,5,1262,15554,4045,2943,8.11,0,46.8,715955,5949,712011,8.64,6.29,0.33235042735042736,0.83,99.45
2022-05-22,Odisha,1139,3,1131,14390,50,28,7.92,5,46.8,717094,5952,713142,0.11,0.06,0.3074786324786325,0.83,99.45
2022-05-23,Odisha,392,2,390,4744,1765,129,8.26,0,46.8,717486,5954,713532,3.77,0.28,0.10136752136752136,0.83,99.45
2022-05-24,Odisha,717,4,709,8673,3554,1056,8.27,4,46.8,718203,5958,714241,7.59,2.26,0.18532051282051282,0.83,99.45
2022-05-25,Odisha,1546,9,1539,19317,182,29,8.0,0,46.8,719749,5967,715780,0.39,0.06,0.41275641025641024,0.83,99.45
2022-05-26,Odisha,533,3,529,6504,2442,2336,8.19,1,46.8,720282,5970,716309,5.22,4.99,0.13897435897435897,0.83,99.45
2022-05-27,Odisha,1519,7,1514,18800,36,7,8.08,0,46.8,721801,5977,717823,0.08,0.01,0.4017094017094017,0.83,99.45
2022-05-28,Odisha,859,10,857,10480,4159,2868,8.2,0,46.8,722660,5987,718680,8.89,6.13,0.22393162393162394,0.83,99.45
2022-05-29,Odisha,1422,19,1421,17651,4514,1848,8.06,0,46.8,724082,6006,720101,9.65,3.95,0.3771581196581197,0.83,99.45
2022-05-30,Odisha,587,2,583,7268,1592,82,8.08,2,46.8,724669,6008,720684,3.4,0.18,0.1552991452991453,0.83,99.45
2022-05-31,Odisha,82,0,80,1008,993,427,8.13,2,46.8,724751,6008,720764,2.12,0.91,0.021538461538461538,0.83,99.45
2022-06-01,Odisha,305,3,299,3636,4040,474,8.39,3,46.8,725056,6011,721063,8.63,1.01,0.07769230769230769,0.83,99.45
2022-06-02,Odisha,1097,4,1097,13119,4904,2922,8.36,0,46.8,726153,6015,722160,10.48,6.24,0.28032051282051285,0.83,99.45
2022-06-03,Odisha,1382,20,1381,17145,801,176,8.06,0,46.8,727535,6035,723541,1.71,0.38,0.3663461538461538,0.83,99.45
2022-06-04,Odisha,846,11,846,10816,1069,39,7.82,0,46.8,728381,6046,724387,2.28,0.08,0.2311111111111111,0.83,99.45
2022-06-05,Odisha,335,3,327,4533,2815,2667,7.39,5,46.8,728716,6049,724714,6.01,5.7,0.09685897435897436,0.83,99.45
2022-06-06,Odisha,630,4,626,7533,1732,166,8.36,0,46.8,729346,6053,725340,3.7,0.35,0.16096153846153846,0.83,99.45
2022-06-07,Odisha,718,7,709,8448,4187,1561,8.5,2,46.8,730064,6060,726049,8.95,3.34,0.18051282051282053,0.83,99.45
2022-06-08,Odisha,740,2,737,9586,1094,444,7.72,1,46.8,730804,6062,726786,2.34,0.95,0.20482905982905983,0.83,99.45
2022-06-09,Odisha,674,9,667,8102,152,33,8.32,0,46.8,731478,6071,727453,0.32,0.07,0.17311965811965813,0.83,99.45
2022-06-10,Odisha,846,2,839,10072,142,6,8.4,5,46.8,732324,6073,728292,0.3,0.01,0.2152136752136752,0.83,99.45
2022-06-11,Odisha,941,4,934,11951,312,137,7.87,3,46.8,733265,6077,729226,0.67,0.29,0.2553632478632479,0.83,99.45
2022-06-12,Odisha,1005,3,999,12359,1128,259,8.13,3,46.8,734270,6080,730225,2.41,0.55,0.2640811965811966,0.83,99.45
2022-06-13,Odisha,178,1,173,2191,4363,3723,8.12,4,46.8,734448,6081,730398,9.32,7.96,0.046816239316239315,0.83,99.45
2022-06-14,Odisha,1414,14,1406,17745,2992,2469,7.97,0,46.8,735862,6095,731804,6.39,5.28,0.37916666666666665,0.83,99.45
2022-06-15,Odisha,1116,5,1111,13917,467,98,8.02,0,46.8,736978,6100,732915,1.0,0.21,0.2973717948717949,0.83,99.45
2022-06-16,Odisha,1213,5,1204,15017,70,19,8.08,4,46.8,738191,6105,734119,0.15,0.04,0.32087606837606836,0.83,99.45
2022-06-17,Odisha,1121,8,1112,13663,1969,1153,8.2,1,46.8,739312,6113,735231,4.21,2.46,0.29194444444444445,0.83,99.45
2022-06-18,Odisha,947,13,943,11861,861,277,7.98,0,46.8,740259,6126,736174,1.84,0.59,0.25344017094017096,0.83,99.45
2022-06-19,Odisha,1284,10,1283,15768,3185,695,8.14,0,46.8,741543,6136,737457,6.81,1.49,0.33692307692307694,0.83,99.45
2022-06-20,Odisha,471,2,462,6177,1538,739,7.63,7,46.8,742014,6138,737919,3.29,1.58,0.13198717948717947,0.83,99.45
2022-06-21,Odisha,1413,10,1408,17504,624,390,8.07,0,46.8,743427,6148,739327,1.33,0.83,0.37401709401709404,0.83,99.45
2022-06-22,Odisha,1274,13,1267,16053,303,253,7.94,0,46.8,744701,6161,740594,0.65,0.54,0.3430128205128205,0.83,99.45
2022-06-23,Odisha,548,1,540,6567,1628,114,8.34,7,46.8,745249,6162,741134,3.48,0.24,0.14032051282051283,0.83,99.45
2022-06-24,Odisha,1556,12,1547,19584,376,230,7.95,0,46.8,746805,6174,742681,0.8,0.49,0.41846153846153844,0.83,99.45
2022-06-25,Odisha,844,8,841,10369,2172,978,8.14,0,46.8,747649,6182,743522,4.64,2.09,0.22155982905982907,0.83,99.45
2022-06-26,Odisha,497,6,494,6551,1737,724,7.59,0,46.8,748146,6188,744016,3.71,1.55,0.1399786324786325,0.83,99.45
2022-06-27,Odisha,771,4,765,9860,3924,2291,7.82,2,46.8,748917,6192,744781,8.38,4.9,0.21068376068376068,0.83,99.45
2022-06-28,Odisha,1221,13,1221,15237,225,61,8.01,0,46.8,750138,6205,746002,0.48,0.13,0.3255769230769231,0.83,99.45
2022-06-29,Odisha,1209,17,1203,15589,4316,1730,7.76,0,46.8,751347,6222,747205,9.22,3.7,0.3330982905982906,0.83,99.45
2022-06-30,Odisha,423,4,422,5643,1364,607,7.5,0,46.8,751770,6226,747627,2.91,1.3,0.12057692307692308,0.83,99.45
2022-07-01,Odisha,191,2,185,2228,2156,1768,8.57,4,46.8,751961,6228,747812,4.61,3.78,0.04760683760683761,0.83,99.45
2022-07-02,Odisha,1128,5,1123,14354,3961,3758,7.86,0,46.8,753089,6233,748935,8.46,8.03,0.3067094017094017,0.83,99.45
2022-07-03,Odisha,113,0,104,1509,3077,1947,7.49,9,46.8,753202,6233,749039,6.57,4.16,0.03224358974358974,0.83,99.45
2022-07-04,Odisha,214,2,213,2777,4266,1515,7.71,0,46.8,753416,6235,749252,9.12,3.24,0.05933760683760684,0.83,99.45
2022-07-05,Odisha,1439,19,1437,17749,4267,3032,8.11,0,46.8,754855,6254,750689,9.12,6.48,0.37925213675213676,0.83,99.45
2022-07-06,Odisha,808,8,799,10192,4561,422,7.93,1,46.8,755663,6262,751488,9.75,0.9,0.21777777777777776,0.83,99.45
2022-07-07,Odisha,1035,7,1033,12563,3277,1501,8.24,0,46.8,756698,6269,752521,7.0,3.21,0.2684401709401709,0.83,99.45
2022-07-08,Odisha,220,1,214,2332,2243,942,9.43,5,46.8,756918,6270,752735,4.79,2.01,0.04982905982905983,0.83,99.45
2022-07-09,Odisha,934,6,925,11436,167,129,8.17,3,46.8,757852,6276,753660,0.36,0.28,0.24435897435897436,0.83,99.45
2022-07-10,Odisha,774,6,766,9790,2157,1060,7.91,2,46.8,758626,6282,754426,4.61,2.26,0.2091880341880342,0.83,99.45
2022-07-11,Odisha,1283,7,1281,16060,4357,106,7.99,0,46.8,759909,6289,755707,9.31,0.23,0.34316239316239316,0.83,99.45
2022-07-12,Odisha,646,7,637,8123,592,161,7.95,2,46.8,760555,6296,756344,1.26,0.34,0.17356837606837608,0.83,99.45
2022-07-13,Odisha,105,0,102,1142,886,32,9.19,3,46.8,760660,6296,756446,1.89,0.07,0.024401709401709402,0.83,99.45
2022-07-14,Odisha,178,1,169,2006,78,23,8.87,8,46.8,760838,6297,756615,0.17,0.05,0.04286324786324786,0.83,99.44
2022-07-15,Odisha,1215,7,1212,15129,1037,201,8.03,0,46.8,762053,6304,757827,2.22,0.43,0.32326923076923075,0.83,99.45
2022-07-16,Odisha,654,7,652,8012,1219,1014,8.16,0,46.8,762707,6311,758479,2.6,2.17,0.1711965811965812,0.83,99.45
2022-07-17,Odisha,1532,6,1528,18650,987,204,8.21,0,46.8,764239,6317,760007,2.11,0.44,0.39850427350427353,0.83,99.45
2022-07-18,Odisha,419,6,419,5173,4348,2016,8.1,0,46.8,764658,6323,760426,9.29,4.31,0.11053418803418803,0.83,99.45
2022-07-19,Odisha,518,4,509,6100,2569,430,8.49,5,46.8,765176,6327,760935,5.49,0.92,0.13034188034188035,0.83,99.45
2022-07-20,Odisha,501,4,498,6225,4913,4883,8.05,0,46.8,765677,6331,761433,10.5,10.43,0.1330128205128205,0.83,99.45
2022-07-21,Odisha,1219,9,1218,15027,54,20,8.11,0,46.8,766896,6340,762651,0.12,0.04,0.32108974358974357,0.83,99.45
2022-07-22,Odisha,1315,16,1315,16085,1327,1256,8.18,0,46.8,768211,6356,763966,2.84,2.68,0.3436965811965812,0.83,99.45
2022-07-23,Odisha,1181,7,1179,14554,1879,1725,8.11,0,46.8,769392,6363,765145,4.01,3.69,0.310982905982906,0.83,99.45
2022-07-24,Odisha,368,3,364,4305,2078,434,8.55,1,46.8,769760,6366,765509,4.44,0.93,0.0919871794871795,0.83,99.45
2022-07-25,Odisha,408,3,404,5075,4540,2675,8.04,1,46.8,770168,6369,765913,9.7,5.72,0.10844017094017094,0.83,99.45
2022-07-26,Odisha,1443,20,1437,18191,3161,1286,7.93,0,46.8,771611,6389,767350,6.75,2.75,0.3886965811965812,0.83,99.45
2022-07-27,Odisha,226,3,220,2886,934,900,7.83,3,46.8,771837,6392,767570,2.0,1.92,0.06166666666666667,0.83,99.45
2022-07-28,Odisha,1286,7,1282,16299,3205,1103,7.89,0,46.8,773123,6399,768852,6.85,2.36,0.3482692307692308,0.83,99.45
2022-07-29,Odisha,1200,16,1196,14652,4362,1680,8.19,0,46.8,774323,6415,770048,9.32,3.59,0.3130769230769231,0.83,99.45
2022-07-30,Odisha,318,3,313,3968,3708,622,8.01,2,46.8,774641,6418,770361,7.92,1.33,0.0847863247863248,0.83,99.45
2022-07-31,Odisha,1535,19,1532,19051,4070,1330,8.06,0,46.8,776176,6437,771893,8.7,2.84,0.40707264957264955,0.83,99.45
2022-08-01,Odisha,752,5,745,9489,981,142,7.92,2,46.8,776928,6442,772638,2.1,0.3,0.20275641025641025,0.83,99.45
2022-08-02,Odisha,752,6,749,9545,3518,2267,7.88,0,46.8,777680,6448,773387,7.52,4.84,0.20395299145299145,0.83,99.45
2022-08-03,Odisha,531,7,526,6533,2427,1435,8.13,0,46.8,778211,6455,773913,5.19,3.07,0.1395940170940171,0.83,99.45
2022-08-04,Odisha,1229,7,1225,15345,3367,1446,8.01,0,46.8,779440,6462,775138,7.19,3.09,0.3278846153846154,0.83,99.45
2022-08-05,Odisha,1010,10,1008,12478,713,180,8.09,0,46.8,780450,6472,776146,1.52,0.38,0.2666239316239316,0.83,99.45
2022-08-06,Odisha,647,7,639,7874,1518,698,8.22,1,46.8,781097,6479,776785,3.24,1.49,0.16824786324786326,0.83,99.45
2022-08-07,Odisha,158,1,157,1771,2368,589,8.92,0,46.8,781255,6480,776942,5.06,1.26,0.037841880341880345,0.83,99.45
2022-08-08,Odisha,179,2,173,2155,1976,1639,8.31,4,46.8,781434,6482,777115,4.22,3.5,0.04604700854700855,0.83,99.45
2022-08-09,Odisha,113,1,110,1996,1269,1102,5.66,2,46.8,781547,6483,777225,2.71,2.35,0.04264957264957265,0.83,99.45
2022-08-10,Odisha,1046,7,1037,13045,1165,576,8.02,2,46.8,782593,6490,778262,2.49,1.23,0.27873931623931625,0.83,99.45
2022-08-11,Odisha,268,1,259,3070,4297,2898,8.73,8,46.8,782861,6491,778521,9.18,6.19,0.0655982905982906,0.83,99.45
2022-08-12,Odisha,762,5,753,9737,4080,1490,7.83,4,46.8,783623,6496,779274,8.72,3.18,0.20805555555555555,0.83,99.45
2022-08-13,Odisha,281,2,279,3708,1805,1253,7.58,0,46.8,783904,6498,779553,3.86,2.68,0.07923076923076923,0.83,99.44
2022-08-14,Odisha,51,0,48,1079,2239,1489,4.73,3,46.8,783955,6498,779601,4.78,3.18,0.023055555555555555,0.83,99.44
2022-08-15,Odisha,452,4,443,5473,3956,1286,8.26,5,46.8,784407,6502,780044,8.45,2.75,0.11694444444444445,0.83,99.44
2022-08-16,Odisha,78,0,72,1129,632,570,6.91,6,46.8,784485,6502,780116,1.35,1.22,0.024123931623931623,0.83,99.44
2022-08-17,Odisha,115,1,107,1405,430,184,8.19,7,46.8,784600,6503,780223,0.92,0.39,0.030021367521367522,0.83,99.44
2022-08-18,Odisha,135,1,128,1334,3705,300,10.12,6,46.8,784735,6504,780351,7.92,0.64,0.028504273504273505,0.83,99.44
2022-08-19,Odisha,1161,9,1152,14585,4847,4391,7.96,0,46.8,785896,6513,781503,10.36,9.38,0.31164529914529915,0.83,99.44
2022-08-20,Odisha,1232,6,1231,15506,4785,2759,7.95,0,46.8,787128,6519,782734,10.22,5.9,0.33132478632478635,0.83,99.44
2022-08-21,Odisha,1593,17,1586,19839,4094,665,8.03,0,46.8,788721,6536,784320,8.75,1.42,0.4239102564102564,0.83,99.44
2022-08-22,Odisha,1465,14,1463,17779,1854,1646,8.24,0,46.8,790186,6550,785783,3.96,3.52,0.3798931623931624,0.83,99.44
2022-08-23,Odisha,441,6,434,5651,1904,760,7.8,1,46.8,790627,6556,786217,4.07,1.62,0.12074786324786325,0.83,99.44
2022-08-24,Odisha,883,4,880,11282,1003,286,7.83,0,46.8,791510,6560,787097,2.14,0.61,0.24106837606837606,0.83,99.44
2022-08-25,Odisha,683,9,675,8508,1361,342,8.03,0,46.8,792193,6569,787772,2.91,0.73,0.1817948717948718,0.83,99.44
2022-08-26,Odisha,1278,11,1270,15984,871,35,8.0,0,46.8,793471,6580,789042,1.86,0.07,0.3415384615384615,0.83,99.44
2022-08-27,Odisha,864,5,864,10913,283,207,7.92,0,46.8,794335,6585,789906,0.6,0.44,0.23318376068376068,0.83,99.44
2022-08-28,Odisha,1022,14,1019,12366,69,47,8.26,0,46.8,795357,6599,790925,0.15,0.1,0.2642307692307692,0.83,99.44
2022-08-29,Odisha,979,8,978,12229,1450,432,8.01,0,46.8,796336,6607,791903,3.1,0.92,0.2613034188034188,0.83,99.44
2022-08-30,Odisha,1252,8,1252,15684,4155,2284,7.98,0,46.8,797588,6615,793155,8.88,4.88,0.3351282051282051,0.83,99.44
2022-08-31,Odisha,1600,8,1593,19844,1122,312,8.06,0,46.8,799188,6623,794748,2.4,0.67,0.42401709401709403,0.83,99.44
2022-09-01,Odisha,1079,14,1071,13236,245,38,8.15,0,46.8,800267,6637,795819,0.52,0.08,0.28282051282051285,0.83,99.44
2022-09-02,Odisha,556,4,548,6874,4888,3764,8.09,4,46.8,800823,6641,796367,10.44,8.04,0.14688034188034188,0.83,99.44
2022-09-03,Odisha,1242,15,1238,15474,3105,89,8.03,0,46.8,802065,6656,797605,6.63,0.19,0.33064102564102565,0.83,99.44
2022-09-04,Odisha,395,2,388,4922,1155,839,8.03,5,46.8,802460,6658,797993,2.47,1.79,0.10517094017094017,0.83,99.44
2022-09-05,Odisha,1544,15,1538,19357,4079,2770,7.98,0,46.8,804004,6673,799531,8.72,5.92,0.4136111111111111,0.83,99.44
2022-09-06,Odisha,1105,7,1101,13577,1295,638,8.14,0,46.8,805109,6680,800632,2.77,1.36,0.2901068376068376,0.83,99.44
2022-09-07,Odisha,994,11,986,12595,4866,4723,7.89,0,46.8,806103,6691,801618,10.4,10.09,0.2691239316239316,0.83,99.44
2022-09-08,Odisha,558,2,557,6852,2636,1943,8.14,0,46.8,806661,6693,802175,5.63,4.15,0.1464102564102564,0.83,99.44
2022-09-09,Odisha,724,3,718,9695,4443,2210,7.47,3,46.8,807385,6696,802893,9.49,4.72,0.20715811965811967,0.83,99.44
2022-09-10,Odisha,1069,5,1066,13187,3037,15,8.11,0,46.8,808454,6701,803959,6.49,0.03,0.2817735042735043,0.83,99.44
2022-09-11,Odisha,1105,3,1103,14161,2024,1043,7.8,0,46.8,809559,6704,805062,4.32,2.23,0.3025854700854701,0.83,99.44
2022-09-12,Odisha,519,4,515,6252,2955,819,8.3,0,46.8,810078,6708,805577,6.31,1.75,0.1335897435897436,0.83,99.44
2022-09-13,Odisha,913,7,909,11793,2427,123,7.74,0,46.8,810991,6715,806486,5.19,0.26,0.25198717948717947,0.83,99.44
2022-09-14,Odisha,1012,7,1003,12429,2665,1169,8.14,2,46.8,812003,6722,807489,5.69,2.5,0.2655769230769231,0.83,99.44
2022-09-15,Odisha,1024,14,1020,12637,105,78,8.1,0,46.8,813027,6736,808509,0.22,0.17,0.2700213675213675,0.83,99.44
2022-09-16,Odisha,1540,4,1538,19475,1251,761,7.91,0,46.8,814567,6740,810047,2.67,1.63,0.41613247863247865,0.83,99.45
2022-09-17,Odisha,672,8,670,8202,2916,173,8.19,0,46.8,815239,6748,810717,6.23,0.37,0.17525641025641026,0.83,99.45
2022-09-18,Odisha,794,3,794,9721,1353,1349,8.17,0,46.8,816033,6751,811511,2.89,2.88,0.2077136752136752,0.83,99.45
2022-09-19,Odisha,952,9,944,12310,3890,2348,7.73,0,46.8,816985,6760,812455,8.31,5.02,0.26303418803418804,0.83,99.45
2022-09-20,Odisha,1264,9,1256,15565,2040,1577,8.12,0,46.8,818249,6769,813711,4.36,3.37,0.33258547008547007,0.83,99.45
2022-09-21,Odisha,986,9,978,12191,2942,1960,8.09,0,46.8,819235,6778,814689,6.29,4.19,0.260491452991453,0.83,99.45
2022-09-22,Odisha,447,5,445,5131,778,121,8.71,0,46.8,819682,6783,815134,1.66,0.26,0.10963675213675214,0.83,99.45
2022-09-23,Odisha,322,4,322,4429,4749,4429,7.27,0,46.8,820004,6787,815456,10.15,9.46,0.09463675213675214,0.83,99.45
2022-09-24,Odisha,1059,12,1050,13251,3776,1888,7.99,0,46.8,821063,6799,816506,8.07,4.03,0.28314102564102567,0.83,99.44
2022-09-25,Odisha,958,12,950,12076,3396,0,7.93,0,46.8,822021,6811,817456,7.26,0.0,0.25803418803418804,0.83,99.44
2022-09-26,Odisha,1484,18,1482,18430,4108,3495,8.05,0,46.8,823505,6829,818938,8.78,7.47,0.3938034188034188,0.83,99.45
2022-09-27,Odisha,125,0,124,926,620,372,13.5,1,46.8,823630,6829,819062,1.32,0.79,0.019786324786324788,0.83,99.45
2022-09-28,Odisha,1407,19,1405,17632,3167,2729,7.98,0,46.8,825037,6848,820467,6.77,5.83,0.37675213675213676,0.83,99.45
2022-09-29,Odisha,588,6,586,7268,333,53,8.09,0,46.8,825625,6854,821053,0.71,0.11,0.1552991452991453,0.83,99.45
2022-09-30,Odisha,1051,4,1049,13208,2094,544,7.96,0,46.8,826676,6858,822102,4.47,1.16,0.2822222222222222,0.83,99.45
2022-10-01,Odisha,67,0,65,684,4170,198,9.8,2,46.8,826743,6858,822167,8.91,0.42,0.014615384615384615,0.83,99.45
2022-10-02,Odisha,359,4,356,4807,1519,353,7.47,0,46.8,827102,6862,822523,3.25,0.75,0.1027136752136752,0.83,99.45
2022-10-03,Odisha,1435,21,1432,17895,3889,230,8.02,0,46.8,828537,6883,823955,8.31,0.49,0.38237179487179485,0.83,99.45
2022-10-04,Odisha,109,0,102,1401,3707,1189,7.78,7,46.8,828646,6883,824057,7.92,2.54,0.029935897435897436,0.83,99.45
2022-10-05,Odisha,1515,7,1514,18578,2570,1966,8.15,0,46.8,830161,6890,825571,5.49,4.2,0.396965811965812,0.83,99.45
2022-10-06,Odisha,1271,5,1264,16133,4622,3174,7.88,2,46.8,831432,6895,826835,9.88,6.78,0.3447222222222222,0.83,99.45
2022-10-07,Odisha,1175,8,1175,14055,1448,109,8.36,0,46.8,832607,6903,828010,3.09,0.23,0.3003205128205128,0.83,99.45
2022-10-08,Odisha,1313,7,1311,16718,330,197,7.85,0,46.8,833920,6910,829321,0.71,0.42,0.3572222222222222,0.83,99.45
2022-10-09,Odisha,689,5,685,8593,732,343,8.02,0,46.8,834609,6915,830006,1.56,0.73,0.1836111111111111,0.83,99.45
2022-10-10,Odisha,504,1,496,6366,4461,2157,7.92,7,46.8,835113,6916,830502,9.53,4.61,0.13602564102564102,0.83,99.45
2022-10-11,Odisha,1226,12,1219,15247,3216,210,8.04,0,46.8,836339,6928,831721,6.87,0.45,0.3257905982905983,0.83,99.45
2022-10-12,Odisha,755,2,751,9466,2582,2417,7.98,2,46.8,837094,6930,832472,5.52,5.16,0.20226495726495727,0.83,99.45
2022-10-13,Odisha,538,6,530,6778,3512,3317,7.94,2,46.8,837632,6936,833002,7.5,7.09,0.14482905982905983,0.83,99.45
2022-10-14,Odisha,689,8,688,8599,2212,112,8.01,0,46.8,838321,6944,833690,4.73,0.24,0.18373931623931625,0.83,99.45
2022-10-15,Odisha,1525,20,1517,19079,1374,1210,7.99,0,46.8,839846,6964,835207,2.94,2.59,0.4076709401709402,0.83,99.45
2022-10-16,Odisha,467,1,460,6009,4647,3323,7.77,6,46.8,840313,6965,835667,9.93,7.1,0.1283974358974359,0.83,99.45
2022-10-17,Odisha,620,8,614,7685,2000,794,8.07,0,46.8,840933,6973,836281,4.27,1.7,0.1642094017094017,0.83,99.45
2022-10-18,Odisha,1215,3,1211,14788,3502,980,8.22,1,46.8,842148,6976,837492,7.48,2.09,0.31598290598290596,0.83,99.45
2022-10-19,Odisha,1363,6,1358,16901,3833,1581,8.06,0,46.8,843511,6982,838850,8.19,3.38,0.36113247863247866,0.83,99.45
2022-10-20,Odisha,130,1,125,1605,1749,943,8.1,4,46.8,843641,6983,838975,3.74,2.01,0.0342948717948718,0.83,99.45
2022-10-21,Odisha,877,8,871,11112,3339,592,7.89,0,46.8,844518,6991,839846,7.13,1.26,0.23743589743589744,0.83,99.45
2022-10-22,Odisha,1340,9,1335,16908,460,65,7.93,0,46.8,845858,7000,841181,0.98,0.14,0.36128205128205126,0.83,99.45
2022-10-23,Odisha,1591,17,1583,19733,705,182,8.06,0,46.8,847449,7017,842764,1.51,0.39,0.42164529914529914,0.83,99.45
2022-10-24,Odisha,444,3,441,5259,2706,2147,8.44,0,46.8,847893,7020,843205,5.78,4.59,0.11237179487179487,0.83,99.45
2022-10-25,Odisha,1010,3,1009,12713,3827,2620,7.94,0,46.8,848903,7023,844214,8.18,5.6,0.27164529914529917,0.83,99.45
2022-10-26,Odisha,619,6,613,7745,2176,399,7.99,0,46.8,849522,7029,844827,4.65,0.85,0.165491452991453,0.83,99.45
2022-10-27,Odisha,771,8,762,9691,4154,1389,7.96,1,46.8,850293,7037,845589,8.88,2.97,0.20707264957264956,0.83,99.45
2022-10-28,Odisha,52,0,51,567,4441,485,9.17,1,46.8,850345,7037,845640,9.49,1.04,0.012115384615384615,0.83,99.45
2022-10-29,Odisha,435,6,428,5277,3569,1992,8.24,1,46.8,850780,7043,846068,7.63,4.26,0.11275641025641026,0.83,99.45
2022-10-30,Odisha,1177,7,1173,15066,2488,2454,7.81,0,46.8,851957,7050,847241,5.32,5.24,0.3219230769230769,0.83,99.45
2022-10-31,Odisha,812,4,810,10262,2229,1233,7.91,0,46.8,852769,7054,848051,4.76,2.63,0.21927350427350428,0.83,99.45
2022-11-01,Odisha,777,9,770,9693,3816,1821,8.02,0,46.8,853546,7063,848821,8.15,3.89,0.20711538461538462,0.83,99.45
2022-11-02,Odisha,835,7,828,10398,2355,2092,8.03,0,46.8,854381,7070,849649,5.03,4.47,0.22217948717948718,0.83,99.45
2022-11-03,Odisha,387,5,382,5230,2191,1899,7.4,0,46.8,854768,7075,850031,4.68,4.06,0.11175213675213676,0.83,99.45
2022-11-04,Odisha,1132,16,1129,14070,980,865,8.05,0,46.8,855900,7091,851160,2.09,1.85,0.3006410256410256,0.83,99.45
2022-11-05,Odisha,948,5,945,12281,4766,4115,7.72,0,46.8,856848,7096,852105,10.18,8.79,0.2624145299145299,0.83,99.45
2022-11-06,Odisha,143,1,139,1632,3889,2190,8.76,3,46.8,856991,7097,852244,8.31,4.68,0.03487179487179487,0.83,99.45
2022-11-07,Odisha,1289,10,1286,15833,2702,2152,8.14,0,46.8,858280,7107,853530,5.77,4.6,0.3383119658119658,0.83,99.45
2022-11-08,Odisha,1220,14,1213,15492,2876,1878,7.88,0,46.8,859500,7121,854743,6.15,4.01,0.331025641025641,0.83,99.45
2022-11-09,Odisha,69,0,69,742,1862,1798,9.3,0,46.8,859569,7121,854812,3.98,3.84,0.015854700854700855,0.83,99.45
2022-11-10,Odisha,474,2,465,5896,1643,285,8.04,7,46.8,860043,7123,855277,3.51,0.61,0.12598290598290598,0.83,99.45
2022-11-11,Odisha,643,8,639,7917,4350,2278,8.12,0,46.8,860686,7131,855916,9.29,4.87,0.16916666666666666,0.83,99.45
2022-11-12,Odisha,33,0,24,706,3845,1434,4.67,9,46.8,860719,7131,855940,8.22,3.06,0.015085470085470086,0.83,99.44
2022-11-13,Odisha,417,3,415,5490,1892,1882,7.6,0,46.8,861136,7134,856355,4.04,4.02,0.11730769230769231,0.83,99.44
2022-11-14,Odisha,430,3,425,5585,2446,848,7.7,2,46.8,861566,7137,856780,5.23,1.81,0.11933760683760684,0.83,99.44
2022-11-15,Odisha,1289,13,1289,16210,4064,1668,7.95,0,46.8,862855,7150,858069,8.68,3.56,0.34636752136752136,0.83,99.45
2022-11-16,Odisha,209,0,206,2856,2551,1644,7.32,3,46.8,863064,7150,858275,5.45,3.51,0.06102564102564102,0.83,99.45
2022-11-17,Odisha,100,0,99,1296,1879,988,7.72,1,46.8,863164,7150,858374,4.01,2.11,0.027692307692307693,0.83,99.45
2022-11-18,Odisha,537,5,532,6805,898,499,7.89,0,46.8,863701,7155,858906,1.92,1.07,0.14540598290598292,0.83,99.44
2022-11-19,Odisha,655,6,649,8123,2920,389,8.06,0,46.8,864356,7161,859555,6.24,0.83,0.17356837606837608,0.83,99.44
2022-11-20,Odisha,1437,19,1434,18096,242,83,7.94,0,46.8,865793,7180,860989,0.52,0.18,0.38666666666666666,0.83,99.45
2022-11-21,Odisha,1208,5,1199,15126,847,700,7.99,4,46.8,867001,7185,862188,1.81,1.5,0.3232051282051282,0.83,99.44
2022-11-22,Odisha,520,2,512,6531,770,282,7.96,6,46.8,867521,7187,862700,1.65,0.6,0.13955128205128206,0.83,99.44
2022-11-23,Odisha,888,10,879,10990,1874,41,8.08,0,46.8,868409,7197,863579,4.0,0.09,0.23482905982905983,0.83,99.44
2022-11-24,Odisha,1442,17,1434,17919,134,52,8.05,0,46.8,869851,7214,865013,0.29,0.11,0.3828846153846154,0.83,99.44
2022-11-25,Odisha,88,0,82,1064,1554,658,8.27,6,46.8,869939,7214,865095,3.32,1.41,0.022735042735042735,0.83,99.44
2022-11-26,Odisha,247,2,242,3256,1083,832,7.59,3,46.8,870186,7216,865337,2.31,1.78,0.06957264957264957,0.83,99.44
2022-11-27,Odisha,660,2,651,8322,1390,17,7.93,7,46.8,870846,7218,865988,2.97,0.04,0.1778205128205128,0.83,99.44
2022-11-28,Odisha,195,1,190,2232,2292,1069,8.74,4,46.8,871041,7219,866178,4.9,2.28,0.047692307692307694,0.83,99.44
2022-11-29,Odisha,1345,14,1336,16959,2715,2153,7.93,0,46.8,872386,7233,867514,5.8,4.6,0.3623717948717949,0.83,99.44
2022-11-30,Odisha,1105,11,1096,13685,2201,1992,8.07,0,46.8,873491,7244,868610,4.7,4.26,0.29241452991452993,0.83,99.44
2022-12-01,Odisha,212,1,208,2593,2582,1733,8.18,3,46.8,873703,7245,868818,5.52,3.7,0.055405982905982906,0.83,99.44
2022-12-02,Odisha,1080,12,1078,13492,4842,481,8.0,0,46.8,874783,7257,869896,10.35,1.03,0.2882905982905983,0.83,99.44
2022-12-03,Odisha,147,0,143,1625,608,505,9.05,4,46.8,874930,7257,870039,1.3,1.08,0.034722222222222224,0.83,99.44
2022-12-04,Odisha,989,4,984,12358,2686,430,8.0,1,46.8,875919,7261,871023,5.74,0.92,0.26405982905982905,0.83,99.44
2022-12-05,Odisha,353,1,344,4169,3221,2101,8.47,8,46.8,876272,7262,871367,6.88,4.49,0.08908119658119658,0.83,99.44
2022-12-06,Odisha,1070,9,1070,13235,2445,592,8.08,0,46.8,877342,7271,872437,5.22,1.26,0.2827991452991453,0.83,99.44
2022-12-07,Odisha,1212,16,1206,15082,3268,1465,8.04,0,46.8,878554,7287,873643,6.98,3.13,0.32226495726495724,0.83,99.44
2022-12-08,Odisha,1587,7,1587,19982,1182,335,7.94,0,46.8,880141,7294,875230,2.53,0.72,0.42696581196581196,0.83,99.44
2022-12-09,Odisha,969,14,960,12400,4475,3163,7.81,0,46.8,881110,7308,876190,9.56,6.76,0.26495726495726496,0.83,99.44
2022-12-10,Odisha,1570,6,1570,19277,1717,1597,8.14,0,46.8,882680,7314,877760,3.67,3.41,0.4119017094017094,0.83,99.44
2022-12-11,Odisha,702,9,698,8607,4493,2499,8.16,0,46.8,883382,7323,878458,9.6,5.34,0.1839102564102564,0.83,99.44
2022-12-12,Odisha,809,4,808,9813,3174,2108,8.24,0,46.8,884191,7327,879266,6.78,4.5,0.20967948717948717,0.83,99.44
2022-12-13,Odisha,69,0,62,739,4155,2930,9.34,7,46.8,884260,7327,879328,8.88,6.26,0.01579059829059829,0.83,99.44
2022-12-14,Odisha,1015,9,1010,12799,3622,2034,7.93,0,46.8,885275,7336,880338,7.74,4.35,0.273482905982906,0.83,99.44
2022-12-15,Odisha,520,6,520,6651,4072,871,7.82,0,46.8,885795,7342,880858,8.7,1.86,0.14211538461538462,0.83,99.44
2022-12-16,Odisha,750,10,743,9352,3935,189,8.02,0,46.8,886545,7352,881601,8.41,0.4,0.19982905982905982,0.83,99.44
2022-12-17,Odisha,70,0,65,945,2857,2567,7.41,5,46.8,886615,7352,881666,6.1,5.49,0.020192307692307693,0.83,99.44
2022-12-18,Odisha,974,8,965,12465,1150,482,7.81,1,46.8,887589,7360,882631,2.46,1.03,0.26634615384615384,0.83,99.44
2022-12-19,Odisha,1532,9,1532,19106,2904,2787,8.02,0,46.8,889121,7369,884163,6.21,5.96,0.4082478632478633,0.83,99.44
2022-12-20,Odisha,165,2,160,2209,93,10,7.47,3,46.8,889286,7371,884323,0.2,0.02,0.0472008547008547,0.83,99.44
2022-12-21,Odisha,807,3,803,9898,4840,2074,8.15,1,46.8,890093,7374,885126,10.34,4.43,0.21149572649572648,0.83,99.44
2022-12-22,Odisha,948,6,939,12296,3302,1992,7.71,3,46.8,891041,7380,886065,7.06,4.26,0.2627350427350427,0.83,99.44
2022-12-23,Odisha,1320,4,1311,16427,4553,4229,8.04,5,46.8,892361,7384,887376,9.73,9.04,0.3510042735042735,0.83,99.44
2022-12-24,Odisha,75,1,74,1103,2005,1445,6.8,0,46.8,892436,7385,887450,4.28,3.09,0.023568376068376067,0.83,99.44
2022-12-25,Odisha,582,7,573,6731,3974,883,8.65,2,46.8,893018,7392,888023,8.49,1.89,0.14382478632478632,0.83,99.44
2022-12-26,Odisha,114,0,105,1380,1224,405,8.26,9,46.8,893132,7392,888128,2.62,0.87,0.029487179487179487,0.83,99.44
2022-12-27,Odisha,1172,8,1172,14729,3443,910,7.96,0,46.8,894304,7400,889300,7.36,1.94,0.31472222222222224,0.83,99.44
2022-12-28,Odisha,636,7,636,8473,3067,510,7.51,0,46.8,894940,7407,889936,6.55,1.09,0.18104700854700856,0.83,99.44
2022-12-29,Odisha,437,2,437,5487,1752,378,7.96,0,46.8,895377,7409,890373,3.74,0.81,0.11724358974358974,0.83,99.44
2022-12-30,Odisha,761,8,761,9404,2939,107,8.09,0,46.8,896138,7417,891134,6.28,0.23,0.20094017094017094,0.83,99.44
2022-12-31,Odisha,337,2,335,4452,4998,3141,7.57,0,46.8,896475,7419,891469,10.68,6.71,0.09512820512820513,0.83,99.44
2020-01-01,Punjab,36,0,31,703,3561,2496,5.12,5,30.0,36,0,31,11.87,8.32,0.023433333333333334,0.0,86.11
2020-01-02,Punjab,709,7,701,8702,2466,1951,8.15,1,30.0,745,7,732,8.22,6.5,0.29006666666666664,0.94,98.26
2020-01-03,Punjab,1114,6,1112,14337,2898,553,7.77,0,30.0,1859,13,1844,9.66,1.84,0.4779,0.7,99.19
2020-01-04,Punjab,945,3,936,11539,4358,1460,8.19,6,30.0,2804,16,2780,14.53,4.87,0.3846333333333333,0.57,99.14
2020-01-05,Punjab,894,11,891,11449,2865,1921,7.81,0,30.0,3698,27,3671,9.55,6.4,0.3816333333333333,0.73,99.27
2020-01-06,Punjab,499,4,493,6236,3771,1021,8.0,2,30.0,4197,31,4164,12.57,3.4,0.20786666666666667,0.74,99.21
2020-01-07,Punjab,794,7,793,9918,3034,2038,8.01,0,30.0,4991,38,4957,10.11,6.79,0.3306,0.76,99.32
2020-01-08,Punjab,465,3,463,5637,2613,1860,8.25,0,30.0,5456,41,5420,8.71,6.2,0.1879,0.75,99.34
2020-01-09,Punjab,1501,16,1494,18377,1303,410,8.17,0,30.0,6957,57,6914,4.34,1.37,0.6125666666666667,0.82,99.38
2020-01-10,Punjab,1277,10,1273,15720,2246,867,8.12,0,30.0,8234,67,8187,7.49,2.89,0.524,0.81,99.43
2020-01-11,Punjab,1394,13,1386,17135,4254,1506,8.14,0,30.0,9628,80,9573,14.18,5.02,0.5711666666666667,0.83,99.43
2020-01-12,Punjab,736,4,733,8982,4571,3593,8.19,0,30.0,10364,84,10306,15.24,11.98,0.2994,0.81,99.44
2020-01-13,Punjab,372,1,371,4618,2230,250,8.06,0,30.0,10736,85,10677,7.43,0.83,0.15393333333333334,0.79,99.45
2020-01-14,Punjab,800,2,792,10202,2636,973,7.84,6,30.0,11536,87,11469,8.79,3.24,0.3400666666666667,0.75,99.42
2020-01-15,Punjab,897,8,888,11367,3125,2831,7.89,1,30.0,12433,95,12357,10.42,9.44,0.3789,0.76,99.39
2020-01-16,Punjab,1570,13,1561,19881,3216,2996,7.9,0,30.0,14003,108,13918,10.72,9.99,0.6627,0.77,99.39
2020-01-17,Punjab,1558,8,1554,19536,694,283,7.98,0,30.0,15561,116,15472,2.31,0.94,0.6512,0.75,99.43
2020-01-18,Punjab,989,4,984,12439,3964,1630,7.95,1,30.0,16550,120,16456,13.21,5.43,0.41463333333333335,0.73,99.43
2020-01-19,Punjab,669,6,667,8696,3818,290,7.69,0,30.0,17219,126,17123,12.73,0.97,0.28986666666666666,0.73,99.44
2020-01-20,Punjab,1571,9,1567,19800,518,491,7.93,0,30.0,18790,135,18690,1.73,1.64,0.66,0.72,99.47
2020-01-21,Punjab,1084,7,1075,13484,4447,2405,8.04,2,30.0,19874,142,19765,14.82,8.02,0.4494666666666667,0.71,99.45
2020-01-22,Punjab,963,8,959,12421,1981,789,7.75,0,30.0,20837,150,20724,6.6,2.63,0.4140333333333333,0.72,99.46
2020-01-23,Punjab,634,8,632,7803,1675,498,8.13,0,30.0,21471,158,21356,5.58,1.66,0.2601,0.74,99.46
2020-01-24,Punjab,301,4,300,3872,3981,2434,7.77,0,30.0,21772,162,21656,13.27,8.11,0.12906666666666666,0.74,99.47
2020-01-25,Punjab,786,9,783,10595,3150,864,7.42,0,30.0,22558,171,22439,10.5,2.88,0.3531666666666667,0.76,99.47
2020-01-26,Punjab,305,4,299,3621,3114,492,8.42,2,30.0,22863,175,22738,10.38,1.64,0.1207,0.77,99.45
2020-01-27,Punjab,935,5,929,11562,4511,300,8.09,1,30.0,23798,180,23667,15.04,1.0,0.3854,0.76,99.45
2020-01-28,Punjab,514,4,513,6383,3266,2468,8.05,0,30.0,24312,184,24180,10.89,8.23,0.21276666666666666,0.76,99.46
2020-01-29,Punjab,1069,4,1060,13828,3634,2861,7.73,5,30.0,25381,188,25240,12.11,9.54,0.4609333333333333,0.74,99.44
2020-01-30,Punjab,270,3,268,3380,3686,1691,7.99,0,30.0,25651,191,25508,12.29,5.64,0.11266666666666666,0.74,99.44
2020-01-31,Punjab,983,11,980,11929,354,334,8.24,0,30.0,26634,202,26488,1.18,1.11,0.39763333333333334,0.76,99.45
2020-02-01,Punjab,1394,9,1394,17428,3321,936,8.0,0,30.0,28028,211,27882,11.07,3.12,0.5809333333333333,0.75,99.48
2020-02-02,Punjab,1558,5,1556,19698,2678,998,7.91,0,30.0,29586,216,29438,8.93,3.33,0.6566,0.73,99.5
2020-02-03,Punjab,1369,6,1361,17408,4393,157,7.86,2,30.0,30955,222,30799,14.64,0.52,0.5802666666666667,0.72,99.5
2020-02-04,Punjab,295,1,289,3840,2136,1020,7.68,5,30.0,31250,223,31088,7.12,3.4,0.128,0.71,99.48
2020-02-05,Punjab,1189,11,1180,14615,3100,2140,8.14,0,30.0,32439,234,32268,10.33,7.13,0.4871666666666667,0.72,99.47
2020-02-06,Punjab,113,1,111,1160,2387,760,9.74,1,30.0,32552,235,32379,7.96,2.53,0.03866666666666667,0.72,99.47
2020-02-07,Punjab,468,2,462,5777,496,38,8.1,4,30.0,33020,237,32841,1.65,0.13,0.19256666666666666,0.72,99.46
2020-02-08,Punjab,1190,5,1190,14879,1965,970,8.0,0,30.0,34210,242,34031,6.55,3.23,0.49596666666666667,0.71,99.48
2020-02-09,Punjab,466,3,460,5444,4200,3133,8.56,3,30.0,34676,245,34491,14.0,10.44,0.18146666666666667,0.71,99.47
2020-02-10,Punjab,272,2,265,3451,4495,2874,7.88,5,30.0,34948,247,34756,14.98,9.58,0.11503333333333333,0.71,99.45
2020-02-11,Punjab,392,3,384,4682,1364,1013,8.37,5,30.0,35340,250,35140,4.55,3.38,0.15606666666666666,0.71,99.43
2020-02-12,Punjab,1415,16,1407,17400,1030,356,8.13,0,30.0,36755,266,36547,3.43,1.19,0.58,0.72,99.43
2020-02-13,Punjab,210,3,202,2087,1074,88,10.06,5,30.0,36965,269,36749,3.58,0.29,0.06956666666666667,0.73,99.42
2020-02-14,Punjab,342,3,334,4289,4034,1307,7.97,5,30.0,37307,272,37083,13.45,4.36,0.14296666666666666,0.73,99.4
2020-02-15,Punjab,458,3,451,5543,3130,1902,8.26,4,30.0,37765,275,37534,10.43,6.34,0.18476666666666666,0.73,99.39
2020-02-16,Punjab,904,6,897,11233,3971,2059,8.05,1,30.0,38669,281,38431,13.24,6.86,0.37443333333333334,0.73,99.38
2020-02-17,Punjab,1311,9,1310,16597,3641,2895,7.9,0,30.0,39980,290,39741,12.14,9.65,0.5532333333333334,0.73,99.4
2020-02-18,Punjab,864,11,861,10876,708,167,7.94,0,30.0,40844,301,40602,2.36,0.56,0.3625333333333333,0.74,99.41
2020-02-19,Punjab,816,6,814,10097,2293,424,8.08,0,30.0,41660,307,41416,7.64,1.41,0.3365666666666667,0.74,99.41
2020-02-20,Punjab,463,4,457,5752,4124,1753,8.05,2,30.0,42123,311,41873,13.75,5.84,0.19173333333333334,0.74,99.41
2020-02-21,Punjab,760,10,758,9521,1082,115,7.98,0,30.0,42883,321,42631,3.61,0.38,0.3173666666666667,0.75,99.41
2020-02-22,Punjab,1054,8,1050,13235,798,392,7.96,0,30.0,43937,329,43681,2.66,1.31,0.44116666666666665,0.75,99.42
2020-02-23,Punjab,31,0,31,551,4800,2609,5.63,0,30.0,43968,329,43712,16.0,8.7,0.018366666666666667,0.75,99.42
2020-02-24,Punjab,1129,15,1126,13985,3445,3110,8.07,0,30.0,45097,344,44838,11.48,10.37,0.4661666666666667,0.76,99.43
2020-02-25,Punjab,648,2,648,8213,377,92,7.89,0,30.0,45745,346,45486,1.26,0.31,0.27376666666666666,0.76,99.43
2020-02-26,Punjab,614,5,610,7653,659,483,8.02,0,30.0,46359,351,46096,2.2,1.61,0.2551,0.76,99.43
2020-02-27,Punjab,78,0,78,973,1711,264,8.02,0,30.0,46437,351,46174,5.7,0.88,0.032433333333333335,0.76,99.43
2020-02-28,Punjab,715,10,707,8927,4465,1466,8.01,0,30.0,47152,361,46881,14.88,4.89,0.29756666666666665,0.77,99.43
2020-02-29,Punjab,1224,11,1223,15839,3359,2451,7.73,0,30.0,48376,372,48104,11.2,8.17,0.5279666666666667,0.77,99.44
2020-03-01,Punjab,1079,5,1070,13641,2348,953,7.91,4,30.0,49455,377,49174,7.83,3.18,0.4547,0.76,99.43
2020-03-02,Punjab,375,3,371,4944,606,110,7.58,1,30.0,49830,380,49545,2.02,0.37,0.1648,0.76,99.43
2020-03-03,Punjab,1054,9,1046,12914,2135,594,8.16,0,30.0,50884,389,50591,7.12,1.98,0.43046666666666666,0.76,99.42
2020-03-04,Punjab,545,1,537,6665,1713,977,8.18,7,30.0,51429,390,51128,5.71,3.26,0.22216666666666668,0.76,99.41
2020-03-05,Punjab,648,9,645,8169,4379,3766,7.93,0,30.0,52077,399,51773,14.6,12.55,0.2723,0.77,99.42
2020-03-06,Punjab,1473,7,1471,18731,942,44,7.86,0,30.0,53550,406,53244,3.14,0.15,0.6243666666666666,0.76,99.43
2020-03-07,Punjab,269,1,261,2751,3023,2594,9.78,7,30.0,53819,407,53505,10.08,8.65,0.0917,0.76,99.42
2020-03-08,Punjab,749,8,743,9585,2388,1576,7.81,0,30.0,54568,415,54248,7.96,5.25,0.3195,0.76,99.41
2020-03-09,Punjab,1471,19,1471,18536,1461,108,7.94,0,30.0,56039,434,55719,4.87,0.36,0.6178666666666667,0.77,99.43
2020-03-10,Punjab,253,2,252,3098,3386,2962,8.17,0,30.0,56292,436,55971,11.29,9.87,0.10326666666666667,0.77,99.43
2020-03-11,Punjab,1210,13,1204,15160,3073,2120,7.98,0,30.0,57502,449,57175,10.24,7.07,0.5053333333333333,0.78,99.43
2020-03-12,Punjab,959,3,952,11659,1503,702,8.23,4,30.0,58461,452,58127,5.01,2.34,0.38863333333333333,0.77,99.43
2020-03-13,Punjab,255,2,246,2886,1470,1357,8.84,7,30.0,58716,454,58373,4.9,4.52,0.0962,0.77,99.42
2020-03-14,Punjab,727,8,723,9140,2102,813,7.95,0,30.0,59443,462,59096,7.01,2.71,0.30466666666666664,0.78,99.42
2020-03-15,Punjab,660,5,660,8111,867,359,8.14,0,30.0,60103,467,59756,2.89,1.2,0.27036666666666664,0.78,99.42
2020-03-16,Punjab,675,2,666,8436,3734,918,8.0,7,30.0,60778,469,60422,12.45,3.06,0.2812,0.77,99.41
2020-03-17,Punjab,1566,11,1563,19775,2916,7,7.92,0,30.0,62344,480,61985,9.72,0.02,0.6591666666666667,0.77,99.42
2020-03-18,Punjab,554,4,547,6703,4798,4178,8.26,3,30.0,62898,484,62532,15.99,13.93,0.22343333333333334,0.77,99.42
2020-03-19,Punjab,990,9,985,12336,1477,5,8.03,0,30.0,63888,493,63517,4.92,0.02,0.4112,0.77,99.42
2020-03-20,Punjab,1363,6,1363,17573,4910,4659,7.76,0,30.0,65251,499,64880,16.37,15.53,0.5857666666666667,0.76,99.43
2020-03-21,Punjab,324,2,319,3993,3157,396,8.11,3,30.0,65575,501,65199,10.52,1.32,0.1331,0.76,99.43
2020-03-22,Punjab,490,6,481,5839,4524,2554,8.39,3,30.0,66065,507,65680,15.08,8.51,0.19463333333333332,0.77,99.42
2020-03-23,Punjab,915,6,910,11490,1850,362,7.96,0,30.0,66980,513,66590,6.17,1.21,0.383,0.77,99.42
2020-03-24,Punjab,792,4,786,9796,3012,1329,8.08,2,30.0,67772,517,67376,10.04,4.43,0.32653333333333334,0.76,99.42
2020-03-25,Punjab,113,1,106,1291,1917,627,8.75,6,30.0,67885,518,67482,6.39,2.09,0.04303333333333333,0.76,99.41
2020-03-26,Punjab,225,1,220,2744,3102,3079,8.2,4,30.0,68110,519,67702,10.34,10.26,0.09146666666666667,0.76,99.4
2020-03-27,Punjab,731,9,730,9255,3605,1391,7.9,0,30.0,68841,528,68432,12.02,4.64,0.3085,0.77,99.41
2020-03-28,Punjab,1512,19,1511,18942,1090,555,7.98,0,30.0,70353,547,69943,3.63,1.85,0.6314,0.78,99.42
2020-03-29,Punjab,416,5,410,5731,26,20,7.26,1,30.0,70769,552,70353,0.09,0.07,0.19103333333333333,0.78,99.41
2020-03-30,Punjab,796,11,787,10087,1960,1296,7.89,0,30.0,71565,563,71140,6.53,4.32,0.33623333333333333,0.79,99.41
2020-03-31,Punjab,891,6,890,11372,996,714,7.84,0,30.0,72456,569,72030,3.32,2.38,0.37906666666666666,0.79,99.41
2020-04-01,Punjab,224,1,222,2340,1632,46,9.57,1,30.0,72680,570,72252,5.44,0.15,0.078,0.78,99.41
2020-04-02,Punjab,1532,22,1523,18900,572,418,8.11,0,30.0,74212,592,73775,1.91,1.39,0.63,0.8,99.41
2020-04-03,Punjab,974,10,966,11972,1988,1178,8.14,0,30.0,75186,602,74741,6.63,3.93,0.3990666666666667,0.8,99.41
2020-04-04,Punjab,769,6,760,9658,2627,645,7.96,3,30.0,75955,608,75501,8.76,2.15,0.32193333333333335,0.8,99.4
2020-04-05,Punjab,234,3,229,3469,3258,3063,6.75,2,30.0,76189,611,75730,10.86,10.21,0.11563333333333334,0.8,99.4
2020-04-06,Punjab,1558,18,1550,19413,13,12,8.03,0,30.0,77747,629,77280,0.04,0.04,0.6471,0.81,99.4
2020-04-07,Punjab,178,2,176,2227,927,148,7.99,0,30.0,77925,631,77456,3.09,0.49,0.07423333333333333,0.81,99.4
2020-04-08,Punjab,1032,7,1032,13267,292,57,7.78,0,30.0,78957,638,78488,0.97,0.19,0.4422333333333333,0.81,99.41
2020-04-09,Punjab,712,7,708,8946,953,43,7.96,0,30.0,79669,645,79196,3.18,0.14,0.2982,0.81,99.41
2020-04-10,Punjab,999,13,993,13057,4704,3474,7.65,0,30.0,80668,658,80189,15.68,11.58,0.43523333333333336,0.82,99.41
2020-04-11,Punjab,136,1,136,1581,3214,2685,8.6,0,30.0,80804,659,80325,10.71,8.95,0.0527,0.82,99.41
2020-04-12,Punjab,273,1,270,3092,1510,1089,8.83,2,30.0,81077,660,80595,5.03,3.63,0.10306666666666667,0.81,99.41
2020-04-13,Punjab,174,0,166,2282,4851,3755,7.62,8,30.0,81251,660,80761,16.17,12.52,0.07606666666666667,0.81,99.4
2020-04-14,Punjab,973,12,964,12322,4175,4013,7.9,0,30.0,82224,672,81725,13.92,13.38,0.41073333333333334,0.82,99.39
2020-04-15,Punjab,494,5,490,6103,603,364,8.09,0,30.0,82718,677,82215,2.01,1.21,0.20343333333333333,0.82,99.39
2020-04-16,Punjab,941,3,936,11939,4273,2146,7.88,2,30.0,83659,680,83151,14.24,7.15,0.3979666666666667,0.81,99.39
2020-04-17,Punjab,99,1,94,1430,1282,96,6.92,4,30.0,83758,681,83245,4.27,0.32,0.04766666666666667,0.81,99.39
2020-04-18,Punjab,93,0,85,1514,4845,3918,6.14,8,30.0,83851,681,83330,16.15,13.06,0.05046666666666667,0.81,99.38
2020-04-19,Punjab,578,3,570,6987,416,45,8.27,5,30.0,84429,684,83900,1.39,0.15,0.2329,0.81,99.37
2020-04-20,Punjab,1321,5,1313,16605,4356,1343,7.96,3,30.0,85750,689,85213,14.52,4.48,0.5535,0.8,99.37
2020-04-21,Punjab,406,5,397,4899,3938,2416,8.29,4,30.0,86156,694,85610,13.13,8.05,0.1633,0.81,99.37
2020-04-22,Punjab,201,1,201,2904,2955,2799,6.92,0,30.0,86357,695,85811,9.85,9.33,0.0968,0.8,99.37
2020-04-23,Punjab,967,3,961,11955,2224,1906,8.09,3,30.0,87324,698,86772,7.41,6.35,0.3985,0.8,99.37
2020-04-24,Punjab,776,7,769,9567,2655,1339,8.11,0,30.0,88100,705,87541,8.85,4.46,0.3189,0.8,99.37
2020-04-25,Punjab,96,0,89,1135,4157,1623,8.46,7,30.0,88196,705,87630,13.86,5.41,0.03783333333333333,0.8,99.36
2020-04-26,Punjab,802,10,798,10101,2342,2266,7.94,0,30.0,88998,715,88428,7.81,7.55,0.3367,0.8,99.36
2020-04-27,Punjab,534,7,533,6772,3234,2622,7.89,0,30.0,89532,722,88961,10.78,8.74,0.22573333333333334,0.81,99.36
2020-04-28,Punjab,175,1,169,2439,3002,316,7.18,5,30.0,89707,723,89130,10.01,1.05,0.0813,0.81,99.36
2020-04-29,Punjab,336,2,330,4207,2186,880,7.99,4,30.0,90043,725,89460,7.29,2.93,0.14023333333333332,0.81,99.35
2020-04-30,Punjab,790,2,784,10192,4583,4425,7.75,4,30.0,90833,727,90244,15.28,14.75,0.33973333333333333,0.8,99.35
2020-05-01,Punjab,860,5,855,11265,4945,1180,7.63,0,30.0,91693,732,91099,16.48,3.93,0.3755,0.8,99.35
2020-05-02,Punjab,619,5,616,8004,230,65,7.73,0,30.0,92312,737,91715,0.77,0.22,0.2668,0.8,99.35
2020-05-03,Punjab,1609,14,1600,19650,569,268,8.19,0,30.0,93921,751,93315,1.9,0.89,0.655,0.8,99.35
2020-05-04,Punjab,605,8,605,7449,192,63,8.12,0,30.0,94526,759,93920,0.64,0.21,0.2483,0.8,99.36
2020-05-05,Punjab,1572,4,1570,19470,1289,649,8.07,0,30.0,96098,763,95490,4.3,2.16,0.649,0.79,99.37
2020-05-06,Punjab,1197,10,1189,15403,3904,140,7.77,0,30.0,97295,773,96679,13.01,0.47,0.5134333333333333,0.79,99.37
2020-05-07,Punjab,333,3,324,4143,2263,1238,8.04,6,30.0,97628,776,97003,7.54,4.13,0.1381,0.79,99.36
2020-05-08,Punjab,779,4,776,9929,4551,452,7.85,0,30.0,98407,780,97779,15.17,1.51,0.3309666666666667,0.79,99.36
2020-05-09,Punjab,1103,7,1100,13620,294,50,8.1,0,30.0,99510,787,98879,0.98,0.17,0.454,0.79,99.37
2020-05-10,Punjab,505,4,496,6654,3313,1378,7.59,5,30.0,100015,791,99375,11.04,4.59,0.2218,0.79,99.36
2020-05-11,Punjab,1183,4,1181,15011,3897,3674,7.88,0,30.0,101198,795,100556,12.99,12.25,0.5003666666666666,0.79,99.37
2020-05-12,Punjab,1066,11,1061,13557,4265,2505,7.86,0,30.0,102264,806,101617,14.22,8.35,0.4519,0.79,99.37
2020-05-13,Punjab,783,8,776,9527,2819,372,8.22,0,30.0,103047,814,102393,9.4,1.24,0.31756666666666666,0.79,99.37
2020-05-14,Punjab,826,3,818,10535,3588,385,7.84,5,30.0,103873,817,103211,11.96,1.28,0.3511666666666667,0.79,99.36
2020-05-15,Punjab,685,2,678,8102,753,281,8.45,5,30.0,104558,819,103889,2.51,0.94,0.2700666666666667,0.78,99.36
2020-05-16,Punjab,857,9,852,10424,1906,1622,8.22,0,30.0,105415,828,104741,6.35,5.41,0.34746666666666665,0.79,99.36
2020-05-17,Punjab,757,9,752,9236,4688,865,8.2,0,30.0,106172,837,105493,15.63,2.88,0.3078666666666667,0.79,99.36
2020-05-18,Punjab,1597,18,1595,19579,2139,1858,8.16,0,30.0,107769,855,107088,7.13,6.19,0.6526333333333333,0.79,99.37
2020-05-19,Punjab,972,13,971,12540,623,479,7.75,0,30.0,108741,868,108059,2.08,1.6,0.418,0.8,99.37
2020-05-20,Punjab,1181,3,1173,14712,1062,651,8.03,5,30.0,109922,871,109232,3.54,2.17,0.4904,0.79,99.37
2020-05-21,Punjab,1236,13,1231,15241,904,618,8.11,0,30.0,111158,884,110463,3.01,2.06,0.5080333333333333,0.8,99.37
2020-05-22,Punjab,456,3,451,5686,1825,1586,8.02,2,30.0,111614,887,110914,6.08,5.29,0.18953333333333333,0.79,99.37
2020-05-23,Punjab,225,1,219,2732,4780,2063,8.24,5,30.0,111839,888,111133,15.93,6.88,0.09106666666666667,0.79,99.37
2020-05-24,Punjab,497,4,495,5989,2747,2097,8.3,0,30.0,112336,892,111628,9.16,6.99,0.19963333333333333,0.79,99.37
2020-05-25,Punjab,733,3,732,9269,4981,1078,7.91,0,30.0,113069,895,112360,16.6,3.59,0.30896666666666667,0.79,99.37
2020-05-26,Punjab,722,6,720,9049,545,406,7.98,0,30.0,113791,901,113080,1.82,1.35,0.3016333333333333,0.79,99.38
2020-05-27,Punjab,1044,15,1039,12850,1225,205,8.12,0,30.0,114835,916,114119,4.08,0.68,0.42833333333333334,0.8,99.38
2020-05-28,Punjab,608,1,608,7551,4625,1353,8.05,0,30.0,115443,917,114727,15.42,4.51,0.2517,0.79,99.38
2020-05-29,Punjab,990,11,988,12874,2835,1551,7.69,0,30.0,116433,928,115715,9.45,5.17,0.4291333333333333,0.8,99.38
2020-05-30,Punjab,800,7,797,10186,3948,2176,7.85,0,30.0,117233,935,116512,13.16,7.25,0.33953333333333335,0.8,99.38
2020-05-31,Punjab,367,2,366,4670,3730,2078,7.86,0,30.0,117600,937,116878,12.43,6.93,0.15566666666666668,0.8,99.39
2020-06-01,Punjab,567,5,558,7174,2745,1375,7.9,4,30.0,118167,942,117436,9.15,4.58,0.23913333333333334,0.8,99.38
2020-06-02,Punjab,766,8,758,9707,3507,671,7.89,0,30.0,118933,950,118194,11.69,2.24,0.32356666666666667,0.8,99.38
2020-06-03,Punjab,1224,11,1223,15011,3177,1145,8.15,0,30.0,120157,961,119417,10.59,3.82,0.5003666666666666,0.8,99.38
2020-06-04,Punjab,1427,17,1420,17380,1119,142,8.21,0,30.0,121584,978,120837,3.73,0.47,0.5793333333333334,0.8,99.39
2020-06-05,Punjab,332,4,329,4123,1653,61,8.05,0,30.0,121916,982,121166,5.51,0.2,0.13743333333333332,0.81,99.38
2020-06-06,Punjab,468,5,464,5727,4988,1113,8.17,0,30.0,122384,987,121630,16.63,3.71,0.1909,0.81,99.38
2020-06-07,Punjab,39,0,33,663,1493,144,5.88,6,30.0,122423,987,121663,4.98,0.48,0.0221,0.81,99.38
2020-06-08,Punjab,1104,12,1100,13811,2479,1299,7.99,0,30.0,123527,999,122763,8.26,4.33,0.46036666666666665,0.81,99.38
2020-06-09,Punjab,1540,17,1535,19129,1196,888,8.05,0,30.0,125067,1016,124298,3.99,2.96,0.6376333333333334,0.81,99.39
2020-06-10,Punjab,1060,9,1056,13809,4040,1179,7.68,0,30.0,126127,1025,125354,13.47,3.93,0.4603,0.81,99.39
2020-06-11,Punjab,839,10,836,10252,1568,713,8.18,0,30.0,126966,1035,126190,5.23,2.38,0.34173333333333333,0.82,99.39
2020-06-12,Punjab,1384,20,1384,17382,4733,94,7.96,0,30.0,128350,1055,127574,15.78,0.31,0.5794,0.82,99.4
2020-06-13,Punjab,523,6,518,6342,1717,947,8.25,0,30.0,128873,1061,128092,5.72,3.16,0.2114,0.82,99.39
2020-06-14,Punjab,390,5,383,4504,2256,266,8.66,2,30.0,129263,1066,128475,7.52,0.89,0.15013333333333334,0.82,99.39
2020-06-15,Punjab,889,2,889,10811,2825,87,8.22,0,30.0,130152,1068,129364,9.42,0.29,0.36036666666666667,0.82,99.39
2020-06-16,Punjab,629,3,623,8344,2038,88,7.54,3,30.0,130781,1071,129987,6.79,0.29,0.27813333333333334,0.82,99.39
2020-06-17,Punjab,1042,13,1034,13278,3731,152,7.85,0,30.0,131823,1084,131021,12.44,0.51,0.4426,0.82,99.39
2020-06-18,Punjab,242,3,242,2546,3929,928,9.51,0,30.0,132065,1087,131263,13.1,3.09,0.08486666666666667,0.82,99.39
2020-06-19,Punjab,583,7,581,6981,3576,1711,8.35,0,30.0,132648,1094,131844,11.92,5.7,0.2327,0.82,99.39
2020-06-20,Punjab,1076,11,1074,13557,1224,615,7.94,0,30.0,133724,1105,132918,4.08,2.05,0.4519,0.83,99.4
2020-06-21,Punjab,1208,14,1199,15069,3524,2548,8.02,0,30.0,134932,1119,134117,11.75,8.49,0.5023,0.83,99.4
2020-06-22,Punjab,1067,3,1060,12997,2823,2285,8.21,4,30.0,135999,1122,135177,9.41,7.62,0.43323333333333336,0.83,99.4
2020-06-23,Punjab,572,1,572,7645,3794,2344,7.48,0,30.0,136571,1123,135749,12.65,7.81,0.25483333333333336,0.82,99.4
2020-06-24,Punjab,1583,8,1578,19878,2577,1744,7.96,0,30.0,138154,1131,137327,8.59,5.81,0.6626,0.82,99.4
2020-06-25,Punjab,81,0,80,768,4853,4481,10.55,1,30.0,138235,1131,137407,16.18,14.94,0.0256,0.82,99.4
2020-06-26,Punjab,210,2,206,3532,4170,3204,5.95,2,30.0,138445,1133,137613,13.9,10.68,0.11773333333333333,0.82,99.4
2020-06-27,Punjab,281,3,272,3755,3690,3183,7.48,6,30.0,138726,1136,137885,12.3,10.61,0.12516666666666668,0.82,99.39
2020-06-28,Punjab,1312,10,1306,16641,2829,629,7.88,0,30.0,140038,1146,139191,9.43,2.1,0.5547,0.82,99.4
2020-06-29,Punjab,620,5,619,7639,1620,1353,8.12,0,30.0,140658,1151,139810,5.4,4.51,0.2546333333333333,0.82,99.4
2020-06-30,Punjab,227,0,226,2782,4723,381,8.16,1,30.0,140885,1151,140036,15.74,1.27,0.09273333333333333,0.82,99.4
2020-07-01,Punjab,1078,3,1070,13544,2366,810,7.96,5,30.0,141963,1154,141106,7.89,2.7,0.4514666666666667,0.81,99.4
2020-07-02,Punjab,783,5,779,9793,109,44,8.0,0,30.0,142746,1159,141885,0.36,0.15,0.32643333333333335,0.81,99.4
2020-07-03,Punjab,1581,16,1574,19939,4787,1809,7.93,0,30.0,144327,1175,143459,15.96,6.03,0.6646333333333333,0.81,99.4
2020-07-04,Punjab,1278,6,1274,16170,4205,4060,7.9,0,30.0,145605,1181,144733,14.02,13.53,0.539,0.81,99.4
2020-07-05,Punjab,1291,18,1287,16197,1576,322,7.97,0,30.0,146896,1199,146020,5.25,1.07,0.5399,0.82,99.4
2020-07-06,Punjab,60,0,58,899,2853,1971,6.67,2,30.0,146956,1199,146078,9.51,6.57,0.029966666666666666,0.82,99.4
2020-07-07,Punjab,159,0,155,1875,17,11,8.48,4,30.0,147115,1199,146233,0.06,0.04,0.0625,0.82,99.4
2020-07-08,Punjab,580,6,578,7621,4282,2334,7.61,0,30.0,147695,1205,146811,14.27,7.78,0.25403333333333333,0.82,99.4
2020-07-09,Punjab,353,4,348,4355,1793,1698,8.11,1,30.0,148048,1209,147159,5.98,5.66,0.14516666666666667,0.82,99.4
2020-07-10,Punjab,1260,18,1260,16246,4836,4589,7.76,0,30.0,149308,1227,148419,16.12,15.3,0.5415333333333333,0.82,99.4
2020-07-11,Punjab,1334,5,1334,16358,1652,349,8.16,0,30.0,150642,1232,149753,5.51,1.16,0.5452666666666667,0.82,99.41
2020-07-12,Punjab,187,2,182,2581,958,220,7.25,3,30.0,150829,1234,149935,3.19,0.73,0.08603333333333334,0.82,99.41
2020-07-13,Punjab,119,0,118,1717,2878,2735,6.93,1,30.0,150948,1234,150053,9.59,9.12,0.05723333333333333,0.82,99.41
2020-07-14,Punjab,457,4,454,5825,2290,430,7.85,0,30.0,151405,1238,150507,7.63,1.43,0.19416666666666665,0.82,99.41
2020-07-15,Punjab,426,3,419,5525,3311,1053,7.71,4,30.0,151831,1241,150926,11.04,3.51,0.18416666666666667,0.82,99.4
2020-07-16,Punjab,1023,8,1021,12385,1940,282,8.26,0,30.0,152854,1249,151947,6.47,0.94,0.41283333333333333,0.82,99.41
2020-07-17,Punjab,1435,17,1433,17991,886,102,7.98,0,30.0,154289,1266,153380,2.95,0.34,0.5997,0.82,99.41
2020-07-18,Punjab,1245,7,1239,15622,3293,437,7.97,0,30.0,155534,1273,154619,10.98,1.46,0.5207333333333334,0.82,99.41
2020-07-19,Punjab,225,2,218,2497,2266,1131,9.01,5,30.0,155759,1275,154837,7.55,3.77,0.08323333333333334,0.82,99.41
2020-07-20,Punjab,1241,10,1240,15368,4094,989,8.08,0,30.0,157000,1285,156077,13.65,3.3,0.5122666666666666,0.82,99.41
2020-07-21,Punjab,674,2,669,8681,1814,470,7.76,3,30.0,157674,1287,156746,6.05,1.57,0.28936666666666666,0.82,99.41
2020-07-22,Punjab,1286,9,1284,16563,3655,2775,7.76,0,30.0,158960,1296,158030,12.18,9.25,0.5521,0.82,99.41
2020-07-23,Punjab,1493,4,1487,18512,249,95,8.07,2,30.0,160453,1300,159517,0.83,0.32,0.6170666666666667,0.81,99.42
2020-07-24,Punjab,888,8,886,10926,1571,583,8.13,0,30.0,161341,1308,160403,5.24,1.94,0.3642,0.81,99.42
2020-07-25,Punjab,715,6,713,9189,3465,2226,7.78,0,30.0,162056,1314,161116,11.55,7.42,0.3063,0.81,99.42
2020-07-26,Punjab,785,4,780,9545,3804,3116,8.22,1,30.0,162841,1318,161896,12.68,10.39,0.31816666666666665,0.81,99.42
2020-07-27,Punjab,695,6,694,8161,4530,2840,8.52,0,30.0,163536,1324,162590,15.1,9.47,0.27203333333333335,0.81,99.42
2020-07-28,Punjab,1555,10,1551,19624,4077,1385,7.92,0,30.0,165091,1334,164141,13.59,4.62,0.6541333333333333,0.81,99.42
2020-07-29,Punjab,763,10,759,9009,355,347,8.47,0,30.0,165854,1344,164900,1.18,1.16,0.3003,0.81,99.42
2020-07-30,Punjab,184,1,182,2295,2856,223,8.02,1,30.0,166038,1345,165082,9.52,0.74,0.0765,0.81,99.42
2020-07-31,Punjab,533,5,529,6528,4386,139,8.16,0,30.0,166571,1350,165611,14.62,0.46,0.2176,0.81,99.42
2020-08-01,Punjab,515,6,514,6703,2332,450,7.68,0,30.0,167086,1356,166125,7.77,1.5,0.22343333333333334,0.81,99.42
2020-08-02,Punjab,1475,6,1474,18342,2693,1094,8.04,0,30.0,168561,1362,167599,8.98,3.65,0.6114,0.81,99.43
2020-08-03,Punjab,550,6,545,6796,3218,853,8.09,0,30.0,169111,1368,168144,10.73,2.84,0.22653333333333334,0.81,99.43
2020-08-04,Punjab,438,4,435,5213,288,79,8.4,0,30.0,169549,1372,168579,0.96,0.26,0.17376666666666668,0.81,99.43
2020-08-05,Punjab,688,6,680,8332,3858,2278,8.26,2,30.0,170237,1378,169259,12.86,7.59,0.27773333333333333,0.81,99.43
2020-08-06,Punjab,1250,6,1243,15714,3408,2120,7.95,1,30.0,171487,1384,170502,11.36,7.07,0.5238,0.81,99.43
2020-08-07,Punjab,663,4,655,8684,4046,3877,7.63,4,30.0,172150,1388,171157,13.49,12.92,0.28946666666666665,0.81,99.42
2020-08-08,Punjab,625,2,624,7656,619,470,8.16,0,30.0,172775,1390,171781,2.06,1.57,0.2552,0.8,99.42
2020-08-09,Punjab,63,0,58,1070,1610,598,5.89,5,30.0,172838,1390,171839,5.37,1.99,0.035666666666666666,0.8,99.42
2020-08-10,Punjab,1306,13,1305,16463,4479,4313,7.93,0,30.0,174144,1403,173144,14.93,14.38,0.5487666666666666,0.81,99.43
2020-08-11,Punjab,950,4,949,11674,4727,3236,8.14,0,30.0,175094,1407,174093,15.76,10.79,0.38913333333333333,0.8,99.43
2020-08-12,Punjab,471,3,470,5957,4849,4738,7.91,0,30.0,175565,1410,174563,16.16,15.79,0.19856666666666667,0.8,99.43
2020-08-13,Punjab,1268,12,1267,16348,1297,107,7.76,0,30.0,176833,1422,175830,4.32,0.36,0.5449333333333334,0.8,99.43
2020-08-14,Punjab,185,2,181,2073,4519,809,8.92,2,30.0,177018,1424,176011,15.06,2.7,0.0691,0.8,99.43
2020-08-15,Punjab,880,4,871,11116,3288,1622,7.92,5,30.0,177898,1428,176882,10.96,5.41,0.3705333333333333,0.8,99.43
2020-08-16,Punjab,1451,5,1444,17794,1490,642,8.15,2,30.0,179349,1433,178326,4.97,2.14,0.5931333333333333,0.8,99.43
2020-08-17,Punjab,690,7,681,8752,12,1,7.88,2,30.0,180039,1440,179007,0.04,0.0,0.29173333333333334,0.8,99.43
2020-08-18,Punjab,1002,14,1001,12796,616,530,7.83,0,30.0,181041,1454,180008,2.05,1.77,0.4265333333333333,0.8,99.43
2020-08-19,Punjab,987,9,979,12548,4229,216,7.87,0,30.0,182028,1463,180987,14.1,0.72,0.4182666666666667,0.8,99.43
2020-08-20,Punjab,928,13,921,11553,2221,349,8.03,0,30.0,182956,1476,181908,7.4,1.16,0.3851,0.81,99.43
2020-08-21,Punjab,1206,17,1206,14622,61,0,8.25,0,30.0,184162,1493,183114,0.2,0.0,0.4874,0.81,99.43
2020-08-22,Punjab,1211,8,1206,14940,4143,3775,8.11,0,30.0,185373,1501,184320,13.81,12.58,0.498,0.81,99.43
2020-08-23,Punjab,1581,17,1576,19572,2863,1776,8.08,0,30.0,186954,1518,185896,9.54,5.92,0.6524,0.81,99.43
2020-08-24,Punjab,1622,11,1619,19786,2353,470,8.2,0,30.0,188576,1529,187515,7.84,1.57,0.6595333333333333,0.81,99.44
2020-08-25,Punjab,869,12,868,10666,846,443,8.15,0,30.0,189445,1541,188383,2.82,1.48,0.3555333333333333,0.81,99.44
2020-08-26,Punjab,1460,12,1451,18524,3506,1371,7.88,0,30.0,190905,1553,189834,11.69,4.57,0.6174666666666667,0.81,99.44
2020-08-27,Punjab,612,5,612,7621,1347,168,8.03,0,30.0,191517,1558,190446,4.49,0.56,0.25403333333333333,0.81,99.44
2020-08-28,Punjab,1530,6,1526,19433,4732,3083,7.87,0,30.0,193047,1564,191972,15.77,10.28,0.6477666666666667,0.81,99.44
2020-08-29,Punjab,806,11,801,10228,491,44,7.88,0,30.0,193853,1575,192773,1.64,0.15,0.3409333333333333,0.81,99.44
2020-08-30,Punjab,187,1,180,1901,3973,1403,9.84,6,30.0,194040,1576,192953,13.24,4.68,0.06336666666666667,0.81,99.44
2020-08-31,Punjab,789,11,781,10190,1447,284,7.74,0,30.0,194829,1587,193734,4.82,0.95,0.3396666666666667,0.81,99.44
2020-09-01,Punjab,769,10,760,9730,1202,861,7.9,0,30.0,195598,1597,194494,4.01,2.87,0.3243333333333333,0.82,99.44
2020-09-02,Punjab,1554,23,1545,19035,4022,1775,8.16,0,30.0,197152,1620,196039,13.41,5.92,0.6345,0.82,99.44
2020-09-03,Punjab,1516,18,1515,19047,2565,1556,7.96,0,30.0,198668,1638,197554,8.55,5.19,0.6349,0.82,99.44
2020-09-04,Punjab,308,3,307,4467,4464,1939,6.9,0,30.0,198976,1641,197861,14.88,6.46,0.1489,0.82,99.44
2020-09-05,Punjab,161,2,159,2062,4703,1254,7.81,0,30.0,199137,1643,198020,15.68,4.18,0.06873333333333333,0.83,99.44
2020-09-06,Punjab,540,1,531,6619,3865,1848,8.16,8,30.0,199677,1644,198551,12.88,6.16,0.22063333333333332,0.82,99.44
2020-09-07,Punjab,376,1,371,4647,873,1,8.09,4,30.0,200053,1645,198922,2.91,0.0,0.1549,0.82,99.43
2020-09-08,Punjab,945,7,945,12106,4384,3606,7.81,0,30.0,200998,1652,199867,14.61,12.02,0.40353333333333335,0.82,99.44
2020-09-09,Punjab,783,5,781,9709,3264,3100,8.06,0,30.0,201781,1657,200648,10.88,10.33,0.32363333333333333,0.82,99.44
2020-09-10,Punjab,1206,14,1205,15229,1446,129,7.92,0,30.0,202987,1671,201853,4.82,0.43,0.5076333333333334,0.82,99.44
2020-09-11,Punjab,1159,8,1150,14782,79,24,7.84,1,30.0,204146,1679,203003,0.26,0.08,0.49273333333333336,0.82,99.44
2020-09-12,Punjab,1403,11,1398,17271,1063,1030,8.12,0,30.0,205549,1690,204401,3.54,3.43,0.5757,0.82,99.44
2020-09-13,Punjab,99,1,93,1229,1104,530,8.06,5,30.0,205648,1691,204494,3.68,1.77,0.040966666666666665,0.82,99.44
2020-09-14,Punjab,1289,9,1281,15948,4992,4288,8.08,0,30.0,206937,1700,205775,16.64,14.29,0.5316,0.82,99.44
2020-09-15,Punjab,226,0,221,2688,4145,708,8.41,5,30.0,207163,1700,205996,13.82,2.36,0.0896,0.82,99.44
2020-09-16,Punjab,602,3,594,7016,4818,3815,8.58,5,30.0,207765,1703,206590,16.06,12.72,0.23386666666666667,0.82,99.43
2020-09-17,Punjab,479,5,474,6398,3944,2180,7.49,0,30.0,208244,1708,207064,13.15,7.27,0.21326666666666666,0.82,99.43
2020-09-18,Punjab,1130,15,1123,13809,767,489,8.18,0,30.0,209374,1723,208187,2.56,1.63,0.4603,0.82,99.43
2020-09-19,Punjab,665,6,661,8270,1958,92,8.04,0,30.0,210039,1729,208848,6.53,0.31,0.27566666666666667,0.82,99.43
2020-09-20,Punjab,925,3,921,11471,4839,2406,8.06,1,30.0,210964,1732,209769,16.13,8.02,0.3823666666666667,0.82,99.43
2020-09-21,Punjab,1590,9,1588,19889,2934,1522,7.99,0,30.0,212554,1741,211357,9.78,5.07,0.6629666666666667,0.82,99.44
2020-09-22,Punjab,1077,5,1077,13256,4810,2439,8.12,0,30.0,213631,1746,212434,16.03,8.13,0.4418666666666667,0.82,99.44
2020-09-23,Punjab,711,8,710,8919,2858,2388,7.97,0,30.0,214342,1754,213144,9.53,7.96,0.2973,0.82,99.44
2020-09-24,Punjab,258,2,251,3101,4388,1788,8.32,5,30.0,214600,1756,213395,14.63,5.96,0.10336666666666666,0.82,99.44
2020-09-25,Punjab,617,3,613,7818,3513,2130,7.89,1,30.0,215217,1759,214008,11.71,7.1,0.2606,0.82,99.44
2020-09-26,Punjab,559,6,556,6830,249,102,8.18,0,30.0,215776,1765,214564,0.83,0.34,0.22766666666666666,0.82,99.44
2020-09-27,Punjab,1132,11,1123,13578,1701,52,8.34,0,30.0,216908,1776,215687,5.67,0.17,0.4526,0.82,99.44
2020-09-28,Punjab,981,9,981,12707,1064,638,7.72,0,30.0,217889,1785,216668,3.55,2.13,0.42356666666666665,0.82,99.44
2020-09-29,Punjab,1265,11,1257,15779,2705,1894,8.02,0,30.0,219154,1796,217925,9.02,6.31,0.5259666666666667,0.82,99.44
2020-09-30,Punjab,1138,3,1131,14326,1702,1445,7.94,4,30.0,220292,1799,219056,5.67,4.82,0.4775333333333333,0.82,99.44
2020-10-01,Punjab,987,8,979,12215,2549,2359,8.08,0,30.0,221279,1807,220035,8.5,7.86,0.4071666666666667,0.82,99.44
2020-10-02,Punjab,1502,12,1493,18651,25,24,8.05,0,30.0,222781,1819,221528,0.08,0.08,0.6217,0.82,99.44
2020-10-03,Punjab,373,1,365,4596,3051,18,8.12,7,30.0,223154,1820,221893,10.17,0.06,0.1532,0.82,99.43
2020-10-04,Punjab,355,1,350,4087,3691,1390,8.69,4,30.0,223509,1821,222243,12.3,4.63,0.13623333333333335,0.81,99.43
2020-10-05,Punjab,209,0,201,2887,3208,63,7.24,8,30.0,223718,1821,222444,10.69,0.21,0.09623333333333334,0.81,99.43
2020-10-06,Punjab,598,7,596,7711,825,587,7.76,0,30.0,224316,1828,223040,2.75,1.96,0.25703333333333334,0.81,99.43
2020-10-07,Punjab,274,1,270,3517,1498,227,7.79,3,30.0,224590,1829,223310,4.99,0.76,0.11723333333333333,0.81,99.43
2020-10-08,Punjab,1618,11,1616,19710,4211,99,8.21,0,30.0,226208,1840,224926,14.04,0.33,0.657,0.81,99.43
2020-10-09,Punjab,152,0,149,1743,4427,2780,8.72,3,30.0,226360,1840,225075,14.76,9.27,0.0581,0.81,99.43
2020-10-10,Punjab,167,1,160,2378,2876,1082,7.02,6,30.0,226527,1841,225235,9.59,3.61,0.07926666666666667,0.81,99.43
2020-10-11,Punjab,637,7,634,8349,2959,2859,7.63,0,30.0,227164,1848,225869,9.86,9.53,0.2783,0.81,99.43
2020-10-12,Punjab,1067,14,1066,13703,1221,370,7.79,0,30.0,228231,1862,226935,4.07,1.23,0.45676666666666665,0.82,99.43
2020-10-13,Punjab,1620,19,1613,19993,2299,282,8.1,0,30.0,229851,1881,228548,7.66,0.94,0.6664333333333333,0.82,99.43
2020-10-14,Punjab,1579,8,1573,19307,1171,1117,8.18,0,30.0,231430,1889,230121,3.9,3.72,0.6435666666666666,0.82,99.43
2020-10-15,Punjab,693,5,684,8532,1290,603,8.12,4,30.0,232123,1894,230805,4.3,2.01,0.2844,0.82,99.43
2020-10-16,Punjab,1019,13,1017,12583,1894,521,8.1,0,30.0,233142,1907,231822,6.31,1.74,0.4194333333333333,0.82,99.43
2020-10-17,Punjab,1216,7,1212,14872,2726,526,8.18,0,30.0,234358,1914,233034,9.09,1.75,0.49573333333333336,0.82,99.44
2020-10-18,Punjab,1164,15,1159,14369,2515,870,8.1,0,30.0,235522,1929,234193,8.38,2.9,0.47896666666666665,0.82,99.44
2020-10-19,Punjab,992,8,983,12657,1824,989,7.84,1,30.0,236514,1937,235176,6.08,3.3,0.4219,0.82,99.43
2020-10-20,Punjab,1071,10,1062,13594,186,153,7.88,0,30.0,237585,1947,236238,0.62,0.51,0.45313333333333333,0.82,99.43
2020-10-21,Punjab,1115,4,1112,13843,4674,704,8.05,0,30.0,238700,1951,237350,15.58,2.35,0.4614333333333333,0.82,99.43
2020-10-22,Punjab,1054,5,1047,13358,3767,3123,7.89,2,30.0,239754,1956,238397,12.56,10.41,0.44526666666666664,0.82,99.43
2020-10-23,Punjab,154,1,154,2047,4030,1664,7.52,0,30.0,239908,1957,238551,13.43,5.55,0.06823333333333333,0.82,99.43
2020-10-24,Punjab,1193,4,1188,15151,2761,1598,7.87,1,30.0,241101,1961,239739,9.2,5.33,0.5050333333333333,0.81,99.44
2020-10-25,Punjab,83,0,78,1326,4242,1898,6.26,5,30.0,241184,1961,239817,14.14,6.33,0.0442,0.81,99.43
2020-10-26,Punjab,489,2,482,5692,1776,94,8.59,5,30.0,241673,1963,240299,5.92,0.31,0.18973333333333334,0.81,99.43
2020-10-27,Punjab,67,0,63,752,3699,1221,8.91,4,30.0,241740,1963,240362,12.33,4.07,0.025066666666666668,0.81,99.43
2020-10-28,Punjab,687,3,685,8825,2663,1324,7.78,0,30.0,242427,1966,241047,8.88,4.41,0.2941666666666667,0.81,99.43
2020-10-29,Punjab,393,3,390,5051,4207,3722,7.78,0,30.0,242820,1969,241437,14.02,12.41,0.16836666666666666,0.81,99.43
2020-10-30,Punjab,388,4,379,4723,3285,791,8.22,5,30.0,243208,1973,241816,10.95,2.64,0.15743333333333334,0.81,99.43
2020-10-31,Punjab,117,0,117,1646,325,49,7.11,0,30.0,243325,1973,241933,1.08,0.16,0.05486666666666667,0.81,99.43
2020-11-01,Punjab,880,3,876,10603,3701,3139,8.3,1,30.0,244205,1976,242809,12.34,10.46,0.3534333333333333,0.81,99.43
2020-11-02,Punjab,1137,14,1135,14210,3979,237,8.0,0,30.0,245342,1990,243944,13.26,0.79,0.4736666666666667,0.81,99.43
2020-11-03,Punjab,901,7,899,11383,3254,3155,7.92,0,30.0,246243,1997,244843,10.85,10.52,0.37943333333333334,0.81,99.43
2020-11-04,Punjab,1537,6,1536,19205,3735,3091,8.0,0,30.0,247780,2003,246379,12.45,10.3,0.6401666666666667,0.81,99.43
2020-11-05,Punjab,1117,3,1113,13899,41,9,8.04,1,30.0,248897,2006,247492,0.14,0.03,0.4633,0.81,99.44
2020-11-06,Punjab,755,8,753,9076,2542,733,8.32,0,30.0,249652,2014,248245,8.47,2.44,0.3025333333333333,0.81,99.44
2020-11-07,Punjab,674,9,670,8382,4993,4898,8.04,0,30.0,250326,2023,248915,16.64,16.33,0.2794,0.81,99.44
2020-11-08,Punjab,953,9,945,12085,2261,2063,7.89,0,30.0,251279,2032,249860,7.54,6.88,0.4028333333333333,0.81,99.44
2020-11-09,Punjab,808,11,800,10400,3461,3156,7.77,0,30.0,252087,2043,250660,11.54,10.52,0.3466666666666667,0.81,99.43
2020-11-10,Punjab,964,6,955,11976,3376,2865,8.05,3,30.0,253051,2049,251615,11.25,9.55,0.3992,0.81,99.43
2020-11-11,Punjab,455,5,448,5695,4233,791,7.99,2,30.0,253506,2054,252063,14.11,2.64,0.18983333333333333,0.81,99.43
2020-11-12,Punjab,1415,4,1411,18268,3996,2092,7.75,0,30.0,254921,2058,253474,13.32,6.97,0.6089333333333333,0.81,99.43
2020-11-13,Punjab,717,4,713,8807,3667,3231,8.14,0,30.0,255638,2062,254187,12.22,10.77,0.29356666666666664,0.81,99.43
2020-11-14,Punjab,1116,13,1107,13944,4073,153,8.0,0,30.0,256754,2075,255294,13.58,0.51,0.4648,0.81,99.43
2020-11-15,Punjab,130,0,122,1537,3092,1769,8.46,8,30.0,256884,2075,255416,10.31,5.9,0.05123333333333333,0.81,99.43
2020-11-16,Punjab,123,0,123,1532,1876,330,8.03,0,30.0,257007,2075,255539,6.25,1.1,0.05106666666666667,0.81,99.43
2020-11-17,Punjab,610,2,603,7726,2807,1088,7.9,5,30.0,257617,2077,256142,9.36,3.63,0.25753333333333334,0.81,99.43
2020-11-18,Punjab,58,0,58,608,654,405,9.54,0,30.0,257675,2077,256200,2.18,1.35,0.020266666666666665,0.81,99.43
2020-11-19,Punjab,1450,6,1443,18612,4107,2250,7.79,1,30.0,259125,2083,257643,13.69,7.5,0.6204,0.8,99.43
2020-11-20,Punjab,1531,19,1526,19316,4346,76,7.93,0,30.0,260656,2102,259169,14.49,0.25,0.6438666666666667,0.81,99.43
2020-11-21,Punjab,1450,19,1447,18023,2095,1940,8.05,0,30.0,262106,2121,260616,6.98,6.47,0.6007666666666667,0.81,99.43
2020-11-22,Punjab,1405,16,1404,17487,1121,90,8.03,0,30.0,263511,2137,262020,3.74,0.3,0.5829,0.81,99.43
2020-11-23,Punjab,1608,21,1602,19926,1435,486,8.07,0,30.0,265119,2158,263622,4.78,1.62,0.6642,0.81,99.44
2020-11-24,Punjab,304,2,299,3434,157,127,8.85,3,30.0,265423,2160,263921,0.52,0.42,0.11446666666666666,0.81,99.43
2020-11-25,Punjab,1379,8,1376,17579,4905,2157,7.84,0,30.0,266802,2168,265297,16.35,7.19,0.5859666666666666,0.81,99.44
2020-11-26,Punjab,1250,8,1249,15808,2203,986,7.91,0,30.0,268052,2176,266546,7.34,3.29,0.5269333333333334,0.81,99.44
2020-11-27,Punjab,581,2,580,7167,2916,1320,8.11,0,30.0,268633,2178,267126,9.72,4.4,0.2389,0.81,99.44
2020-11-28,Punjab,1104,9,1098,13650,4073,1511,8.09,0,30.0,269737,2187,268224,13.58,5.04,0.455,0.81,99.44
2020-11-29,Punjab,1139,5,1130,14144,1555,226,8.05,4,30.0,270876,2192,269354,5.18,0.75,0.47146666666666665,0.81,99.44
2020-11-30,Punjab,266,3,262,3353,4980,2299,7.93,1,30.0,271142,2195,269616,16.6,7.66,0.11176666666666667,0.81,99.44
2020-12-01,Punjab,827,10,826,10388,1540,928,7.96,0,30.0,271969,2205,270442,5.13,3.09,0.34626666666666667,0.81,99.44
2020-12-02,Punjab,743,10,736,9187,3512,888,8.09,0,30.0,272712,2215,271178,11.71,2.96,0.30623333333333336,0.81,99.44
2020-12-03,Punjab,1385,12,1378,17191,2978,1611,8.06,0,30.0,274097,2227,272556,9.93,5.37,0.5730333333333333,0.81,99.44
2020-12-04,Punjab,529,6,527,6801,3496,210,7.78,0,30.0,274626,2233,273083,11.65,0.7,0.2267,0.81,99.44
2020-12-05,Punjab,1373,9,1368,16943,4826,3448,8.1,0,30.0,275999,2242,274451,16.09,11.49,0.5647666666666666,0.81,99.44
2020-12-06,Punjab,234,3,234,2554,2582,141,9.16,0,30.0,276233,2245,274685,8.61,0.47,0.08513333333333334,0.81,99.44
2020-12-07,Punjab,789,2,782,9804,1628,861,8.05,5,30.0,277022,2247,275467,5.43,2.87,0.3268,0.81,99.44
2020-12-08,Punjab,1155,10,1151,14585,2391,2280,7.92,0,30.0,278177,2257,276618,7.97,7.6,0.4861666666666667,0.81,99.44
2020-12-09,Punjab,746,6,737,8926,158,91,8.36,3,30.0,278923,2263,277355,0.53,0.3,0.2975333333333333,0.81,99.44
2020-12-10,Punjab,542,4,536,7111,1930,443,7.62,2,30.0,279465,2267,277891,6.43,1.48,0.23703333333333335,0.81,99.44
2020-12-11,Punjab,1345,17,1343,17191,4502,638,7.82,0,30.0,280810,2284,279234,15.01,2.13,0.5730333333333333,0.81,99.44
2020-12-12,Punjab,67,0,65,855,79,35,7.84,2,30.0,280877,2284,279299,0.26,0.12,0.0285,0.81,99.44
2020-12-13,Punjab,90,0,88,1163,3873,3557,7.74,2,30.0,280967,2284,279387,12.91,11.86,0.038766666666666665,0.81,99.44
2020-12-14,Punjab,356,5,355,4657,2696,1006,7.64,0,30.0,281323,2289,279742,8.99,3.35,0.15523333333333333,0.81,99.44
2020-12-15,Punjab,921,12,917,11800,4807,4084,7.81,0,30.0,282244,2301,280659,16.02,13.61,0.3933333333333333,0.82,99.44
2020-12-16,Punjab,1254,7,1252,16065,584,536,7.81,0,30.0,283498,2308,281911,1.95,1.79,0.5355,0.81,99.44
2020-12-17,Punjab,1029,9,1026,13009,3813,582,7.91,0,30.0,284527,2317,282937,12.71,1.94,0.4336333333333333,0.81,99.44
2020-12-18,Punjab,367,3,367,4400,4818,474,8.34,0,30.0,284894,2320,283304,16.06,1.58,0.14666666666666667,0.81,99.44
2020-12-19,Punjab,987,6,985,12143,1184,878,8.13,0,30.0,285881,2326,284289,3.95,2.93,0.40476666666666666,0.81,99.44
2020-12-20,Punjab,1142,7,1141,14380,4438,3627,7.94,0,30.0,287023,2333,285430,14.79,12.09,0.47933333333333333,0.81,99.44
2020-12-21,Punjab,836,5,827,10668,4718,3091,7.84,4,30.0,287859,2338,286257,15.73,10.3,0.3556,0.81,99.44
2020-12-22,Punjab,1023,9,1021,12386,3549,209,8.26,0,30.0,288882,2347,287278,11.83,0.7,0.41286666666666666,0.81,99.44
2020-12-23,Punjab,650,6,646,8010,1098,463,8.11,0,30.0,289532,2353,287924,3.66,1.54,0.267,0.81,99.44
2020-12-24,Punjab,1289,4,1289,15780,1393,1302,8.17,0,30.0,290821,2357,289213,4.64,4.34,0.526,0.81,99.45
2020-12-25,Punjab,659,2,650,8285,2809,2605,7.95,7,30.0,291480,2359,289863,9.36,8.68,0.27616666666666667,0.81,99.45
2020-12-26,Punjab,219,1,219,3039,174,104,7.21,0,30.0,291699,2360,290082,0.58,0.35,0.1013,0.81,99.45
2020-12-27,Punjab,364,2,363,4485,2568,2334,8.12,0,30.0,292063,2362,290445,8.56,7.78,0.1495,0.81,99.45
2020-12-28,Punjab,1287,5,1283,15904,1963,1813,8.09,0,30.0,293350,2367,291728,6.54,6.04,0.5301333333333333,0.81,99.45
2020-12-29,Punjab,1188,11,1182,14758,4386,3885,8.05,0,30.0,294538,2378,292910,14.62,12.95,0.49193333333333333,0.81,99.45
2020-12-30,Punjab,890,3,886,11132,3542,2896,7.99,1,30.0,295428,2381,293796,11.81,9.65,0.37106666666666666,0.81,99.45
2020-12-31,Punjab,321,3,320,4049,1760,1648,7.93,0,30.0,295749,2384,294116,5.87,5.49,0.13496666666666668,0.81,99.45
2021-01-01,Punjab,1051,11,1046,13084,88,22,8.03,0,30.0,296800,2395,295162,0.29,0.07,0.4361333333333333,0.81,99.45
2021-01-02,Punjab,1546,15,1543,19600,4407,39,7.89,0,30.0,298346,2410,296705,14.69,0.13,0.6533333333333333,0.81,99.45
2021-01-03,Punjab,1581,7,1575,19448,1763,1730,8.13,0,30.0,299927,2417,298280,5.88,5.77,0.6482666666666667,0.81,99.45
2021-01-04,Punjab,357,3,349,4493,4612,4375,7.95,5,30.0,300284,2420,298629,15.37,14.58,0.14976666666666666,0.81,99.45
2021-01-05,Punjab,175,1,166,2408,230,29,7.27,8,30.0,300459,2421,298795,0.77,0.1,0.08026666666666667,0.81,99.45
2021-01-06,Punjab,1057,9,1056,13444,3327,1339,7.86,0,30.0,301516,2430,299851,11.09,4.46,0.44813333333333333,0.81,99.45
2021-01-07,Punjab,561,6,553,6889,2998,174,8.14,2,30.0,302077,2436,300404,9.99,0.58,0.22963333333333333,0.81,99.45
2021-01-08,Punjab,805,10,798,10293,614,291,7.82,0,30.0,302882,2446,301202,2.05,0.97,0.3431,0.81,99.45
2021-01-09,Punjab,1174,10,1165,14228,192,142,8.25,0,30.0,304056,2456,302367,0.64,0.47,0.47426666666666667,0.81,99.44
2021-01-10,Punjab,156,0,152,1661,320,207,9.39,4,30.0,304212,2456,302519,1.07,0.69,0.05536666666666667,0.81,99.44
2021-01-11,Punjab,1343,15,1339,16728,3315,183,8.03,0,30.0,305555,2471,303858,11.05,0.61,0.5576,0.81,99.44
2021-01-12,Punjab,102,1,93,1654,1982,1352,6.17,8,30.0,305657,2472,303951,6.61,4.51,0.05513333333333333,0.81,99.44
2021-01-13,Punjab,717,3,717,9008,3542,1724,7.96,0,30.0,306374,2475,304668,11.81,5.75,0.3002666666666667,0.81,99.44
2021-01-14,Punjab,867,2,867,10843,373,107,8.0,0,30.0,307241,2477,305535,1.24,0.36,0.36143333333333333,0.81,99.44
2021-01-15,Punjab,1551,9,1550,19608,1235,721,7.91,0,30.0,308792,2486,307085,4.12,2.4,0.6536,0.81,99.45
2021-01-16,Punjab,1177,12,1168,14785,3308,875,7.96,0,30.0,309969,2498,308253,11.03,2.92,0.49283333333333335,0.81,99.45
2021-01-17,Punjab,1005,6,999,12636,1451,862,7.95,0,30.0,310974,2504,309252,4.84,2.87,0.4212,0.81,99.45
2021-01-18,Punjab,364,2,359,4450,2882,1275,8.18,3,30.0,311338,2506,309611,9.61,4.25,0.14833333333333334,0.8,99.45
2021-01-19,Punjab,317,1,309,3973,1213,962,7.98,7,30.0,311655,2507,309920,4.04,3.21,0.13243333333333332,0.8,99.44
2021-01-20,Punjab,1427,16,1425,17522,3060,2584,8.14,0,30.0,313082,2523,311345,10.2,8.61,0.5840666666666666,0.81,99.45
2021-01-21,Punjab,570,6,568,7535,4553,3815,7.56,0,30.0,313652,2529,311913,15.18,12.72,0.25116666666666665,0.81,99.45
2021-01-22,Punjab,1195,11,1195,14749,2116,751,8.1,0,30.0,314847,2540,313108,7.05,2.5,0.4916333333333333,0.81,99.45
2021-01-23,Punjab,1231,9,1225,15853,4476,3340,7.77,0,30.0,316078,2549,314333,14.92,11.13,0.5284333333333333,0.81,99.45
2021-01-24,Punjab,79,1,70,862,2123,1013,9.16,8,30.0,316157,2550,314403,7.08,3.38,0.028733333333333333,0.81,99.45
2021-01-25,Punjab,1353,6,1348,16936,2718,2311,7.99,0,30.0,317510,2556,315751,9.06,7.7,0.5645333333333333,0.81,99.45
2021-01-26,Punjab,954,12,949,11741,3316,1301,8.13,0,30.0,318464,2568,316700,11.05,4.34,0.39136666666666664,0.81,99.45
2021-01-27,Punjab,1268,6,1266,16297,3694,1639,7.78,0,30.0,319732,2574,317966,12.31,5.46,0.5432333333333333,0.81,99.45
2021-01-28,Punjab,1600,8,1600,19863,1440,854,8.06,0,30.0,321332,2582,319566,4.8,2.85,0.6621,0.8,99.45
2021-01-29,Punjab,293,3,290,3682,1471,1350,7.96,0,30.0,321625,2585,319856,4.9,4.5,0.12273333333333333,0.8,99.45
2021-01-30,Punjab,1132,8,1126,14261,643,450,7.94,0,30.0,322757,2593,320982,2.14,1.5,0.47536666666666666,0.8,99.45
2021-01-31,Punjab,1548,16,1540,19447,2253,1522,7.96,0,30.0,324305,2609,322522,7.51,5.07,0.6482333333333333,0.8,99.45
2021-02-01,Punjab,88,1,88,1164,4251,249,7.56,0,30.0,324393,2610,322610,14.17,0.83,0.0388,0.8,99.45
2021-02-02,Punjab,904,8,896,11216,4855,4542,8.06,0,30.0,325297,2618,323506,16.18,15.14,0.3738666666666667,0.8,99.45
2021-02-03,Punjab,167,1,164,2359,869,423,7.08,2,30.0,325464,2619,323670,2.9,1.41,0.07863333333333333,0.8,99.45
2021-02-04,Punjab,1642,14,1639,19780,2612,915,8.3,0,30.0,327106,2633,325309,8.71,3.05,0.6593333333333333,0.8,99.45
2021-02-05,Punjab,949,7,949,11485,4812,2239,8.26,0,30.0,328055,2640,326258,16.04,7.46,0.38283333333333336,0.8,99.45
2021-02-06,Punjab,1048,14,1042,13131,3689,731,7.98,0,30.0,329103,2654,327300,12.3,2.44,0.4377,0.81,99.45
2021-02-07,Punjab,532,5,527,6777,2389,1495,7.85,0,30.0,329635,2659,327827,7.96,4.98,0.2259,0.81,99.45
2021-02-08,Punjab,1138,16,1131,14252,1194,677,7.98,0,30.0,330773,2675,328958,3.98,2.26,0.4750666666666667,0.81,99.45
2021-02-09,Punjab,837,5,831,10496,4661,3806,7.97,1,30.0,331610,2680,329789,15.54,12.69,0.34986666666666666,0.81,99.45
2021-02-10,Punjab,549,4,548,7219,903,639,7.6,0,30.0,332159,2684,330337,3.01,2.13,0.24063333333333334,0.81,99.45
2021-02-11,Punjab,1460,15,1460,18279,971,592,7.99,0,30.0,333619,2699,331797,3.24,1.97,0.6093,0.81,99.45
2021-02-12,Punjab,1208,14,1199,15429,917,711,7.83,0,30.0,334827,2713,332996,3.06,2.37,0.5143,0.81,99.45
2021-02-13,Punjab,68,1,64,888,3004,571,7.66,3,30.0,334895,2714,333060,10.01,1.9,0.0296,0.81,99.45
2021-02-14,Punjab,194,1,194,2711,2647,2550,7.16,0,30.0,335089,2715,333254,8.82,8.5,0.09036666666666666,0.81,99.45
2021-02-15,Punjab,1190,15,1190,14917,2419,2393,7.98,0,30.0,336279,2730,334444,8.06,7.98,0.49723333333333336,0.81,99.45
2021-02-16,Punjab,987,13,986,12909,4174,881,7.65,0,30.0,337266,2743,335430,13.91,2.94,0.4303,0.81,99.46
2021-02-17,Punjab,152,2,145,1921,2359,654,7.91,5,30.0,337418,2745,335575,7.86,2.18,0.06403333333333333,0.81,99.45
2021-02-18,Punjab,560,2,558,6892,4734,2260,8.13,0,30.0,337978,2747,336133,15.78,7.53,0.22973333333333334,0.81,99.45
2021-02-19,Punjab,485,2,477,5817,525,23,8.34,6,30.0,338463,2749,336610,1.75,0.08,0.1939,0.81,99.45
2021-02-20,Punjab,184,2,184,2436,1646,254,7.55,0,30.0,338647,2751,336794,5.49,0.85,0.0812,0.81,99.45
2021-02-21,Punjab,1382,20,1373,17466,298,105,7.91,0,30.0,340029,2771,338167,0.99,0.35,0.5822,0.81,99.45
2021-02-22,Punjab,1133,8,1127,14286,154,145,7.93,0,30.0,341162,2779,339294,0.51,0.48,0.4762,0.81,99.45
2021-02-23,Punjab,322,4,316,3995,4466,2114,8.06,2,30.0,341484,2783,339610,14.89,7.05,0.13316666666666666,0.81,99.45
2021-02-24,Punjab,1253,17,1245,15634,2129,1235,8.01,0,30.0,342737,2800,340855,7.1,4.12,0.5211333333333333,0.82,99.45
2021-02-25,Punjab,1089,15,1089,13235,1668,66,8.23,0,30.0,343826,2815,341944,5.56,0.22,0.44116666666666665,0.82,99.45
2021-02-26,Punjab,861,12,852,10441,2465,898,8.25,0,30.0,344687,2827,342796,8.22,2.99,0.3480333333333333,0.82,99.45
2021-02-27,Punjab,1506,12,1497,18990,1029,294,7.93,0,30.0,346193,2839,344293,3.43,0.98,0.633,0.82,99.45
2021-02-28,Punjab,88,1,88,984,388,344,8.94,0,30.0,346281,2840,344381,1.29,1.15,0.0328,0.82,99.45
2021-03-01,Punjab,762,5,760,9618,3058,3031,7.92,0,30.0,347043,2845,345141,10.19,10.1,0.3206,0.82,99.45
2021-03-02,Punjab,354,4,348,4457,3218,2225,7.94,2,30.0,347397,2849,345489,10.73,7.42,0.14856666666666668,0.82,99.45
2021-03-03,Punjab,1472,6,1472,18738,2629,539,7.86,0,30.0,348869,2855,346961,8.76,1.8,0.6246,0.82,99.45
2021-03-04,Punjab,140,1,137,1688,2882,1893,8.29,2,30.0,349009,2856,347098,9.61,6.31,0.056266666666666666,0.82,99.45
2021-03-05,Punjab,415,4,406,4867,1504,1224,8.53,5,30.0,349424,2860,347504,5.01,4.08,0.16223333333333334,0.82,99.45
2021-03-06,Punjab,71,1,65,1286,4946,3805,5.52,5,30.0,349495,2861,347569,16.49,12.68,0.042866666666666664,0.82,99.45
2021-03-07,Punjab,1362,8,1359,17040,3755,3488,7.99,0,30.0,350857,2869,348928,12.52,11.63,0.568,0.82,99.45
2021-03-08,Punjab,1358,18,1352,17463,569,137,7.78,0,30.0,352215,2887,350280,1.9,0.46,0.5821,0.82,99.45
2021-03-09,Punjab,52,0,52,875,3359,3119,5.94,0,30.0,352267,2887,350332,11.2,10.4,0.029166666666666667,0.82,99.45
2021-03-10,Punjab,1514,6,1512,19079,3266,2221,7.94,0,30.0,353781,2893,351844,10.89,7.4,0.6359666666666667,0.82,99.45
2021-03-11,Punjab,339,3,337,4170,1551,643,8.13,0,30.0,354120,2896,352181,5.17,2.14,0.139,0.82,99.45
2021-03-12,Punjab,161,1,154,1594,1748,557,10.1,6,30.0,354281,2897,352335,5.83,1.86,0.05313333333333333,0.82,99.45
2021-03-13,Punjab,875,7,870,10422,4190,3487,8.4,0,30.0,355156,2904,353205,13.97,11.62,0.3474,0.82,99.45
2021-03-14,Punjab,658,3,649,8390,1876,212,7.84,6,30.0,355814,2907,353854,6.25,0.71,0.2796666666666667,0.82,99.45
2021-03-15,Punjab,1147,10,1141,14070,1569,9,8.15,0,30.0,356961,2917,354995,5.23,0.03,0.469,0.82,99.45
2021-03-16,Punjab,1590,8,1588,19886,1788,270,8.0,0,30.0,358551,2925,356583,5.96,0.9,0.6628666666666667,0.82,99.45
2021-03-17,Punjab,1435,4,1435,18125,3756,2401,7.92,0,30.0,359986,2929,358018,12.52,8.0,0.6041666666666666,0.81,99.45
2021-03-18,Punjab,242,2,240,3034,252,156,7.98,0,30.0,360228,2931,358258,0.84,0.52,0.10113333333333334,0.81,99.45
2021-03-19,Punjab,555,2,546,6550,2493,1783,8.47,7,30.0,360783,2933,358804,8.31,5.94,0.21833333333333332,0.81,99.45
2021-03-20,Punjab,1165,9,1161,14605,4983,4941,7.98,0,30.0,361948,2942,359965,16.61,16.47,0.48683333333333334,0.81,99.45
2021-03-21,Punjab,1009,8,1008,12442,3268,3121,8.11,0,30.0,362957,2950,360973,10.89,10.4,0.41473333333333334,0.81,99.45
2021-03-22,Punjab,1332,4,1328,16680,2446,1739,7.99,0,30.0,364289,2954,362301,8.15,5.8,0.556,0.81,99.45
2021-03-23,Punjab,870,9,867,10843,4353,2944,8.02,0,30.0,365159,2963,363168,14.51,9.81,0.36143333333333333,0.81,99.45
2021-03-24,Punjab,1009,14,1008,13041,144,74,7.74,0,30.0,366168,2977,364176,0.48,0.25,0.4347,0.81,99.46
2021-03-25,Punjab,386,5,385,4718,4697,2628,8.18,0,30.0,366554,2982,364561,15.66,8.76,0.15726666666666667,0.81,99.46
2021-03-26,Punjab,246,3,241,2992,2663,52,8.22,2,30.0,366800,2985,364802,8.88,0.17,0.09973333333333333,0.81,99.46
2021-03-27,Punjab,1042,15,1040,13268,4318,857,7.85,0,30.0,367842,3000,365842,14.39,2.86,0.44226666666666664,0.82,99.46
2021-03-28,Punjab,1277,5,1275,16014,486,260,7.97,0,30.0,369119,3005,367117,1.62,0.87,0.5338,0.81,99.46
2021-03-29,Punjab,1552,11,1545,19745,1282,1177,7.86,0,30.0,370671,3016,368662,4.27,3.92,0.6581666666666667,0.81,99.46
2021-03-30,Punjab,602,2,597,7793,401,29,7.72,3,30.0,371273,3018,369259,1.34,0.1,0.25976666666666665,0.81,99.46
2021-03-31,Punjab,1073,3,1073,13187,1023,826,8.14,0,30.0,372346,3021,370332,3.41,2.75,0.43956666666666666,0.81,99.46
2021-04-01,Punjab,1285,11,1284,16087,4328,619,7.99,0,30.0,373631,3032,371616,14.43,2.06,0.5362333333333333,0.81,99.46
2021-04-02,Punjab,1000,3,993,12835,1835,836,7.79,4,30.0,374631,3035,372609,6.12,2.79,0.42783333333333334,0.81,99.46
2021-04-03,Punjab,1080,15,1077,13572,3348,1515,7.96,0,30.0,375711,3050,373686,11.16,5.05,0.4524,0.81,99.46
2021-04-04,Punjab,1196,8,1194,14802,3838,2074,8.08,0,30.0,376907,3058,374880,12.79,6.91,0.4934,0.81,99.46
2021-04-05,Punjab,458,4,450,5762,4773,3356,7.95,4,30.0,377365,3062,375330,15.91,11.19,0.19206666666666666,0.81,99.46
2021-04-06,Punjab,60,0,59,684,2968,2300,8.77,1,30.0,377425,3062,375389,9.89,7.67,0.0228,0.81,99.46
2021-04-07,Punjab,625,8,625,7701,411,205,8.12,0,30.0,378050,3070,376014,1.37,0.68,0.2567,0.81,99.46
2021-04-08,Punjab,1259,4,1251,15744,1341,551,8.0,4,30.0,379309,3074,377265,4.47,1.84,0.5248,0.81,99.46
2021-04-09,Punjab,1138,10,1131,14272,4538,4021,7.97,0,30.0,380447,3084,378396,15.13,13.4,0.47573333333333334,0.81,99.46
2021-04-10,Punjab,543,4,534,6867,2914,1305,7.91,5,30.0,380990,3088,378930,9.71,4.35,0.2289,0.81,99.46
2021-04-11,Punjab,1130,12,1125,14484,2934,2611,7.8,0,30.0,382120,3100,380055,9.78,8.7,0.4828,0.81,99.46
2021-04-12,Punjab,1250,12,1248,15714,2454,2285,7.95,0,30.0,383370,3112,381303,8.18,7.62,0.5238,0.81,99.46
2021-04-13,Punjab,1544,13,1538,19059,3465,2247,8.1,0,30.0,384914,3125,382841,11.55,7.49,0.6353,0.81,99.46
2021-04-14,Punjab,937,10,934,11770,4304,954,7.96,0,30.0,385851,3135,383775,14.35,3.18,0.3923333333333333,0.81,99.46
2021-04-15,Punjab,1050,7,1050,13414,2,0,7.83,0,30.0,386901,3142,384825,0.01,0.0,0.4471333333333333,0.81,99.46
2021-04-16,Punjab,286,3,286,2598,1660,499,11.01,0,30.0,387187,3145,385111,5.53,1.66,0.0866,0.81,99.46
2021-04-17,Punjab,963,10,962,12496,614,544,7.71,0,30.0,388150,3155,386073,2.05,1.81,0.4165333333333333,0.81,99.46
2021-04-18,Punjab,1187,6,1184,14516,2559,1462,8.18,0,30.0,389337,3161,387257,8.53,4.87,0.48386666666666667,0.81,99.47
2021-04-19,Punjab,1269,16,1264,15739,484,314,8.06,0,30.0,390606,3177,388521,1.61,1.05,0.5246333333333333,0.81,99.47
2021-04-20,Punjab,542,6,536,6491,4790,944,8.35,0,30.0,391148,3183,389057,15.97,3.15,0.21636666666666668,0.81,99.47
2021-04-21,Punjab,1065,12,1058,13533,495,477,7.87,0,30.0,392213,3195,390115,1.65,1.59,0.4511,0.81,99.47
2021-04-22,Punjab,940,3,939,11822,4699,533,7.95,0,30.0,393153,3198,391054,15.66,1.78,0.3940666666666667,0.81,99.47
2021-04-23,Punjab,921,10,917,11336,1679,708,8.12,0,30.0,394074,3208,391971,5.6,2.36,0.3778666666666667,0.81,99.47
2021-04-24,Punjab,1436,13,1436,18090,2590,846,7.94,0,30.0,395510,3221,393407,8.63,2.82,0.603,0.81,99.47
2021-04-25,Punjab,357,3,352,4293,1173,911,8.32,2,30.0,395867,3224,393759,3.91,3.04,0.1431,0.81,99.47
2021-04-26,Punjab,514,2,514,6425,4869,759,8.0,0,30.0,396381,3226,394273,16.23,2.53,0.21416666666666667,0.81,99.47
2021-04-27,Punjab,1391,6,1390,17156,3891,3086,8.11,0,30.0,397772,3232,395663,12.97,10.29,0.5718666666666666,0.81,99.47
2021-04-28,Punjab,673,7,669,8307,454,432,8.1,0,30.0,398445,3239,396332,1.51,1.44,0.2769,0.81,99.47
2021-04-29,Punjab,1294,11,1293,16154,1625,1120,8.01,0,30.0,399739,3250,397625,5.42,3.73,0.5384666666666666,0.81,99.47
2021-04-30,Punjab,1602,22,1594,19946,3809,1422,8.03,0,30.0,401341,3272,399219,12.7,4.74,0.6648666666666667,0.82,99.47
2021-05-01,Punjab,636,5,632,8341,2649,1921,7.62,0,30.0,401977,3277,399851,8.83,6.4,0.27803333333333335,0.82,99.47
2021-05-02,Punjab,274,3,269,3419,35,12,8.01,2,30.0,402251,3280,400120,0.12,0.04,0.11396666666666666,0.82,99.47
2021-05-03,Punjab,99,0,99,1076,1302,194,9.2,0,30.0,402350,3280,400219,4.34,0.65,0.035866666666666665,0.82,99.47
2021-05-04,Punjab,503,5,497,5998,2683,2450,8.39,1,30.0,402853,3285,400716,8.94,8.17,0.19993333333333332,0.82,99.47
2021-05-05,Punjab,347,3,340,4631,1035,1018,7.49,4,30.0,403200,3288,401056,3.45,3.39,0.15436666666666668,0.82,99.47
2021-05-06,Punjab,1245,17,1239,15649,2865,1939,7.96,0,30.0,404445,3305,402295,9.55,6.46,0.5216333333333333,0.82,99.47
2021-05-07,Punjab,351,4,348,4366,833,542,8.04,0,30.0,404796,3309,402643,2.78,1.81,0.14553333333333332,0.82,99.47
2021-05-08,Punjab,905,5,896,11782,3542,430,7.68,4,30.0,405701,3314,403539,11.81,1.43,0.3927333333333333,0.82,99.47
2021-05-09,Punjab,1187,14,1181,15131,3829,1045,7.84,0,30.0,406888,3328,404720,12.76,3.48,0.5043666666666666,0.82,99.47
2021-05-10,Punjab,179,1,173,1888,370,299,9.48,5,30.0,407067,3329,404893,1.23,1.0,0.06293333333333333,0.82,99.47
2021-05-11,Punjab,1459,5,1454,18090,459,95,8.07,0,30.0,408526,3334,406347,1.53,0.32,0.603,0.82,99.47
2021-05-12,Punjab,1295,12,1288,16175,3254,1103,8.01,0,30.0,409821,3346,407635,10.85,3.68,0.5391666666666667,0.82,99.47
2021-05-13,Punjab,75,1,66,772,1689,233,9.72,8,30.0,409896,3347,407701,5.63,0.78,0.025733333333333334,0.82,99.46
2021-05-14,Punjab,1136,15,1130,13813,2895,2384,8.22,0,30.0,411032,3362,408831,9.65,7.95,0.4604333333333333,0.82,99.46
2021-05-15,Punjab,743,10,742,8598,4186,2291,8.64,0,30.0,411775,3372,409573,13.95,7.64,0.2866,0.82,99.47
2021-05-16,Punjab,941,5,940,12022,2425,1919,7.83,0,30.0,412716,3377,410513,8.08,6.4,0.40073333333333333,0.82,99.47
2021-05-17,Punjab,126,1,124,1504,1261,198,8.38,1,30.0,412842,3378,410637,4.2,0.66,0.050133333333333335,0.82,99.47
2021-05-18,Punjab,657,6,657,8011,4677,1306,8.2,0,30.0,413499,3384,411294,15.59,4.35,0.26703333333333334,0.82,99.47
2021-05-19,Punjab,987,14,979,12156,2195,137,8.12,0,30.0,414486,3398,412273,7.32,0.46,0.4052,0.82,99.47
2021-05-20,Punjab,1361,18,1356,17257,2309,512,7.89,0,30.0,415847,3416,413629,7.7,1.71,0.5752333333333334,0.82,99.47
2021-05-21,Punjab,1511,13,1511,18980,3001,2073,7.96,0,30.0,417358,3429,415140,10.0,6.91,0.6326666666666667,0.82,99.47
2021-05-22,Punjab,222,1,221,2506,4729,2675,8.86,0,30.0,417580,3430,415361,15.76,8.92,0.08353333333333333,0.82,99.47
2021-05-23,Punjab,243,2,238,3279,4932,1668,7.41,3,30.0,417823,3432,415599,16.44,5.56,0.1093,0.82,99.47
2021-05-24,Punjab,1142,11,1137,13937,2512,196,8.19,0,30.0,418965,3443,416736,8.37,0.65,0.4645666666666667,0.82,99.47
2021-05-25,Punjab,452,3,450,5483,827,520,8.24,0,30.0,419417,3446,417186,2.76,1.73,0.18276666666666666,0.82,99.47
2021-05-26,Punjab,507,7,503,6300,1308,461,8.05,0,30.0,419924,3453,417689,4.36,1.54,0.21,0.82,99.47
2021-05-27,Punjab,969,6,964,11716,3309,3229,8.27,0,30.0,420893,3459,418653,11.03,10.76,0.39053333333333334,0.82,99.47
2021-05-28,Punjab,469,2,460,6004,1300,617,7.81,7,30.0,421362,3461,419113,4.33,2.06,0.20013333333333333,0.82,99.47
2021-05-29,Punjab,126,0,118,1441,3029,1026,8.74,8,30.0,421488,3461,419231,10.1,3.42,0.04803333333333333,0.82,99.46
2021-05-30,Punjab,1549,12,1548,19458,4038,510,7.96,0,30.0,423037,3473,420779,13.46,1.7,0.6486,0.82,99.47
2021-05-31,Punjab,1471,6,1465,18346,1446,562,8.02,0,30.0,424508,3479,422244,4.82,1.87,0.6115333333333334,0.82,99.47
2021-06-01,Punjab,863,7,859,10571,4919,4622,8.16,0,30.0,425371,3486,423103,16.4,15.41,0.35236666666666666,0.82,99.47
2021-06-02,Punjab,430,6,425,5148,2034,828,8.35,0,30.0,425801,3492,423528,6.78,2.76,0.1716,0.82,99.47
2021-06-03,Punjab,1502,6,1500,18575,3352,1313,8.09,0,30.0,427303,3498,425028,11.17,4.38,0.6191666666666666,0.82,99.47
2021-06-04,Punjab,1064,4,1059,13410,4902,3187,7.93,1,30.0,428367,3502,426087,16.34,10.62,0.447,0.82,99.47
2021-06-05,Punjab,1038,14,1036,13060,273,79,7.95,0,30.0,429405,3516,427123,0.91,0.26,0.43533333333333335,0.82,99.47
2021-06-06,Punjab,826,5,822,10568,1946,217,7.82,0,30.0,430231,3521,427945,6.49,0.72,0.3522666666666667,0.82,99.47
2021-06-07,Punjab,807,11,800,10569,3736,1570,7.64,0,30.0,431038,3532,428745,12.45,5.23,0.3523,0.82,99.47
2021-06-08,Punjab,1230,5,1225,15451,447,366,7.96,0,30.0,432268,3537,429970,1.49,1.22,0.5150333333333333,0.82,99.47
2021-06-09,Punjab,1244,11,1237,15536,3793,228,8.01,0,30.0,433512,3548,431207,12.64,0.76,0.5178666666666667,0.82,99.47
2021-06-10,Punjab,1331,6,1326,16610,4230,2402,8.01,0,30.0,434843,3554,432533,14.1,8.01,0.5536666666666666,0.82,99.47
2021-06-11,Punjab,1430,14,1430,17607,2273,1315,8.12,0,30.0,436273,3568,433963,7.58,4.38,0.5869,0.82,99.47
2021-06-12,Punjab,157,2,149,1666,449,259,9.42,6,30.0,436430,3570,434112,1.5,0.86,0.05553333333333333,0.82,99.47
2021-06-13,Punjab,954,5,950,11953,4420,3912,7.98,0,30.0,437384,3575,435062,14.73,13.04,0.3984333333333333,0.82,99.47
2021-06-14,Punjab,920,11,913,11544,1835,1292,7.97,0,30.0,438304,3586,435975,6.12,4.31,0.3848,0.82,99.47
2021-06-15,Punjab,814,9,814,10318,4144,57,7.89,0,30.0,439118,3595,436789,13.81,0.19,0.3439333333333333,0.82,99.47
2021-06-16,Punjab,1338,15,1333,16704,3809,710,8.01,0,30.0,440456,3610,438122,12.7,2.37,0.5568,0.82,99.47
2021-06-17,Punjab,434,5,430,5483,441,119,7.92,0,30.0,440890,3615,438552,1.47,0.4,0.18276666666666666,0.82,99.47
2021-06-18,Punjab,446,3,443,5435,478,236,8.21,0,30.0,441336,3618,438995,1.59,0.79,0.18116666666666667,0.82,99.47
2021-06-19,Punjab,1328,7,1326,16578,1562,776,8.01,0,30.0,442664,3625,440321,5.21,2.59,0.5526,0.82,99.47
2021-06-20,Punjab,40,0,35,1019,1214,46,3.93,5,30.0,442704,3625,440356,4.05,0.15,0.033966666666666666,0.82,99.47
2021-06-21,Punjab,532,4,529,6580,2073,347,8.09,0,30.0,443236,3629,440885,6.91,1.16,0.21933333333333332,0.82,99.47
2021-06-22,Punjab,836,12,829,10331,1465,475,8.09,0,30.0,444072,3641,441714,4.88,1.58,0.34436666666666665,0.82,99.47
2021-06-23,Punjab,1579,14,1571,19739,4786,1069,8.0,0,30.0,445651,3655,443285,15.95,3.56,0.6579666666666667,0.82,99.47
2021-06-24,Punjab,456,1,447,5796,4363,3924,7.87,8,30.0,446107,3656,443732,14.54,13.08,0.1932,0.82,99.47
2021-06-25,Punjab,668,9,666,8368,4977,203,7.98,0,30.0,446775,3665,444398,16.59,0.68,0.2789333333333333,0.82,99.47
2021-06-26,Punjab,444,5,444,5780,4139,4053,7.68,0,30.0,447219,3670,444842,13.8,13.51,0.19266666666666668,0.82,99.47
2021-06-27,Punjab,1480,12,1477,18743,4439,2058,7.9,0,30.0,448699,3682,446319,14.8,6.86,0.6247666666666667,0.82,99.47
2021-06-28,Punjab,461,5,461,5559,3316,2692,8.29,0,30.0,449160,3687,446780,11.05,8.97,0.1853,0.82,99.47
2021-06-29,Punjab,1333,15,1329,16893,435,429,7.89,0,30.0,450493,3702,448109,1.45,1.43,0.5631,0.82,99.47
2021-06-30,Punjab,281,3,277,3657,4455,2726,7.68,1,30.0,450774,3705,448386,14.85,9.09,0.1219,0.82,99.47
2021-07-01,Punjab,269,3,260,3225,3321,1135,8.34,6,30.0,451043,3708,448646,11.07,3.78,0.1075,0.82,99.47
2021-07-02,Punjab,993,13,991,12181,4498,2897,8.15,0,30.0,452036,3721,449637,14.99,9.66,0.40603333333333336,0.82,99.47
2021-07-03,Punjab,1539,7,1539,19257,457,102,7.99,0,30.0,453575,3728,451176,1.52,0.34,0.6419,0.82,99.47
2021-07-04,Punjab,1071,14,1071,13378,2766,515,8.01,0,30.0,454646,3742,452247,9.22,1.72,0.44593333333333335,0.82,99.47
2021-07-05,Punjab,1425,16,1416,17961,431,305,7.93,0,30.0,456071,3758,453663,1.44,1.02,0.5987,0.82,99.47
2021-07-06,Punjab,180,2,176,2533,2166,498,7.11,2,30.0,456251,3760,453839,7.22,1.66,0.08443333333333333,0.82,99.47
2021-07-07,Punjab,517,1,515,6440,3072,395,8.03,1,30.0,456768,3761,454354,10.24,1.32,0.21466666666666667,0.82,99.47
2021-07-08,Punjab,1326,19,1317,16422,1389,270,8.07,0,30.0,458094,3780,455671,4.63,0.9,0.5474,0.83,99.47
2021-07-09,Punjab,1143,9,1135,14529,3235,2365,7.87,0,30.0,459237,3789,456806,10.78,7.88,0.4843,0.83,99.47
2021-07-10,Punjab,1151,14,1150,13943,2183,1391,8.26,0,30.0,460388,3803,457956,7.28,4.64,0.46476666666666666,0.83,99.47
2021-07-11,Punjab,231,3,231,2501,2250,413,9.24,0,30.0,460619,3806,458187,7.5,1.38,0.08336666666666667,0.83,99.47
2021-07-12,Punjab,909,10,904,11216,2989,1429,8.1,0,30.0,461528,3816,459091,9.96,4.76,0.3738666666666667,0.83,99.47
2021-07-13,Punjab,596,3,593,7747,181,86,7.69,0,30.0,462124,3819,459684,0.6,0.29,0.2582333333333333,0.83,99.47
2021-07-14,Punjab,1150,16,1150,14500,3364,2682,7.93,0,30.0,463274,3835,460834,11.21,8.94,0.48333333333333334,0.83,99.47
2021-07-15,Punjab,1082,7,1074,13254,117,12,8.16,1,30.0,464356,3842,461908,0.39,0.04,0.4418,0.83,99.47
2021-07-16,Punjab,480,6,472,5822,4265,3057,8.24,2,30.0,464836,3848,462380,14.22,10.19,0.19406666666666667,0.83,99.47
2021-07-17,Punjab,483,3,475,5401,2488,1286,8.94,5,30.0,465319,3851,462855,8.29,4.29,0.18003333333333332,0.83,99.47
2021-07-18,Punjab,81,0,76,942,3171,992,8.6,5,30.0,465400,3851,462931,10.57,3.31,0.0314,0.83,99.47
2021-07-19,Punjab,979,13,978,12116,4007,1625,8.08,0,30.0,466379,3864,463909,13.36,5.42,0.40386666666666665,0.83,99.47
2021-07-20,Punjab,852,10,844,10517,247,95,8.1,0,30.0,467231,3874,464753,0.82,0.32,0.3505666666666667,0.83,99.47
2021-07-21,Punjab,343,1,342,4039,401,86,8.49,0,30.0,467574,3875,465095,1.34,0.29,0.13463333333333333,0.83,99.47
2021-07-22,Punjab,1224,11,1224,14791,3993,1786,8.28,0,30.0,468798,3886,466319,13.31,5.95,0.4930333333333333,0.83,99.47
2021-07-23,Punjab,1450,16,1443,18021,4547,2165,8.05,0,30.0,470248,3902,467762,15.16,7.22,0.6007,0.83,99.47
2021-07-24,Punjab,1426,9,1421,17629,1506,860,8.09,0,30.0,471674,3911,469183,5.02,2.87,0.5876333333333333,0.83,99.47
2021-07-25,Punjab,1264,9,1264,15695,2105,1175,8.05,0,30.0,472938,3920,470447,7.02,3.92,0.5231666666666667,0.83,99.47
2021-07-26,Punjab,1370,18,1365,17577,3434,1105,7.79,0,30.0,474308,3938,471812,11.45,3.68,0.5859,0.83,99.47
2021-07-27,Punjab,648,6,645,7848,1257,1191,8.26,0,30.0,474956,3944,472457,4.19,3.97,0.2616,0.83,99.47
2021-07-28,Punjab,682,4,681,8404,1625,461,8.12,0,30.0,475638,3948,473138,5.42,1.54,0.28013333333333335,0.83,99.47
2021-07-29,Punjab,523,7,516,6627,4296,4082,7.89,0,30.0,476161,3955,473654,14.32,13.61,0.2209,0.83,99.47
2021-07-30,Punjab,657,7,649,8378,508,68,7.84,1,30.0,476818,3962,474303,1.69,0.23,0.27926666666666666,0.83,99.47
2021-07-31,Punjab,1469,16,1469,18326,4885,2299,8.02,0,30.0,478287,3978,475772,16.28,7.66,0.6108666666666667,0.83,99.47
2021-08-01,Punjab,1012,13,1007,12444,2679,1544,8.13,0,30.0,479299,3991,476779,8.93,5.15,0.4148,0.83,99.47
2021-08-02,Punjab,1440,10,1437,18313,755,143,7.86,0,30.0,480739,4001,478216,2.52,0.48,0.6104333333333334,0.83,99.48
2021-08-03,Punjab,75,0,70,1131,4268,1747,6.63,5,30.0,480814,4001,478286,14.23,5.82,0.0377,0.83,99.47
2021-08-04,Punjab,1523,7,1516,18993,3193,52,8.02,0,30.0,482337,4008,479802,10.64,0.17,0.6331,0.83,99.47
2021-08-05,Punjab,116,0,110,1228,3633,2538,9.45,6,30.0,482453,4008,479912,12.11,8.46,0.040933333333333335,0.83,99.47
2021-08-06,Punjab,1045,5,1039,13076,345,11,7.99,1,30.0,483498,4013,480951,1.15,0.04,0.4358666666666667,0.83,99.47
2021-08-07,Punjab,179,2,171,1889,4493,2380,9.48,6,30.0,483677,4015,481122,14.98,7.93,0.06296666666666667,0.83,99.47
2021-08-08,Punjab,863,4,854,11060,1089,131,7.8,5,30.0,484540,4019,481976,3.63,0.44,0.36866666666666664,0.83,99.47
2021-08-09,Punjab,1399,11,1395,17176,4532,2708,8.15,0,30.0,485939,4030,483371,15.11,9.03,0.5725333333333333,0.83,99.47
2021-08-10,Punjab,1128,9,1120,14158,4887,1884,7.97,0,30.0,487067,4039,484491,16.29,6.28,0.4719333333333333,0.83,99.47
2021-08-11,Punjab,1072,10,1070,13678,3025,2923,7.84,0,30.0,488139,4049,485561,10.08,9.74,0.45593333333333336,0.83,99.47
2021-08-12,Punjab,264,3,259,3607,1772,561,7.32,2,30.0,488403,4052,485820,5.91,1.87,0.12023333333333333,0.83,99.47
2021-08-13,Punjab,1121,8,1114,13705,2668,844,8.18,0,30.0,489524,4060,486934,8.89,2.81,0.4568333333333333,0.83,99.47
2021-08-14,Punjab,821,3,816,10151,2646,343,8.09,2,30.0,490345,4063,487750,8.82,1.14,0.33836666666666665,0.83,99.47
2021-08-15,Punjab,1380,18,1371,17726,1353,941,7.79,0,30.0,491725,4081,489121,4.51,3.14,0.5908666666666667,0.83,99.47
2021-08-16,Punjab,827,10,818,10375,2460,55,7.97,0,30.0,492552,4091,489939,8.2,0.18,0.3458333333333333,0.83,99.47
2021-08-17,Punjab,187,2,185,2663,458,18,7.02,0,30.0,492739,4093,490124,1.53,0.06,0.08876666666666666,0.83,99.47
2021-08-18,Punjab,911,7,903,11892,460,147,7.66,1,30.0,493650,4100,491027,1.53,0.49,0.3964,0.83,99.47
2021-08-19,Punjab,67,0,63,1150,4178,1589,5.83,4,30.0,493717,4100,491090,13.93,5.3,0.03833333333333333,0.83,99.47
2021-08-20,Punjab,498,4,490,5935,4257,2514,8.39,4,30.0,494215,4104,491580,14.19,8.38,0.19783333333333333,0.83,99.47
2021-08-21,Punjab,741,6,738,9625,1428,269,7.7,0,30.0,494956,4110,492318,4.76,0.9,0.32083333333333336,0.83,99.47
2021-08-22,Punjab,1281,6,1273,16209,1579,402,7.9,2,30.0,496237,4116,493591,5.26,1.34,0.5403,0.83,99.47
2021-08-23,Punjab,119,1,113,1827,3475,531,6.51,5,30.0,496356,4117,493704,11.58,1.77,0.0609,0.83,99.47
2021-08-24,Punjab,459,6,456,5887,128,96,7.8,0,30.0,496815,4123,494160,0.43,0.32,0.19623333333333334,0.83,99.47
2021-08-25,Punjab,104,1,103,1380,1047,675,7.54,0,30.0,496919,4124,494263,3.49,2.25,0.046,0.83,99.47
2021-08-26,Punjab,1590,14,1588,19774,1935,793,8.04,0,30.0,498509,4138,495851,6.45,2.64,0.6591333333333333,0.83,99.47
2021-08-27,Punjab,665,6,659,8054,675,112,8.26,0,30.0,499174,4144,496510,2.25,0.37,0.2684666666666667,0.83,99.47
2021-08-28,Punjab,1038,12,1033,12718,1820,215,8.16,0,30.0,500212,4156,497543,6.07,0.72,0.42393333333333333,0.83,99.47
2021-08-29,Punjab,418,1,417,4708,3688,3598,8.88,0,30.0,500630,4157,497960,12.29,11.99,0.15693333333333334,0.83,99.47
2021-08-30,Punjab,176,2,173,2214,1552,976,7.95,1,30.0,500806,4159,498133,5.17,3.25,0.0738,0.83,99.47
2021-08-31,Punjab,978,4,969,12337,969,591,7.93,5,30.0,501784,4163,499102,3.23,1.97,0.41123333333333334,0.83,99.47
2021-09-01,Punjab,976,12,970,12525,4687,2066,7.79,0,30.0,502760,4175,500072,15.62,6.89,0.4175,0.83,99.47
2021-09-02,Punjab,323,0,318,3855,1410,1329,8.38,5,30.0,503083,4175,500390,4.7,4.43,0.1285,0.83,99.46
2021-09-03,Punjab,651,7,645,8298,2084,518,7.85,0,30.0,503734,4182,501035,6.95,1.73,0.2766,0.83,99.46
2021-09-04,Punjab,104,1,98,1251,4680,2605,8.31,5,30.0,503838,4183,501133,15.6,8.68,0.0417,0.83,99.46
2021-09-05,Punjab,548,5,543,6881,1098,623,7.96,0,30.0,504386,4188,501676,3.66,2.08,0.22936666666666666,0.83,99.46
2021-09-06,Punjab,948,8,940,12094,2839,1139,7.84,0,30.0,505334,4196,502616,9.46,3.8,0.40313333333333334,0.83,99.46
2021-09-07,Punjab,626,4,623,7696,2224,2005,8.13,0,30.0,505960,4200,503239,7.41,6.68,0.25653333333333334,0.83,99.46
2021-09-08,Punjab,776,10,775,9337,4578,2385,8.31,0,30.0,506736,4210,504014,15.26,7.95,0.3112333333333333,0.83,99.46
2021-09-09,Punjab,1187,10,1186,14676,1284,660,8.09,0,30.0,507923,4220,505200,4.28,2.2,0.4892,0.83,99.46
2021-09-10,Punjab,1555,12,1554,19285,3567,1216,8.06,0,30.0,509478,4232,506754,11.89,4.05,0.6428333333333334,0.83,99.47
2021-09-11,Punjab,676,7,676,7964,14,2,8.49,0,30.0,510154,4239,507430,0.05,0.01,0.2654666666666667,0.83,99.47
2021-09-12,Punjab,912,10,911,11110,2092,324,8.21,0,30.0,511066,4249,508341,6.97,1.08,0.37033333333333335,0.83,99.47
2021-09-13,Punjab,1037,12,1035,12994,4231,4219,7.98,0,30.0,512103,4261,509376,14.1,14.06,0.4331333333333333,0.83,99.47
2021-09-14,Punjab,444,3,438,5396,15,10,8.23,3,30.0,512547,4264,509814,0.05,0.03,0.17986666666666667,0.83,99.47
2021-09-15,Punjab,1017,5,1016,12532,2176,796,8.12,0,30.0,513564,4269,510830,7.25,2.65,0.41773333333333335,0.83,99.47
2021-09-16,Punjab,1307,17,1305,16445,3896,2308,7.95,0,30.0,514871,4286,512135,12.99,7.69,0.5481666666666667,0.83,99.47
2021-09-17,Punjab,1225,4,1221,15260,2819,93,8.03,0,30.0,516096,4290,513356,9.4,0.31,0.5086666666666667,0.83,99.47
2021-09-18,Punjab,1024,10,1018,13234,2493,2428,7.74,0,30.0,517120,4300,514374,8.31,8.09,0.4411333333333333,0.83,99.47
2021-09-19,Punjab,715,7,707,8486,4890,772,8.43,1,30.0,517835,4307,515081,16.3,2.57,0.28286666666666666,0.83,99.47
2021-09-20,Punjab,389,4,389,4315,3289,756,9.02,0,30.0,518224,4311,515470,10.96,2.52,0.14383333333333334,0.83,99.47
2021-09-21,Punjab,77,0,74,835,1976,716,9.22,3,30.0,518301,4311,515544,6.59,2.39,0.027833333333333335,0.83,99.47
2021-09-22,Punjab,520,4,511,6554,4901,4413,7.93,5,30.0,518821,4315,516055,16.34,14.71,0.21846666666666667,0.83,99.47
2021-09-23,Punjab,772,4,769,9615,289,163,8.03,0,30.0,519593,4319,516824,0.96,0.54,0.3205,0.83,99.47
2021-09-24,Punjab,908,3,908,11132,1164,607,8.16,0,30.0,520501,4322,517732,3.88,2.02,0.37106666666666666,0.83,99.47
2021-09-25,Punjab,832,6,827,10903,3003,1421,7.63,0,30.0,521333,4328,518559,10.01,4.74,0.36343333333333333,0.83,99.47
2021-09-26,Punjab,805,2,796,10038,2212,2068,8.02,7,30.0,522138,4330,519355,7.37,6.89,0.3346,0.83,99.47
2021-09-27,Punjab,1510,22,1502,18838,214,118,8.02,0,30.0,523648,4352,520857,0.71,0.39,0.6279333333333333,0.83,99.47
2021-09-28,Punjab,570,8,569,6985,4595,3456,8.16,0,30.0,524218,4360,521426,15.32,11.52,0.23283333333333334,0.83,99.47
2021-09-29,Punjab,910,8,903,11385,2398,1063,7.99,0,30.0,525128,4368,522329,7.99,3.54,0.3795,0.83,99.47
2021-09-30,Punjab,737,2,736,9144,4051,467,8.06,0,30.0,525865,4370,523065,13.5,1.56,0.3048,0.83,99.47
2021-10-01,Punjab,667,3,667,8459,2116,1250,7.89,0,30.0,526532,4373,523732,7.05,4.17,0.28196666666666664,0.83,99.47
2021-10-02,Punjab,1617,11,1609,19943,1127,290,8.11,0,30.0,528149,4384,525341,3.76,0.97,0.6647666666666666,0.83,99.47
2021-10-03,Punjab,462,4,462,6024,1029,385,7.67,0,30.0,528611,4388,525803,3.43,1.28,0.2008,0.83,99.47
2021-10-04,Punjab,174,0,165,2234,374,120,7.79,9,30.0,528785,4388,525968,1.25,0.4,0.07446666666666667,0.83,99.47
2021-10-05,Punjab,373,3,365,4641,3554,1515,8.04,5,30.0,529158,4391,526333,11.85,5.05,0.1547,0.83,99.47
2021-10-06,Punjab,264,0,260,3161,3153,614,8.35,4,30.0,529422,4391,526593,10.51,2.05,0.10536666666666666,0.83,99.47
2021-10-07,Punjab,1071,8,1065,13508,84,54,7.93,0,30.0,530493,4399,527658,0.28,0.18,0.45026666666666665,0.83,99.47
2021-10-08,Punjab,1374,10,1371,17375,3282,346,7.91,0,30.0,531867,4409,529029,10.94,1.15,0.5791666666666667,0.83,99.47
2021-10-09,Punjab,707,9,703,8947,3686,1262,7.9,0,30.0,532574,4418,529732,12.29,4.21,0.29823333333333335,0.83,99.47
2021-10-10,Punjab,617,8,613,7711,356,136,8.0,0,30.0,533191,4426,530345,1.19,0.45,0.25703333333333334,0.83,99.47
2021-10-11,Punjab,1182,10,1177,14768,1443,339,8.0,0,30.0,534373,4436,531522,4.81,1.13,0.4922666666666667,0.83,99.47
2021-10-12,Punjab,434,1,430,5279,1465,7,8.22,3,30.0,534807,4437,531952,4.88,0.02,0.17596666666666666,0.83,99.47
2021-10-13,Punjab,638,3,635,8067,3640,1152,7.91,0,30.0,535445,4440,532587,12.13,3.84,0.2689,0.83,99.47
2021-10-14,Punjab,90,1,84,1276,2916,2718,7.05,5,30.0,535535,4441,532671,9.72,9.06,0.04253333333333333,0.83,99.47
2021-10-15,Punjab,160,1,153,2093,370,201,7.64,6,30.0,535695,4442,532824,1.23,0.67,0.06976666666666667,0.83,99.46
2021-10-16,Punjab,1224,17,1218,15174,2620,1224,8.07,0,30.0,536919,4459,534042,8.73,4.08,0.5058,0.83,99.46
2021-10-17,Punjab,140,1,139,1705,1957,379,8.21,0,30.0,537059,4460,534181,6.52,1.26,0.05683333333333333,0.83,99.46
2021-10-18,Punjab,1202,9,1196,15088,1441,1398,7.97,0,30.0,538261,4469,535377,4.8,4.66,0.5029333333333333,0.83,99.46
2021-10-19,Punjab,991,9,985,12417,4805,2954,7.98,0,30.0,539252,4478,536362,16.02,9.85,0.4139,0.83,99.46
2021-10-20,Punjab,312,2,305,3755,307,173,8.31,5,30.0,539564,4480,536667,1.02,0.58,0.12516666666666668,0.83,99.46
2021-10-21,Punjab,1155,9,1151,14682,3064,2007,7.87,0,30.0,540719,4489,537818,10.21,6.69,0.4894,0.83,99.46
2021-10-22,Punjab,637,6,632,8224,3759,3374,7.75,0,30.0,541356,4495,538450,12.53,11.25,0.27413333333333334,0.83,99.46
2021-10-23,Punjab,1242,15,1234,14999,3796,3528,8.28,0,30.0,542598,4510,539684,12.65,11.76,0.49996666666666667,0.83,99.46
2021-10-24,Punjab,1178,11,1172,14785,2201,1480,7.97,0,30.0,543776,4521,540856,7.34,4.93,0.49283333333333335,0.83,99.46
2021-10-25,Punjab,784,3,781,9531,2473,469,8.23,0,30.0,544560,4524,541637,8.24,1.56,0.3177,0.83,99.46
2021-10-26,Punjab,91,0,82,1184,2879,419,7.69,9,30.0,544651,4524,541719,9.6,1.4,0.039466666666666664,0.83,99.46
2021-10-27,Punjab,1607,17,1601,19822,2690,284,8.11,0,30.0,546258,4541,543320,8.97,0.95,0.6607333333333333,0.83,99.46
2021-10-28,Punjab,9,0,1,904,1583,801,1.0,8,30.0,546267,4541,543321,5.28,2.67,0.030133333333333335,0.83,99.46
2021-10-29,Punjab,399,4,396,4935,4269,766,8.09,0,30.0,546666,4545,543717,14.23,2.55,0.1645,0.83,99.46
2021-10-30,Punjab,382,2,380,5105,3316,2325,7.48,0,30.0,547048,4547,544097,11.05,7.75,0.17016666666666666,0.83,99.46
2021-10-31,Punjab,1100,10,1092,13414,3163,2216,8.2,0,30.0,548148,4557,545189,10.54,7.39,0.4471333333333333,0.83,99.46
2021-11-01,Punjab,534,7,533,6434,668,288,8.3,0,30.0,548682,4564,545722,2.23,0.96,0.21446666666666667,0.83,99.46
2021-11-02,Punjab,194,1,188,2276,2086,1495,8.52,5,30.0,548876,4565,545910,6.95,4.98,0.07586666666666667,0.83,99.46
2021-11-03,Punjab,725,2,721,8989,1771,159,8.07,2,30.0,549601,4567,546631,5.9,0.53,0.2996333333333333,0.83,99.46
2021-11-04,Punjab,183,2,174,2486,4370,3724,7.36,7,30.0,549784,4569,546805,14.57,12.41,0.08286666666666667,0.83,99.46
2021-11-05,Punjab,1320,4,1317,16693,1426,1132,7.91,0,30.0,551104,4573,548122,4.75,3.77,0.5564333333333333,0.83,99.46
2021-11-06,Punjab,1248,4,1240,15297,1764,145,8.16,4,30.0,552352,4577,549362,5.88,0.48,0.5099,0.83,99.46
2021-11-07,Punjab,1343,8,1338,16441,4442,3787,8.17,0,30.0,553695,4585,550700,14.81,12.62,0.5480333333333334,0.83,99.46
2021-11-08,Punjab,1402,15,1399,17650,2656,1198,7.94,0,30.0,555097,4600,552099,8.85,3.99,0.5883333333333334,0.83,99.46
2021-11-09,Punjab,1348,9,1347,16940,291,282,7.96,0,30.0,556445,4609,553446,0.97,0.94,0.5646666666666667,0.83,99.46
2021-11-10,Punjab,1532,6,1531,19058,1052,89,8.04,0,30.0,557977,4615,554977,3.51,0.3,0.6352666666666666,0.83,99.46
2021-11-11,Punjab,1289,7,1288,16294,1136,681,7.91,0,30.0,559266,4622,556265,3.79,2.27,0.5431333333333334,0.83,99.46
2021-11-12,Punjab,842,10,834,10142,1919,176,8.3,0,30.0,560108,4632,557099,6.4,0.59,0.3380666666666667,0.83,99.46
2021-11-13,Punjab,1059,4,1051,12970,1092,0,8.16,4,30.0,561167,4636,558150,3.64,0.0,0.43233333333333335,0.83,99.46
2021-11-14,Punjab,1561,19,1555,19285,4271,3301,8.09,0,30.0,562728,4655,559705,14.24,11.0,0.6428333333333334,0.83,99.46
2021-11-15,Punjab,1564,18,1560,19535,1316,703,8.01,0,30.0,564292,4673,561265,4.39,2.34,0.6511666666666667,0.83,99.46
2021-11-16,Punjab,1260,7,1252,15586,4591,4291,8.08,1,30.0,565552,4680,562517,15.3,14.3,0.5195333333333333,0.83,99.46
2021-11-17,Punjab,305,4,304,3559,2498,957,8.57,0,30.0,565857,4684,562821,8.33,3.19,0.11863333333333333,0.83,99.46
2021-11-18,Punjab,833,4,831,10302,3695,3515,8.09,0,30.0,566690,4688,563652,12.32,11.72,0.3434,0.83,99.46
2021-11-19,Punjab,1109,6,1101,13722,4924,2350,8.08,2,30.0,567799,4694,564753,16.41,7.83,0.4574,0.83,99.46
2021-11-20,Punjab,1309,5,1303,16724,4954,254,7.83,1,30.0,569108,4699,566056,16.51,0.85,0.5574666666666667,0.83,99.46
2021-11-21,Punjab,786,9,783,10094,2298,768,7.79,0,30.0,569894,4708,566839,7.66,2.56,0.3364666666666667,0.83,99.46
2021-11-22,Punjab,1238,14,1236,15319,1256,298,8.08,0,30.0,571132,4722,568075,4.19,0.99,0.5106333333333334,0.83,99.46
2021-11-23,Punjab,1180,7,1172,14606,3249,1370,8.08,1,30.0,572312,4729,569247,10.83,4.57,0.48686666666666667,0.83,99.46
2021-11-24,Punjab,1502,9,1499,18577,4655,2183,8.09,0,30.0,573814,4738,570746,15.52,7.28,0.6192333333333333,0.83,99.47
2021-11-25,Punjab,1271,8,1268,16090,3618,3327,7.9,0,30.0,575085,4746,572014,12.06,11.09,0.5363333333333333,0.83,99.47
2021-11-26,Punjab,1139,3,1134,14627,644,512,7.79,2,30.0,576224,4749,573148,2.15,1.71,0.48756666666666665,0.82,99.47
2021-11-27,Punjab,512,5,509,6288,4042,2254,8.14,0,30.0,576736,4754,573657,13.47,7.51,0.2096,0.82,99.47
2021-11-28,Punjab,857,11,850,10759,1281,728,7.97,0,30.0,577593,4765,574507,4.27,2.43,0.35863333333333336,0.82,99.47
2021-11-29,Punjab,666,5,665,7933,2218,1486,8.4,0,30.0,578259,4770,575172,7.39,4.95,0.26443333333333335,0.82,99.47
2021-11-30,Punjab,807,11,799,9917,338,282,8.14,0,30.0,579066,4781,575971,1.13,0.94,0.3305666666666667,0.83,99.47
2021-12-01,Punjab,341,2,339,4233,4047,1232,8.06,0,30.0,579407,4783,576310,13.49,4.11,0.1411,0.83,99.47
2021-12-02,Punjab,725,9,719,8865,2165,955,8.18,0,30.0,580132,4792,577029,7.22,3.18,0.2955,0.83,99.47
2021-12-03,Punjab,516,1,509,6148,3132,1516,8.39,6,30.0,580648,4793,577538,10.44,5.05,0.20493333333333333,0.83,99.46
2021-12-04,Punjab,972,12,968,12312,1119,89,7.89,0,30.0,581620,4805,578506,3.73,0.3,0.4104,0.83,99.46
2021-12-05,Punjab,909,5,907,11575,228,19,7.85,0,30.0,582529,4810,579413,0.76,0.06,0.3858333333333333,0.83,99.47
2021-12-06,Punjab,1351,13,1343,16821,4838,1473,8.03,0,30.0,583880,4823,580756,16.13,4.91,0.5607,0.83,99.46
2021-12-07,Punjab,458,2,453,5881,4539,852,7.79,3,30.0,584338,4825,581209,15.13,2.84,0.19603333333333334,0.83,99.46
2021-12-08,Punjab,656,3,650,8672,4019,2637,7.56,3,30.0,584994,4828,581859,13.4,8.79,0.2890666666666667,0.83,99.46
2021-12-09,Punjab,1263,16,1254,15750,3004,1757,8.02,0,30.0,586257,4844,583113,10.01,5.86,0.525,0.83,99.46
2021-12-10,Punjab,426,4,417,5835,3330,999,7.3,5,30.0,586683,4848,583530,11.1,3.33,0.1945,0.83,99.46
2021-12-11,Punjab,1246,14,1239,15455,4627,4479,8.06,0,30.0,587929,4862,584769,15.42,14.93,0.5151666666666667,0.83,99.46
2021-12-12,Punjab,1333,13,1331,16394,1498,482,8.13,0,30.0,589262,4875,586100,4.99,1.61,0.5464666666666667,0.83,99.46
2021-12-13,Punjab,1407,12,1400,17549,844,303,8.02,0,30.0,590669,4887,587500,2.81,1.01,0.5849666666666666,0.83,99.46
2021-12-14,Punjab,1405,6,1400,17185,1268,640,8.18,0,30.0,592074,4893,588900,4.23,2.13,0.5728333333333333,0.83,99.46
2021-12-15,Punjab,1344,14,1339,17064,178,133,7.88,0,30.0,593418,4907,590239,0.59,0.44,0.5688,0.83,99.46
2021-12-16,Punjab,420,3,418,5401,593,109,7.78,0,30.0,593838,4910,590657,1.98,0.36,0.18003333333333332,0.83,99.46
2021-12-17,Punjab,612,4,610,7559,4554,3852,8.1,0,30.0,594450,4914,591267,15.18,12.84,0.25196666666666667,0.83,99.46
2021-12-18,Punjab,1410,5,1409,17903,3120,2084,7.88,0,30.0,595860,4919,592676,10.4,6.95,0.5967666666666667,0.83,99.47
2021-12-19,Punjab,548,5,539,7033,4170,4066,7.79,4,30.0,596408,4924,593215,13.9,13.55,0.23443333333333333,0.83,99.46
2021-12-20,Punjab,1369,18,1368,17066,1850,1703,8.02,0,30.0,597777,4942,594583,6.17,5.68,0.5688666666666666,0.83,99.47
2021-12-21,Punjab,1446,18,1444,17816,2645,1670,8.12,0,30.0,599223,4960,596027,8.82,5.57,0.5938666666666667,0.83,99.47
2021-12-22,Punjab,1562,17,1555,19301,878,784,8.09,0,30.0,600785,4977,597582,2.93,2.61,0.6433666666666666,0.83,99.47
2021-12-23,Punjab,951,9,951,12074,3011,1260,7.88,0,30.0,601736,4986,598533,10.04,4.2,0.40246666666666664,0.83,99.47
2021-12-24,Punjab,796,11,795,9774,2361,1702,8.14,0,30.0,602532,4997,599328,7.87,5.67,0.3258,0.83,99.47
2021-12-25,Punjab,266,2,257,3040,2711,1926,8.75,7,30.0,602798,4999,599585,9.04,6.42,0.10133333333333333,0.83,99.47
2021-12-26,Punjab,627,7,623,7980,3444,2288,7.86,0,30.0,603425,5006,600208,11.48,7.63,0.266,0.83,99.47
2021-12-27,Punjab,961,8,958,11975,3794,962,8.03,0,30.0,604386,5014,601166,12.65,3.21,0.39916666666666667,0.83,99.47
2021-12-28,Punjab,1516,14,1511,19056,2266,265,7.96,0,30.0,605902,5028,602677,7.55,0.88,0.6352,0.83,99.47
2021-12-29,Punjab,101,1,100,1361,240,82,7.42,0,30.0,606003,5029,602777,0.8,0.27,0.045366666666666666,0.83,99.47
2021-12-30,Punjab,399,4,393,4611,4164,1840,8.65,2,30.0,606402,5033,603170,13.88,6.13,0.1537,0.83,99.47
2021-12-31,Punjab,1106,9,1100,13273,1220,659,8.33,0,30.0,607508,5042,604270,4.07,2.2,0.44243333333333335,0.83,99.47
2022-01-01,Punjab,1316,7,1313,16209,3795,1286,8.12,0,30.0,608824,5049,605583,12.65,4.29,0.5403,0.83,99.47
2022-01-02,Punjab,1072,16,1072,13156,2475,386,8.15,0,30.0,609896,5065,606655,8.25,1.29,0.43853333333333333,0.83,99.47
2022-01-03,Punjab,495,3,488,6073,3135,349,8.15,4,30.0,610391,5068,607143,10.45,1.16,0.20243333333333333,0.83,99.47
2022-01-04,Punjab,686,2,679,8487,3238,730,8.08,5,30.0,611077,5070,607822,10.79,2.43,0.2829,0.83,99.47
2022-01-05,Punjab,1330,17,1324,16595,2059,1533,8.01,0,30.0,612407,5087,609146,6.86,5.11,0.5531666666666667,0.83,99.47
2022-01-06,Punjab,504,5,502,6363,2164,504,7.92,0,30.0,612911,5092,609648,7.21,1.68,0.2121,0.83,99.47
2022-01-07,Punjab,1116,6,1108,13849,4663,1693,8.06,2,30.0,614027,5098,610756,15.54,5.64,0.46163333333333334,0.83,99.47
2022-01-08,Punjab,201,2,201,2442,2949,2140,8.23,0,30.0,614228,5100,610957,9.83,7.13,0.0814,0.83,99.47
2022-01-09,Punjab,102,0,94,1341,3239,24,7.61,8,30.0,614330,5100,611051,10.8,0.08,0.0447,0.83,99.47
2022-01-10,Punjab,1081,3,1079,13566,1179,138,7.97,0,30.0,615411,5103,612130,3.93,0.46,0.4522,0.83,99.47
2022-01-11,Punjab,765,9,756,9561,1529,25,8.0,0,30.0,616176,5112,612886,5.1,0.08,0.3187,0.83,99.47
2022-01-12,Punjab,708,6,699,9139,4237,2818,7.75,3,30.0,616884,5118,613585,14.12,9.39,0.3046333333333333,0.83,99.47
2022-01-13,Punjab,261,2,260,2780,2146,528,9.39,0,30.0,617145,5120,613845,7.15,1.76,0.09266666666666666,0.83,99.47
2022-01-14,Punjab,949,9,941,12126,783,163,7.83,0,30.0,618094,5129,614786,2.61,0.54,0.4042,0.83,99.46
2022-01-15,Punjab,981,13,977,12064,1100,1087,8.13,0,30.0,619075,5142,615763,3.67,3.62,0.40213333333333334,0.83,99.47
2022-01-16,Punjab,1238,18,1234,15767,995,763,7.85,0,30.0,620313,5160,616997,3.32,2.54,0.5255666666666666,0.83,99.47
2022-01-17,Punjab,669,4,660,8820,4842,2718,7.59,5,30.0,620982,5164,617657,16.14,9.06,0.294,0.83,99.46
2022-01-18,Punjab,177,1,175,2071,4542,4364,8.55,1,30.0,621159,5165,617832,15.14,14.55,0.06903333333333334,0.83,99.46
2022-01-19,Punjab,1321,17,1312,16824,3982,2130,7.85,0,30.0,622480,5182,619144,13.27,7.1,0.5608,0.83,99.46
2022-01-20,Punjab,1461,19,1454,18235,841,229,8.01,0,30.0,623941,5201,620598,2.8,0.76,0.6078333333333333,0.83,99.46
2022-01-21,Punjab,1527,13,1519,19042,3219,3218,8.02,0,30.0,625468,5214,622117,10.73,10.73,0.6347333333333334,0.83,99.46
2022-01-22,Punjab,216,0,209,2563,3227,2249,8.43,7,30.0,625684,5214,622326,10.76,7.5,0.08543333333333333,0.83,99.46
2022-01-23,Punjab,1615,11,1609,19987,3692,400,8.08,0,30.0,627299,5225,623935,12.31,1.33,0.6662333333333333,0.83,99.46
2022-01-24,Punjab,1455,17,1453,18234,2741,1283,7.98,0,30.0,628754,5242,625388,9.14,4.28,0.6078,0.83,99.46
2022-01-25,Punjab,747,7,740,9360,3182,379,7.98,0,30.0,629501,5249,626128,10.61,1.26,0.312,0.83,99.46
2022-01-26,Punjab,1132,12,1125,14110,3754,637,8.02,0,30.0,630633,5261,627253,12.51,2.12,0.4703333333333333,0.83,99.46
2022-01-27,Punjab,685,2,683,8010,3505,2462,8.55,0,30.0,631318,5263,627936,11.68,8.21,0.267,0.83,99.46
2022-01-28,Punjab,754,7,754,9376,3217,2387,8.04,0,30.0,632072,5270,628690,10.72,7.96,0.31253333333333333,0.83,99.46
2022-01-29,Punjab,618,8,609,7763,290,192,7.96,1,30.0,632690,5278,629299,0.97,0.64,0.25876666666666664,0.83,99.46
2022-01-30,Punjab,670,5,662,8447,3257,330,7.93,3,30.0,633360,5283,629961,10.86,1.1,0.2815666666666667,0.83,99.46
2022-01-31,Punjab,715,6,714,8857,97,56,8.07,0,30.0,634075,5289,630675,0.32,0.19,0.29523333333333335,0.83,99.46
2022-02-01,Punjab,1188,7,1182,14719,4874,4784,8.07,0,30.0,635263,5296,631857,16.25,15.95,0.4906333333333333,0.83,99.46
2022-02-02,Punjab,159,1,156,2013,2057,270,7.9,2,30.0,635422,5297,632013,6.86,0.9,0.0671,0.83,99.46
2022-02-03,Punjab,340,1,332,3702,4193,1687,9.18,7,30.0,635762,5298,632345,13.98,5.62,0.1234,0.83,99.46
2022-02-04,Punjab,583,7,582,7153,3018,399,8.15,0,30.0,636345,5305,632927,10.06,1.33,0.23843333333333333,0.83,99.46
2022-02-05,Punjab,497,7,490,6346,820,747,7.83,0,30.0,636842,5312,633417,2.73,2.49,0.21153333333333332,0.83,99.46
2022-02-06,Punjab,549,3,540,6784,4767,1785,8.09,6,30.0,637391,5315,633957,15.89,5.95,0.22613333333333333,0.83,99.46
2022-02-07,Punjab,591,7,587,7382,3895,2286,8.01,0,30.0,637982,5322,634544,12.98,7.62,0.24606666666666666,0.83,99.46
2022-02-08,Punjab,509,7,502,6280,1070,926,8.11,0,30.0,638491,5329,635046,3.57,3.09,0.20933333333333334,0.83,99.46
2022-02-09,Punjab,1159,10,1158,13951,4814,3443,8.31,0,30.0,639650,5339,636204,16.05,11.48,0.46503333333333335,0.83,99.46
2022-02-10,Punjab,999,10,999,12603,3907,3840,7.93,0,30.0,640649,5349,637203,13.02,12.8,0.4201,0.83,99.46
2022-02-11,Punjab,1548,22,1543,19455,1227,141,7.96,0,30.0,642197,5371,638746,4.09,0.47,0.6485,0.84,99.46
2022-02-12,Punjab,901,4,897,11563,4620,779,7.79,0,30.0,643098,5375,639643,15.4,2.6,0.38543333333333335,0.84,99.46
2022-02-13,Punjab,439,2,433,5545,1680,853,7.92,4,30.0,643537,5377,640076,5.6,2.84,0.18483333333333332,0.84,99.46
2022-02-14,Punjab,1161,9,1160,14632,1944,320,7.93,0,30.0,644698,5386,641236,6.48,1.07,0.48773333333333335,0.84,99.46
2022-02-15,Punjab,562,7,560,7532,4514,1182,7.46,0,30.0,645260,5393,641796,15.05,3.94,0.25106666666666666,0.84,99.46
2022-02-16,Punjab,639,8,639,7640,1027,888,8.36,0,30.0,645899,5401,642435,3.42,2.96,0.25466666666666665,0.84,99.46
2022-02-17,Punjab,754,3,751,9433,2367,1875,7.99,0,30.0,646653,5404,643186,7.89,6.25,0.31443333333333334,0.84,99.46
2022-02-18,Punjab,891,5,887,11274,4463,322,7.9,0,30.0,647544,5409,644073,14.88,1.07,0.3758,0.84,99.46
2022-02-19,Punjab,1279,15,1270,16007,2825,1746,7.99,0,30.0,648823,5424,645343,9.42,5.82,0.5335666666666666,0.84,99.46
2022-02-20,Punjab,1452,18,1449,18166,1027,78,7.99,0,30.0,650275,5442,646792,3.42,0.26,0.6055333333333334,0.84,99.46
2022-02-21,Punjab,1553,20,1548,19741,611,107,7.87,0,30.0,651828,5462,648340,2.04,0.36,0.6580333333333334,0.84,99.46
2022-02-22,Punjab,1158,12,1149,13947,2282,1075,8.3,0,30.0,652986,5474,649489,7.61,3.58,0.4649,0.84,99.46
2022-02-23,Punjab,49,0,44,666,741,41,7.36,5,30.0,653035,5474,649533,2.47,0.14,0.0222,0.84,99.46
2022-02-24,Punjab,640,3,631,7887,1238,79,8.11,6,30.0,653675,5477,650164,4.13,0.26,0.2629,0.84,99.46
2022-02-25,Punjab,309,2,306,3815,2279,875,8.1,1,30.0,653984,5479,650470,7.6,2.92,0.12716666666666668,0.84,99.46
2022-02-26,Punjab,1512,15,1503,18898,3167,2268,8.0,0,30.0,655496,5494,651973,10.56,7.56,0.6299333333333333,0.84,99.46
2022-02-27,Punjab,190,1,187,2344,175,71,8.11,2,30.0,655686,5495,652160,0.58,0.24,0.07813333333333333,0.84,99.46
2022-02-28,Punjab,971,4,969,12427,1942,1821,7.81,0,30.0,656657,5499,653129,6.47,6.07,0.41423333333333334,0.84,99.46
2022-03-01,Punjab,1566,12,1562,19410,2777,1809,8.07,0,30.0,658223,5511,654691,9.26,6.03,0.647,0.84,99.46
2022-03-02,Punjab,1539,15,1537,19632,977,210,7.84,0,30.0,659762,5526,656228,3.26,0.7,0.6544,0.84,99.46
2022-03-03,Punjab,1158,11,1158,14636,4578,2462,7.91,0,30.0,660920,5537,657386,15.26,8.21,0.48786666666666667,0.84,99.47
2022-03-04,Punjab,784,8,777,9963,2022,1702,7.87,0,30.0,661704,5545,658163,6.74,5.67,0.3321,0.84,99.46
2022-03-05,Punjab,1208,10,1207,15364,2062,1155,7.86,0,30.0,662912,5555,659370,6.87,3.85,0.5121333333333333,0.84,99.47
2022-03-06,Punjab,1421,9,1417,17201,3433,3353,8.26,0,30.0,664333,5564,660787,11.44,11.18,0.5733666666666667,0.84,99.47
2022-03-07,Punjab,1450,13,1446,17806,2204,860,8.14,0,30.0,665783,5577,662233,7.35,2.87,0.5935333333333334,0.84,99.47
2022-03-08,Punjab,1152,4,1146,14181,1559,414,8.12,2,30.0,666935,5581,663379,5.2,1.38,0.4727,0.84,99.47
2022-03-09,Punjab,782,10,777,9582,4423,2963,8.16,0,30.0,667717,5591,664156,14.74,9.88,0.3194,0.84,99.47
2022-03-10,Punjab,1219,4,1218,15543,4976,4276,7.84,0,30.0,668936,5595,665374,16.59,14.25,0.5181,0.84,99.47
2022-03-11,Punjab,247,2,241,2581,4496,62,9.57,4,30.0,669183,5597,665615,14.99,0.21,0.08603333333333334,0.84,99.47
2022-03-12,Punjab,127,1,121,2082,1145,472,6.1,5,30.0,669310,5598,665736,3.82,1.57,0.0694,0.84,99.47
2022-03-13,Punjab,286,3,278,3814,2981,1435,7.5,5,30.0,669596,5601,666014,9.94,4.78,0.12713333333333332,0.84,99.47
2022-03-14,Punjab,1243,15,1235,15717,1846,1246,7.91,0,30.0,670839,5616,667249,6.15,4.15,0.5239,0.84,99.46
2022-03-15,Punjab,1307,6,1304,15980,2508,2368,8.18,0,30.0,672146,5622,668553,8.36,7.89,0.5326666666666666,0.84,99.47
2022-03-16,Punjab,1573,19,1567,19433,318,165,8.09,0,30.0,673719,5641,670120,1.06,0.55,0.6477666666666667,0.84,99.47
2022-03-17,Punjab,130,0,122,1537,3011,2165,8.46,8,30.0,673849,5641,670242,10.04,7.22,0.05123333333333333,0.84,99.46
2022-03-18,Punjab,1227,17,1226,15335,1718,253,8.0,0,30.0,675076,5658,671468,5.73,0.84,0.5111666666666667,0.84,99.47
2022-03-19,Punjab,925,2,918,12240,4220,4064,7.56,5,30.0,676001,5660,672386,14.07,13.55,0.408,0.84,99.47
2022-03-20,Punjab,1140,14,1140,14497,3793,964,7.86,0,30.0,677141,5674,673526,12.64,3.21,0.48323333333333335,0.84,99.47
2022-03-21,Punjab,1150,11,1147,13897,3947,275,8.28,0,30.0,678291,5685,674673,13.16,0.92,0.46323333333333333,0.84,99.47
2022-03-22,Punjab,402,3,400,4752,731,367,8.46,0,30.0,678693,5688,675073,2.44,1.22,0.1584,0.84,99.47
2022-03-23,Punjab,599,8,593,7619,2772,1746,7.86,0,30.0,679292,5696,675666,9.24,5.82,0.2539666666666667,0.84,99.47
2022-03-24,Punjab,1087,6,1081,13703,1056,995,7.93,0,30.0,680379,5702,676747,3.52,3.32,0.45676666666666665,0.84,99.47
2022-03-25,Punjab,413,1,412,5026,785,131,8.22,0,30.0,680792,5703,677159,2.62,0.44,0.16753333333333334,0.84,99.47
2022-03-26,Punjab,395,5,392,4447,101,16,8.88,0,30.0,681187,5708,677551,0.34,0.05,0.14823333333333333,0.84,99.47
2022-03-27,Punjab,244,3,238,3337,4041,2636,7.31,3,30.0,681431,5711,677789,13.47,8.79,0.11123333333333334,0.84,99.47
2022-03-28,Punjab,627,6,626,7819,243,9,8.02,0,30.0,682058,5717,678415,0.81,0.03,0.26063333333333333,0.84,99.47
2022-03-29,Punjab,666,3,662,8317,1793,1367,8.01,1,30.0,682724,5720,679077,5.98,4.56,0.27723333333333333,0.84,99.47
2022-03-30,Punjab,1169,3,1168,14786,2365,145,7.91,0,30.0,683893,5723,680245,7.88,0.48,0.4928666666666667,0.84,99.47
2022-03-31,Punjab,1194,15,1188,15058,888,640,7.93,0,30.0,685087,5738,681433,2.96,2.13,0.5019333333333333,0.84,99.47
2022-04-01,Punjab,1458,17,1455,17619,4612,1541,8.28,0,30.0,686545,5755,682888,15.37,5.14,0.5873,0.84,99.47
2022-04-02,Punjab,751,11,750,9370,4311,2532,8.01,0,30.0,687296,5766,683638,14.37,8.44,0.31233333333333335,0.84,99.47
2022-04-03,Punjab,930,9,921,11586,2195,9,8.03,0,30.0,688226,5775,684559,7.32,0.03,0.3862,0.84,99.47
2022-04-04,Punjab,381,1,375,4405,180,38,8.65,5,30.0,688607,5776,684934,0.6,0.13,0.14683333333333334,0.84,99.47
2022-04-05,Punjab,150,1,142,1816,2461,1366,8.26,7,30.0,688757,5777,685076,8.2,4.55,0.060533333333333335,0.84,99.47
2022-04-06,Punjab,127,1,119,1461,528,258,8.69,7,30.0,688884,5778,685195,1.76,0.86,0.0487,0.84,99.46
2022-04-07,Punjab,90,1,82,642,425,367,14.02,7,30.0,688974,5779,685277,1.42,1.22,0.0214,0.84,99.46
2022-04-08,Punjab,676,8,674,8528,889,79,7.93,0,30.0,689650,5787,685951,2.96,0.26,0.28426666666666667,0.84,99.46
2022-04-09,Punjab,973,3,967,12421,2577,2073,7.83,3,30.0,690623,5790,686918,8.59,6.91,0.4140333333333333,0.84,99.46
2022-04-10,Punjab,1501,21,1495,18528,4151,239,8.1,0,30.0,692124,5811,688413,13.84,0.8,0.6176,0.84,99.46
2022-04-11,Punjab,995,10,987,12680,3627,2739,7.85,0,30.0,693119,5821,689400,12.09,9.13,0.4226666666666667,0.84,99.46
2022-04-12,Punjab,443,3,441,5411,2538,831,8.19,0,30.0,693562,5824,689841,8.46,2.77,0.18036666666666668,0.84,99.46
2022-04-13,Punjab,739,6,738,9234,2781,365,8.0,0,30.0,694301,5830,690579,9.27,1.22,0.3078,0.84,99.46
2022-04-14,Punjab,1431,20,1425,17711,1000,652,8.08,0,30.0,695732,5850,692004,3.33,2.17,0.5903666666666667,0.84,99.46
2022-04-15,Punjab,944,4,940,12212,1088,446,7.73,0,30.0,696676,5854,692944,3.63,1.49,0.4070666666666667,0.84,99.46
2022-04-16,Punjab,361,4,361,4383,1850,1304,8.24,0,30.0,697037,5858,693305,6.17,4.35,0.1461,0.84,99.46
2022-04-17,Punjab,1084,8,1084,13408,285,11,8.08,0,30.0,698121,5866,694389,0.95,0.04,0.44693333333333335,0.84,99.47
2022-04-18,Punjab,197,2,195,2553,1476,1211,7.72,0,30.0,698318,5868,694584,4.92,4.04,0.0851,0.84,99.47
2022-04-19,Punjab,1150,7,1146,14476,4548,3706,7.94,0,30.0,699468,5875,695730,15.16,12.35,0.4825333333333333,0.84,99.47
2022-04-20,Punjab,1306,18,1306,16562,197,193,7.89,0,30.0,700774,5893,697036,0.66,0.64,0.5520666666666667,0.84,99.47
2022-04-21,Punjab,1452,16,1450,18110,1123,258,8.02,0,30.0,702226,5909,698486,3.74,0.86,0.6036666666666667,0.84,99.47
2022-04-22,Punjab,228,2,224,2892,3113,1782,7.88,2,30.0,702454,5911,698710,10.38,5.94,0.0964,0.84,99.47
2022-04-23,Punjab,1068,11,1061,13356,3814,3185,8.0,0,30.0,703522,5922,699771,12.71,10.62,0.4452,0.84,99.47
2022-04-24,Punjab,561,6,555,6947,4572,1142,8.08,0,30.0,704083,5928,700326,15.24,3.81,0.23156666666666667,0.84,99.47
2022-04-25,Punjab,337,4,336,4091,3098,2199,8.24,0,30.0,704420,5932,700662,10.33,7.33,0.13636666666666666,0.84,99.47
2022-04-26,Punjab,60,0,56,754,1177,125,7.96,4,30.0,704480,5932,700718,3.92,0.42,0.025133333333333334,0.84,99.47
2022-04-27,Punjab,95,0,90,1276,4054,1234,7.45,5,30.0,704575,5932,700808,13.51,4.11,0.04253333333333333,0.84,99.47
2022-04-28,Punjab,337,1,337,4035,395,217,8.35,0,30.0,704912,5933,701145,1.32,0.72,0.1345,0.84,99.47
2022-04-29,Punjab,466,6,461,5546,23,9,8.4,0,30.0,705378,5939,701606,0.08,0.03,0.18486666666666668,0.84,99.47
2022-04-30,Punjab,1258,4,1249,15555,192,97,8.09,5,30.0,706636,5943,702855,0.64,0.32,0.5185,0.84,99.46
2022-05-01,Punjab,748,9,748,8736,4748,1837,8.56,0,30.0,707384,5952,703603,15.83,6.12,0.2912,0.84,99.47
2022-05-02,Punjab,249,0,245,3032,2008,1419,8.21,4,30.0,707633,5952,703848,6.69,4.73,0.10106666666666667,0.84,99.47
2022-05-03,Punjab,35,0,35,875,3568,2332,4.0,0,30.0,707668,5952,703883,11.89,7.77,0.029166666666666667,0.84,99.47
2022-05-04,Punjab,731,2,729,8921,2120,1856,8.19,0,30.0,708399,5954,704612,7.07,6.19,0.29736666666666667,0.84,99.47
2022-05-05,Punjab,892,11,889,11349,2307,2012,7.86,0,30.0,709291,5965,705501,7.69,6.71,0.3783,0.84,99.47
2022-05-06,Punjab,909,13,905,11199,247,37,8.12,0,30.0,710200,5978,706406,0.82,0.12,0.3733,0.84,99.47
2022-05-07,Punjab,1021,5,1014,12409,3891,2909,8.23,2,30.0,711221,5983,707420,12.97,9.7,0.41363333333333335,0.84,99.47
2022-05-08,Punjab,1106,10,1103,13715,4320,1837,8.06,0,30.0,712327,5993,708523,14.4,6.12,0.45716666666666667,0.84,99.47
2022-05-09,Punjab,630,9,626,8017,231,9,7.86,0,30.0,712957,6002,709149,0.77,0.03,0.2672333333333333,0.84,99.47
2022-05-10,Punjab,1379,11,1372,16784,3702,518,8.22,0,30.0,714336,6013,710521,12.34,1.73,0.5594666666666667,0.84,99.47
2022-05-11,Punjab,1510,17,1501,18628,4136,2195,8.11,0,30.0,715846,6030,712022,13.79,7.32,0.6209333333333333,0.84,99.47
2022-05-12,Punjab,698,9,696,8312,1450,1411,8.4,0,30.0,716544,6039,712718,4.83,4.7,0.2770666666666667,0.84,99.47
2022-05-13,Punjab,502,2,495,6189,2317,1073,8.11,5,30.0,717046,6041,713213,7.72,3.58,0.2063,0.84,99.47
2022-05-14,Punjab,1243,11,1243,15546,2701,1482,8.0,0,30.0,718289,6052,714456,9.0,4.94,0.5182,0.84,99.47
2022-05-15,Punjab,760,6,752,9255,1176,556,8.21,2,30.0,719049,6058,715208,3.92,1.85,0.3085,0.84,99.47
2022-05-16,Punjab,199,1,197,2000,3797,415,9.95,1,30.0,719248,6059,715405,12.66,1.38,0.06666666666666667,0.84,99.47
2022-05-17,Punjab,133,0,132,1751,4274,3295,7.6,1,30.0,719381,6059,715537,14.25,10.98,0.058366666666666664,0.84,99.47
2022-05-18,Punjab,174,0,169,1960,2368,2221,8.88,5,30.0,719555,6059,715706,7.89,7.4,0.06533333333333333,0.84,99.47
2022-05-19,Punjab,1230,11,1223,15343,3417,794,8.02,0,30.0,720785,6070,716929,11.39,2.65,0.5114333333333333,0.84,99.47
2022-05-20,Punjab,857,9,852,10533,4975,1923,8.14,0,30.0,721642,6079,717781,16.58,6.41,0.3511,0.84,99.46
2022-05-21,Punjab,222,1,217,2785,2146,87,7.97,4,30.0,721864,6080,717998,7.15,0.29,0.09283333333333334,0.84,99.46
2022-05-22,Punjab,840,5,839,10478,3504,46,8.02,0,30.0,722704,6085,718837,11.68,0.15,0.34926666666666667,0.84,99.46
2022-05-23,Punjab,656,6,653,8609,826,506,7.62,0,30.0,723360,6091,719490,2.75,1.69,0.28696666666666665,0.84,99.46
2022-05-24,Punjab,856,12,856,10596,2493,1648,8.08,0,30.0,724216,6103,720346,8.31,5.49,0.3532,0.84,99.47
2022-05-25,Punjab,664,5,661,8068,1097,628,8.23,0,30.0,724880,6108,721007,3.66,2.09,0.26893333333333336,0.84,99.47
2022-05-26,Punjab,1456,17,1450,18055,1068,908,8.06,0,30.0,726336,6125,722457,3.56,3.03,0.6018333333333333,0.84,99.47
2022-05-27,Punjab,833,6,833,10426,3759,2468,7.99,0,30.0,727169,6131,723290,12.53,8.23,0.34753333333333336,0.84,99.47
2022-05-28,Punjab,454,2,453,5966,809,302,7.61,0,30.0,727623,6133,723743,2.7,1.01,0.19886666666666666,0.84,99.47
2022-05-29,Punjab,1219,6,1218,15290,3667,624,7.97,0,30.0,728842,6139,724961,12.22,2.08,0.5096666666666667,0.84,99.47
2022-05-30,Punjab,1456,15,1451,18369,3494,3294,7.93,0,30.0,730298,6154,726412,11.65,10.98,0.6123,0.84,99.47
2022-05-31,Punjab,767,11,761,9360,1564,567,8.19,0,30.0,731065,6165,727173,5.21,1.89,0.312,0.84,99.47
2022-06-01,Punjab,1269,10,1263,15782,4395,1574,8.04,0,30.0,732334,6175,728436,14.65,5.25,0.5260666666666667,0.84,99.47
2022-06-02,Punjab,242,3,238,3110,4921,2633,7.78,1,30.0,732576,6178,728674,16.4,8.78,0.10366666666666667,0.84,99.47
2022-06-03,Punjab,426,2,419,5653,3997,1071,7.54,5,30.0,733002,6180,729093,13.32,3.57,0.18843333333333334,0.84,99.47
2022-06-04,Punjab,1084,8,1076,13239,4046,1146,8.19,0,30.0,734086,6188,730169,13.49,3.82,0.4413,0.84,99.47
2022-06-05,Punjab,837,9,833,10051,1118,784,8.33,0,30.0,734923,6197,731002,3.73,2.61,0.33503333333333335,0.84,99.47
2022-06-06,Punjab,556,3,548,6719,2082,732,8.28,5,30.0,735479,6200,731550,6.94,2.44,0.22396666666666668,0.84,99.47
2022-06-07,Punjab,1012,14,1006,13345,3995,2734,7.58,0,30.0,736491,6214,732556,13.32,9.11,0.44483333333333336,0.84,99.47
2022-06-08,Punjab,300,1,296,3972,1065,698,7.55,3,30.0,736791,6215,732852,3.55,2.33,0.1324,0.84,99.47
2022-06-09,Punjab,560,4,559,6953,3079,37,8.05,0,30.0,737351,6219,733411,10.26,0.12,0.23176666666666668,0.84,99.47
2022-06-10,Punjab,1414,8,1409,17712,1718,1705,7.98,0,30.0,738765,6227,734820,5.73,5.68,0.5904,0.84,99.47
2022-06-11,Punjab,203,2,197,2516,797,20,8.07,4,30.0,738968,6229,735017,2.66,0.07,0.08386666666666667,0.84,99.47
2022-06-12,Punjab,1344,7,1340,17087,3378,3096,7.87,0,30.0,740312,6236,736357,11.26,10.32,0.5695666666666667,0.84,99.47
2022-06-13,Punjab,438,3,438,5439,182,31,8.05,0,30.0,740750,6239,736795,0.61,0.1,0.1813,0.84,99.47
2022-06-14,Punjab,1261,7,1261,15657,1880,75,8.05,0,30.0,742011,6246,738056,6.27,0.25,0.5219,0.84,99.47
2022-06-15,Punjab,458,5,454,5895,829,145,7.77,0,30.0,742469,6251,738510,2.76,0.48,0.1965,0.84,99.47
2022-06-16,Punjab,319,1,318,3914,269,259,8.15,0,30.0,742788,6252,738828,0.9,0.86,0.13046666666666668,0.84,99.47
2022-06-17,Punjab,840,9,839,10574,4390,2891,7.94,0,30.0,743628,6261,739667,14.63,9.64,0.35246666666666665,0.84,99.47
2022-06-18,Punjab,1386,13,1381,17061,3581,2137,8.12,0,30.0,745014,6274,741048,11.94,7.12,0.5687,0.84,99.47
2022-06-19,Punjab,687,6,683,8996,2202,126,7.64,0,30.0,745701,6280,741731,7.34,0.42,0.29986666666666667,0.84,99.47
2022-06-20,Punjab,253,2,251,3102,283,249,8.16,0,30.0,745954,6282,741982,0.94,0.83,0.1034,0.84,99.47
2022-06-21,Punjab,761,4,757,9707,903,138,7.84,0,30.0,746715,6286,742739,3.01,0.46,0.32356666666666667,0.84,99.47
2022-06-22,Punjab,196,1,190,2153,1915,1894,9.1,5,30.0,746911,6287,742929,6.38,6.31,0.07176666666666667,0.84,99.47
2022-06-23,Punjab,1293,16,1290,16176,3365,1301,7.99,0,30.0,748204,6303,744219,11.22,4.34,0.5392,0.84,99.47
2022-06-24,Punjab,692,4,686,8595,748,311,8.05,2,30.0,748896,6307,744905,2.49,1.04,0.2865,0.84,99.47
2022-06-25,Punjab,1550,5,1541,19679,899,37,7.88,4,30.0,750446,6312,746446,3.0,0.12,0.6559666666666667,0.84,99.47
2022-06-26,Punjab,52,0,46,727,4071,20,7.15,6,30.0,750498,6312,746492,13.57,0.07,0.024233333333333332,0.84,99.47
2022-06-27,Punjab,591,3,585,7677,3884,2636,7.7,3,30.0,751089,6315,747077,12.95,8.79,0.2559,0.84,99.47
2022-06-28,Punjab,881,8,881,11263,4459,2196,7.82,0,30.0,751970,6323,747958,14.86,7.32,0.37543333333333334,0.84,99.47
2022-06-29,Punjab,905,10,902,11323,3825,849,7.99,0,30.0,752875,6333,748860,12.75,2.83,0.37743333333333334,0.84,99.47
2022-06-30,Punjab,499,4,492,6132,1372,1209,8.14,3,30.0,753374,6337,749352,4.57,4.03,0.2044,0.84,99.47
2022-07-01,Punjab,1543,9,1537,19157,1726,95,8.05,0,30.0,754917,6346,750889,5.75,0.32,0.6385666666666666,0.84,99.47
2022-07-02,Punjab,1040,12,1035,13037,4142,3031,7.98,0,30.0,755957,6358,751924,13.81,10.1,0.43456666666666666,0.84,99.47
2022-07-03,Punjab,288,2,283,3787,3648,3408,7.6,3,30.0,756245,6360,752207,12.16,11.36,0.12623333333333334,0.84,99.47
2022-07-04,Punjab,654,8,645,8178,4311,3950,8.0,1,30.0,756899,6368,752852,14.37,13.17,0.2726,0.84,99.47
2022-07-05,Punjab,1200,13,1197,14800,1853,1111,8.11,0,30.0,758099,6381,754049,6.18,3.7,0.49333333333333335,0.84,99.47
2022-07-06,Punjab,262,3,254,3193,4478,3058,8.21,5,30.0,758361,6384,754303,14.93,10.19,0.10643333333333334,0.84,99.46
2022-07-07,Punjab,38,0,31,512,2284,1959,7.42,7,30.0,758399,6384,754334,7.61,6.53,0.017066666666666667,0.84,99.46
2022-07-08,Punjab,1532,11,1527,18746,2013,916,8.17,0,30.0,759931,6395,755861,6.71,3.05,0.6248666666666667,0.84,99.46
2022-07-09,Punjab,1411,9,1405,17410,2722,2317,8.1,0,30.0,761342,6404,757266,9.07,7.72,0.5803333333333334,0.84,99.46
2022-07-10,Punjab,261,3,260,3281,3446,1517,7.95,0,30.0,761603,6407,757526,11.49,5.06,0.10936666666666667,0.84,99.46
2022-07-11,Punjab,98,1,95,1393,1018,698,7.04,2,30.0,761701,6408,757621,3.39,2.33,0.04643333333333333,0.84,99.46
2022-07-12,Punjab,717,3,711,8717,627,480,8.23,3,30.0,762418,6411,758332,2.09,1.6,0.29056666666666664,0.84,99.46
2022-07-13,Punjab,453,3,446,5941,2113,1908,7.62,4,30.0,762871,6414,758778,7.04,6.36,0.19803333333333334,0.84,99.46
2022-07-14,Punjab,1380,6,1377,17132,403,324,8.06,0,30.0,764251,6420,760155,1.34,1.08,0.5710666666666666,0.84,99.46
2022-07-15,Punjab,1277,17,1268,16376,3366,1601,7.8,0,30.0,765528,6437,761423,11.22,5.34,0.5458666666666666,0.84,99.46
2022-07-16,Punjab,359,3,352,4517,2736,2157,7.95,4,30.0,765887,6440,761775,9.12,7.19,0.15056666666666665,0.84,99.46
2022-07-17,Punjab,1023,5,1018,12864,3649,478,7.95,0,30.0,766910,6445,762793,12.16,1.59,0.4288,0.84,99.46
2022-07-18,Punjab,1566,19,1564,19893,3851,196,7.87,0,30.0,768476,6464,764357,12.84,0.65,0.6631,0.84,99.46
2022-07-19,Punjab,214,0,206,2567,502,337,8.34,8,30.0,768690,6464,764563,1.67,1.12,0.08556666666666667,0.84,99.46
2022-07-20,Punjab,844,10,837,10784,1991,1407,7.83,0,30.0,769534,6474,765400,6.64,4.69,0.35946666666666666,0.84,99.46
2022-07-21,Punjab,812,3,804,9820,1785,480,8.27,5,30.0,770346,6477,766204,5.95,1.6,0.3273333333333333,0.84,99.46
2022-07-22,Punjab,691,3,686,8653,4148,3993,7.99,2,30.0,771037,6480,766890,13.83,13.31,0.2884333333333333,0.84,99.46
2022-07-23,Punjab,1441,9,1439,18079,3742,993,7.97,0,30.0,772478,6489,768329,12.47,3.31,0.6026333333333334,0.84,99.46
2022-07-24,Punjab,1502,21,1497,19002,2276,439,7.9,0,30.0,773980,6510,769826,7.59,1.46,0.6334,0.84,99.46
2022-07-25,Punjab,1181,14,1180,14912,4859,1459,7.92,0,30.0,775161,6524,771006,16.2,4.86,0.49706666666666666,0.84,99.46
2022-07-26,Punjab,914,11,911,11309,1224,999,8.08,0,30.0,776075,6535,771917,4.08,3.33,0.37696666666666667,0.84,99.46
2022-07-27,Punjab,167,1,161,1923,1879,236,8.68,5,30.0,776242,6536,772078,6.26,0.79,0.0641,0.84,99.46
2022-07-28,Punjab,868,7,867,10742,1372,305,8.08,0,30.0,777110,6543,772945,4.57,1.02,0.35806666666666664,0.84,99.46
2022-07-29,Punjab,630,5,629,8167,4433,1029,7.71,0,30.0,777740,6548,773574,14.78,3.43,0.2722333333333333,0.84,99.46
2022-07-30,Punjab,401,3,393,4932,2302,278,8.13,5,30.0,778141,6551,773967,7.67,0.93,0.1644,0.84,99.46
2022-07-31,Punjab,685,4,678,8577,4278,3896,7.99,3,30.0,778826,6555,774645,14.26,12.99,0.2859,0.84,99.46
2022-08-01,Punjab,1287,14,1283,15864,3205,1665,8.11,0,30.0,780113,6569,775928,10.68,5.55,0.5288,0.84,99.46
2022-08-02,Punjab,1449,12,1444,17989,3155,606,8.05,0,30.0,781562,6581,777372,10.52,2.02,0.5996333333333334,0.84,99.46
2022-08-03,Punjab,941,5,932,11457,381,69,8.21,4,30.0,782503,6586,778304,1.27,0.23,0.3819,0.84,99.46
2022-08-04,Punjab,514,6,514,6278,4426,2289,8.19,0,30.0,783017,6592,778818,14.75,7.63,0.20926666666666666,0.84,99.46
2022-08-05,Punjab,445,4,444,6060,2024,677,7.34,0,30.0,783462,6596,779262,6.75,2.26,0.202,0.84,99.46
2022-08-06,Punjab,1370,7,1366,17471,3315,1304,7.84,0,30.0,784832,6603,780628,11.05,4.35,0.5823666666666667,0.84,99.46
2022-08-07,Punjab,120,0,118,1548,873,196,7.75,2,30.0,784952,6603,780746,2.91,0.65,0.0516,0.84,99.46
2022-08-08,Punjab,856,12,855,10709,4713,653,7.99,0,30.0,785808,6615,781601,15.71,2.18,0.35696666666666665,0.84,99.46
2022-08-09,Punjab,1360,12,1355,17095,3011,1311,7.96,0,30.0,787168,6627,782956,10.04,4.37,0.5698333333333333,0.84,99.46
2022-08-10,Punjab,1035,9,1034,13184,3569,3156,7.85,0,30.0,788203,6636,783990,11.9,10.52,0.43946666666666667,0.84,99.47
2022-08-11,Punjab,1074,3,1070,13693,4895,1469,7.84,1,30.0,789277,6639,785060,16.32,4.9,0.45643333333333336,0.84,99.47
2022-08-12,Punjab,1260,18,1255,15583,1411,305,8.09,0,30.0,790537,6657,786315,4.7,1.02,0.5194333333333333,0.84,99.47
2022-08-13,Punjab,1428,5,1424,18021,793,255,7.92,0,30.0,791965,6662,787739,2.64,0.85,0.6007,0.84,99.47
2022-08-14,Punjab,450,5,448,6080,1670,1554,7.4,0,30.0,792415,6667,788187,5.57,5.18,0.20266666666666666,0.84,99.47
2022-08-15,Punjab,607,5,601,7297,4951,4886,8.32,1,30.0,793022,6672,788788,16.5,16.29,0.24323333333333333,0.84,99.47
2022-08-16,Punjab,1577,13,1574,19953,4966,237,7.9,0,30.0,794599,6685,790362,16.55,0.79,0.6651,0.84,99.47
2022-08-17,Punjab,265,1,265,3310,1695,666,8.01,0,30.0,794864,6686,790627,5.65,2.22,0.11033333333333334,0.84,99.47
2022-08-18,Punjab,976,2,967,12485,4922,1680,7.82,7,30.0,795840,6688,791594,16.41,5.6,0.4161666666666667,0.84,99.47
2022-08-19,Punjab,747,6,746,9270,738,637,8.06,0,30.0,796587,6694,792340,2.46,2.12,0.309,0.84,99.47
2022-08-20,Punjab,1492,9,1488,18960,267,208,7.87,0,30.0,798079,6703,793828,0.89,0.69,0.632,0.84,99.47
2022-08-21,Punjab,1223,5,1220,15447,2256,1739,7.92,0,30.0,799302,6708,795048,7.52,5.8,0.5149,0.84,99.47
2022-08-22,Punjab,438,3,433,5436,366,193,8.06,2,30.0,799740,6711,795481,1.22,0.64,0.1812,0.84,99.47
2022-08-23,Punjab,1171,17,1165,14445,365,130,8.11,0,30.0,800911,6728,796646,1.22,0.43,0.4815,0.84,99.47
2022-08-24,Punjab,721,8,720,9412,4169,1815,7.66,0,30.0,801632,6736,797366,13.9,6.05,0.3137333333333333,0.84,99.47
2022-08-25,Punjab,1208,11,1206,15579,3696,1229,7.75,0,30.0,802840,6747,798572,12.32,4.1,0.5193,0.84,99.47
2022-08-26,Punjab,706,5,706,9032,1152,164,7.82,0,30.0,803546,6752,799278,3.84,0.55,0.30106666666666665,0.84,99.47
2022-08-27,Punjab,285,4,285,3665,415,18,7.78,0,30.0,803831,6756,799563,1.38,0.06,0.12216666666666667,0.84,99.47
2022-08-28,Punjab,1219,4,1215,15371,2459,859,7.93,0,30.0,805050,6760,800778,8.2,2.86,0.5123666666666666,0.84,99.47
2022-08-29,Punjab,1529,14,1523,19268,2103,1333,7.94,0,30.0,806579,6774,802301,7.01,4.44,0.6422666666666667,0.84,99.47
2022-08-30,Punjab,680,6,675,8353,4207,2763,8.14,0,30.0,807259,6780,802976,14.02,9.21,0.2784333333333333,0.84,99.47
2022-08-31,Punjab,794,10,790,10059,3856,2143,7.89,0,30.0,808053,6790,803766,12.85,7.14,0.3353,0.84,99.47
2022-09-01,Punjab,520,1,515,6574,3035,3030,7.91,4,30.0,808573,6791,804281,10.12,10.1,0.21913333333333335,0.84,99.47
2022-09-02,Punjab,664,6,661,8298,2235,1681,8.0,0,30.0,809237,6797,804942,7.45,5.6,0.2766,0.84,99.47
2022-09-03,Punjab,802,4,801,9704,341,222,8.26,0,30.0,810039,6801,805743,1.14,0.74,0.3234666666666667,0.84,99.47
2022-09-04,Punjab,627,4,625,7840,259,150,8.0,0,30.0,810666,6805,806368,0.86,0.5,0.2613333333333333,0.84,99.47
2022-09-05,Punjab,884,11,879,10916,1206,1201,8.1,0,30.0,811550,6816,807247,4.02,4.0,0.36386666666666667,0.84,99.47
2022-09-06,Punjab,564,6,562,7671,4198,3605,7.35,0,30.0,812114,6822,807809,13.99,12.02,0.2557,0.84,99.47
2022-09-07,Punjab,591,7,584,7310,3113,1888,8.08,0,30.0,812705,6829,808393,10.38,6.29,0.24366666666666667,0.84,99.47
2022-09-08,Punjab,434,3,427,5442,2484,674,7.98,4,30.0,813139,6832,808820,8.28,2.25,0.1814,0.84,99.47
2022-09-09,Punjab,920,6,913,11051,609,96,8.33,1,30.0,814059,6838,809733,2.03,0.32,0.3683666666666667,0.84,99.47
2022-09-10,Punjab,1324,13,1320,17144,3962,2287,7.72,0,30.0,815383,6851,811053,13.21,7.62,0.5714666666666667,0.84,99.47
2022-09-11,Punjab,657,4,656,7982,2117,1945,8.23,0,30.0,816040,6855,811709,7.06,6.48,0.2660666666666667,0.84,99.47
2022-09-12,Punjab,253,3,250,3203,1836,466,7.9,0,30.0,816293,6858,811959,6.12,1.55,0.10676666666666666,0.84,99.47
2022-09-13,Punjab,965,10,960,12218,3763,1113,7.9,0,30.0,817258,6868,812919,12.54,3.71,0.40726666666666667,0.84,99.47
2022-09-14,Punjab,72,0,66,676,1697,1148,10.65,6,30.0,817330,6868,812985,5.66,3.83,0.022533333333333332,0.84,99.47
2022-09-15,Punjab,1258,18,1250,15743,2087,573,7.99,0,30.0,818588,6886,814235,6.96,1.91,0.5247666666666667,0.84,99.47
2022-09-16,Punjab,726,5,724,8935,1806,1602,8.13,0,30.0,819314,6891,814959,6.02,5.34,0.29783333333333334,0.84,99.47
2022-09-17,Punjab,504,1,502,6120,3053,2664,8.24,1,30.0,819818,6892,815461,10.18,8.88,0.204,0.84,99.47
2022-09-18,Punjab,1515,14,1513,18815,1312,716,8.05,0,30.0,821333,6906,816974,4.37,2.39,0.6271666666666667,0.84,99.47
2022-09-19,Punjab,1093,6,1086,13454,2460,544,8.12,1,30.0,822426,6912,818060,8.2,1.81,0.4484666666666667,0.84,99.47
2022-09-20,Punjab,1065,14,1063,13276,3431,597,8.02,0,30.0,823491,6926,819123,11.44,1.99,0.44253333333333333,0.84,99.47
2022-09-21,Punjab,1109,8,1105,14242,4141,2907,7.79,0,30.0,824600,6934,820228,13.8,9.69,0.47473333333333334,0.84,99.47
2022-09-22,Punjab,897,12,896,11405,988,260,7.86,0,30.0,825497,6946,821124,3.29,0.87,0.38016666666666665,0.84,99.47
2022-09-23,Punjab,899,11,899,11495,1676,1112,7.82,0,30.0,826396,6957,822023,5.59,3.71,0.38316666666666666,0.84,99.47
2022-09-24,Punjab,804,9,803,10138,4617,16,7.93,0,30.0,827200,6966,822826,15.39,0.05,0.3379333333333333,0.84,99.47
2022-09-25,Punjab,794,9,793,10250,2541,765,7.75,0,30.0,827994,6975,823619,8.47,2.55,0.3416666666666667,0.84,99.47
2022-09-26,Punjab,970,7,962,12262,1883,1629,7.91,1,30.0,828964,6982,824581,6.28,5.43,0.40873333333333334,0.84,99.47
2022-09-27,Punjab,144,1,142,1902,4876,3546,7.57,1,30.0,829108,6983,824723,16.25,11.82,0.0634,0.84,99.47
2022-09-28,Punjab,1387,18,1386,17059,1476,485,8.13,0,30.0,830495,7001,826109,4.92,1.62,0.5686333333333333,0.84,99.47
2022-09-29,Punjab,1178,10,1178,14791,4308,278,7.96,0,30.0,831673,7011,827287,14.36,0.93,0.4930333333333333,0.84,99.47
2022-09-30,Punjab,883,9,878,11063,1742,278,7.98,0,30.0,832556,7020,828165,5.81,0.93,0.3687666666666667,0.84,99.47
2022-10-01,Punjab,707,7,698,9015,1594,1530,7.84,2,30.0,833263,7027,828863,5.31,5.1,0.3005,0.84,99.47
2022-10-02,Punjab,544,5,537,6825,1789,786,7.97,2,30.0,833807,7032,829400,5.96,2.62,0.2275,0.84,99.47
2022-10-03,Punjab,165,1,160,1975,3743,2493,8.35,4,30.0,833972,7033,829560,12.48,8.31,0.06583333333333333,0.84,99.47
2022-10-04,Punjab,295,1,291,3614,3764,3279,8.16,3,30.0,834267,7034,829851,12.55,10.93,0.12046666666666667,0.84,99.47
2022-10-05,Punjab,1204,6,1197,14693,2876,1772,8.19,1,30.0,835471,7040,831048,9.59,5.91,0.4897666666666667,0.84,99.47
2022-10-06,Punjab,1046,3,1044,12983,3593,1565,8.06,0,30.0,836517,7043,832092,11.98,5.22,0.4327666666666667,0.84,99.47
2022-10-07,Punjab,850,8,849,10284,2301,912,8.27,0,30.0,837367,7051,832941,7.67,3.04,0.3428,0.84,99.47
2022-10-08,Punjab,1135,3,1131,14493,965,874,7.83,1,30.0,838502,7054,834072,3.22,2.91,0.4831,0.84,99.47
2022-10-09,Punjab,303,3,296,3552,2859,281,8.53,4,30.0,838805,7057,834368,9.53,0.94,0.1184,0.84,99.47
2022-10-10,Punjab,335,4,331,4064,3467,2037,8.24,0,30.0,839140,7061,834699,11.56,6.79,0.13546666666666668,0.84,99.47
2022-10-11,Punjab,404,4,395,5225,1072,390,7.73,5,30.0,839544,7065,835094,3.57,1.3,0.17416666666666666,0.84,99.47
2022-10-12,Punjab,1196,9,1196,14908,3009,1723,8.02,0,30.0,840740,7074,836290,10.03,5.74,0.49693333333333334,0.84,99.47
2022-10-13,Punjab,600,8,593,7668,4202,2991,7.82,0,30.0,841340,7082,836883,14.01,9.97,0.2556,0.84,99.47
2022-10-14,Punjab,990,14,985,12813,4558,3206,7.73,0,30.0,842330,7096,837868,15.19,10.69,0.4271,0.84,99.47
2022-10-15,Punjab,493,2,486,6083,4369,4315,8.1,5,30.0,842823,7098,838354,14.56,14.38,0.20276666666666668,0.84,99.47
2022-10-16,Punjab,41,0,38,545,4633,4591,7.52,3,30.0,842864,7098,838392,15.44,15.3,0.018166666666666668,0.84,99.47
2022-10-17,Punjab,1442,16,1438,18238,2908,1324,7.91,0,30.0,844306,7114,839830,9.69,4.41,0.6079333333333333,0.84,99.47
2022-10-18,Punjab,135,1,128,1904,3325,888,7.09,6,30.0,844441,7115,839958,11.08,2.96,0.06346666666666667,0.84,99.47
2022-10-19,Punjab,931,5,928,11258,4122,2591,8.27,0,30.0,845372,7120,840886,13.74,8.64,0.3752666666666667,0.84,99.47
2022-10-20,Punjab,302,1,297,3717,2555,331,8.12,4,30.0,845674,7121,841183,8.52,1.1,0.1239,0.84,99.47
2022-10-21,Punjab,336,4,327,4551,4858,6,7.38,5,30.0,846010,7125,841510,16.19,0.02,0.1517,0.84,99.47
2022-10-22,Punjab,1362,12,1354,17162,2842,810,7.94,0,30.0,847372,7137,842864,9.47,2.7,0.5720666666666666,0.84,99.47
2022-10-23,Punjab,1086,3,1086,13906,745,666,7.81,0,30.0,848458,7140,843950,2.48,2.22,0.46353333333333335,0.84,99.47
2022-10-24,Punjab,1271,13,1270,15909,2812,309,7.99,0,30.0,849729,7153,845220,9.37,1.03,0.5303,0.84,99.47
2022-10-25,Punjab,1065,5,1062,13444,4343,3388,7.92,0,30.0,850794,7158,846282,14.48,11.29,0.44813333333333333,0.84,99.47
2022-10-26,Punjab,947,5,947,11516,3820,428,8.22,0,30.0,851741,7163,847229,12.73,1.43,0.3838666666666667,0.84,99.47
2022-10-27,Punjab,973,4,972,12460,471,113,7.81,0,30.0,852714,7167,848201,1.57,0.38,0.41533333333333333,0.84,99.47
2022-10-28,Punjab,170,2,167,1982,4482,3711,8.58,1,30.0,852884,7169,848368,14.94,12.37,0.06606666666666666,0.84,99.47
2022-10-29,Punjab,1474,13,1474,18102,379,76,8.14,0,30.0,854358,7182,849842,1.26,0.25,0.6034,0.84,99.47
2022-10-30,Punjab,751,4,745,9570,4574,2012,7.85,2,30.0,855109,7186,850587,15.25,6.71,0.319,0.84,99.47
2022-10-31,Punjab,367,4,363,4297,758,194,8.54,0,30.0,855476,7190,850950,2.53,0.65,0.14323333333333332,0.84,99.47
2022-11-01,Punjab,475,7,472,6175,579,38,7.69,0,30.0,855951,7197,851422,1.93,0.13,0.20583333333333334,0.84,99.47
2022-11-02,Punjab,352,2,345,4650,4585,3330,7.57,5,30.0,856303,7199,851767,15.28,11.1,0.155,0.84,99.47
2022-11-03,Punjab,585,3,585,7073,425,267,8.27,0,30.0,856888,7202,852352,1.42,0.89,0.23576666666666668,0.84,99.47
2022-11-04,Punjab,1482,8,1478,18616,4177,4098,7.96,0,30.0,858370,7210,853830,13.92,13.66,0.6205333333333334,0.84,99.47
2022-11-05,Punjab,529,7,525,6754,2269,1360,7.83,0,30.0,858899,7217,854355,7.56,4.53,0.22513333333333332,0.84,99.47
2022-11-06,Punjab,730,2,730,9087,976,359,8.03,0,30.0,859629,7219,855085,3.25,1.2,0.3029,0.84,99.47
2022-11-07,Punjab,813,6,807,9865,2207,322,8.24,0,30.0,860442,7225,855892,7.36,1.07,0.3288333333333333,0.84,99.47
2022-11-08,Punjab,1542,6,1537,19291,3546,986,7.99,0,30.0,861984,7231,857429,11.82,3.29,0.6430333333333333,0.84,99.47
2022-11-09,Punjab,1263,6,1258,15725,1368,608,8.03,0,30.0,863247,7237,858687,4.56,2.03,0.5241666666666667,0.84,99.47
2022-11-10,Punjab,1269,6,1261,16043,1711,591,7.91,2,30.0,864516,7243,859948,5.7,1.97,0.5347666666666666,0.84,99.47
2022-11-11,Punjab,1246,6,1244,15457,3005,829,8.06,0,30.0,865762,7249,861192,10.02,2.76,0.5152333333333333,0.84,99.47
2022-11-12,Punjab,828,11,820,10587,4277,1938,7.82,0,30.0,866590,7260,862012,14.26,6.46,0.3529,0.84,99.47
2022-11-13,Punjab,985,6,980,12315,4900,991,8.0,0,30.0,867575,7266,862992,16.33,3.3,0.4105,0.84,99.47
2022-11-14,Punjab,212,2,205,2736,189,56,7.75,5,30.0,867787,7268,863197,0.63,0.19,0.0912,0.84,99.47
2022-11-15,Punjab,899,10,895,11267,4494,472,7.98,0,30.0,868686,7278,864092,14.98,1.57,0.37556666666666666,0.84,99.47
2022-11-16,Punjab,733,4,725,9144,3972,1181,8.02,4,30.0,869419,7282,864817,13.24,3.94,0.3048,0.84,99.47
2022-11-17,Punjab,181,0,178,1966,1789,357,9.21,3,30.0,869600,7282,864995,5.96,1.19,0.06553333333333333,0.84,99.47
2022-11-18,Punjab,635,5,634,7844,211,11,8.1,0,30.0,870235,7287,865629,0.7,0.04,0.2614666666666667,0.84,99.47
2022-11-19,Punjab,817,4,808,10037,4502,3316,8.14,5,30.0,871052,7291,866437,15.01,11.05,0.3345666666666667,0.84,99.47
2022-11-20,Punjab,1001,11,993,12293,669,248,8.14,0,30.0,872053,7302,867430,2.23,0.83,0.40976666666666667,0.84,99.47
2022-11-21,Punjab,566,2,565,7366,1607,897,7.68,0,30.0,872619,7304,867995,5.36,2.99,0.24553333333333333,0.84,99.47
2022-11-22,Punjab,213,2,209,2698,2157,729,7.89,2,30.0,872832,7306,868204,7.19,2.43,0.08993333333333334,0.84,99.47
2022-11-23,Punjab,1209,11,1202,14844,1389,405,8.14,0,30.0,874041,7317,869406,4.63,1.35,0.4948,0.84,99.47
2022-11-24,Punjab,1258,15,1254,16094,3175,1522,7.82,0,30.0,875299,7332,870660,10.58,5.07,0.5364666666666666,0.84,99.47
2022-11-25,Punjab,736,5,732,9086,3767,191,8.1,0,30.0,876035,7337,871392,12.56,0.64,0.3028666666666667,0.84,99.47
2022-11-26,Punjab,668,5,660,8609,1683,1574,7.76,3,30.0,876703,7342,872052,5.61,5.25,0.28696666666666665,0.84,99.47
2022-11-27,Punjab,1469,13,1461,18499,288,282,7.94,0,30.0,878172,7355,873513,0.96,0.94,0.6166333333333334,0.84,99.47
2022-11-28,Punjab,1084,15,1083,13683,1607,1270,7.92,0,30.0,879256,7370,874596,5.36,4.23,0.4561,0.84,99.47
2022-11-29,Punjab,526,4,523,6435,4295,3416,8.17,0,30.0,879782,7374,875119,14.32,11.39,0.2145,0.84,99.47
2022-11-30,Punjab,974,4,965,12135,1092,53,8.03,5,30.0,880756,7378,876084,3.64,0.18,0.4045,0.84,99.47
2022-12-01,Punjab,448,5,446,5102,2271,1417,8.78,0,30.0,881204,7383,876530,7.57,4.72,0.17006666666666667,0.84,99.47
2022-12-02,Punjab,1462,13,1457,18524,3628,3065,7.89,0,30.0,882666,7396,877987,12.09,10.22,0.6174666666666667,0.84,99.47
2022-12-03,Punjab,361,4,355,4693,2083,1521,7.69,2,30.0,883027,7400,878342,6.94,5.07,0.15643333333333334,0.84,99.47
2022-12-04,Punjab,1503,7,1503,19255,3057,424,7.81,0,30.0,884530,7407,879845,10.19,1.41,0.6418333333333334,0.84,99.47
2022-12-05,Punjab,418,2,411,5277,105,74,7.92,5,30.0,884948,7409,880256,0.35,0.25,0.1759,0.84,99.47
2022-12-06,Punjab,799,5,794,9560,3580,904,8.36,0,30.0,885747,7414,881050,11.93,3.01,0.31866666666666665,0.84,99.47
2022-12-07,Punjab,1163,4,1154,14326,1143,64,8.12,5,30.0,886910,7418,882204,3.81,0.21,0.4775333333333333,0.84,99.47
2022-12-08,Punjab,223,2,220,2935,3654,1779,7.6,1,30.0,887133,7420,882424,12.18,5.93,0.09783333333333333,0.84,99.47
2022-12-09,Punjab,120,1,114,1740,3986,2237,6.9,5,30.0,887253,7421,882538,13.29,7.46,0.058,0.84,99.47
2022-12-10,Punjab,493,5,490,6009,58,36,8.2,0,30.0,887746,7426,883028,0.19,0.12,0.2003,0.84,99.47
2022-12-11,Punjab,1304,18,1302,16279,1459,54,8.01,0,30.0,889050,7444,884330,4.86,0.18,0.5426333333333333,0.84,99.47
2022-12-12,Punjab,236,1,230,2658,1130,957,8.88,5,30.0,889286,7445,884560,3.77,3.19,0.0886,0.84,99.47
2022-12-13,Punjab,1105,6,1104,13684,2759,314,8.08,0,30.0,890391,7451,885664,9.2,1.05,0.45613333333333334,0.84,99.47
2022-12-14,Punjab,121,1,118,1831,2879,1001,6.61,2,30.0,890512,7452,885782,9.6,3.34,0.061033333333333335,0.84,99.47
2022-12-15,Punjab,119,1,112,1266,4263,3637,9.4,6,30.0,890631,7453,885894,14.21,12.12,0.0422,0.84,99.47
2022-12-16,Punjab,241,3,235,3321,333,176,7.26,3,30.0,890872,7456,886129,1.11,0.59,0.1107,0.84,99.47
2022-12-17,Punjab,762,8,754,9282,2123,244,8.21,0,30.0,891634,7464,886883,7.08,0.81,0.3094,0.84,99.47
2022-12-18,Punjab,773,10,766,9343,299,78,8.27,0,30.0,892407,7474,887649,1.0,0.26,0.31143333333333334,0.84,99.47
2022-12-19,Punjab,1355,6,1354,16506,4357,2960,8.21,0,30.0,893762,7480,889003,14.52,9.87,0.5502,0.84,99.47
2022-12-20,Punjab,1251,15,1244,15696,80,72,7.97,0,30.0,895013,7495,890247,0.27,0.24,0.5232,0.84,99.47
2022-12-21,Punjab,712,6,707,9139,737,37,7.79,0,30.0,895725,7501,890954,2.46,0.12,0.3046333333333333,0.84,99.47
2022-12-22,Punjab,1591,19,1586,19836,3213,552,8.02,0,30.0,897316,7520,892540,10.71,1.84,0.6612,0.84,99.47
2022-12-23,Punjab,429,4,426,5612,4903,4763,7.64,0,30.0,897745,7524,892966,16.34,15.88,0.18706666666666666,0.84,99.47
2022-12-24,Punjab,475,4,473,5520,2202,410,8.61,0,30.0,898220,7528,893439,7.34,1.37,0.184,0.84,99.47
2022-12-25,Punjab,1006,5,1003,12927,2636,221,7.78,0,30.0,899226,7533,894442,8.79,0.74,0.4309,0.84,99.47
2022-12-26,Punjab,813,3,810,10529,732,364,7.72,0,30.0,900039,7536,895252,2.44,1.21,0.35096666666666665,0.84,99.47
2022-12-27,Punjab,749,7,749,9067,89,1,8.26,0,30.0,900788,7543,896001,0.3,0.0,0.30223333333333335,0.84,99.47
2022-12-28,Punjab,273,1,268,3435,4218,92,7.95,4,30.0,901061,7544,896269,14.06,0.31,0.1145,0.84,99.47
2022-12-29,Punjab,498,6,492,6177,2874,2372,8.06,0,30.0,901559,7550,896761,9.58,7.91,0.2059,0.84,99.47
2022-12-30,Punjab,406,4,397,4992,4549,387,8.13,5,30.0,901965,7554,897158,15.16,1.29,0.1664,0.84,99.47
2022-12-31,Punjab,477,6,468,6055,3253,280,7.88,3,30.0,902442,7560,897626,10.84,0.93,0.20183333333333334,0.84,99.47
2020-01-01,Rajasthan,854,7,850,10629,3971,3049,8.03,0,81.0,854,7,850,4.9,3.76,0.1312222222222222,0.82,99.53
2020-01-02,Rajasthan,332,2,332,4324,1476,1302,7.68,0,81.0,1186,9,1182,1.82,1.61,0.05338271604938272,0.76,99.66
2020-01-03,Rajasthan,950,4,945,11588,4129,1627,8.2,1,81.0,2136,13,2127,5.1,2.01,0.14306172839506173,0.61,99.58
2020-01-04,Rajasthan,1462,7,1457,18042,2212,1990,8.1,0,81.0,3598,20,3584,2.73,2.46,0.22274074074074074,0.56,99.61
2020-01-05,Rajasthan,215,1,211,2591,298,19,8.3,3,81.0,3813,21,3795,0.37,0.02,0.03198765432098766,0.55,99.53
2020-01-06,Rajasthan,1342,11,1336,17049,2111,1698,7.87,0,81.0,5155,32,5131,2.61,2.1,0.2104814814814815,0.62,99.53
2020-01-07,Rajasthan,1462,5,1457,17957,3668,2189,8.14,0,81.0,6617,37,6588,4.53,2.7,0.22169135802469137,0.56,99.56
2020-01-08,Rajasthan,1337,13,1328,16746,4665,4154,7.98,0,81.0,7954,50,7916,5.76,5.13,0.20674074074074075,0.63,99.52
2020-01-09,Rajasthan,1030,4,1024,12810,2675,1803,8.04,2,81.0,8984,54,8940,3.3,2.23,0.15814814814814815,0.6,99.51
2020-01-10,Rajasthan,379,3,378,5070,3207,3041,7.48,0,81.0,9363,57,9318,3.96,3.75,0.06259259259259259,0.61,99.52
2020-01-11,Rajasthan,995,7,990,12558,4125,2082,7.92,0,81.0,10358,64,10308,5.09,2.57,0.15503703703703703,0.62,99.52
2020-01-12,Rajasthan,926,13,926,11007,2222,1357,8.41,0,81.0,11284,77,11234,2.74,1.68,0.1358888888888889,0.68,99.56
2020-01-13,Rajasthan,1415,11,1415,17459,4174,954,8.1,0,81.0,12699,88,12649,5.15,1.18,0.2155432098765432,0.69,99.61
2020-01-14,Rajasthan,418,4,410,5110,844,822,8.18,4,81.0,13117,92,13059,1.04,1.01,0.06308641975308642,0.7,99.56
2020-01-15,Rajasthan,847,7,843,10349,4346,2677,8.18,0,81.0,13964,99,13902,5.37,3.3,0.12776543209876542,0.71,99.56
2020-01-16,Rajasthan,1288,18,1284,16419,2215,312,7.84,0,81.0,15252,117,15186,2.73,0.39,0.2027037037037037,0.77,99.57
2020-01-17,Rajasthan,1042,7,1037,13049,4168,2369,7.99,0,81.0,16294,124,16223,5.15,2.92,0.16109876543209878,0.76,99.56
2020-01-18,Rajasthan,1185,14,1185,14530,2632,2230,8.16,0,81.0,17479,138,17408,3.25,2.75,0.17938271604938272,0.79,99.59
2020-01-19,Rajasthan,345,1,342,4387,4154,2932,7.86,2,81.0,17824,139,17750,5.13,3.62,0.0541604938271605,0.78,99.58
2020-01-20,Rajasthan,599,3,597,7624,3429,2670,7.86,0,81.0,18423,142,18347,4.23,3.3,0.09412345679012346,0.77,99.59
2020-01-21,Rajasthan,936,8,935,11805,1235,140,7.93,0,81.0,19359,150,19282,1.52,0.17,0.14574074074074075,0.77,99.6
2020-01-22,Rajasthan,1289,4,1284,16040,1165,175,8.04,1,81.0,20648,154,20566,1.44,0.22,0.1980246913580247,0.75,99.6
2020-01-23,Rajasthan,418,5,415,5130,3861,1941,8.15,0,81.0,21066,159,20981,4.77,2.4,0.06333333333333334,0.75,99.6
2020-01-24,Rajasthan,1466,10,1458,17754,2978,2029,8.26,0,81.0,22532,169,22439,3.68,2.5,0.21918518518518518,0.75,99.59
2020-01-25,Rajasthan,521,5,516,6302,2609,676,8.27,0,81.0,23053,174,22955,3.22,0.83,0.07780246913580247,0.75,99.57
2020-01-26,Rajasthan,1384,10,1377,17429,4021,3741,7.94,0,81.0,24437,184,24332,4.96,4.62,0.21517283950617283,0.75,99.57
2020-01-27,Rajasthan,929,4,921,11517,1434,790,8.07,4,81.0,25366,188,25253,1.77,0.98,0.1421851851851852,0.74,99.55
2020-01-28,Rajasthan,647,9,640,8419,3714,899,7.68,0,81.0,26013,197,25893,4.59,1.11,0.10393827160493826,0.76,99.54
2020-01-29,Rajasthan,243,1,240,3233,4442,3568,7.52,2,81.0,26256,198,26133,5.48,4.4,0.03991358024691358,0.75,99.53
2020-01-30,Rajasthan,1327,4,1323,16298,1761,638,8.14,0,81.0,27583,202,27456,2.17,0.79,0.20120987654320988,0.73,99.54
2020-01-31,Rajasthan,1385,18,1379,17420,3866,3740,7.95,0,81.0,28968,220,28835,4.77,4.62,0.21506172839506174,0.76,99.54
2020-02-01,Rajasthan,215,1,211,3168,1966,104,6.79,3,81.0,29183,221,29046,2.43,0.13,0.03911111111111111,0.76,99.53
2020-02-02,Rajasthan,1035,11,1027,12717,2431,827,8.14,0,81.0,30218,232,30073,3.0,1.02,0.157,0.77,99.52
2020-02-03,Rajasthan,274,2,265,3188,4470,2031,8.59,7,81.0,30492,234,30338,5.52,2.51,0.039358024691358025,0.77,99.49
2020-02-04,Rajasthan,990,9,989,12335,3931,1123,8.03,0,81.0,31482,243,31327,4.85,1.39,0.15228395061728395,0.77,99.51
2020-02-05,Rajasthan,1265,15,1258,16140,1110,1064,7.84,0,81.0,32747,258,32585,1.37,1.31,0.19925925925925925,0.79,99.51
2020-02-06,Rajasthan,1534,13,1528,19235,4729,2020,7.98,0,81.0,34281,271,34113,5.84,2.49,0.23746913580246914,0.79,99.51
2020-02-07,Rajasthan,199,0,194,2322,2431,922,8.57,5,81.0,34480,271,34307,3.0,1.14,0.028666666666666667,0.79,99.5
2020-02-08,Rajasthan,515,3,514,6399,2147,1533,8.05,0,81.0,34995,274,34821,2.65,1.89,0.079,0.78,99.5
2020-02-09,Rajasthan,891,6,891,11061,2367,788,8.06,0,81.0,35886,280,35712,2.92,0.97,0.13655555555555557,0.78,99.52
2020-02-10,Rajasthan,191,2,185,2507,466,451,7.62,4,81.0,36077,282,35897,0.58,0.56,0.030950617283950616,0.78,99.5
2020-02-11,Rajasthan,229,3,223,3191,4662,2862,7.18,3,81.0,36306,285,36120,5.76,3.53,0.03939506172839506,0.78,99.49
2020-02-12,Rajasthan,444,4,437,5666,4561,1697,7.84,3,81.0,36750,289,36557,5.63,2.1,0.06995061728395062,0.79,99.47
2020-02-13,Rajasthan,865,9,860,11032,120,95,7.84,0,81.0,37615,298,37417,0.15,0.12,0.13619753086419753,0.79,99.47
2020-02-14,Rajasthan,222,2,215,3204,2477,1704,6.93,5,81.0,37837,300,37632,3.06,2.1,0.03955555555555555,0.79,99.46
2020-02-15,Rajasthan,902,7,893,11954,1948,1872,7.55,2,81.0,38739,307,38525,2.4,2.31,0.14758024691358024,0.79,99.45
2020-02-16,Rajasthan,1125,14,1119,14363,851,526,7.83,0,81.0,39864,321,39644,1.05,0.65,0.177320987654321,0.81,99.45
2020-02-17,Rajasthan,265,3,265,3013,2377,1962,8.8,0,81.0,40129,324,39909,2.93,2.42,0.03719753086419753,0.81,99.45
2020-02-18,Rajasthan,1139,10,1138,14557,638,440,7.82,0,81.0,41268,334,41047,0.79,0.54,0.17971604938271604,0.81,99.46
2020-02-19,Rajasthan,1505,18,1500,18659,4728,1962,8.07,0,81.0,42773,352,42547,5.84,2.42,0.23035802469135802,0.82,99.47
2020-02-20,Rajasthan,457,2,449,5657,911,829,8.08,6,81.0,43230,354,42996,1.12,1.02,0.0698395061728395,0.82,99.46
2020-02-21,Rajasthan,1198,3,1190,14743,3131,717,8.13,5,81.0,44428,357,44186,3.87,0.89,0.18201234567901234,0.8,99.46
2020-02-22,Rajasthan,779,5,778,9412,900,318,8.28,0,81.0,45207,362,44964,1.11,0.39,0.11619753086419753,0.8,99.46
2020-02-23,Rajasthan,1581,7,1579,19461,357,219,8.12,0,81.0,46788,369,46543,0.44,0.27,0.24025925925925926,0.79,99.48
2020-02-24,Rajasthan,494,4,485,5707,4292,2543,8.66,5,81.0,47282,373,47028,5.3,3.14,0.07045679012345679,0.79,99.46
2020-02-25,Rajasthan,516,4,515,6250,4375,3345,8.26,0,81.0,47798,377,47543,5.4,4.13,0.07716049382716049,0.79,99.47
2020-02-26,Rajasthan,740,3,739,9202,1468,1266,8.04,0,81.0,48538,380,48282,1.81,1.56,0.11360493827160494,0.78,99.47
2020-02-27,Rajasthan,1282,15,1273,15853,1245,676,8.09,0,81.0,49820,395,49555,1.54,0.83,0.19571604938271606,0.79,99.47
2020-02-28,Rajasthan,469,3,461,5877,2486,1190,7.98,5,81.0,50289,398,50016,3.07,1.47,0.07255555555555555,0.79,99.46
2020-02-29,Rajasthan,1503,18,1496,18677,4564,3245,8.05,0,81.0,51792,416,51512,5.63,4.01,0.23058024691358026,0.8,99.46
2020-03-01,Rajasthan,1141,9,1138,13837,2006,1789,8.25,0,81.0,52933,425,52650,2.48,2.21,0.17082716049382715,0.8,99.47
2020-03-02,Rajasthan,137,1,130,1791,3217,423,7.65,6,81.0,53070,426,52780,3.97,0.52,0.022111111111111113,0.8,99.45
2020-03-03,Rajasthan,569,5,563,6944,4315,162,8.19,1,81.0,53639,431,53343,5.33,0.2,0.0857283950617284,0.8,99.45
2020-03-04,Rajasthan,171,1,170,2001,2854,1481,8.55,0,81.0,53810,432,53513,3.52,1.83,0.024703703703703703,0.8,99.45
2020-03-05,Rajasthan,1188,8,1188,15231,4042,348,7.8,0,81.0,54998,440,54701,4.99,0.43,0.18803703703703703,0.8,99.46
2020-03-06,Rajasthan,718,6,710,9109,4700,3774,7.88,2,81.0,55716,446,55411,5.8,4.66,0.11245679012345679,0.8,99.45
2020-03-07,Rajasthan,1272,6,1263,15872,2423,1456,8.01,3,81.0,56988,452,56674,2.99,1.8,0.1959506172839506,0.79,99.45
2020-03-08,Rajasthan,390,5,382,5360,4010,253,7.28,3,81.0,57378,457,57056,4.95,0.31,0.06617283950617284,0.8,99.44
2020-03-09,Rajasthan,175,1,169,2141,1442,163,8.17,5,81.0,57553,458,57225,1.78,0.2,0.026432098765432097,0.8,99.43
2020-03-10,Rajasthan,539,7,534,6862,2737,1757,7.85,0,81.0,58092,465,57759,3.38,2.17,0.08471604938271605,0.8,99.43
2020-03-11,Rajasthan,1561,12,1555,19292,503,179,8.09,0,81.0,59653,477,59314,0.62,0.22,0.23817283950617285,0.8,99.43
2020-03-12,Rajasthan,546,2,544,7120,1470,303,7.67,0,81.0,60199,479,59858,1.81,0.37,0.08790123456790123,0.8,99.43
2020-03-13,Rajasthan,691,6,690,8464,4405,1728,8.16,0,81.0,60890,485,60548,5.44,2.13,0.10449382716049382,0.8,99.44
2020-03-14,Rajasthan,267,2,263,3051,814,742,8.75,2,81.0,61157,487,60811,1.0,0.92,0.03766666666666667,0.8,99.43
2020-03-15,Rajasthan,1289,4,1288,16106,3518,2492,8.0,0,81.0,62446,491,62099,4.34,3.08,0.19883950617283952,0.79,99.44
2020-03-16,Rajasthan,1610,16,1605,19790,877,138,8.14,0,81.0,64056,507,63704,1.08,0.17,0.24432098765432098,0.79,99.45
2020-03-17,Rajasthan,171,2,170,2171,4731,1342,7.88,0,81.0,64227,509,63874,5.84,1.66,0.02680246913580247,0.79,99.45
2020-03-18,Rajasthan,1401,14,1394,17555,977,333,7.98,0,81.0,65628,523,65268,1.21,0.41,0.2167283950617284,0.8,99.45
2020-03-19,Rajasthan,357,3,350,4604,4715,1015,7.75,4,81.0,65985,526,65618,5.82,1.25,0.056839506172839505,0.8,99.44
2020-03-20,Rajasthan,1357,7,1349,16667,204,187,8.14,1,81.0,67342,533,66967,0.25,0.23,0.20576543209876544,0.79,99.44
2020-03-21,Rajasthan,481,2,480,5783,2478,505,8.32,0,81.0,67823,535,67447,3.06,0.62,0.07139506172839506,0.79,99.45
2020-03-22,Rajasthan,244,2,236,2693,2202,1855,9.06,6,81.0,68067,537,67683,2.72,2.29,0.033246913580246916,0.79,99.44
2020-03-23,Rajasthan,1542,20,1542,18870,3446,1732,8.17,0,81.0,69609,557,69225,4.25,2.14,0.23296296296296296,0.8,99.45
2020-03-24,Rajasthan,287,1,280,3453,2333,297,8.31,6,81.0,69896,558,69505,2.88,0.37,0.04262962962962963,0.8,99.44
2020-03-25,Rajasthan,887,4,878,11138,2888,511,7.96,5,81.0,70783,562,70383,3.57,0.63,0.13750617283950617,0.79,99.43
2020-03-26,Rajasthan,704,2,700,8523,4875,334,8.26,2,81.0,71487,564,71083,6.02,0.41,0.10522222222222222,0.79,99.43
2020-03-27,Rajasthan,306,3,303,3815,2551,1477,8.02,0,81.0,71793,567,71386,3.15,1.82,0.04709876543209877,0.79,99.43
2020-03-28,Rajasthan,521,2,512,5979,596,257,8.71,7,81.0,72314,569,71898,0.74,0.32,0.07381481481481482,0.79,99.42
2020-03-29,Rajasthan,1267,5,1262,15947,4388,942,7.95,0,81.0,73581,574,73160,5.42,1.16,0.19687654320987655,0.78,99.43
2020-03-30,Rajasthan,313,2,312,4004,44,43,7.82,0,81.0,73894,576,73472,0.05,0.05,0.0494320987654321,0.78,99.43
2020-03-31,Rajasthan,359,3,355,4215,3030,686,8.52,1,81.0,74253,579,73827,3.74,0.85,0.052037037037037034,0.78,99.43
2020-04-01,Rajasthan,1554,23,1551,19205,662,116,8.09,0,81.0,75807,602,75378,0.82,0.14,0.23709876543209876,0.79,99.43
2020-04-02,Rajasthan,1264,16,1261,16050,4954,4555,7.88,0,81.0,77071,618,76639,6.12,5.62,0.19814814814814816,0.8,99.44
2020-04-03,Rajasthan,1580,5,1572,19343,329,307,8.17,3,81.0,78651,623,78211,0.41,0.38,0.23880246913580247,0.79,99.44
2020-04-04,Rajasthan,1312,11,1306,16818,1294,189,7.8,0,81.0,79963,634,79517,1.6,0.23,0.20762962962962964,0.79,99.44
2020-04-05,Rajasthan,581,5,579,6935,603,600,8.38,0,81.0,80544,639,80096,0.74,0.74,0.08561728395061728,0.79,99.44
2020-04-06,Rajasthan,1428,9,1424,17714,2761,299,8.06,0,81.0,81972,648,81520,3.41,0.37,0.21869135802469136,0.79,99.45
2020-04-07,Rajasthan,608,2,604,7605,3975,2933,7.99,2,81.0,82580,650,82124,4.91,3.62,0.09388888888888888,0.79,99.45
2020-04-08,Rajasthan,939,10,933,11709,1919,439,8.02,0,81.0,83519,660,83057,2.37,0.54,0.14455555555555555,0.79,99.45
2020-04-09,Rajasthan,1547,22,1544,19487,2693,2001,7.94,0,81.0,85066,682,84601,3.32,2.47,0.24058024691358024,0.8,99.45
2020-04-10,Rajasthan,1314,18,1311,16496,2065,1302,7.97,0,81.0,86380,700,85912,2.55,1.61,0.20365432098765432,0.81,99.46
2020-04-11,Rajasthan,421,5,414,5152,4795,1459,8.17,2,81.0,86801,705,86326,5.92,1.8,0.06360493827160493,0.81,99.45
2020-04-12,Rajasthan,954,6,953,12190,606,101,7.83,0,81.0,87755,711,87279,0.75,0.12,0.15049382716049384,0.81,99.46
2020-04-13,Rajasthan,1576,19,1575,19820,4470,602,7.95,0,81.0,89331,730,88854,5.52,0.74,0.24469135802469136,0.82,99.47
2020-04-14,Rajasthan,1422,11,1419,17956,4339,2747,7.92,0,81.0,90753,741,90273,5.36,3.39,0.22167901234567902,0.82,99.47
2020-04-15,Rajasthan,1415,17,1415,17529,3954,2772,8.07,0,81.0,92168,758,91688,4.88,3.42,0.2164074074074074,0.82,99.48
2020-04-16,Rajasthan,1483,12,1476,18197,2980,83,8.15,0,81.0,93651,770,93164,3.68,0.1,0.2246543209876543,0.82,99.48
2020-04-17,Rajasthan,750,11,742,9289,4249,848,8.07,0,81.0,94401,781,93906,5.25,1.05,0.11467901234567901,0.83,99.48
2020-04-18,Rajasthan,940,7,939,11583,4539,3648,8.12,0,81.0,95341,788,94845,5.6,4.5,0.143,0.83,99.48
2020-04-19,Rajasthan,1024,6,1019,12572,729,237,8.15,0,81.0,96365,794,95864,0.9,0.29,0.1552098765432099,0.82,99.48
2020-04-20,Rajasthan,1052,7,1047,13118,4577,4419,8.02,0,81.0,97417,801,96911,5.65,5.46,0.1619506172839506,0.82,99.48
2020-04-21,Rajasthan,889,7,888,10995,3264,1015,8.09,0,81.0,98306,808,97799,4.03,1.25,0.13574074074074075,0.82,99.48
2020-04-22,Rajasthan,1420,5,1417,17846,1855,1650,7.96,0,81.0,99726,813,99216,2.29,2.04,0.22032098765432098,0.82,99.49
2020-04-23,Rajasthan,1428,4,1427,18218,4469,1674,7.84,0,81.0,101154,817,100643,5.52,2.07,0.22491358024691357,0.81,99.49
2020-04-24,Rajasthan,342,2,340,4354,4597,463,7.85,0,81.0,101496,819,100983,5.68,0.57,0.053753086419753085,0.81,99.49
2020-04-25,Rajasthan,341,3,337,4158,296,17,8.2,1,81.0,101837,822,101320,0.37,0.02,0.051333333333333335,0.81,99.49
2020-04-26,Rajasthan,1585,6,1582,19923,3031,1013,7.96,0,81.0,103422,828,102902,3.74,1.25,0.24596296296296297,0.8,99.5
2020-04-27,Rajasthan,1096,13,1090,14409,3798,3709,7.61,0,81.0,104518,841,103992,4.69,4.58,0.1778888888888889,0.8,99.5
2020-04-28,Rajasthan,1433,17,1427,17620,2173,237,8.13,0,81.0,105951,858,105419,2.68,0.29,0.21753086419753087,0.81,99.5
2020-04-29,Rajasthan,451,1,447,6113,3784,1615,7.38,3,81.0,106402,859,105866,4.67,1.99,0.07546913580246914,0.81,99.5
2020-04-30,Rajasthan,734,7,734,9091,1589,353,8.07,0,81.0,107136,866,106600,1.96,0.44,0.11223456790123457,0.81,99.5
2020-05-01,Rajasthan,255,2,251,3298,752,209,7.73,2,81.0,107391,868,106851,0.93,0.26,0.04071604938271605,0.81,99.5
2020-05-02,Rajasthan,822,3,818,10157,1421,725,8.09,1,81.0,108213,871,107669,1.75,0.9,0.12539506172839507,0.8,99.5
2020-05-03,Rajasthan,827,11,820,10577,3186,2018,7.82,0,81.0,109040,882,108489,3.93,2.49,0.13058024691358025,0.81,99.49
2020-05-04,Rajasthan,1332,13,1323,16927,4120,1984,7.87,0,81.0,110372,895,109812,5.09,2.45,0.2089753086419753,0.81,99.49
2020-05-05,Rajasthan,710,5,705,8529,4631,4345,8.32,0,81.0,111082,900,110517,5.72,5.36,0.10529629629629629,0.81,99.49
2020-05-06,Rajasthan,797,10,790,10275,2223,1744,7.76,0,81.0,111879,910,111307,2.74,2.15,0.12685185185185185,0.81,99.49
2020-05-07,Rajasthan,344,3,342,4604,4168,3226,7.47,0,81.0,112223,913,111649,5.15,3.98,0.056839506172839505,0.81,99.49
2020-05-08,Rajasthan,237,3,234,2750,439,399,8.62,0,81.0,112460,916,111883,0.54,0.49,0.033950617283950615,0.81,99.49
2020-05-09,Rajasthan,991,7,984,12162,1861,323,8.15,0,81.0,113451,923,112867,2.3,0.4,0.15014814814814814,0.81,99.49
2020-05-10,Rajasthan,969,4,962,12639,3953,2340,7.67,3,81.0,114420,927,113829,4.88,2.89,0.15603703703703703,0.81,99.48
2020-05-11,Rajasthan,1251,7,1251,15186,3738,3536,8.24,0,81.0,115671,934,115080,4.61,4.37,0.18748148148148147,0.81,99.49
2020-05-12,Rajasthan,1122,14,1122,14003,113,40,8.01,0,81.0,116793,948,116202,0.14,0.05,0.17287654320987655,0.81,99.49
2020-05-13,Rajasthan,617,8,617,7491,63,7,8.24,0,81.0,117410,956,116819,0.08,0.01,0.09248148148148148,0.81,99.5
2020-05-14,Rajasthan,771,4,763,9920,2607,2607,7.77,4,81.0,118181,960,117582,3.22,3.22,0.12246913580246914,0.81,99.49
2020-05-15,Rajasthan,947,4,938,11990,2915,2854,7.9,5,81.0,119128,964,118520,3.6,3.52,0.14802469135802468,0.81,99.49
2020-05-16,Rajasthan,526,5,519,6902,2053,310,7.62,2,81.0,119654,969,119039,2.53,0.38,0.08520987654320987,0.81,99.49
2020-05-17,Rajasthan,686,9,683,8391,1430,903,8.18,0,81.0,120340,978,119722,1.77,1.11,0.1035925925925926,0.81,99.49
2020-05-18,Rajasthan,1183,6,1176,14696,4149,2863,8.05,1,81.0,121523,984,120898,5.12,3.53,0.1814320987654321,0.81,99.49
2020-05-19,Rajasthan,1075,3,1075,13402,3745,1590,8.02,0,81.0,122598,987,121973,4.62,1.96,0.1654567901234568,0.81,99.49
2020-05-20,Rajasthan,1253,12,1249,15428,3750,2771,8.12,0,81.0,123851,999,123222,4.63,3.42,0.19046913580246913,0.81,99.49
2020-05-21,Rajasthan,405,1,403,5721,2338,2299,7.08,1,81.0,124256,1000,123625,2.89,2.84,0.07062962962962963,0.8,99.49
2020-05-22,Rajasthan,110,1,110,1289,1939,1757,8.53,0,81.0,124366,1001,123735,2.39,2.17,0.01591358024691358,0.8,99.49
2020-05-23,Rajasthan,166,1,160,2015,3649,311,8.24,5,81.0,124532,1002,123895,4.5,0.38,0.024876543209876544,0.8,99.49
2020-05-24,Rajasthan,771,3,768,9694,67,20,7.95,0,81.0,125303,1005,124663,0.08,0.02,0.11967901234567901,0.8,99.49
2020-05-25,Rajasthan,127,0,125,1615,2733,78,7.86,2,81.0,125430,1005,124788,3.37,0.1,0.01993827160493827,0.8,99.49
2020-05-26,Rajasthan,903,3,896,10826,2940,1790,8.34,4,81.0,126333,1008,125684,3.63,2.21,0.1336543209876543,0.8,99.49
2020-05-27,Rajasthan,1451,20,1442,18194,3946,2398,7.98,0,81.0,127784,1028,127126,4.87,2.96,0.22461728395061728,0.8,99.49
2020-05-28,Rajasthan,1281,5,1279,16233,2384,1599,7.89,0,81.0,129065,1033,128405,2.94,1.97,0.2004074074074074,0.8,99.49
2020-05-29,Rajasthan,1525,18,1520,19040,137,22,8.01,0,81.0,130590,1051,129925,0.17,0.03,0.23506172839506173,0.8,99.49
2020-05-30,Rajasthan,383,3,381,4587,674,423,8.35,0,81.0,130973,1054,130306,0.83,0.52,0.05662962962962963,0.8,99.49
2020-05-31,Rajasthan,338,2,329,4348,4129,1324,7.77,7,81.0,131311,1056,130635,5.1,1.63,0.05367901234567901,0.8,99.49
2020-06-01,Rajasthan,1221,14,1214,15448,1848,1785,7.9,0,81.0,132532,1070,131849,2.28,2.2,0.19071604938271605,0.81,99.48
2020-06-02,Rajasthan,1431,12,1431,17950,3507,2036,7.97,0,81.0,133963,1082,133280,4.33,2.51,0.22160493827160493,0.81,99.49
2020-06-03,Rajasthan,867,8,865,10576,3344,2349,8.2,0,81.0,134830,1090,134145,4.13,2.9,0.1305679012345679,0.81,99.49
2020-06-04,Rajasthan,473,6,469,5619,2843,2448,8.42,0,81.0,135303,1096,134614,3.51,3.02,0.06937037037037037,0.81,99.49
2020-06-05,Rajasthan,480,7,475,5905,807,653,8.13,0,81.0,135783,1103,135089,1.0,0.81,0.07290123456790124,0.81,99.49
2020-06-06,Rajasthan,202,2,198,2092,333,139,9.66,2,81.0,135985,1105,135287,0.41,0.17,0.02582716049382716,0.81,99.49
2020-06-07,Rajasthan,966,10,959,12429,2709,201,7.77,0,81.0,136951,1115,136246,3.34,0.25,0.15344444444444444,0.81,99.49
2020-06-08,Rajasthan,933,4,931,12063,1531,832,7.73,0,81.0,137884,1119,137177,1.89,1.03,0.14892592592592593,0.81,99.49
2020-06-09,Rajasthan,1109,11,1106,13891,4327,3999,7.98,0,81.0,138993,1130,138283,5.34,4.94,0.17149382716049383,0.81,99.49
2020-06-10,Rajasthan,1076,14,1070,13857,1439,505,7.77,0,81.0,140069,1144,139353,1.78,0.62,0.17107407407407407,0.82,99.49
2020-06-11,Rajasthan,772,4,768,9684,2451,1160,7.97,0,81.0,140841,1148,140121,3.03,1.43,0.11955555555555555,0.82,99.49
2020-06-12,Rajasthan,1338,8,1331,16294,3506,3207,8.21,0,81.0,142179,1156,141452,4.33,3.96,0.2011604938271605,0.81,99.49
2020-06-13,Rajasthan,59,0,51,532,4595,1348,11.09,8,81.0,142238,1156,141503,5.67,1.66,0.006567901234567901,0.81,99.48
2020-06-14,Rajasthan,1554,8,1547,19177,483,168,8.1,0,81.0,143792,1164,143050,0.6,0.21,0.2367530864197531,0.81,99.48
2020-06-15,Rajasthan,999,6,995,12485,2466,547,8.0,0,81.0,144791,1170,144045,3.04,0.68,0.1541358024691358,0.81,99.48
2020-06-16,Rajasthan,375,2,374,4469,2501,1330,8.39,0,81.0,145166,1172,144419,3.09,1.64,0.05517283950617284,0.81,99.49
2020-06-17,Rajasthan,499,5,490,6171,3285,556,8.09,4,81.0,145665,1177,144909,4.06,0.69,0.07618518518518519,0.81,99.48
2020-06-18,Rajasthan,746,2,745,9311,2510,34,8.01,0,81.0,146411,1179,145654,3.1,0.04,0.11495061728395062,0.81,99.48
2020-06-19,Rajasthan,1300,4,1298,16363,4563,1564,7.94,0,81.0,147711,1183,146952,5.63,1.93,0.20201234567901236,0.8,99.49
2020-06-20,Rajasthan,384,3,381,4879,1479,365,7.87,0,81.0,148095,1186,147333,1.83,0.45,0.06023456790123457,0.8,99.49
2020-06-21,Rajasthan,1518,10,1513,19370,571,463,7.84,0,81.0,149613,1196,148846,0.7,0.57,0.2391358024691358,0.8,99.49
2020-06-22,Rajasthan,632,4,624,7856,683,375,8.04,4,81.0,150245,1200,149470,0.84,0.46,0.09698765432098766,0.8,99.48
2020-06-23,Rajasthan,1124,12,1117,13818,1059,886,8.13,0,81.0,151369,1212,150587,1.31,1.09,0.1705925925925926,0.8,99.48
2020-06-24,Rajasthan,688,7,684,8506,1420,306,8.09,0,81.0,152057,1219,151271,1.75,0.38,0.10501234567901234,0.8,99.48
2020-06-25,Rajasthan,722,9,720,9058,4312,1333,7.97,0,81.0,152779,1228,151991,5.32,1.65,0.11182716049382715,0.8,99.48
2020-06-26,Rajasthan,321,2,317,4281,1782,380,7.5,2,81.0,153100,1230,152308,2.2,0.47,0.05285185185185185,0.8,99.48
2020-06-27,Rajasthan,810,4,804,9820,18,16,8.25,2,81.0,153910,1234,153112,0.02,0.02,0.12123456790123457,0.8,99.48
2020-06-28,Rajasthan,1262,12,1253,16299,4829,4754,7.74,0,81.0,155172,1246,154365,5.96,5.87,0.20122222222222222,0.8,99.48
2020-06-29,Rajasthan,399,4,395,4951,1171,1113,8.06,0,81.0,155571,1250,154760,1.45,1.37,0.06112345679012346,0.8,99.48
2020-06-30,Rajasthan,1529,12,1529,19396,200,17,7.88,0,81.0,157100,1262,156289,0.25,0.02,0.2394567901234568,0.8,99.48
2020-07-01,Rajasthan,701,2,701,9167,960,18,7.65,0,81.0,157801,1264,156990,1.19,0.02,0.11317283950617284,0.8,99.49
2020-07-02,Rajasthan,1125,3,1125,14475,2339,2100,7.77,0,81.0,158926,1267,158115,2.89,2.59,0.1787037037037037,0.8,99.49
2020-07-03,Rajasthan,1522,9,1515,18493,3254,1310,8.23,0,81.0,160448,1276,159630,4.02,1.62,0.22830864197530865,0.8,99.49
2020-07-04,Rajasthan,1172,12,1163,14519,4931,1449,8.07,0,81.0,161620,1288,160793,6.09,1.79,0.1792469135802469,0.8,99.49
2020-07-05,Rajasthan,478,6,469,6068,3794,916,7.88,3,81.0,162098,1294,161262,4.68,1.13,0.07491358024691358,0.8,99.48
2020-07-06,Rajasthan,1275,9,1272,15507,791,734,8.22,0,81.0,163373,1303,162534,0.98,0.91,0.19144444444444444,0.8,99.49
2020-07-07,Rajasthan,941,13,934,11713,2191,820,8.03,0,81.0,164314,1316,163468,2.7,1.01,0.14460493827160495,0.8,99.49
2020-07-08,Rajasthan,200,2,191,2867,4610,209,6.98,7,81.0,164514,1318,163659,5.69,0.26,0.035395061728395065,0.8,99.48
2020-07-09,Rajasthan,1321,14,1319,16561,295,58,7.98,0,81.0,165835,1332,164978,0.36,0.07,0.2044567901234568,0.8,99.48
2020-07-10,Rajasthan,169,0,161,2165,2126,1111,7.81,8,81.0,166004,1332,165139,2.62,1.37,0.026728395061728395,0.8,99.48
2020-07-11,Rajasthan,1158,4,1150,14250,4136,446,8.13,4,81.0,167162,1336,166289,5.11,0.55,0.17592592592592593,0.8,99.48
2020-07-12,Rajasthan,482,2,474,6162,4096,3725,7.82,6,81.0,167644,1338,166763,5.06,4.6,0.07607407407407407,0.8,99.47
2020-07-13,Rajasthan,565,8,565,6822,3403,111,8.28,0,81.0,168209,1346,167328,4.2,0.14,0.08422222222222223,0.8,99.48
2020-07-14,Rajasthan,882,7,876,11539,4018,3932,7.64,0,81.0,169091,1353,168204,4.96,4.85,0.1424567901234568,0.8,99.48
2020-07-15,Rajasthan,787,3,780,10749,3706,2783,7.32,4,81.0,169878,1356,168984,4.58,3.44,0.1327037037037037,0.8,99.47
2020-07-16,Rajasthan,967,7,963,12221,1074,788,7.91,0,81.0,170845,1363,169947,1.33,0.97,0.15087654320987653,0.8,99.47
2020-07-17,Rajasthan,1000,10,991,12857,308,8,7.78,0,81.0,171845,1373,170938,0.38,0.01,0.1587283950617284,0.8,99.47
2020-07-18,Rajasthan,487,3,480,6083,4538,2879,8.01,4,81.0,172332,1376,171418,5.6,3.55,0.07509876543209877,0.8,99.47
2020-07-19,Rajasthan,1066,6,1060,13014,4069,167,8.19,0,81.0,173398,1382,172478,5.02,0.21,0.16066666666666668,0.8,99.47
2020-07-20,Rajasthan,747,8,743,9201,4876,2631,8.12,0,81.0,174145,1390,173221,6.02,3.25,0.11359259259259259,0.8,99.47
2020-07-21,Rajasthan,1190,10,1183,14760,703,584,8.06,0,81.0,175335,1400,174404,0.87,0.72,0.18222222222222223,0.8,99.47
2020-07-22,Rajasthan,667,8,664,8516,1179,750,7.83,0,81.0,176002,1408,175068,1.46,0.93,0.1051358024691358,0.8,99.47
2020-07-23,Rajasthan,1111,6,1110,13715,517,247,8.1,0,81.0,177113,1414,176178,0.64,0.3,0.169320987654321,0.8,99.47
2020-07-24,Rajasthan,1332,12,1328,16411,2517,1023,8.12,0,81.0,178445,1426,177506,3.11,1.26,0.20260493827160495,0.8,99.47
2020-07-25,Rajasthan,531,2,523,7121,367,344,7.46,6,81.0,178976,1428,178029,0.45,0.42,0.08791358024691358,0.8,99.47
2020-07-26,Rajasthan,97,1,97,883,1773,1503,10.99,0,81.0,179073,1429,178126,2.19,1.86,0.010901234567901234,0.8,99.47
2020-07-27,Rajasthan,567,4,559,7096,1730,1497,7.99,4,81.0,179640,1433,178685,2.14,1.85,0.08760493827160494,0.8,99.47
2020-07-28,Rajasthan,762,6,757,9481,3816,1665,8.04,0,81.0,180402,1439,179442,4.71,2.06,0.11704938271604938,0.8,99.47
2020-07-29,Rajasthan,1156,16,1152,14299,620,570,8.08,0,81.0,181558,1455,180594,0.77,0.7,0.17653086419753086,0.8,99.47
2020-07-30,Rajasthan,98,1,93,1427,902,281,6.87,4,81.0,181656,1456,180687,1.11,0.35,0.017617283950617284,0.8,99.47
2020-07-31,Rajasthan,1294,5,1285,16155,1643,747,8.01,4,81.0,182950,1461,181972,2.03,0.92,0.19944444444444445,0.8,99.47
2020-08-01,Rajasthan,1427,4,1426,17820,3816,795,8.01,0,81.0,184377,1465,183398,4.71,0.98,0.22,0.79,99.47
2020-08-02,Rajasthan,630,8,622,7753,1072,966,8.13,0,81.0,185007,1473,184020,1.32,1.19,0.09571604938271605,0.8,99.47
2020-08-03,Rajasthan,564,3,557,7055,4939,2761,7.99,4,81.0,185571,1476,184577,6.1,3.41,0.08709876543209877,0.8,99.46
2020-08-04,Rajasthan,431,3,424,5165,2598,1580,8.34,4,81.0,186002,1479,185001,3.21,1.95,0.06376543209876544,0.8,99.46
2020-08-05,Rajasthan,914,9,910,11313,3693,2317,8.08,0,81.0,186916,1488,185911,4.56,2.86,0.13966666666666666,0.8,99.46
2020-08-06,Rajasthan,1455,17,1449,18197,177,38,8.0,0,81.0,188371,1505,187360,0.22,0.05,0.2246543209876543,0.8,99.46
2020-08-07,Rajasthan,987,3,985,12290,4178,2702,8.03,0,81.0,189358,1508,188345,5.16,3.34,0.1517283950617284,0.8,99.47
2020-08-08,Rajasthan,873,10,869,10984,4461,522,7.95,0,81.0,190231,1518,189214,5.51,0.64,0.13560493827160494,0.8,99.47
2020-08-09,Rajasthan,1479,6,1477,18014,4837,3274,8.21,0,81.0,191710,1524,190691,5.97,4.04,0.22239506172839507,0.79,99.47
2020-08-10,Rajasthan,893,7,893,11258,4895,4001,7.93,0,81.0,192603,1531,191584,6.04,4.94,0.13898765432098764,0.79,99.47
2020-08-11,Rajasthan,190,2,187,2184,2379,528,8.7,1,81.0,192793,1533,191771,2.94,0.65,0.026962962962962963,0.8,99.47
2020-08-12,Rajasthan,155,0,155,2122,2029,974,7.3,0,81.0,192948,1533,191926,2.5,1.2,0.02619753086419753,0.79,99.47
2020-08-13,Rajasthan,630,8,622,7858,2934,2780,8.02,0,81.0,193578,1541,192548,3.62,3.43,0.09701234567901235,0.8,99.47
2020-08-14,Rajasthan,1206,12,1203,15257,4697,981,7.9,0,81.0,194784,1553,193751,5.8,1.21,0.188358024691358,0.8,99.47
2020-08-15,Rajasthan,777,5,777,9357,3490,1187,8.3,0,81.0,195561,1558,194528,4.31,1.47,0.11551851851851852,0.8,99.47
2020-08-16,Rajasthan,207,1,206,2534,4166,3013,8.17,0,81.0,195768,1559,194734,5.14,3.72,0.03128395061728395,0.8,99.47
2020-08-17,Rajasthan,1149,12,1144,14544,4632,4110,7.9,0,81.0,196917,1571,195878,5.72,5.07,0.17955555555555555,0.8,99.47
2020-08-18,Rajasthan,648,7,646,8021,2145,1463,8.08,0,81.0,197565,1578,196524,2.65,1.81,0.09902469135802469,0.8,99.47
2020-08-19,Rajasthan,447,4,445,5356,2714,1266,8.35,0,81.0,198012,1582,196969,3.35,1.56,0.06612345679012345,0.8,99.47
2020-08-20,Rajasthan,1100,11,1098,13609,4430,729,8.08,0,81.0,199112,1593,198067,5.47,0.9,0.16801234567901235,0.8,99.48
2020-08-21,Rajasthan,1105,7,1096,13635,1180,160,8.1,2,81.0,200217,1600,199163,1.46,0.2,0.16833333333333333,0.8,99.47
2020-08-22,Rajasthan,440,3,439,5605,874,468,7.85,0,81.0,200657,1603,199602,1.08,0.58,0.06919753086419753,0.8,99.47
2020-08-23,Rajasthan,826,5,821,10773,2141,1544,7.67,0,81.0,201483,1608,200423,2.64,1.91,0.133,0.8,99.47
2020-08-24,Rajasthan,733,6,725,9498,4631,90,7.72,2,81.0,202216,1614,201148,5.72,0.11,0.11725925925925926,0.8,99.47
2020-08-25,Rajasthan,834,4,830,10339,2630,1792,8.07,0,81.0,203050,1618,201978,3.25,2.21,0.12764197530864196,0.8,99.47
2020-08-26,Rajasthan,989,9,982,12421,174,156,7.96,0,81.0,204039,1627,202960,0.21,0.19,0.1533456790123457,0.8,99.47
2020-08-27,Rajasthan,771,9,765,9526,4132,3004,8.09,0,81.0,204810,1636,203725,5.1,3.71,0.11760493827160494,0.8,99.47
2020-08-28,Rajasthan,804,7,796,10274,4803,1159,7.83,1,81.0,205614,1643,204521,5.93,1.43,0.1268395061728395,0.8,99.47
2020-08-29,Rajasthan,1346,14,1343,17059,4296,3818,7.89,0,81.0,206960,1657,205864,5.3,4.71,0.21060493827160492,0.8,99.47
2020-08-30,Rajasthan,460,4,451,5458,1385,439,8.43,5,81.0,207420,1661,206315,1.71,0.54,0.06738271604938272,0.8,99.47
2020-08-31,Rajasthan,1588,13,1586,19664,3179,2412,8.08,0,81.0,209008,1674,207901,3.92,2.98,0.24276543209876544,0.8,99.47
2020-09-01,Rajasthan,1263,15,1260,15925,1529,1197,7.93,0,81.0,210271,1689,209161,1.89,1.48,0.19660493827160494,0.8,99.47
2020-09-02,Rajasthan,1396,18,1390,17718,2162,1127,7.88,0,81.0,211667,1707,210551,2.67,1.39,0.21874074074074074,0.81,99.47
2020-09-03,Rajasthan,334,2,333,4626,2210,414,7.22,0,81.0,212001,1709,210884,2.73,0.51,0.05711111111111111,0.81,99.47
2020-09-04,Rajasthan,937,7,931,11877,1695,1482,7.89,0,81.0,212938,1716,211815,2.09,1.83,0.14662962962962964,0.81,99.47
2020-09-05,Rajasthan,1494,10,1489,18478,1601,196,8.09,0,81.0,214432,1726,213304,1.98,0.24,0.22812345679012347,0.8,99.47
2020-09-06,Rajasthan,377,1,373,4883,2045,582,7.72,3,81.0,214809,1727,213677,2.52,0.72,0.06028395061728395,0.8,99.47
2020-09-07,Rajasthan,418,1,409,5116,4055,2249,8.17,8,81.0,215227,1728,214086,5.01,2.78,0.06316049382716049,0.8,99.47
2020-09-08,Rajasthan,1410,17,1410,17507,912,841,8.05,0,81.0,216637,1745,215496,1.13,1.04,0.2161358024691358,0.81,99.47
2020-09-09,Rajasthan,1475,12,1475,18451,3058,2828,7.99,0,81.0,218112,1757,216971,3.78,3.49,0.22779012345679012,0.81,99.48
2020-09-10,Rajasthan,1006,5,1006,12421,4015,66,8.1,0,81.0,219118,1762,217977,4.96,0.08,0.1533456790123457,0.8,99.48
2020-09-11,Rajasthan,78,0,71,760,762,243,10.26,7,81.0,219196,1762,218048,0.94,0.3,0.009382716049382716,0.8,99.48
2020-09-12,Rajasthan,424,2,416,5421,2664,1288,7.82,6,81.0,219620,1764,218464,3.29,1.59,0.06692592592592593,0.8,99.47
2020-09-13,Rajasthan,1343,5,1337,16948,778,121,7.92,1,81.0,220963,1769,219801,0.96,0.15,0.20923456790123457,0.8,99.47
2020-09-14,Rajasthan,1484,9,1478,19136,3128,2600,7.76,0,81.0,222447,1778,221279,3.86,3.21,0.2362469135802469,0.8,99.47
2020-09-15,Rajasthan,556,2,554,6815,2918,2916,8.16,0,81.0,223003,1780,221833,3.6,3.6,0.08413580246913581,0.8,99.48
2020-09-16,Rajasthan,156,0,150,1534,3678,2448,10.17,6,81.0,223159,1780,221983,4.54,3.02,0.018938271604938273,0.8,99.47
2020-09-17,Rajasthan,546,8,539,6855,2302,2115,7.96,0,81.0,223705,1788,222522,2.84,2.61,0.08462962962962962,0.8,99.47
2020-09-18,Rajasthan,1310,18,1305,16547,683,152,7.92,0,81.0,225015,1806,223827,0.84,0.19,0.20428395061728394,0.8,99.47
2020-09-19,Rajasthan,1609,17,1606,19853,3445,1180,8.1,0,81.0,226624,1823,225433,4.25,1.46,0.24509876543209877,0.8,99.47
2020-09-20,Rajasthan,416,1,411,5048,30,8,8.24,4,81.0,227040,1824,225844,0.04,0.01,0.06232098765432099,0.8,99.47
2020-09-21,Rajasthan,575,5,569,7307,841,532,7.87,1,81.0,227615,1829,226413,1.04,0.66,0.09020987654320987,0.8,99.47
2020-09-22,Rajasthan,87,0,78,1570,2861,2405,5.54,9,81.0,227702,1829,226491,3.53,2.97,0.019382716049382714,0.8,99.47
2020-09-23,Rajasthan,940,3,934,11673,2978,2338,8.05,3,81.0,228642,1832,227425,3.68,2.89,0.1441111111111111,0.8,99.47
2020-09-24,Rajasthan,822,8,814,10321,3359,3355,7.96,0,81.0,229464,1840,228239,4.15,4.14,0.12741975308641976,0.8,99.47
2020-09-25,Rajasthan,171,1,168,2227,827,801,7.68,2,81.0,229635,1841,228407,1.02,0.99,0.02749382716049383,0.8,99.47
2020-09-26,Rajasthan,607,2,604,7842,709,663,7.74,1,81.0,230242,1843,229011,0.88,0.82,0.09681481481481481,0.8,99.47
2020-09-27,Rajasthan,814,2,813,9892,950,370,8.23,0,81.0,231056,1845,229824,1.17,0.46,0.12212345679012346,0.8,99.47
2020-09-28,Rajasthan,1259,9,1250,15821,3205,518,7.96,0,81.0,232315,1854,231074,3.96,0.64,0.195320987654321,0.8,99.47
2020-09-29,Rajasthan,485,4,478,5825,3935,617,8.33,3,81.0,232800,1858,231552,4.86,0.76,0.07191358024691358,0.8,99.46
2020-09-30,Rajasthan,1496,7,1488,19190,1931,1180,7.8,1,81.0,234296,1865,233040,2.38,1.46,0.23691358024691359,0.8,99.46
2020-10-01,Rajasthan,1536,6,1529,19223,2996,2942,7.99,1,81.0,235832,1871,234569,3.7,3.63,0.237320987654321,0.79,99.46
2020-10-02,Rajasthan,248,3,242,3558,3416,2516,6.97,3,81.0,236080,1874,234811,4.22,3.11,0.043925925925925924,0.79,99.46
2020-10-03,Rajasthan,250,1,249,3290,883,94,7.6,0,81.0,236330,1875,235060,1.09,0.12,0.04061728395061728,0.79,99.46
2020-10-04,Rajasthan,1066,12,1060,13520,4527,1120,7.88,0,81.0,237396,1887,236120,5.59,1.38,0.16691358024691358,0.79,99.46
2020-10-05,Rajasthan,857,5,857,10476,4318,3306,8.18,0,81.0,238253,1892,236977,5.33,4.08,0.12933333333333333,0.79,99.46
2020-10-06,Rajasthan,308,2,306,3741,3054,453,8.23,0,81.0,238561,1894,237283,3.77,0.56,0.04618518518518518,0.79,99.46
2020-10-07,Rajasthan,364,2,359,4595,4721,2058,7.92,3,81.0,238925,1896,237642,5.83,2.54,0.056728395061728394,0.79,99.46
2020-10-08,Rajasthan,587,8,585,7414,3491,3338,7.92,0,81.0,239512,1904,238227,4.31,4.12,0.09153086419753087,0.79,99.46
2020-10-09,Rajasthan,1105,11,1103,13225,3760,1986,8.36,0,81.0,240617,1915,239330,4.64,2.45,0.16327160493827161,0.8,99.47
2020-10-10,Rajasthan,653,3,648,8227,4557,1195,7.94,2,81.0,241270,1918,239978,5.63,1.48,0.1015679012345679,0.79,99.46
2020-10-11,Rajasthan,1131,12,1124,14557,3478,3125,7.77,0,81.0,242401,1930,241102,4.29,3.86,0.17971604938271604,0.8,99.46
2020-10-12,Rajasthan,909,7,901,11728,195,78,7.75,1,81.0,243310,1937,242003,0.24,0.1,0.14479012345679013,0.8,99.46
2020-10-13,Rajasthan,755,8,751,9349,4458,2041,8.08,0,81.0,244065,1945,242754,5.5,2.52,0.11541975308641975,0.8,99.46
2020-10-14,Rajasthan,87,0,85,1495,1692,114,5.82,2,81.0,244152,1945,242839,2.09,0.14,0.01845679012345679,0.8,99.46
2020-10-15,Rajasthan,933,10,932,11395,3910,2561,8.19,0,81.0,245085,1955,243771,4.83,3.16,0.140679012345679,0.8,99.46
2020-10-16,Rajasthan,1491,6,1487,18619,2384,1349,8.01,0,81.0,246576,1961,245258,2.94,1.67,0.2298641975308642,0.8,99.47
2020-10-17,Rajasthan,1200,6,1192,15230,4492,1333,7.88,2,81.0,247776,1967,246450,5.55,1.65,0.1880246913580247,0.79,99.46
2020-10-18,Rajasthan,1319,6,1319,16437,4234,2856,8.02,0,81.0,249095,1973,247769,5.23,3.53,0.20292592592592593,0.79,99.47
2020-10-19,Rajasthan,807,3,804,10033,1457,688,8.04,0,81.0,249902,1976,248573,1.8,0.85,0.1238641975308642,0.79,99.47
2020-10-20,Rajasthan,1307,10,1303,16474,1809,1204,7.93,0,81.0,251209,1986,249876,2.23,1.49,0.2033827160493827,0.79,99.47
2020-10-21,Rajasthan,249,1,243,3281,422,275,7.59,5,81.0,251458,1987,250119,0.52,0.34,0.04050617283950617,0.79,99.47
2020-10-22,Rajasthan,294,2,293,4140,1176,601,7.1,0,81.0,251752,1989,250412,1.45,0.74,0.051111111111111114,0.79,99.47
2020-10-23,Rajasthan,289,1,282,3405,1983,457,8.49,6,81.0,252041,1990,250694,2.45,0.56,0.04203703703703704,0.79,99.47
2020-10-24,Rajasthan,1505,16,1504,18828,3457,2779,7.99,0,81.0,253546,2006,252198,4.27,3.43,0.23244444444444445,0.79,99.47
2020-10-25,Rajasthan,910,7,903,11374,1945,1195,8.0,0,81.0,254456,2013,253101,2.4,1.48,0.14041975308641974,0.79,99.47
2020-10-26,Rajasthan,1493,20,1492,18789,70,29,7.95,0,81.0,255949,2033,254593,0.09,0.04,0.23196296296296295,0.79,99.47
2020-10-27,Rajasthan,1339,8,1336,16953,1379,560,7.9,0,81.0,257288,2041,255929,1.7,0.69,0.20929629629629629,0.79,99.47
2020-10-28,Rajasthan,351,3,346,4221,695,643,8.32,2,81.0,257639,2044,256275,0.86,0.79,0.05211111111111111,0.79,99.47
2020-10-29,Rajasthan,252,1,251,2938,3252,3002,8.58,0,81.0,257891,2045,256526,4.01,3.71,0.036271604938271605,0.79,99.47
2020-10-30,Rajasthan,530,4,529,6506,3947,3931,8.15,0,81.0,258421,2049,257055,4.87,4.85,0.08032098765432098,0.79,99.47
2020-10-31,Rajasthan,253,0,252,2629,733,335,9.62,1,81.0,258674,2049,257307,0.9,0.41,0.03245679012345679,0.79,99.47
2020-11-01,Rajasthan,311,1,304,3799,2383,1784,8.19,6,81.0,258985,2050,257611,2.94,2.2,0.04690123456790123,0.79,99.47
2020-11-02,Rajasthan,1328,15,1319,17209,3227,2919,7.72,0,81.0,260313,2065,258930,3.98,3.6,0.21245679012345678,0.79,99.47
2020-11-03,Rajasthan,465,3,463,5790,4619,1429,8.03,0,81.0,260778,2068,259393,5.7,1.76,0.07148148148148148,0.79,99.47
2020-11-04,Rajasthan,1515,18,1507,19043,4597,2501,7.96,0,81.0,262293,2086,260900,5.68,3.09,0.23509876543209876,0.8,99.47
2020-11-05,Rajasthan,1275,15,1269,15973,958,165,7.98,0,81.0,263568,2101,262169,1.18,0.2,0.19719753086419753,0.8,99.47
2020-11-06,Rajasthan,778,5,773,9508,4744,3903,8.18,0,81.0,264346,2106,262942,5.86,4.82,0.11738271604938272,0.8,99.47
2020-11-07,Rajasthan,994,8,985,12009,108,12,8.28,1,81.0,265340,2114,263927,0.13,0.01,0.14825925925925926,0.8,99.47
2020-11-08,Rajasthan,796,3,788,10184,2527,1772,7.82,5,81.0,266136,2117,264715,3.12,2.19,0.1257283950617284,0.8,99.47
2020-11-09,Rajasthan,1494,4,1493,18875,3165,978,7.92,0,81.0,267630,2121,266208,3.91,1.21,0.2330246913580247,0.79,99.47
2020-11-10,Rajasthan,833,7,833,10185,2356,865,8.18,0,81.0,268463,2128,267041,2.91,1.07,0.12574074074074074,0.79,99.47
2020-11-11,Rajasthan,1365,14,1358,17205,3814,7,7.93,0,81.0,269828,2142,268399,4.71,0.01,0.2124074074074074,0.79,99.47
2020-11-12,Rajasthan,358,2,355,4688,3082,268,7.64,1,81.0,270186,2144,268754,3.8,0.33,0.05787654320987654,0.79,99.47
2020-11-13,Rajasthan,285,1,285,3511,1474,1367,8.12,0,81.0,270471,2145,269039,1.82,1.69,0.04334567901234568,0.79,99.47
2020-11-14,Rajasthan,1339,10,1335,16603,4177,2180,8.06,0,81.0,271810,2155,270374,5.16,2.69,0.2049753086419753,0.79,99.47
2020-11-15,Rajasthan,563,2,555,6831,1446,650,8.24,6,81.0,272373,2157,270929,1.79,0.8,0.08433333333333333,0.79,99.47
2020-11-16,Rajasthan,1566,16,1565,19378,884,515,8.08,0,81.0,273939,2173,272494,1.09,0.64,0.23923456790123457,0.79,99.47
2020-11-17,Rajasthan,261,2,253,3055,2148,1737,8.54,6,81.0,274200,2175,272747,2.65,2.14,0.03771604938271605,0.79,99.47
2020-11-18,Rajasthan,730,2,727,9209,879,501,7.93,1,81.0,274930,2177,273474,1.09,0.62,0.11369135802469135,0.79,99.47
2020-11-19,Rajasthan,902,5,900,11329,453,157,7.96,0,81.0,275832,2182,274374,0.56,0.19,0.1398641975308642,0.79,99.47
2020-11-20,Rajasthan,1191,8,1188,14469,380,131,8.23,0,81.0,277023,2190,275562,0.47,0.16,0.17862962962962964,0.79,99.47
2020-11-21,Rajasthan,198,2,198,2519,4075,3525,7.86,0,81.0,277221,2192,275760,5.03,4.35,0.031098765432098767,0.79,99.47
2020-11-22,Rajasthan,631,5,623,7813,1998,1744,8.08,3,81.0,277852,2197,276383,2.47,2.15,0.09645679012345679,0.79,99.47
2020-11-23,Rajasthan,104,1,101,1348,739,70,7.72,2,81.0,277956,2198,276484,0.91,0.09,0.016641975308641976,0.79,99.47
2020-11-24,Rajasthan,1602,9,1598,19993,743,514,8.01,0,81.0,279558,2207,278082,0.92,0.63,0.24682716049382716,0.79,99.47
2020-11-25,Rajasthan,1303,6,1296,16534,3095,1087,7.88,1,81.0,280861,2213,279378,3.82,1.34,0.20412345679012345,0.79,99.47
2020-11-26,Rajasthan,1481,19,1475,18308,483,23,8.09,0,81.0,282342,2232,280853,0.6,0.03,0.2260246913580247,0.79,99.47
2020-11-27,Rajasthan,387,3,381,4960,2549,855,7.8,3,81.0,282729,2235,281234,3.15,1.06,0.06123456790123457,0.79,99.47
2020-11-28,Rajasthan,1038,11,1036,12850,2198,2055,8.08,0,81.0,283767,2246,282270,2.71,2.54,0.15864197530864196,0.79,99.47
2020-11-29,Rajasthan,1529,9,1527,19530,1955,111,7.83,0,81.0,285296,2255,283797,2.41,0.14,0.2411111111111111,0.79,99.47
2020-11-30,Rajasthan,258,2,249,3408,2486,1702,7.57,7,81.0,285554,2257,284046,3.07,2.1,0.042074074074074076,0.79,99.47
2020-12-01,Rajasthan,393,2,389,5294,4047,2338,7.42,2,81.0,285947,2259,284435,5.0,2.89,0.06535802469135803,0.79,99.47
2020-12-02,Rajasthan,443,5,440,5792,2041,1621,7.65,0,81.0,286390,2264,284875,2.52,2.0,0.07150617283950618,0.79,99.47
2020-12-03,Rajasthan,277,2,269,3078,2254,2074,9.0,6,81.0,286667,2266,285144,2.78,2.56,0.038,0.79,99.47
2020-12-04,Rajasthan,1445,5,1445,18321,4547,2654,7.89,0,81.0,288112,2271,286589,5.61,3.28,0.22618518518518518,0.79,99.47
2020-12-05,Rajasthan,790,6,781,10356,4909,2714,7.63,3,81.0,288902,2277,287370,6.06,3.35,0.12785185185185186,0.79,99.47
2020-12-06,Rajasthan,965,14,962,12452,4992,1707,7.75,0,81.0,289867,2291,288332,6.16,2.11,0.1537283950617284,0.79,99.47
2020-12-07,Rajasthan,101,0,100,717,746,369,14.09,1,81.0,289968,2291,288432,0.92,0.46,0.008851851851851852,0.79,99.47
2020-12-08,Rajasthan,1491,10,1491,18692,3903,2206,7.98,0,81.0,291459,2301,289923,4.82,2.72,0.23076543209876543,0.79,99.47
2020-12-09,Rajasthan,1061,10,1053,13042,1118,1083,8.14,0,81.0,292520,2311,290976,1.38,1.34,0.16101234567901235,0.79,99.47
2020-12-10,Rajasthan,1133,5,1128,14007,4911,1559,8.09,0,81.0,293653,2316,292104,6.06,1.92,0.17292592592592593,0.79,99.47
2020-12-11,Rajasthan,702,8,700,8747,823,641,8.03,0,81.0,294355,2324,292804,1.02,0.79,0.10798765432098766,0.79,99.47
2020-12-12,Rajasthan,785,6,784,9746,3197,1933,8.05,0,81.0,295140,2330,293588,3.95,2.39,0.12032098765432099,0.79,99.47
2020-12-13,Rajasthan,819,7,814,10058,4878,413,8.14,0,81.0,295959,2337,294402,6.02,0.51,0.12417283950617283,0.79,99.47
2020-12-14,Rajasthan,310,2,302,4080,450,270,7.6,6,81.0,296269,2339,294704,0.56,0.33,0.05037037037037037,0.79,99.47
2020-12-15,Rajasthan,1571,15,1564,19450,2326,1618,8.08,0,81.0,297840,2354,296268,2.87,2.0,0.24012345679012345,0.79,99.47
2020-12-16,Rajasthan,405,5,404,4998,4114,1267,8.1,0,81.0,298245,2359,296672,5.08,1.56,0.061703703703703705,0.79,99.47
2020-12-17,Rajasthan,1508,17,1508,18889,1453,480,7.98,0,81.0,299753,2376,298180,1.79,0.59,0.23319753086419753,0.79,99.48
2020-12-18,Rajasthan,901,9,893,10652,4733,3306,8.46,0,81.0,300654,2385,299073,5.84,4.08,0.13150617283950616,0.79,99.47
2020-12-19,Rajasthan,410,5,408,4934,1782,1722,8.31,0,81.0,301064,2390,299481,2.2,2.13,0.06091358024691358,0.79,99.47
2020-12-20,Rajasthan,1036,12,1035,13421,1860,161,7.72,0,81.0,302100,2402,300516,2.3,0.2,0.16569135802469137,0.8,99.48
2020-12-21,Rajasthan,194,2,189,2302,2467,184,8.43,3,81.0,302294,2404,300705,3.05,0.23,0.028419753086419752,0.8,99.47
2020-12-22,Rajasthan,636,8,634,8096,3552,2283,7.86,0,81.0,302930,2412,301339,4.39,2.82,0.09995061728395062,0.8,99.47
2020-12-23,Rajasthan,241,2,239,3527,2175,1327,6.83,0,81.0,303171,2414,301578,2.69,1.64,0.04354320987654321,0.8,99.47
2020-12-24,Rajasthan,732,2,726,9063,2629,1823,8.08,4,81.0,303903,2416,302304,3.25,2.25,0.11188888888888888,0.79,99.47
2020-12-25,Rajasthan,929,11,927,11504,121,121,8.08,0,81.0,304832,2427,303231,0.15,0.15,0.1420246913580247,0.8,99.47
2020-12-26,Rajasthan,134,0,131,2230,298,284,6.01,3,81.0,304966,2427,303362,0.37,0.35,0.027530864197530865,0.8,99.47
2020-12-27,Rajasthan,1198,10,1190,15196,2871,832,7.88,0,81.0,306164,2437,304552,3.54,1.03,0.18760493827160493,0.8,99.47
2020-12-28,Rajasthan,907,3,899,11794,4896,2118,7.69,5,81.0,307071,2440,305451,6.04,2.61,0.14560493827160495,0.79,99.47
2020-12-29,Rajasthan,1320,15,1315,16406,3194,3176,8.05,0,81.0,308391,2455,306766,3.94,3.92,0.2025432098765432,0.8,99.47
2020-12-30,Rajasthan,344,4,335,3908,4824,4301,8.8,5,81.0,308735,2459,307101,5.96,5.31,0.048246913580246915,0.8,99.47
2020-12-31,Rajasthan,1351,17,1349,17260,2825,950,7.83,0,81.0,310086,2476,308450,3.49,1.17,0.21308641975308643,0.8,99.47
2021-01-01,Rajasthan,823,10,823,10057,1026,511,8.18,0,81.0,310909,2486,309273,1.27,0.63,0.12416049382716049,0.8,99.47
2021-01-02,Rajasthan,109,0,101,1624,3832,772,6.71,8,81.0,311018,2486,309374,4.73,0.95,0.020049382716049384,0.8,99.47
2021-01-03,Rajasthan,122,1,114,1659,3384,2160,7.35,7,81.0,311140,2487,309488,4.18,2.67,0.020481481481481482,0.8,99.47
2021-01-04,Rajasthan,457,6,452,5646,1255,113,8.09,0,81.0,311597,2493,309940,1.55,0.14,0.0697037037037037,0.8,99.47
2021-01-05,Rajasthan,928,4,923,12209,2750,946,7.6,1,81.0,312525,2497,310863,3.4,1.17,0.1507283950617284,0.8,99.47
2021-01-06,Rajasthan,1323,9,1318,16626,3984,1130,7.96,0,81.0,313848,2506,312181,4.92,1.4,0.20525925925925925,0.8,99.47
2021-01-07,Rajasthan,505,1,498,6495,1185,774,7.78,6,81.0,314353,2507,312679,1.46,0.96,0.08018518518518518,0.8,99.47
2021-01-08,Rajasthan,1423,13,1416,18069,406,69,7.88,0,81.0,315776,2520,314095,0.5,0.09,0.22307407407407406,0.8,99.47
2021-01-09,Rajasthan,1152,7,1148,14401,883,586,8.0,0,81.0,316928,2527,315243,1.09,0.72,0.17779012345679013,0.8,99.47
2021-01-10,Rajasthan,256,1,256,3302,4401,2779,7.75,0,81.0,317184,2528,315499,5.43,3.43,0.04076543209876543,0.8,99.47
2021-01-11,Rajasthan,393,4,388,5120,2890,914,7.68,1,81.0,317577,2532,315887,3.57,1.13,0.06320987654320988,0.8,99.47
2021-01-12,Rajasthan,331,4,329,4314,3512,250,7.67,0,81.0,317908,2536,316216,4.34,0.31,0.053259259259259256,0.8,99.47
2021-01-13,Rajasthan,409,1,405,5383,4614,1234,7.6,3,81.0,318317,2537,316621,5.7,1.52,0.06645679012345679,0.8,99.47
2021-01-14,Rajasthan,632,7,623,8522,4187,14,7.42,2,81.0,318949,2544,317244,5.17,0.02,0.10520987654320987,0.8,99.47
2021-01-15,Rajasthan,289,2,280,3459,2154,956,8.36,7,81.0,319238,2546,317524,2.66,1.18,0.0427037037037037,0.8,99.46
2021-01-16,Rajasthan,148,1,148,1540,2795,2778,9.61,0,81.0,319386,2547,317672,3.45,3.43,0.019012345679012346,0.8,99.46
2021-01-17,Rajasthan,1466,18,1457,17625,1558,810,8.32,0,81.0,320852,2565,319129,1.92,1.0,0.2175925925925926,0.8,99.46
2021-01-18,Rajasthan,1044,7,1040,13121,2825,2406,7.96,0,81.0,321896,2572,320169,3.49,2.97,0.16198765432098766,0.8,99.46
2021-01-19,Rajasthan,1191,17,1183,15020,314,172,7.93,0,81.0,323087,2589,321352,0.39,0.21,0.1854320987654321,0.8,99.46
2021-01-20,Rajasthan,745,10,744,8526,4039,908,8.74,0,81.0,323832,2599,322096,4.99,1.12,0.10525925925925926,0.8,99.46
2021-01-21,Rajasthan,205,3,198,1806,826,174,11.35,4,81.0,324037,2602,322294,1.02,0.21,0.022296296296296297,0.8,99.46
2021-01-22,Rajasthan,1268,15,1261,15819,2296,1403,8.02,0,81.0,325305,2617,323555,2.83,1.73,0.1952962962962963,0.8,99.46
2021-01-23,Rajasthan,1526,22,1526,19466,3519,335,7.84,0,81.0,326831,2639,325081,4.34,0.41,0.240320987654321,0.81,99.46
2021-01-24,Rajasthan,709,5,702,8586,3457,2476,8.26,2,81.0,327540,2644,325783,4.27,3.06,0.106,0.81,99.46
2021-01-25,Rajasthan,120,1,112,1627,1892,503,7.38,7,81.0,327660,2645,325895,2.34,0.62,0.02008641975308642,0.81,99.46
2021-01-26,Rajasthan,1099,9,1099,13961,3293,3021,7.87,0,81.0,328759,2654,326994,4.07,3.73,0.17235802469135802,0.81,99.46
2021-01-27,Rajasthan,112,1,103,1078,4499,2595,10.39,8,81.0,328871,2655,327097,5.55,3.2,0.013308641975308642,0.81,99.46
2021-01-28,Rajasthan,1354,17,1351,16770,4526,1620,8.07,0,81.0,330225,2672,328448,5.59,2.0,0.20703703703703705,0.81,99.46
2021-01-29,Rajasthan,1184,4,1183,14535,2462,2226,8.15,0,81.0,331409,2676,329631,3.04,2.75,0.17944444444444443,0.81,99.46
2021-01-30,Rajasthan,142,1,141,1763,4915,3532,8.05,0,81.0,331551,2677,329772,6.07,4.36,0.02176543209876543,0.81,99.46
2021-01-31,Rajasthan,1565,16,1556,19684,3031,1684,7.95,0,81.0,333116,2693,331328,3.74,2.08,0.24301234567901234,0.81,99.46
2021-02-01,Rajasthan,279,1,275,3840,1037,216,7.27,3,81.0,333395,2694,331603,1.28,0.27,0.047407407407407405,0.81,99.46
2021-02-02,Rajasthan,384,5,382,5056,4776,4165,7.59,0,81.0,333779,2699,331985,5.9,5.14,0.062419753086419755,0.81,99.46
2021-02-03,Rajasthan,1310,6,1304,16848,531,415,7.78,0,81.0,335089,2705,333289,0.66,0.51,0.208,0.81,99.46
2021-02-04,Rajasthan,1423,6,1419,18079,2124,834,7.87,0,81.0,336512,2711,334708,2.62,1.03,0.22319753086419752,0.81,99.46
2021-02-05,Rajasthan,141,1,141,1779,3229,3218,7.93,0,81.0,336653,2712,334849,3.99,3.97,0.021962962962962962,0.81,99.46
2021-02-06,Rajasthan,1489,14,1481,18387,621,183,8.1,0,81.0,338142,2726,336330,0.77,0.23,0.227,0.81,99.46
2021-02-07,Rajasthan,1094,10,1088,13785,4457,2215,7.94,0,81.0,339236,2736,337418,5.5,2.73,0.1701851851851852,0.81,99.46
2021-02-08,Rajasthan,1046,11,1038,13321,2816,739,7.85,0,81.0,340282,2747,338456,3.48,0.91,0.1644567901234568,0.81,99.46
2021-02-09,Rajasthan,339,1,336,4625,155,66,7.33,2,81.0,340621,2748,338792,0.19,0.08,0.05709876543209876,0.81,99.46
2021-02-10,Rajasthan,64,0,59,1217,4798,1568,5.26,5,81.0,340685,2748,338851,5.92,1.94,0.015024691358024691,0.81,99.46
2021-02-11,Rajasthan,1306,18,1305,16251,3039,2034,8.04,0,81.0,341991,2766,340156,3.75,2.51,0.20062962962962963,0.81,99.46
2021-02-12,Rajasthan,167,1,160,1877,1287,735,8.9,6,81.0,342158,2767,340316,1.59,0.91,0.02317283950617284,0.81,99.46
2021-02-13,Rajasthan,562,2,555,6730,1673,996,8.35,5,81.0,342720,2769,340871,2.07,1.23,0.08308641975308642,0.81,99.46
2021-02-14,Rajasthan,696,6,690,8344,4806,1563,8.34,0,81.0,343416,2775,341561,5.93,1.93,0.10301234567901235,0.81,99.46
2021-02-15,Rajasthan,999,11,996,12571,1650,23,7.95,0,81.0,344415,2786,342557,2.04,0.03,0.15519753086419752,0.81,99.46
2021-02-16,Rajasthan,200,2,199,2764,2205,148,7.24,0,81.0,344615,2788,342756,2.72,0.18,0.034123456790123456,0.81,99.46
2021-02-17,Rajasthan,1089,4,1083,13832,929,198,7.87,2,81.0,345704,2792,343839,1.15,0.24,0.17076543209876544,0.81,99.46
2021-02-18,Rajasthan,1260,5,1257,15878,1093,406,7.94,0,81.0,346964,2797,345096,1.35,0.5,0.1960246913580247,0.81,99.46
2021-02-19,Rajasthan,194,1,192,2649,511,93,7.32,1,81.0,347158,2798,345288,0.63,0.11,0.03270370370370371,0.81,99.46
2021-02-20,Rajasthan,870,4,870,11056,3523,174,7.87,0,81.0,348028,2802,346158,4.35,0.21,0.13649382716049382,0.81,99.46
2021-02-21,Rajasthan,183,1,182,2293,3851,397,7.98,0,81.0,348211,2803,346340,4.75,0.49,0.028308641975308642,0.8,99.46
2021-02-22,Rajasthan,820,9,813,10247,2032,1935,8.0,0,81.0,349031,2812,347153,2.51,2.39,0.12650617283950616,0.81,99.46
2021-02-23,Rajasthan,1270,6,1266,15622,3091,826,8.13,0,81.0,350301,2818,348419,3.82,1.02,0.1928641975308642,0.8,99.46
2021-02-24,Rajasthan,424,4,415,5335,4064,3286,7.95,5,81.0,350725,2822,348834,5.02,4.06,0.0658641975308642,0.8,99.46
2021-02-25,Rajasthan,1057,4,1052,13700,3007,2338,7.72,1,81.0,351782,2826,349886,3.71,2.89,0.16913580246913582,0.8,99.46
2021-02-26,Rajasthan,364,2,364,4144,3718,3660,8.78,0,81.0,352146,2828,350250,4.59,4.52,0.051160493827160494,0.8,99.46
2021-02-27,Rajasthan,81,1,79,1289,150,29,6.28,1,81.0,352227,2829,350329,0.19,0.04,0.01591358024691358,0.8,99.46
2021-02-28,Rajasthan,364,3,358,4473,3710,138,8.14,3,81.0,352591,2832,350687,4.58,0.17,0.05522222222222222,0.8,99.46
2021-03-01,Rajasthan,798,9,794,9982,1484,1319,7.99,0,81.0,353389,2841,351481,1.83,1.63,0.12323456790123456,0.8,99.46
2021-03-02,Rajasthan,593,7,590,7430,2810,1377,7.98,0,81.0,353982,2848,352071,3.47,1.7,0.09172839506172839,0.8,99.46
2021-03-03,Rajasthan,152,1,146,1882,1598,505,8.08,5,81.0,354134,2849,352217,1.97,0.62,0.023234567901234567,0.8,99.46
2021-03-04,Rajasthan,211,3,208,2987,4335,3170,7.06,0,81.0,354345,2852,352425,5.35,3.91,0.036876543209876544,0.8,99.46
2021-03-05,Rajasthan,805,10,799,9853,4678,3846,8.17,0,81.0,355150,2862,353224,5.78,4.75,0.12164197530864197,0.81,99.46
2021-03-06,Rajasthan,245,1,242,2980,2430,1280,8.22,2,81.0,355395,2863,353466,3.0,1.58,0.03679012345679012,0.81,99.46
2021-03-07,Rajasthan,1291,14,1286,15845,3476,1712,8.15,0,81.0,356686,2877,354752,4.29,2.11,0.19561728395061728,0.81,99.46
2021-03-08,Rajasthan,539,3,537,7020,1281,13,7.68,0,81.0,357225,2880,355289,1.58,0.02,0.08666666666666667,0.81,99.46
2021-03-09,Rajasthan,200,2,200,2394,2275,534,8.35,0,81.0,357425,2882,355489,2.81,0.66,0.029555555555555557,0.81,99.46
2021-03-10,Rajasthan,908,5,906,11191,1767,1022,8.11,0,81.0,358333,2887,356395,2.18,1.26,0.1381604938271605,0.81,99.46
2021-03-11,Rajasthan,824,7,817,10386,3426,2564,7.93,0,81.0,359157,2894,357212,4.23,3.17,0.1282222222222222,0.81,99.46
2021-03-12,Rajasthan,1362,12,1362,17055,1181,788,7.99,0,81.0,360519,2906,358574,1.46,0.97,0.21055555555555555,0.81,99.46
2021-03-13,Rajasthan,97,1,88,1477,4489,169,6.57,8,81.0,360616,2907,358662,5.54,0.21,0.018234567901234566,0.81,99.46
2021-03-14,Rajasthan,107,0,100,1083,2770,2633,9.88,7,81.0,360723,2907,358762,3.42,3.25,0.013370370370370371,0.81,99.46
2021-03-15,Rajasthan,347,4,338,4049,1567,912,8.57,5,81.0,361070,2911,359100,1.93,1.13,0.04998765432098765,0.81,99.45
2021-03-16,Rajasthan,672,4,664,8420,4599,3242,7.98,4,81.0,361742,2915,359764,5.68,4.0,0.10395061728395062,0.81,99.45
2021-03-17,Rajasthan,436,5,428,4876,2442,1507,8.94,3,81.0,362178,2920,360192,3.01,1.86,0.06019753086419753,0.81,99.45
2021-03-18,Rajasthan,943,8,938,12047,3176,227,7.83,0,81.0,363121,2928,361130,3.92,0.28,0.14872839506172839,0.81,99.45
2021-03-19,Rajasthan,1488,9,1481,18747,3490,2165,7.94,0,81.0,364609,2937,362611,4.31,2.67,0.23144444444444445,0.81,99.45
2021-03-20,Rajasthan,559,1,559,6680,1487,757,8.37,0,81.0,365168,2938,363170,1.84,0.93,0.08246913580246913,0.8,99.45
2021-03-21,Rajasthan,1435,10,1429,17586,4743,2548,8.16,0,81.0,366603,2948,364599,5.86,3.15,0.21711111111111112,0.8,99.45
2021-03-22,Rajasthan,394,3,390,4631,3572,273,8.51,1,81.0,366997,2951,364989,4.41,0.34,0.05717283950617284,0.8,99.45
2021-03-23,Rajasthan,694,3,690,8659,4166,3225,8.01,1,81.0,367691,2954,365679,5.14,3.98,0.10690123456790124,0.8,99.45
2021-03-24,Rajasthan,331,1,323,3997,279,129,8.28,7,81.0,368022,2955,366002,0.34,0.16,0.049345679012345676,0.8,99.45
2021-03-25,Rajasthan,255,2,252,3374,3337,2427,7.56,1,81.0,368277,2957,366254,4.12,3.0,0.04165432098765432,0.8,99.45
2021-03-26,Rajasthan,378,1,376,4667,3672,2533,8.1,1,81.0,368655,2958,366630,4.53,3.13,0.057617283950617285,0.8,99.45
2021-03-27,Rajasthan,295,2,290,3583,2186,715,8.23,3,81.0,368950,2960,366920,2.7,0.88,0.04423456790123457,0.8,99.45
2021-03-28,Rajasthan,272,2,270,3798,3733,2139,7.16,0,81.0,369222,2962,367190,4.61,2.64,0.04688888888888889,0.8,99.45
2021-03-29,Rajasthan,670,8,667,8156,3205,456,8.21,0,81.0,369892,2970,367857,3.96,0.56,0.10069135802469135,0.8,99.45
2021-03-30,Rajasthan,213,2,212,2931,4371,323,7.27,0,81.0,370105,2972,368069,5.4,0.4,0.03618518518518519,0.8,99.45
2021-03-31,Rajasthan,93,1,93,1078,4819,2343,8.63,0,81.0,370198,2973,368162,5.95,2.89,0.013308641975308642,0.8,99.45
2021-04-01,Rajasthan,95,1,90,1674,4275,2054,5.68,4,81.0,370293,2974,368252,5.28,2.54,0.020666666666666667,0.8,99.45
2021-04-02,Rajasthan,1279,4,1278,15907,3151,1805,8.04,0,81.0,371572,2978,369530,3.89,2.23,0.1963827160493827,0.8,99.45
2021-04-03,Rajasthan,45,0,38,656,2736,1608,6.86,7,81.0,371617,2978,369568,3.38,1.99,0.008098765432098766,0.8,99.45
2021-04-04,Rajasthan,1213,11,1210,14773,1531,1262,8.21,0,81.0,372830,2989,370778,1.89,1.56,0.18238271604938272,0.8,99.45
2021-04-05,Rajasthan,1298,8,1298,16048,426,407,8.09,0,81.0,374128,2997,372076,0.53,0.5,0.19812345679012347,0.8,99.45
2021-04-06,Rajasthan,1264,9,1255,16126,614,3,7.84,0,81.0,375392,3006,373331,0.76,0.0,0.1990864197530864,0.8,99.45
2021-04-07,Rajasthan,1275,12,1273,16290,4560,519,7.83,0,81.0,376667,3018,374604,5.63,0.64,0.2011111111111111,0.8,99.45
2021-04-08,Rajasthan,872,5,872,10606,3500,1043,8.22,0,81.0,377539,3023,375476,4.32,1.29,0.13093827160493826,0.8,99.45
2021-04-09,Rajasthan,160,2,154,1880,92,77,8.51,4,81.0,377699,3025,375630,0.11,0.1,0.023209876543209877,0.8,99.45
2021-04-10,Rajasthan,427,4,419,5298,1468,127,8.06,4,81.0,378126,3029,376049,1.81,0.16,0.06540740740740741,0.8,99.45
2021-04-11,Rajasthan,865,3,856,10666,561,369,8.11,6,81.0,378991,3032,376905,0.69,0.46,0.13167901234567903,0.8,99.45
2021-04-12,Rajasthan,88,1,80,1311,2162,1485,6.71,7,81.0,379079,3033,376985,2.67,1.83,0.016185185185185184,0.8,99.45
2021-04-13,Rajasthan,1408,15,1403,17385,4040,3868,8.1,0,81.0,380487,3048,378388,4.99,4.78,0.21462962962962964,0.8,99.45
2021-04-14,Rajasthan,1377,16,1370,17142,3809,1797,8.03,0,81.0,381864,3064,379758,4.7,2.22,0.21162962962962964,0.8,99.45
2021-04-15,Rajasthan,114,1,109,1344,4188,2482,8.48,4,81.0,381978,3065,379867,5.17,3.06,0.016592592592592593,0.8,99.45
2021-04-16,Rajasthan,944,7,943,11424,2907,1550,8.26,0,81.0,382922,3072,380810,3.59,1.91,0.14103703703703704,0.8,99.45
2021-04-17,Rajasthan,775,4,770,9964,3227,618,7.78,1,81.0,383697,3076,381580,3.98,0.76,0.12301234567901234,0.8,99.45
2021-04-18,Rajasthan,1533,18,1524,19383,2668,1468,7.91,0,81.0,385230,3094,383104,3.29,1.81,0.23929629629629628,0.8,99.45
2021-04-19,Rajasthan,439,4,432,5223,4601,2049,8.41,3,81.0,385669,3098,383536,5.68,2.53,0.06448148148148149,0.8,99.45
2021-04-20,Rajasthan,1528,21,1525,19055,817,260,8.02,0,81.0,387197,3119,385061,1.01,0.32,0.2352469135802469,0.81,99.45
2021-04-21,Rajasthan,1424,17,1416,17867,4161,2399,7.97,0,81.0,388621,3136,386477,5.14,2.96,0.22058024691358025,0.81,99.45
2021-04-22,Rajasthan,1213,10,1205,15132,493,262,8.02,0,81.0,389834,3146,387682,0.61,0.32,0.18681481481481482,0.81,99.45
2021-04-23,Rajasthan,1049,10,1047,13541,2463,1967,7.75,0,81.0,390883,3156,388729,3.04,2.43,0.16717283950617284,0.81,99.45
2021-04-24,Rajasthan,934,3,933,11522,314,153,8.11,0,81.0,391817,3159,389662,0.39,0.19,0.1422469135802469,0.81,99.45
2021-04-25,Rajasthan,1077,9,1077,13186,1819,331,8.17,0,81.0,392894,3168,390739,2.25,0.41,0.16279012345679011,0.81,99.45
2021-04-26,Rajasthan,561,2,557,7275,1364,1005,7.71,2,81.0,393455,3170,391296,1.68,1.24,0.08981481481481482,0.81,99.45
2021-04-27,Rajasthan,656,6,655,8177,1535,513,8.02,0,81.0,394111,3176,391951,1.9,0.63,0.10095061728395062,0.81,99.45
2021-04-28,Rajasthan,1327,4,1326,16554,3759,2986,8.02,0,81.0,395438,3180,393277,4.64,3.69,0.20437037037037037,0.8,99.45
2021-04-29,Rajasthan,1597,15,1592,19872,712,375,8.04,0,81.0,397035,3195,394869,0.88,0.46,0.24533333333333332,0.8,99.45
2021-04-30,Rajasthan,1553,7,1544,19611,3681,79,7.92,2,81.0,398588,3202,396413,4.54,0.1,0.2421111111111111,0.8,99.45
2021-05-01,Rajasthan,736,10,734,9048,3645,531,8.13,0,81.0,399324,3212,397147,4.5,0.66,0.11170370370370371,0.8,99.45
2021-05-02,Rajasthan,1468,15,1459,18541,1102,495,7.92,0,81.0,400792,3227,398606,1.36,0.61,0.22890123456790124,0.81,99.45
2021-05-03,Rajasthan,137,1,133,2062,3926,1264,6.64,3,81.0,400929,3228,398739,4.85,1.56,0.02545679012345679,0.81,99.45
2021-05-04,Rajasthan,79,0,78,964,1929,893,8.2,1,81.0,401008,3228,398817,2.38,1.1,0.011901234567901235,0.8,99.45
2021-05-05,Rajasthan,732,5,728,9153,1475,720,8.0,0,81.0,401740,3233,399545,1.82,0.89,0.113,0.8,99.45
2021-05-06,Rajasthan,998,7,991,12645,4947,2311,7.89,0,81.0,402738,3240,400536,6.11,2.85,0.15611111111111112,0.8,99.45
2021-05-07,Rajasthan,1149,11,1144,14855,1218,392,7.73,0,81.0,403887,3251,401680,1.5,0.48,0.18339506172839506,0.8,99.45
2021-05-08,Rajasthan,361,3,361,4914,2964,2714,7.35,0,81.0,404248,3254,402041,3.66,3.35,0.06066666666666667,0.8,99.45
2021-05-09,Rajasthan,1106,8,1099,13405,2194,1174,8.25,0,81.0,405354,3262,403140,2.71,1.45,0.16549382716049382,0.8,99.45
2021-05-10,Rajasthan,1505,9,1502,18748,740,710,8.03,0,81.0,406859,3271,404642,0.91,0.88,0.2314567901234568,0.8,99.46
2021-05-11,Rajasthan,184,0,180,2178,278,103,8.45,4,81.0,407043,3271,404822,0.34,0.13,0.02688888888888889,0.8,99.45
2021-05-12,Rajasthan,779,5,776,9650,2784,527,8.07,0,81.0,407822,3276,405598,3.44,0.65,0.1191358024691358,0.8,99.45
2021-05-13,Rajasthan,1477,14,1475,18450,4314,1334,8.01,0,81.0,409299,3290,407073,5.33,1.65,0.22777777777777777,0.8,99.46
2021-05-14,Rajasthan,1165,11,1163,14377,2519,174,8.1,0,81.0,410464,3301,408236,3.11,0.21,0.17749382716049383,0.8,99.46
2021-05-15,Rajasthan,1095,13,1087,13944,4528,1821,7.85,0,81.0,411559,3314,409323,5.59,2.25,0.17214814814814816,0.81,99.46
2021-05-16,Rajasthan,587,5,578,7615,16,16,7.71,4,81.0,412146,3319,409901,0.02,0.02,0.09401234567901234,0.81,99.46
2021-05-17,Rajasthan,1550,18,1548,19228,2434,78,8.06,0,81.0,413696,3337,411449,3.0,0.1,0.2373827160493827,0.81,99.46
2021-05-18,Rajasthan,968,4,960,12120,3247,303,7.99,4,81.0,414664,3341,412409,4.01,0.37,0.14962962962962964,0.81,99.46
2021-05-19,Rajasthan,1293,10,1286,16537,2174,326,7.82,0,81.0,415957,3351,413695,2.68,0.4,0.2041604938271605,0.81,99.46
2021-05-20,Rajasthan,1064,11,1057,13847,3616,745,7.68,0,81.0,417021,3362,414752,4.46,0.92,0.1709506172839506,0.81,99.46
2021-05-21,Rajasthan,1181,7,1178,14907,3980,112,7.92,0,81.0,418202,3369,415930,4.91,0.14,0.18403703703703703,0.81,99.46
2021-05-22,Rajasthan,1494,5,1494,18628,133,36,8.02,0,81.0,419696,3374,417424,0.16,0.04,0.2299753086419753,0.8,99.46
2021-05-23,Rajasthan,1222,9,1215,15362,2121,1636,7.95,0,81.0,420918,3383,418639,2.62,2.02,0.18965432098765433,0.8,99.46
2021-05-24,Rajasthan,987,8,983,12725,1650,21,7.76,0,81.0,421905,3391,419622,2.04,0.03,0.15709876543209877,0.8,99.46
2021-05-25,Rajasthan,439,5,437,5191,2809,2001,8.46,0,81.0,422344,3396,420059,3.47,2.47,0.06408641975308642,0.8,99.46
2021-05-26,Rajasthan,1048,6,1045,12889,3086,180,8.13,0,81.0,423392,3402,421104,3.81,0.22,0.15912345679012346,0.8,99.46
2021-05-27,Rajasthan,486,7,482,6033,1819,560,8.06,0,81.0,423878,3409,421586,2.25,0.69,0.07448148148148148,0.8,99.46
2021-05-28,Rajasthan,1009,14,1007,12267,4873,252,8.23,0,81.0,424887,3423,422593,6.02,0.31,0.15144444444444444,0.81,99.46
2021-05-29,Rajasthan,1141,8,1132,14347,2612,460,7.95,1,81.0,426028,3431,423725,3.22,0.57,0.17712345679012345,0.81,99.46
2021-05-30,Rajasthan,136,1,136,2070,4652,1728,6.57,0,81.0,426164,3432,423861,5.74,2.13,0.025555555555555557,0.81,99.46
2021-05-31,Rajasthan,1039,9,1039,12901,59,1,8.05,0,81.0,427203,3441,424900,0.07,0.0,0.1592716049382716,0.81,99.46
2021-06-01,Rajasthan,328,3,325,3699,1375,978,8.87,0,81.0,427531,3444,425225,1.7,1.21,0.04566666666666667,0.81,99.46
2021-06-02,Rajasthan,720,9,717,8898,4691,2601,8.09,0,81.0,428251,3453,425942,5.79,3.21,0.10985185185185185,0.81,99.46
2021-06-03,Rajasthan,857,4,856,10484,222,20,8.17,0,81.0,429108,3457,426798,0.27,0.02,0.1294320987654321,0.81,99.46
2021-06-04,Rajasthan,298,2,298,3494,1697,1683,8.53,0,81.0,429406,3459,427096,2.1,2.08,0.0431358024691358,0.81,99.46
2021-06-05,Rajasthan,1581,12,1574,19994,3817,2139,7.91,0,81.0,430987,3471,428670,4.71,2.64,0.2468395061728395,0.81,99.46
2021-06-06,Rajasthan,1218,9,1211,14775,1592,610,8.24,0,81.0,432205,3480,429881,1.97,0.75,0.1824074074074074,0.81,99.46
2021-06-07,Rajasthan,997,12,995,12615,5,4,7.9,0,81.0,433202,3492,430876,0.01,0.0,0.15574074074074074,0.81,99.46
2021-06-08,Rajasthan,1140,3,1137,14450,1537,1001,7.89,0,81.0,434342,3495,432013,1.9,1.24,0.17839506172839506,0.8,99.46
2021-06-09,Rajasthan,757,5,750,9629,2295,1726,7.86,2,81.0,435099,3500,432763,2.83,2.13,0.11887654320987655,0.8,99.46
2021-06-10,Rajasthan,164,1,156,2259,338,283,7.26,7,81.0,435263,3501,432919,0.42,0.35,0.02788888888888889,0.8,99.46
2021-06-11,Rajasthan,1080,13,1079,13392,2602,2045,8.06,0,81.0,436343,3514,433998,3.21,2.52,0.16533333333333333,0.81,99.46
2021-06-12,Rajasthan,839,8,838,10480,2775,1457,8.01,0,81.0,437182,3522,434836,3.43,1.8,0.12938271604938273,0.81,99.46
2021-06-13,Rajasthan,1236,8,1233,15568,4755,786,7.94,0,81.0,438418,3530,436069,5.87,0.97,0.19219753086419752,0.81,99.46
2021-06-14,Rajasthan,1475,20,1467,18293,3821,3099,8.06,0,81.0,439893,3550,437536,4.72,3.83,0.22583950617283952,0.81,99.46
2021-06-15,Rajasthan,385,4,379,4881,193,25,7.89,2,81.0,440278,3554,437915,0.24,0.03,0.06025925925925926,0.81,99.46
2021-06-16,Rajasthan,181,1,178,2174,1284,783,8.33,2,81.0,440459,3555,438093,1.59,0.97,0.026839506172839506,0.81,99.46
2021-06-17,Rajasthan,380,3,378,4694,3151,257,8.1,0,81.0,440839,3558,438471,3.89,0.32,0.057950617283950616,0.81,99.46
2021-06-18,Rajasthan,409,2,408,4894,3616,638,8.36,0,81.0,441248,3560,438879,4.46,0.79,0.06041975308641975,0.81,99.46
2021-06-19,Rajasthan,1085,8,1081,13371,1223,1104,8.11,0,81.0,442333,3568,439960,1.51,1.36,0.16507407407407407,0.81,99.46
2021-06-20,Rajasthan,946,3,945,11795,2225,2017,8.02,0,81.0,443279,3571,440905,2.75,2.49,0.1456172839506173,0.81,99.46
2021-06-21,Rajasthan,1497,9,1496,18483,4001,3411,8.1,0,81.0,444776,3580,442401,4.94,4.21,0.22818518518518519,0.8,99.47
2021-06-22,Rajasthan,73,0,65,1194,1033,415,6.11,8,81.0,444849,3580,442466,1.28,0.51,0.01474074074074074,0.8,99.46
2021-06-23,Rajasthan,388,4,379,4996,3103,796,7.77,5,81.0,445237,3584,442845,3.83,0.98,0.06167901234567901,0.8,99.46
2021-06-24,Rajasthan,91,0,84,740,4645,3410,12.3,7,81.0,445328,3584,442929,5.73,4.21,0.009135802469135803,0.8,99.46
2021-06-25,Rajasthan,499,3,490,6408,1030,22,7.79,6,81.0,445827,3587,443419,1.27,0.03,0.0791111111111111,0.8,99.46
2021-06-26,Rajasthan,1235,7,1227,15361,4280,1813,8.04,1,81.0,447062,3594,444646,5.28,2.24,0.18964197530864196,0.8,99.46
2021-06-27,Rajasthan,1219,4,1218,15107,4099,3309,8.07,0,81.0,448281,3598,445864,5.06,4.09,0.18650617283950618,0.8,99.46
2021-06-28,Rajasthan,182,0,174,2253,4188,1647,8.08,8,81.0,448463,3598,446038,5.17,2.03,0.027814814814814817,0.8,99.46
2021-06-29,Rajasthan,686,4,679,8781,2536,360,7.81,3,81.0,449149,3602,446717,3.13,0.44,0.10840740740740741,0.8,99.46
2021-06-30,Rajasthan,140,1,139,1566,1321,1259,8.94,0,81.0,449289,3603,446856,1.63,1.55,0.019333333333333334,0.8,99.46
2021-07-01,Rajasthan,1176,14,1172,14627,675,402,8.04,0,81.0,450465,3617,448028,0.83,0.5,0.18058024691358024,0.8,99.46
2021-07-02,Rajasthan,1582,10,1574,19722,1103,49,8.02,0,81.0,452047,3627,449602,1.36,0.06,0.2434814814814815,0.8,99.46
2021-07-03,Rajasthan,833,5,833,10839,1926,244,7.69,0,81.0,452880,3632,450435,2.38,0.3,0.1338148148148148,0.8,99.46
2021-07-04,Rajasthan,999,10,993,12201,1862,407,8.19,0,81.0,453879,3642,451428,2.3,0.5,0.15062962962962964,0.8,99.46
2021-07-05,Rajasthan,141,1,132,1839,1837,941,7.67,8,81.0,454020,3643,451560,2.27,1.16,0.022703703703703705,0.8,99.46
2021-07-06,Rajasthan,1226,6,1223,15490,3375,501,7.91,0,81.0,455246,3649,452783,4.17,0.62,0.19123456790123458,0.8,99.46
2021-07-07,Rajasthan,1257,5,1250,15591,1429,357,8.06,2,81.0,456503,3654,454033,1.76,0.44,0.19248148148148148,0.8,99.46
2021-07-08,Rajasthan,541,6,532,6245,1884,186,8.66,3,81.0,457044,3660,454565,2.33,0.23,0.07709876543209876,0.8,99.46
2021-07-09,Rajasthan,110,0,108,1006,1023,741,10.93,2,81.0,457154,3660,454673,1.26,0.91,0.012419753086419754,0.8,99.46
2021-07-10,Rajasthan,675,3,670,8540,4024,569,7.9,2,81.0,457829,3663,455343,4.97,0.7,0.1054320987654321,0.8,99.46
2021-07-11,Rajasthan,1201,12,1199,15103,1979,490,7.95,0,81.0,459030,3675,456542,2.44,0.6,0.18645679012345678,0.8,99.46
2021-07-12,Rajasthan,727,5,718,8913,189,36,8.16,4,81.0,459757,3680,457260,0.23,0.04,0.11003703703703703,0.8,99.46
2021-07-13,Rajasthan,877,5,872,10999,463,52,7.97,0,81.0,460634,3685,458132,0.57,0.06,0.13579012345679012,0.8,99.46
2021-07-14,Rajasthan,1362,15,1356,16859,4196,852,8.08,0,81.0,461996,3700,459488,5.18,1.05,0.2081358024691358,0.8,99.46
2021-07-15,Rajasthan,1293,15,1286,16091,3553,1943,8.04,0,81.0,463289,3715,460774,4.39,2.4,0.19865432098765431,0.8,99.46
2021-07-16,Rajasthan,1120,11,1120,14224,176,88,7.87,0,81.0,464409,3726,461894,0.22,0.11,0.17560493827160495,0.8,99.46
2021-07-17,Rajasthan,1535,9,1529,19228,1061,943,7.98,0,81.0,465944,3735,463423,1.31,1.16,0.2373827160493827,0.8,99.46
2021-07-18,Rajasthan,672,7,666,8045,2529,29,8.35,0,81.0,466616,3742,464089,3.12,0.04,0.09932098765432099,0.8,99.46
2021-07-19,Rajasthan,106,1,97,995,4390,880,10.65,8,81.0,466722,3743,464186,5.42,1.09,0.012283950617283951,0.8,99.46
2021-07-20,Rajasthan,881,12,873,11242,870,89,7.84,0,81.0,467603,3755,465059,1.07,0.11,0.13879012345679012,0.8,99.46
2021-07-21,Rajasthan,1013,5,1004,12657,4245,4143,8.0,4,81.0,468616,3760,466063,5.24,5.11,0.15625925925925926,0.8,99.46
2021-07-22,Rajasthan,1082,4,1076,13364,2260,689,8.1,2,81.0,469698,3764,467139,2.79,0.85,0.16498765432098766,0.8,99.46
2021-07-23,Rajasthan,1195,4,1189,15049,4366,1701,7.94,2,81.0,470893,3768,468328,5.39,2.1,0.18579012345679013,0.8,99.46
2021-07-24,Rajasthan,986,9,979,12461,290,178,7.91,0,81.0,471879,3777,469307,0.36,0.22,0.1538395061728395,0.8,99.45
2021-07-25,Rajasthan,803,4,802,9574,965,951,8.39,0,81.0,472682,3781,470109,1.19,1.17,0.11819753086419753,0.8,99.46
2021-07-26,Rajasthan,964,10,957,12127,121,54,7.95,0,81.0,473646,3791,471066,0.15,0.07,0.14971604938271604,0.8,99.46
2021-07-27,Rajasthan,85,1,77,1159,4100,765,7.33,7,81.0,473731,3792,471143,5.06,0.94,0.014308641975308642,0.8,99.45
2021-07-28,Rajasthan,1477,17,1472,18571,3281,3068,7.95,0,81.0,475208,3809,472615,4.05,3.79,0.22927160493827162,0.8,99.45
2021-07-29,Rajasthan,1019,6,1015,12714,3477,564,8.01,0,81.0,476227,3815,473630,4.29,0.7,0.15696296296296297,0.8,99.45
2021-07-30,Rajasthan,525,6,516,6520,2747,1807,8.05,3,81.0,476752,3821,474146,3.39,2.23,0.08049382716049383,0.8,99.45
2021-07-31,Rajasthan,841,10,833,10691,2736,2576,7.87,0,81.0,477593,3831,474979,3.38,3.18,0.13198765432098766,0.8,99.45
2021-08-01,Rajasthan,989,9,980,11995,4744,2886,8.25,0,81.0,478582,3840,475959,5.86,3.56,0.14808641975308642,0.8,99.45
2021-08-02,Rajasthan,1309,13,1309,16007,3452,2871,8.18,0,81.0,479891,3853,477268,4.26,3.54,0.19761728395061728,0.8,99.45
2021-08-03,Rajasthan,768,2,767,9997,2653,1891,7.68,0,81.0,480659,3855,478035,3.28,2.33,0.12341975308641975,0.8,99.45
2021-08-04,Rajasthan,997,3,989,12464,4961,1500,8.0,5,81.0,481656,3858,479024,6.12,1.85,0.15387654320987654,0.8,99.45
2021-08-05,Rajasthan,1371,6,1362,16367,3254,1811,8.38,3,81.0,483027,3864,480386,4.02,2.24,0.20206172839506173,0.8,99.45
2021-08-06,Rajasthan,1031,7,1023,12547,954,342,8.22,1,81.0,484058,3871,481409,1.18,0.42,0.15490123456790122,0.8,99.45
2021-08-07,Rajasthan,801,5,794,9814,791,145,8.16,2,81.0,484859,3876,482203,0.98,0.18,0.12116049382716049,0.8,99.45
2021-08-08,Rajasthan,1236,3,1227,15618,3346,1296,7.91,6,81.0,486095,3879,483430,4.13,1.6,0.19281481481481483,0.8,99.45
2021-08-09,Rajasthan,1382,7,1378,16814,2684,233,8.22,0,81.0,487477,3886,484808,3.31,0.29,0.20758024691358024,0.8,99.45
2021-08-10,Rajasthan,809,3,806,10248,1474,732,7.89,0,81.0,488286,3889,485614,1.82,0.9,0.12651851851851853,0.8,99.45
2021-08-11,Rajasthan,120,0,114,1500,2419,1246,8.0,6,81.0,488406,3889,485728,2.99,1.54,0.018518518518518517,0.8,99.45
2021-08-12,Rajasthan,743,9,736,8881,2983,1138,8.37,0,81.0,489149,3898,486464,3.68,1.4,0.10964197530864198,0.8,99.45
2021-08-13,Rajasthan,645,3,641,8102,2276,774,7.96,1,81.0,489794,3901,487105,2.81,0.96,0.10002469135802469,0.8,99.45
2021-08-14,Rajasthan,716,3,710,8834,2650,830,8.11,3,81.0,490510,3904,487815,3.27,1.02,0.10906172839506173,0.8,99.45
2021-08-15,Rajasthan,1443,16,1436,18337,4120,3383,7.87,0,81.0,491953,3920,489251,5.09,4.18,0.2263827160493827,0.8,99.45
2021-08-16,Rajasthan,358,1,350,4660,741,560,7.68,7,81.0,492311,3921,489601,0.91,0.69,0.05753086419753087,0.8,99.45
2021-08-17,Rajasthan,819,4,815,10390,2031,1741,7.88,0,81.0,493130,3925,490416,2.51,2.15,0.1282716049382716,0.8,99.45
2021-08-18,Rajasthan,671,8,665,8226,3168,2964,8.16,0,81.0,493801,3933,491081,3.91,3.66,0.10155555555555555,0.8,99.45
2021-08-19,Rajasthan,926,10,920,11748,12,0,7.88,0,81.0,494727,3943,492001,0.01,0.0,0.14503703703703705,0.8,99.45
2021-08-20,Rajasthan,1296,11,1287,16416,2200,1582,7.89,0,81.0,496023,3954,493288,2.72,1.95,0.20266666666666666,0.8,99.45
2021-08-21,Rajasthan,389,5,383,5024,1440,780,7.74,1,81.0,496412,3959,493671,1.78,0.96,0.06202469135802469,0.8,99.45
2021-08-22,Rajasthan,703,2,699,8573,3701,2693,8.2,2,81.0,497115,3961,494370,4.57,3.32,0.1058395061728395,0.8,99.45
2021-08-23,Rajasthan,1455,13,1453,17696,557,187,8.22,0,81.0,498570,3974,495823,0.69,0.23,0.21846913580246913,0.8,99.45
2021-08-24,Rajasthan,95,0,87,1329,1867,63,7.15,8,81.0,498665,3974,495910,2.3,0.08,0.01640740740740741,0.8,99.45
2021-08-25,Rajasthan,451,5,446,5431,1990,743,8.3,0,81.0,499116,3979,496356,2.46,0.92,0.06704938271604938,0.8,99.45
2021-08-26,Rajasthan,1085,7,1078,13674,3897,3773,7.93,0,81.0,500201,3986,497434,4.81,4.66,0.1688148148148148,0.8,99.45
2021-08-27,Rajasthan,1428,10,1424,17871,2485,1837,7.99,0,81.0,501629,3996,498858,3.07,2.27,0.22062962962962962,0.8,99.45
2021-08-28,Rajasthan,1049,11,1047,13781,4968,605,7.61,0,81.0,502678,4007,499905,6.13,0.75,0.17013580246913582,0.8,99.45
2021-08-29,Rajasthan,597,5,594,7534,2758,2438,7.92,0,81.0,503275,4012,500499,3.4,3.01,0.09301234567901234,0.8,99.45
2021-08-30,Rajasthan,846,5,839,10798,4529,3099,7.83,2,81.0,504121,4017,501338,5.59,3.83,0.13330864197530864,0.8,99.45
2021-08-31,Rajasthan,803,5,797,10167,1303,1012,7.9,1,81.0,504924,4022,502135,1.61,1.25,0.12551851851851853,0.8,99.45
2021-09-01,Rajasthan,1352,16,1343,16837,4039,2534,8.03,0,81.0,506276,4038,503478,4.99,3.13,0.2078641975308642,0.8,99.45
2021-09-02,Rajasthan,644,3,640,7511,4368,3519,8.57,1,81.0,506920,4041,504118,5.39,4.34,0.09272839506172839,0.8,99.45
2021-09-03,Rajasthan,958,13,958,11724,1671,1529,8.17,0,81.0,507878,4054,505076,2.06,1.89,0.14474074074074075,0.8,99.45
2021-09-04,Rajasthan,271,1,268,3635,1112,11,7.46,2,81.0,508149,4055,505344,1.37,0.01,0.044876543209876545,0.8,99.45
2021-09-05,Rajasthan,1132,6,1131,14155,2675,665,8.0,0,81.0,509281,4061,506475,3.3,0.82,0.1747530864197531,0.8,99.45
2021-09-06,Rajasthan,486,4,484,6714,4760,3456,7.24,0,81.0,509767,4065,506959,5.88,4.27,0.08288888888888889,0.8,99.45
2021-09-07,Rajasthan,223,1,217,2409,1649,1394,9.26,5,81.0,509990,4066,507176,2.04,1.72,0.02974074074074074,0.8,99.45
2021-09-08,Rajasthan,167,2,161,2433,1046,709,6.86,4,81.0,510157,4068,507337,1.29,0.88,0.030037037037037036,0.8,99.45
2021-09-09,Rajasthan,1141,7,1136,14434,424,37,7.9,0,81.0,511298,4075,508473,0.52,0.05,0.17819753086419754,0.8,99.45
2021-09-10,Rajasthan,762,3,755,9779,3198,2433,7.79,4,81.0,512060,4078,509228,3.95,3.0,0.12072839506172839,0.8,99.45
2021-09-11,Rajasthan,715,7,707,9010,1457,301,7.94,1,81.0,512775,4085,509935,1.8,0.37,0.11123456790123457,0.8,99.45
2021-09-12,Rajasthan,56,0,47,796,3854,2401,7.04,9,81.0,512831,4085,509982,4.76,2.96,0.009827160493827161,0.8,99.44
2021-09-13,Rajasthan,400,1,396,4936,2567,83,8.1,3,81.0,513231,4086,510378,3.17,0.1,0.06093827160493827,0.8,99.44
2021-09-14,Rajasthan,586,5,582,7317,2545,323,8.01,0,81.0,513817,4091,510960,3.14,0.4,0.09033333333333333,0.8,99.44
2021-09-15,Rajasthan,1444,20,1442,18280,2774,939,7.9,0,81.0,515261,4111,512402,3.42,1.16,0.22567901234567903,0.8,99.45
2021-09-16,Rajasthan,1563,23,1561,19222,389,37,8.13,0,81.0,516824,4134,513963,0.48,0.05,0.23730864197530865,0.8,99.45
2021-09-17,Rajasthan,553,6,553,6514,2451,397,8.49,0,81.0,517377,4140,514516,3.03,0.49,0.08041975308641976,0.8,99.45
2021-09-18,Rajasthan,1421,16,1414,17546,42,32,8.1,0,81.0,518798,4156,515930,0.05,0.04,0.21661728395061727,0.8,99.45
2021-09-19,Rajasthan,118,1,111,1765,840,30,6.69,6,81.0,518916,4157,516041,1.04,0.04,0.021790123456790125,0.8,99.45
2021-09-20,Rajasthan,470,4,463,5956,3085,670,7.89,3,81.0,519386,4161,516504,3.81,0.83,0.07353086419753087,0.8,99.45
2021-09-21,Rajasthan,1467,13,1464,18559,293,58,7.9,0,81.0,520853,4174,517968,0.36,0.07,0.22912345679012347,0.8,99.45
2021-09-22,Rajasthan,560,7,554,6608,1640,1598,8.47,0,81.0,521413,4181,518522,2.02,1.97,0.08158024691358025,0.8,99.45
2021-09-23,Rajasthan,1361,16,1359,17204,1384,493,7.91,0,81.0,522774,4197,519881,1.71,0.61,0.21239506172839506,0.8,99.45
2021-09-24,Rajasthan,1320,15,1316,16745,4966,1861,7.88,0,81.0,524094,4212,521197,6.13,2.3,0.20672839506172838,0.8,99.45
2021-09-25,Rajasthan,1286,5,1284,16087,4822,343,7.99,0,81.0,525380,4217,522481,5.95,0.42,0.19860493827160494,0.8,99.45
2021-09-26,Rajasthan,597,3,596,7693,1371,683,7.76,0,81.0,525977,4220,523077,1.69,0.84,0.09497530864197531,0.8,99.45
2021-09-27,Rajasthan,1516,8,1515,19099,1519,246,7.94,0,81.0,527493,4228,524592,1.88,0.3,0.23579012345679012,0.8,99.45
2021-09-28,Rajasthan,109,0,105,1508,866,281,7.23,4,81.0,527602,4228,524697,1.07,0.35,0.018617283950617285,0.8,99.45
2021-09-29,Rajasthan,432,3,427,5178,1388,205,8.34,2,81.0,528034,4231,525124,1.71,0.25,0.06392592592592593,0.8,99.45
2021-09-30,Rajasthan,818,5,814,10203,2775,1456,8.02,0,81.0,528852,4236,525938,3.43,1.8,0.12596296296296297,0.8,99.45
2021-10-01,Rajasthan,1099,5,1097,13365,4469,2797,8.22,0,81.0,529951,4241,527035,5.52,3.45,0.165,0.8,99.45
2021-10-02,Rajasthan,1000,12,998,13145,2005,585,7.61,0,81.0,530951,4253,528033,2.48,0.72,0.16228395061728396,0.8,99.45
2021-10-03,Rajasthan,364,2,364,4390,2049,193,8.29,0,81.0,531315,4255,528397,2.53,0.24,0.054197530864197534,0.8,99.45
2021-10-04,Rajasthan,328,4,319,3959,3507,1554,8.28,5,81.0,531643,4259,528716,4.33,1.92,0.04887654320987654,0.8,99.45
2021-10-05,Rajasthan,1304,12,1300,16776,970,853,7.77,0,81.0,532947,4271,530016,1.2,1.05,0.2071111111111111,0.8,99.45
2021-10-06,Rajasthan,109,0,104,1096,4894,937,9.95,5,81.0,533056,4271,530120,6.04,1.16,0.013530864197530865,0.8,99.45
2021-10-07,Rajasthan,181,2,173,2202,1389,229,8.22,6,81.0,533237,4273,530293,1.71,0.28,0.027185185185185184,0.8,99.45
2021-10-08,Rajasthan,917,5,916,11411,4055,997,8.04,0,81.0,534154,4278,531209,5.01,1.23,0.14087654320987655,0.8,99.45
2021-10-09,Rajasthan,885,7,885,11026,2808,2609,8.03,0,81.0,535039,4285,532094,3.47,3.22,0.13612345679012347,0.8,99.45
2021-10-10,Rajasthan,526,4,517,6917,3976,3923,7.6,5,81.0,535565,4289,532611,4.91,4.84,0.08539506172839506,0.8,99.45
2021-10-11,Rajasthan,325,4,319,4346,4320,1202,7.48,2,81.0,535890,4293,532930,5.33,1.48,0.05365432098765432,0.8,99.45
2021-10-12,Rajasthan,907,3,898,11691,569,14,7.76,6,81.0,536797,4296,533828,0.7,0.02,0.14433333333333334,0.8,99.45
2021-10-13,Rajasthan,1179,17,1172,14809,310,235,7.96,0,81.0,537976,4313,535000,0.38,0.29,0.18282716049382716,0.8,99.45
2021-10-14,Rajasthan,1261,10,1258,15443,3286,1237,8.17,0,81.0,539237,4323,536258,4.06,1.53,0.1906543209876543,0.8,99.45
2021-10-15,Rajasthan,1391,16,1391,17208,2332,1404,8.08,0,81.0,540628,4339,537649,2.88,1.73,0.21244444444444444,0.8,99.45
2021-10-16,Rajasthan,296,1,296,3969,180,51,7.46,0,81.0,540924,4340,537945,0.22,0.06,0.049,0.8,99.45
2021-10-17,Rajasthan,451,4,449,5453,1244,999,8.27,0,81.0,541375,4344,538394,1.54,1.23,0.06732098765432099,0.8,99.45
2021-10-18,Rajasthan,1548,7,1540,19195,740,606,8.06,1,81.0,542923,4351,539934,0.91,0.75,0.2369753086419753,0.8,99.45
2021-10-19,Rajasthan,285,3,283,3295,4985,2161,8.65,0,81.0,543208,4354,540217,6.15,2.67,0.040679012345679014,0.8,99.45
2021-10-20,Rajasthan,1177,8,1175,15237,454,37,7.72,0,81.0,544385,4362,541392,0.56,0.05,0.18811111111111112,0.8,99.45
2021-10-21,Rajasthan,346,1,344,3968,875,575,8.72,1,81.0,544731,4363,541736,1.08,0.71,0.04898765432098765,0.8,99.45
2021-10-22,Rajasthan,61,0,60,632,4844,1048,9.65,1,81.0,544792,4363,541796,5.98,1.29,0.007802469135802469,0.8,99.45
2021-10-23,Rajasthan,469,4,463,5449,2848,2767,8.61,2,81.0,545261,4367,542259,3.52,3.42,0.0672716049382716,0.8,99.45
2021-10-24,Rajasthan,296,2,293,3858,4753,745,7.67,1,81.0,545557,4369,542552,5.87,0.92,0.04762962962962963,0.8,99.45
2021-10-25,Rajasthan,1354,5,1348,16738,3882,2331,8.09,1,81.0,546911,4374,543900,4.79,2.88,0.20664197530864198,0.8,99.45
2021-10-26,Rajasthan,1243,15,1236,15607,1296,764,7.96,0,81.0,548154,4389,545136,1.6,0.94,0.19267901234567902,0.8,99.45
2021-10-27,Rajasthan,1582,22,1582,19842,4875,3693,7.97,0,81.0,549736,4411,546718,6.02,4.56,0.24496296296296297,0.8,99.45
2021-10-28,Rajasthan,1309,4,1307,16216,536,154,8.07,0,81.0,551045,4415,548025,0.66,0.19,0.20019753086419753,0.8,99.45
2021-10-29,Rajasthan,606,3,600,7074,3714,179,8.57,3,81.0,551651,4418,548625,4.59,0.22,0.08733333333333333,0.8,99.45
2021-10-30,Rajasthan,731,9,722,9409,757,533,7.77,0,81.0,552382,4427,549347,0.93,0.66,0.1161604938271605,0.8,99.45
2021-10-31,Rajasthan,706,3,704,8899,3206,24,7.93,0,81.0,553088,4430,550051,3.96,0.03,0.1098641975308642,0.8,99.45
2021-11-01,Rajasthan,204,3,199,2244,3397,3288,9.09,2,81.0,553292,4433,550250,4.19,4.06,0.027703703703703703,0.8,99.45
2021-11-02,Rajasthan,946,13,946,11887,441,113,7.96,0,81.0,554238,4446,551196,0.54,0.14,0.1467530864197531,0.8,99.45
2021-11-03,Rajasthan,1242,16,1235,15670,2291,132,7.93,0,81.0,555480,4462,552431,2.83,0.16,0.1934567901234568,0.8,99.45
2021-11-04,Rajasthan,465,3,463,5471,3760,2940,8.5,0,81.0,555945,4465,552894,4.64,3.63,0.0675432098765432,0.8,99.45
2021-11-05,Rajasthan,584,5,579,7027,1925,500,8.31,0,81.0,556529,4470,553473,2.38,0.62,0.08675308641975309,0.8,99.45
2021-11-06,Rajasthan,868,7,863,10324,1781,1512,8.41,0,81.0,557397,4477,554336,2.2,1.87,0.1274567901234568,0.8,99.45
2021-11-07,Rajasthan,842,3,835,10204,3820,2744,8.25,4,81.0,558239,4480,555171,4.72,3.39,0.12597530864197531,0.8,99.45
2021-11-08,Rajasthan,1213,17,1211,15419,3129,2566,7.87,0,81.0,559452,4497,556382,3.86,3.17,0.190358024691358,0.8,99.45
2021-11-09,Rajasthan,793,5,788,9952,567,254,7.97,0,81.0,560245,4502,557170,0.7,0.31,0.1228641975308642,0.8,99.45
2021-11-10,Rajasthan,1379,15,1378,17319,3913,3236,7.96,0,81.0,561624,4517,558548,4.83,4.0,0.21381481481481482,0.8,99.45
2021-11-11,Rajasthan,1053,9,1045,13120,4104,3,8.03,0,81.0,562677,4526,559593,5.07,0.0,0.16197530864197532,0.8,99.45
2021-11-12,Rajasthan,280,3,275,3279,4883,988,8.54,2,81.0,562957,4529,559868,6.03,1.22,0.04048148148148148,0.8,99.45
2021-11-13,Rajasthan,785,4,779,10349,1385,1227,7.59,2,81.0,563742,4533,560647,1.71,1.51,0.12776543209876542,0.8,99.45
2021-11-14,Rajasthan,304,1,303,3881,1765,681,7.83,0,81.0,564046,4534,560950,2.18,0.84,0.04791358024691358,0.8,99.45
2021-11-15,Rajasthan,1102,8,1098,13480,2984,719,8.18,0,81.0,565148,4542,562048,3.68,0.89,0.16641975308641976,0.8,99.45
2021-11-16,Rajasthan,577,5,571,7514,4937,431,7.68,1,81.0,565725,4547,562619,6.1,0.53,0.09276543209876544,0.8,99.45
2021-11-17,Rajasthan,1275,5,1271,15889,3039,1636,8.02,0,81.0,567000,4552,563890,3.75,2.02,0.1961604938271605,0.8,99.45
2021-11-18,Rajasthan,469,2,463,6171,3374,551,7.6,4,81.0,567469,4554,564353,4.17,0.68,0.07618518518518519,0.8,99.45
2021-11-19,Rajasthan,1365,15,1361,16876,4897,2357,8.09,0,81.0,568834,4569,565714,6.05,2.91,0.20834567901234569,0.8,99.45
2021-11-20,Rajasthan,995,6,988,12784,2215,1929,7.78,1,81.0,569829,4575,566702,2.73,2.38,0.15782716049382717,0.8,99.45
2021-11-21,Rajasthan,575,2,571,7281,1877,1340,7.9,2,81.0,570404,4577,567273,2.32,1.65,0.0898888888888889,0.8,99.45
2021-11-22,Rajasthan,1010,8,1007,12727,1330,1189,7.94,0,81.0,571414,4585,568280,1.64,1.47,0.15712345679012346,0.8,99.45
2021-11-23,Rajasthan,1244,17,1237,15442,3077,1452,8.06,0,81.0,572658,4602,569517,3.8,1.79,0.19064197530864196,0.8,99.45
2021-11-24,Rajasthan,435,2,430,5287,267,4,8.23,3,81.0,573093,4604,569947,0.33,0.0,0.06527160493827161,0.8,99.45
2021-11-25,Rajasthan,1429,4,1423,18059,4952,3348,7.91,2,81.0,574522,4608,571370,6.11,4.13,0.22295061728395063,0.8,99.45
2021-11-26,Rajasthan,832,5,831,9875,3487,325,8.43,0,81.0,575354,4613,572201,4.3,0.4,0.12191358024691358,0.8,99.45
2021-11-27,Rajasthan,1298,10,1297,15995,1648,1266,8.12,0,81.0,576652,4623,573498,2.03,1.56,0.19746913580246914,0.8,99.45
2021-11-28,Rajasthan,991,11,982,12285,4273,2769,8.07,0,81.0,577643,4634,574480,5.28,3.42,0.15166666666666667,0.8,99.45
2021-11-29,Rajasthan,1401,10,1393,17746,1423,478,7.89,0,81.0,579044,4644,575873,1.76,0.59,0.21908641975308643,0.8,99.45
2021-11-30,Rajasthan,1310,7,1301,16186,2552,2315,8.09,2,81.0,580354,4651,577174,3.15,2.86,0.19982716049382715,0.8,99.45
2021-12-01,Rajasthan,556,5,555,7084,1731,1688,7.85,0,81.0,580910,4656,577729,2.14,2.08,0.08745679012345679,0.8,99.45
2021-12-02,Rajasthan,829,5,827,10802,3759,1447,7.67,0,81.0,581739,4661,578556,4.64,1.79,0.13335802469135802,0.8,99.45
2021-12-03,Rajasthan,861,3,860,10583,3299,2702,8.14,0,81.0,582600,4664,579416,4.07,3.34,0.1306543209876543,0.8,99.45
2021-12-04,Rajasthan,830,10,823,10030,2427,1248,8.28,0,81.0,583430,4674,580239,3.0,1.54,0.12382716049382717,0.8,99.45
2021-12-05,Rajasthan,1412,15,1403,17691,1713,713,7.98,0,81.0,584842,4689,581642,2.11,0.88,0.2184074074074074,0.8,99.45
2021-12-06,Rajasthan,453,6,453,5531,3007,771,8.19,0,81.0,585295,4695,582095,3.71,0.95,0.06828395061728396,0.8,99.45
2021-12-07,Rajasthan,1153,10,1153,14163,2026,222,8.14,0,81.0,586448,4705,583248,2.5,0.27,0.17485185185185184,0.8,99.45
2021-12-08,Rajasthan,964,4,959,12280,3358,1455,7.85,1,81.0,587412,4709,584207,4.15,1.8,0.15160493827160493,0.8,99.45
2021-12-09,Rajasthan,667,5,667,8423,2586,1101,7.92,0,81.0,588079,4714,584874,3.19,1.36,0.10398765432098765,0.8,99.46
2021-12-10,Rajasthan,1362,19,1355,17175,4773,2360,7.93,0,81.0,589441,4733,586229,5.89,2.91,0.21203703703703702,0.8,99.46
2021-12-11,Rajasthan,603,8,600,7238,4562,4062,8.33,0,81.0,590044,4741,586829,5.63,5.01,0.08935802469135802,0.8,99.46
2021-12-12,Rajasthan,1608,12,1602,19970,2831,1954,8.05,0,81.0,591652,4753,588431,3.5,2.41,0.2465432098765432,0.8,99.46
2021-12-13,Rajasthan,102,1,102,1384,371,184,7.37,0,81.0,591754,4754,588533,0.46,0.23,0.017086419753086418,0.8,99.46
2021-12-14,Rajasthan,698,4,694,8717,1870,1427,8.01,0,81.0,592452,4758,589227,2.31,1.76,0.10761728395061729,0.8,99.46
2021-12-15,Rajasthan,89,0,89,1486,2405,813,5.99,0,81.0,592541,4758,589316,2.97,1.0,0.01834567901234568,0.8,99.46
2021-12-16,Rajasthan,1103,11,1099,13438,832,468,8.21,0,81.0,593644,4769,590415,1.03,0.58,0.16590123456790123,0.8,99.46
2021-12-17,Rajasthan,850,7,850,10519,3885,2118,8.08,0,81.0,594494,4776,591265,4.8,2.61,0.1298641975308642,0.8,99.46
2021-12-18,Rajasthan,1058,4,1053,13493,245,104,7.84,1,81.0,595552,4780,592318,0.3,0.13,0.16658024691358025,0.8,99.46
2021-12-19,Rajasthan,1215,7,1208,15129,1279,1154,8.03,0,81.0,596767,4787,593526,1.58,1.42,0.18677777777777776,0.8,99.46
2021-12-20,Rajasthan,1541,6,1534,19275,4122,655,7.99,1,81.0,598308,4793,595060,5.09,0.81,0.23796296296296296,0.8,99.46
2021-12-21,Rajasthan,592,8,586,7390,3212,3033,8.01,0,81.0,598900,4801,595646,3.97,3.74,0.09123456790123456,0.8,99.46
2021-12-22,Rajasthan,758,6,753,9448,4008,3072,8.02,0,81.0,599658,4807,596399,4.95,3.79,0.11664197530864198,0.8,99.46
2021-12-23,Rajasthan,963,6,959,12106,2500,2409,7.95,0,81.0,600621,4813,597358,3.09,2.97,0.14945679012345678,0.8,99.46
2021-12-24,Rajasthan,1211,14,1209,14908,2064,566,8.12,0,81.0,601832,4827,598567,2.55,0.7,0.18404938271604937,0.8,99.46
2021-12-25,Rajasthan,696,7,696,8809,3642,2188,7.9,0,81.0,602528,4834,599263,4.5,2.7,0.10875308641975309,0.8,99.46
2021-12-26,Rajasthan,197,1,197,2318,4758,456,8.5,0,81.0,602725,4835,599460,5.87,0.56,0.028617283950617283,0.8,99.46
2021-12-27,Rajasthan,684,4,680,8627,853,497,7.93,0,81.0,603409,4839,600140,1.05,0.61,0.10650617283950617,0.8,99.46
2021-12-28,Rajasthan,1233,9,1229,15230,950,37,8.1,0,81.0,604642,4848,601369,1.17,0.05,0.1880246913580247,0.8,99.46
2021-12-29,Rajasthan,685,3,680,8506,2374,1898,8.05,2,81.0,605327,4851,602049,2.93,2.34,0.10501234567901234,0.8,99.46
2021-12-30,Rajasthan,1437,8,1435,17701,484,261,8.12,0,81.0,606764,4859,603484,0.6,0.32,0.21853086419753087,0.8,99.46
2021-12-31,Rajasthan,1455,16,1447,18306,824,623,7.95,0,81.0,608219,4875,604931,1.02,0.77,0.226,0.8,99.46
2022-01-01,Rajasthan,918,7,917,11735,1741,477,7.82,0,81.0,609137,4882,605848,2.15,0.59,0.14487654320987653,0.8,99.46
2022-01-02,Rajasthan,626,7,619,7918,3348,2287,7.91,0,81.0,609763,4889,606467,4.13,2.82,0.09775308641975308,0.8,99.46
2022-01-03,Rajasthan,1041,10,1040,12897,3055,1770,8.07,0,81.0,610804,4899,607507,3.77,2.19,0.1592222222222222,0.8,99.46
2022-01-04,Rajasthan,1053,6,1050,12742,3778,1954,8.26,0,81.0,611857,4905,608557,4.66,2.41,0.15730864197530864,0.8,99.46
2022-01-05,Rajasthan,1184,11,1175,15067,3600,2926,7.86,0,81.0,613041,4916,609732,4.44,3.61,0.18601234567901234,0.8,99.46
2022-01-06,Rajasthan,24,0,15,859,3640,1523,2.79,9,81.0,613065,4916,609747,4.49,1.88,0.010604938271604938,0.8,99.46
2022-01-07,Rajasthan,1216,16,1215,14913,493,266,8.15,0,81.0,614281,4932,610962,0.61,0.33,0.18411111111111111,0.8,99.46
2022-01-08,Rajasthan,1322,7,1315,16751,2089,1293,7.89,0,81.0,615603,4939,612277,2.58,1.6,0.20680246913580247,0.8,99.46
2022-01-09,Rajasthan,274,1,271,3514,4530,1445,7.8,2,81.0,615877,4940,612548,5.59,1.78,0.043382716049382715,0.8,99.46
2022-01-10,Rajasthan,655,5,650,7810,4384,300,8.39,0,81.0,616532,4945,613198,5.41,0.37,0.09641975308641976,0.8,99.46
2022-01-11,Rajasthan,118,0,114,1814,3126,3074,6.5,4,81.0,616650,4945,613312,3.86,3.8,0.02239506172839506,0.8,99.46
2022-01-12,Rajasthan,844,12,836,10727,2973,2166,7.87,0,81.0,617494,4957,614148,3.67,2.67,0.1324320987654321,0.8,99.46
2022-01-13,Rajasthan,1496,18,1487,18761,3196,410,7.97,0,81.0,618990,4975,615635,3.95,0.51,0.2316172839506173,0.8,99.46
2022-01-14,Rajasthan,345,2,339,3845,4110,2110,8.97,4,81.0,619335,4977,615974,5.07,2.6,0.047469135802469135,0.8,99.46
2022-01-15,Rajasthan,310,2,304,4189,973,152,7.4,4,81.0,619645,4979,616278,1.2,0.19,0.051716049382716046,0.8,99.46
2022-01-16,Rajasthan,246,1,244,2635,3796,270,9.34,1,81.0,619891,4980,616522,4.69,0.33,0.032530864197530866,0.8,99.46
2022-01-17,Rajasthan,1082,10,1075,13383,1617,1073,8.08,0,81.0,620973,4990,617597,2.0,1.32,0.16522222222222221,0.8,99.46
2022-01-18,Rajasthan,288,1,285,3289,406,60,8.76,2,81.0,621261,4991,617882,0.5,0.07,0.04060493827160494,0.8,99.46
2022-01-19,Rajasthan,689,5,686,8666,56,35,7.95,0,81.0,621950,4996,618568,0.07,0.04,0.10698765432098765,0.8,99.46
2022-01-20,Rajasthan,98,1,91,1271,1489,483,7.71,6,81.0,622048,4997,618659,1.84,0.6,0.01569135802469136,0.8,99.46
2022-01-21,Rajasthan,1515,4,1508,18936,3778,867,8.0,3,81.0,623563,5001,620167,4.66,1.07,0.23377777777777778,0.8,99.46
2022-01-22,Rajasthan,372,4,371,4733,3383,2396,7.86,0,81.0,623935,5005,620538,4.18,2.96,0.0584320987654321,0.8,99.46
2022-01-23,Rajasthan,694,3,685,8456,2597,1542,8.21,6,81.0,624629,5008,621223,3.21,1.9,0.10439506172839506,0.8,99.45
2022-01-24,Rajasthan,373,3,373,4615,1842,1274,8.08,0,81.0,625002,5011,621596,2.27,1.57,0.05697530864197531,0.8,99.46
2022-01-25,Rajasthan,304,2,300,3692,4052,3501,8.23,2,81.0,625306,5013,621896,5.0,4.32,0.045580246913580244,0.8,99.45
2022-01-26,Rajasthan,460,3,455,5894,4336,2856,7.8,2,81.0,625766,5016,622351,5.35,3.53,0.07276543209876543,0.8,99.45
2022-01-27,Rajasthan,1156,9,1154,14373,1655,203,8.04,0,81.0,626922,5025,623505,2.04,0.25,0.17744444444444443,0.8,99.45
2022-01-28,Rajasthan,914,11,911,11466,113,109,7.97,0,81.0,627836,5036,624416,0.14,0.13,0.14155555555555555,0.8,99.46
2022-01-29,Rajasthan,1304,10,1297,16351,680,85,7.98,0,81.0,629140,5046,625713,0.84,0.1,0.2018641975308642,0.8,99.46
2022-01-30,Rajasthan,1108,4,1105,13787,3936,552,8.04,0,81.0,630248,5050,626818,4.86,0.68,0.17020987654320988,0.8,99.46
2022-01-31,Rajasthan,1163,6,1155,14056,1707,1687,8.27,2,81.0,631411,5056,627973,2.11,2.08,0.17353086419753086,0.8,99.46
2022-02-01,Rajasthan,1274,4,1265,15981,822,724,7.97,5,81.0,632685,5060,629238,1.01,0.89,0.1972962962962963,0.8,99.46
2022-02-02,Rajasthan,198,0,189,2413,2207,2046,8.21,9,81.0,632883,5060,629427,2.72,2.53,0.029790123456790125,0.8,99.45
2022-02-03,Rajasthan,111,1,106,1460,2081,404,7.6,4,81.0,632994,5061,629533,2.57,0.5,0.018024691358024692,0.8,99.45
2022-02-04,Rajasthan,1335,4,1333,16471,870,485,8.11,0,81.0,634329,5065,630866,1.07,0.6,0.20334567901234568,0.8,99.45
2022-02-05,Rajasthan,767,7,761,9638,398,111,7.96,0,81.0,635096,5072,631627,0.49,0.14,0.11898765432098765,0.8,99.45
2022-02-06,Rajasthan,326,3,324,4422,446,162,7.37,0,81.0,635422,5075,631951,0.55,0.2,0.054592592592592595,0.8,99.45
2022-02-07,Rajasthan,617,5,617,7543,651,143,8.18,0,81.0,636039,5080,632568,0.8,0.18,0.09312345679012346,0.8,99.45
2022-02-08,Rajasthan,77,0,75,1025,271,26,7.51,2,81.0,636116,5080,632643,0.33,0.03,0.012654320987654321,0.8,99.45
2022-02-09,Rajasthan,155,1,154,1822,463,74,8.51,0,81.0,636271,5081,632797,0.57,0.09,0.022493827160493828,0.8,99.45
2022-02-10,Rajasthan,889,5,887,11354,2059,1245,7.83,0,81.0,637160,5086,633684,2.54,1.54,0.14017283950617285,0.8,99.45
2022-02-11,Rajasthan,1367,13,1359,17199,673,45,7.95,0,81.0,638527,5099,635043,0.83,0.06,0.21233333333333335,0.8,99.45
2022-02-12,Rajasthan,673,9,669,8436,175,157,7.98,0,81.0,639200,5108,635712,0.22,0.19,0.10414814814814814,0.8,99.45
2022-02-13,Rajasthan,1062,6,1055,13450,3795,562,7.9,1,81.0,640262,5114,636767,4.69,0.69,0.16604938271604938,0.8,99.45
2022-02-14,Rajasthan,1130,15,1125,13953,4274,3479,8.1,0,81.0,641392,5129,637892,5.28,4.3,0.17225925925925925,0.8,99.45
2022-02-15,Rajasthan,988,11,986,12802,4980,4376,7.72,0,81.0,642380,5140,638878,6.15,5.4,0.15804938271604937,0.8,99.45
2022-02-16,Rajasthan,419,6,417,5091,2150,849,8.23,0,81.0,642799,5146,639295,2.65,1.05,0.06285185185185185,0.8,99.45
2022-02-17,Rajasthan,361,4,360,4613,2221,101,7.83,0,81.0,643160,5150,639655,2.74,0.12,0.056950617283950615,0.8,99.46
2022-02-18,Rajasthan,470,5,468,5806,4985,2901,8.1,0,81.0,643630,5155,640123,6.15,3.58,0.07167901234567901,0.8,99.46
2022-02-19,Rajasthan,668,3,668,8360,1808,768,7.99,0,81.0,644298,5158,640791,2.23,0.95,0.10320987654320987,0.8,99.46
2022-02-20,Rajasthan,1427,20,1423,17695,3421,212,8.06,0,81.0,645725,5178,642214,4.22,0.26,0.21845679012345678,0.8,99.46
2022-02-21,Rajasthan,1132,10,1129,14219,2503,1550,7.96,0,81.0,646857,5188,643343,3.09,1.91,0.1755432098765432,0.8,99.46
2022-02-22,Rajasthan,251,3,248,3037,2361,827,8.26,0,81.0,647108,5191,643591,2.91,1.02,0.03749382716049383,0.8,99.46
2022-02-23,Rajasthan,369,2,365,5322,1462,1289,6.93,2,81.0,647477,5193,643956,1.8,1.59,0.06570370370370371,0.8,99.46
2022-02-24,Rajasthan,900,12,891,10954,1327,68,8.22,0,81.0,648377,5205,644847,1.64,0.08,0.13523456790123456,0.8,99.46
2022-02-25,Rajasthan,1423,16,1423,17816,3419,1645,7.99,0,81.0,649800,5221,646270,4.22,2.03,0.21995061728395063,0.8,99.46
2022-02-26,Rajasthan,1562,21,1555,19377,1341,856,8.06,0,81.0,651362,5242,647825,1.66,1.06,0.23922222222222222,0.8,99.46
2022-02-27,Rajasthan,1178,17,1172,14896,773,60,7.91,0,81.0,652540,5259,648997,0.95,0.07,0.18390123456790122,0.81,99.46
2022-02-28,Rajasthan,1459,6,1459,18465,2193,918,7.9,0,81.0,653999,5265,650456,2.71,1.13,0.22796296296296295,0.81,99.46
2022-03-01,Rajasthan,358,3,352,4398,605,599,8.14,3,81.0,654357,5268,650808,0.75,0.74,0.054296296296296294,0.81,99.46
2022-03-02,Rajasthan,744,7,739,8927,3664,2689,8.33,0,81.0,655101,5275,651547,4.52,3.32,0.11020987654320988,0.81,99.46
2022-03-03,Rajasthan,1022,10,1017,12835,4415,3682,7.96,0,81.0,656123,5285,652564,5.45,4.55,0.1584567901234568,0.81,99.46
2022-03-04,Rajasthan,1253,18,1247,15262,4641,919,8.21,0,81.0,657376,5303,653811,5.73,1.13,0.18841975308641976,0.81,99.46
2022-03-05,Rajasthan,274,0,266,3734,3785,2028,7.34,8,81.0,657650,5303,654077,4.67,2.5,0.046098765432098766,0.81,99.46
2022-03-06,Rajasthan,967,8,964,12167,3226,2693,7.95,0,81.0,658617,5311,655041,3.98,3.32,0.15020987654320989,0.81,99.46
2022-03-07,Rajasthan,16,0,11,722,4352,380,2.22,5,81.0,658633,5311,655052,5.37,0.47,0.00891358024691358,0.81,99.46
2022-03-08,Rajasthan,430,5,424,5494,4619,2784,7.83,1,81.0,659063,5316,655476,5.7,3.44,0.06782716049382716,0.81,99.46
2022-03-09,Rajasthan,723,7,720,9550,1102,10,7.57,0,81.0,659786,5323,656196,1.36,0.01,0.11790123456790123,0.81,99.46
2022-03-10,Rajasthan,423,1,422,5339,4833,1290,7.92,0,81.0,660209,5324,656618,5.97,1.59,0.06591358024691359,0.81,99.46
2022-03-11,Rajasthan,419,2,416,5463,447,245,7.67,1,81.0,660628,5326,657034,0.55,0.3,0.06744444444444445,0.81,99.46
2022-03-12,Rajasthan,468,4,467,5899,184,66,7.93,0,81.0,661096,5330,657501,0.23,0.08,0.07282716049382716,0.81,99.46
2022-03-13,Rajasthan,571,8,562,6735,1307,1118,8.48,1,81.0,661667,5338,658063,1.61,1.38,0.08314814814814815,0.81,99.46
2022-03-14,Rajasthan,365,3,365,4722,4591,2419,7.73,0,81.0,662032,5341,658428,5.67,2.99,0.0582962962962963,0.81,99.46
2022-03-15,Rajasthan,1355,14,1351,17020,907,389,7.96,0,81.0,663387,5355,659779,1.12,0.48,0.21012345679012345,0.81,99.46
2022-03-16,Rajasthan,1108,7,1102,14257,1155,448,7.77,0,81.0,664495,5362,660881,1.43,0.55,0.17601234567901233,0.81,99.46
2022-03-17,Rajasthan,929,9,921,11438,3796,3315,8.12,0,81.0,665424,5371,661802,4.69,4.09,0.14120987654320988,0.81,99.46
2022-03-18,Rajasthan,557,2,550,7143,2291,157,7.8,5,81.0,665981,5373,662352,2.83,0.19,0.08818518518518519,0.81,99.46
2022-03-19,Rajasthan,715,4,715,9050,2611,174,7.9,0,81.0,666696,5377,663067,3.22,0.21,0.1117283950617284,0.81,99.46
2022-03-20,Rajasthan,1382,9,1381,17431,4838,102,7.93,0,81.0,668078,5386,664448,5.97,0.13,0.21519753086419752,0.81,99.46
2022-03-21,Rajasthan,544,4,537,6703,826,337,8.12,3,81.0,668622,5390,664985,1.02,0.42,0.08275308641975308,0.81,99.46
2022-03-22,Rajasthan,77,0,71,724,4678,1721,10.64,6,81.0,668699,5390,665056,5.78,2.12,0.008938271604938272,0.81,99.46
2022-03-23,Rajasthan,483,5,477,5847,3107,2714,8.26,1,81.0,669182,5395,665533,3.84,3.35,0.07218518518518519,0.81,99.45
2022-03-24,Rajasthan,697,7,694,8857,3668,1723,7.87,0,81.0,669879,5402,666227,4.53,2.13,0.10934567901234568,0.81,99.45
2022-03-25,Rajasthan,453,5,447,5706,2634,2624,7.94,1,81.0,670332,5407,666674,3.25,3.24,0.07044444444444445,0.81,99.45
2022-03-26,Rajasthan,268,1,266,3136,468,108,8.55,1,81.0,670600,5408,666940,0.58,0.13,0.03871604938271605,0.81,99.45
2022-03-27,Rajasthan,402,4,400,5173,961,248,7.77,0,81.0,671002,5412,667340,1.19,0.31,0.0638641975308642,0.81,99.45
2022-03-28,Rajasthan,948,12,947,12465,2211,1455,7.61,0,81.0,671950,5424,668287,2.73,1.8,0.15388888888888888,0.81,99.45
2022-03-29,Rajasthan,1563,17,1562,19261,1912,484,8.11,0,81.0,673513,5441,669849,2.36,0.6,0.23779012345679013,0.81,99.46
2022-03-30,Rajasthan,529,1,525,6265,1130,126,8.44,3,81.0,674042,5442,670374,1.4,0.16,0.07734567901234568,0.81,99.46
2022-03-31,Rajasthan,307,4,304,3783,3187,714,8.12,0,81.0,674349,5446,670678,3.93,0.88,0.046703703703703706,0.81,99.46
2022-04-01,Rajasthan,758,5,752,9607,3301,1001,7.89,1,81.0,675107,5451,671430,4.08,1.24,0.11860493827160494,0.81,99.46
2022-04-02,Rajasthan,1442,8,1440,18278,1532,603,7.89,0,81.0,676549,5459,672870,1.89,0.74,0.2256543209876543,0.81,99.46
2022-04-03,Rajasthan,1053,13,1044,12778,4801,1678,8.24,0,81.0,677602,5472,673914,5.93,2.07,0.15775308641975308,0.81,99.46
2022-04-04,Rajasthan,947,5,944,12073,4000,1315,7.84,0,81.0,678549,5477,674858,4.94,1.62,0.1490493827160494,0.81,99.46
2022-04-05,Rajasthan,796,10,794,9532,1300,1202,8.35,0,81.0,679345,5487,675652,1.6,1.48,0.11767901234567901,0.81,99.46
2022-04-06,Rajasthan,347,4,340,4246,2912,141,8.17,3,81.0,679692,5491,675992,3.6,0.17,0.05241975308641975,0.81,99.46
2022-04-07,Rajasthan,990,3,982,12921,4056,2464,7.66,5,81.0,680682,5494,676974,5.01,3.04,0.15951851851851853,0.81,99.46
2022-04-08,Rajasthan,1156,9,1149,14080,2191,2181,8.21,0,81.0,681838,5503,678123,2.7,2.69,0.17382716049382715,0.81,99.46
2022-04-09,Rajasthan,256,1,255,3438,4862,4196,7.45,0,81.0,682094,5504,678378,6.0,5.18,0.042444444444444444,0.81,99.46
2022-04-10,Rajasthan,53,0,46,713,2868,2540,7.43,7,81.0,682147,5504,678424,3.54,3.14,0.008802469135802468,0.81,99.45
2022-04-11,Rajasthan,1164,14,1158,14449,2907,2018,8.06,0,81.0,683311,5518,679582,3.59,2.49,0.17838271604938272,0.81,99.45
2022-04-12,Rajasthan,166,1,165,1706,1270,645,9.73,0,81.0,683477,5519,679747,1.57,0.8,0.021061728395061728,0.81,99.45
2022-04-13,Rajasthan,806,3,803,9870,10,10,8.17,0,81.0,684283,5522,680550,0.01,0.01,0.12185185185185185,0.81,99.45
2022-04-14,Rajasthan,1453,19,1445,18367,1632,188,7.91,0,81.0,685736,5541,681995,2.01,0.23,0.22675308641975309,0.81,99.45
2022-04-15,Rajasthan,642,5,638,8203,3397,1381,7.83,0,81.0,686378,5546,682633,4.19,1.7,0.1012716049382716,0.81,99.45
2022-04-16,Rajasthan,478,3,478,6276,1646,260,7.62,0,81.0,686856,5549,683111,2.03,0.32,0.07748148148148148,0.81,99.45
2022-04-17,Rajasthan,400,3,394,4709,4797,4400,8.49,3,81.0,687256,5552,683505,5.92,5.43,0.0581358024691358,0.81,99.45
2022-04-18,Rajasthan,699,9,699,8733,2936,189,8.0,0,81.0,687955,5561,684204,3.62,0.23,0.10781481481481482,0.81,99.45
2022-04-19,Rajasthan,473,3,470,6617,2364,1967,7.15,0,81.0,688428,5564,684674,2.92,2.43,0.08169135802469135,0.81,99.45
2022-04-20,Rajasthan,709,7,700,9024,1499,1077,7.86,2,81.0,689137,5571,685374,1.85,1.33,0.11140740740740741,0.81,99.45
2022-04-21,Rajasthan,239,1,235,2640,1610,1330,9.05,3,81.0,689376,5572,685609,1.99,1.64,0.03259259259259259,0.81,99.45
2022-04-22,Rajasthan,797,10,794,10057,4544,1384,7.92,0,81.0,690173,5582,686403,5.61,1.71,0.12416049382716049,0.81,99.45
2022-04-23,Rajasthan,1584,17,1576,19833,4286,1333,7.99,0,81.0,691757,5599,687979,5.29,1.65,0.24485185185185185,0.81,99.45
2022-04-24,Rajasthan,176,2,176,2084,2459,1301,8.45,0,81.0,691933,5601,688155,3.04,1.61,0.025728395061728394,0.81,99.45
2022-04-25,Rajasthan,1410,13,1408,17665,4087,2937,7.98,0,81.0,693343,5614,689563,5.05,3.63,0.21808641975308643,0.81,99.45
2022-04-26,Rajasthan,772,4,769,9473,2596,1915,8.15,0,81.0,694115,5618,690332,3.2,2.36,0.11695061728395062,0.81,99.45
2022-04-27,Rajasthan,747,9,743,8897,968,452,8.4,0,81.0,694862,5627,691075,1.2,0.56,0.10983950617283951,0.81,99.45
2022-04-28,Rajasthan,765,11,756,9497,4447,1184,8.06,0,81.0,695627,5638,691831,5.49,1.46,0.11724691358024691,0.81,99.45
2022-04-29,Rajasthan,558,4,558,7135,2474,1974,7.82,0,81.0,696185,5642,692389,3.05,2.44,0.08808641975308643,0.81,99.45
2022-04-30,Rajasthan,679,5,679,8322,3788,2412,8.16,0,81.0,696864,5647,693068,4.68,2.98,0.10274074074074074,0.81,99.46
2022-05-01,Rajasthan,1502,16,1494,18558,1161,103,8.09,0,81.0,698366,5663,694562,1.43,0.13,0.2291111111111111,0.81,99.46
2022-05-02,Rajasthan,1282,14,1282,15544,4566,3729,8.25,0,81.0,699648,5677,695844,5.64,4.6,0.19190123456790123,0.81,99.46
2022-05-03,Rajasthan,903,12,897,11182,1402,910,8.08,0,81.0,700551,5689,696741,1.73,1.12,0.13804938271604938,0.81,99.46
2022-05-04,Rajasthan,860,4,852,10664,4143,2559,8.06,4,81.0,701411,5693,697593,5.11,3.16,0.1316543209876543,0.81,99.46
2022-05-05,Rajasthan,849,4,840,10411,1527,600,8.15,5,81.0,702260,5697,698433,1.89,0.74,0.12853086419753088,0.81,99.46
2022-05-06,Rajasthan,1560,15,1555,19264,1182,965,8.1,0,81.0,703820,5712,699988,1.46,1.19,0.23782716049382716,0.81,99.46
2022-05-07,Rajasthan,336,4,331,4683,528,169,7.17,1,81.0,704156,5716,700319,0.65,0.21,0.05781481481481481,0.81,99.46
2022-05-08,Rajasthan,1256,13,1251,15662,3730,3565,8.02,0,81.0,705412,5729,701570,4.6,4.4,0.19335802469135802,0.81,99.46
2022-05-09,Rajasthan,64,0,60,685,2694,2664,9.34,4,81.0,705476,5729,701630,3.33,3.29,0.00845679012345679,0.81,99.45
2022-05-10,Rajasthan,1374,5,1373,17200,579,47,7.99,0,81.0,706850,5734,703003,0.71,0.06,0.2123456790123457,0.81,99.46
2022-05-11,Rajasthan,1323,18,1321,16263,1213,1121,8.14,0,81.0,708173,5752,704324,1.5,1.38,0.20077777777777778,0.81,99.46
2022-05-12,Rajasthan,124,0,118,1047,182,47,11.84,6,81.0,708297,5752,704442,0.22,0.06,0.012925925925925926,0.81,99.46
2022-05-13,Rajasthan,118,0,112,1811,3124,760,6.52,6,81.0,708415,5752,704554,3.86,0.94,0.022358024691358024,0.81,99.45
2022-05-14,Rajasthan,499,4,498,6470,3599,3547,7.71,0,81.0,708914,5756,705052,4.44,4.38,0.07987654320987654,0.81,99.46
2022-05-15,Rajasthan,214,1,209,2273,1202,841,9.41,4,81.0,709128,5757,705261,1.48,1.04,0.028061728395061727,0.81,99.45
2022-05-16,Rajasthan,729,4,725,9095,4914,2891,8.02,0,81.0,709857,5761,705986,6.07,3.57,0.11228395061728395,0.81,99.45
2022-05-17,Rajasthan,252,2,245,3190,826,16,7.9,5,81.0,710109,5763,706231,1.02,0.02,0.03938271604938272,0.81,99.45
2022-05-18,Rajasthan,438,5,437,5315,4936,1684,8.24,0,81.0,710547,5768,706668,6.09,2.08,0.06561728395061728,0.81,99.45
2022-05-19,Rajasthan,257,2,256,3012,2465,90,8.53,0,81.0,710804,5770,706924,3.04,0.11,0.03718518518518518,0.81,99.45
2022-05-20,Rajasthan,895,4,891,11279,626,259,7.94,0,81.0,711699,5774,707815,0.77,0.32,0.1392469135802469,0.81,99.45
2022-05-21,Rajasthan,1023,6,1021,12890,3353,2153,7.94,0,81.0,712722,5780,708836,4.14,2.66,0.1591358024691358,0.81,99.45
2022-05-22,Rajasthan,750,9,745,9501,2674,1199,7.89,0,81.0,713472,5789,709581,3.3,1.48,0.1172962962962963,0.81,99.45
2022-05-23,Rajasthan,559,4,558,7070,4337,1631,7.91,0,81.0,714031,5793,710139,5.35,2.01,0.08728395061728395,0.81,99.45
2022-05-24,Rajasthan,752,2,749,9175,2022,1608,8.2,1,81.0,714783,5795,710888,2.5,1.99,0.11327160493827161,0.81,99.46
2022-05-25,Rajasthan,407,3,400,5259,1614,505,7.74,4,81.0,715190,5798,711288,1.99,0.62,0.06492592592592593,0.81,99.45
2022-05-26,Rajasthan,1568,12,1560,19659,1339,236,7.98,0,81.0,716758,5810,712848,1.65,0.29,0.2427037037037037,0.81,99.45
2022-05-27,Rajasthan,566,2,560,6770,2474,273,8.36,4,81.0,717324,5812,713408,3.05,0.34,0.08358024691358025,0.81,99.45
2022-05-28,Rajasthan,1010,3,1005,12344,1706,1325,8.18,2,81.0,718334,5815,714413,2.11,1.64,0.15239506172839506,0.81,99.45
2022-05-29,Rajasthan,803,9,802,10187,1638,1089,7.88,0,81.0,719137,5824,715215,2.02,1.34,0.12576543209876542,0.81,99.45
2022-05-30,Rajasthan,435,5,431,5222,4987,276,8.33,0,81.0,719572,5829,715646,6.16,0.34,0.06446913580246913,0.81,99.45
2022-05-31,Rajasthan,724,7,715,9239,825,10,7.84,2,81.0,720296,5836,716361,1.02,0.01,0.11406172839506173,0.81,99.45
2022-06-01,Rajasthan,797,9,790,10362,3132,1174,7.69,0,81.0,721093,5845,717151,3.87,1.45,0.12792592592592592,0.81,99.45
2022-06-02,Rajasthan,249,3,242,3090,1843,1684,8.06,4,81.0,721342,5848,717393,2.28,2.08,0.038148148148148146,0.81,99.45
2022-06-03,Rajasthan,680,9,676,8629,1923,846,7.88,0,81.0,722022,5857,718069,2.37,1.04,0.10653086419753087,0.81,99.45
2022-06-04,Rajasthan,1359,18,1351,17315,1347,136,7.85,0,81.0,723381,5875,719420,1.66,0.17,0.21376543209876545,0.81,99.45
2022-06-05,Rajasthan,1373,9,1366,17116,4757,47,8.02,0,81.0,724754,5884,720786,5.87,0.06,0.21130864197530863,0.81,99.45
2022-06-06,Rajasthan,556,2,551,7024,868,809,7.92,3,81.0,725310,5886,721337,1.07,1.0,0.08671604938271604,0.81,99.45
2022-06-07,Rajasthan,1230,12,1227,15792,1157,808,7.79,0,81.0,726540,5898,722564,1.43,1.0,0.19496296296296298,0.81,99.45
2022-06-08,Rajasthan,46,0,42,614,4788,3413,7.49,4,81.0,726586,5898,722606,5.91,4.21,0.007580246913580247,0.81,99.45
2022-06-09,Rajasthan,585,5,576,7573,1813,1734,7.72,4,81.0,727171,5903,723182,2.24,2.14,0.09349382716049383,0.81,99.45
2022-06-10,Rajasthan,874,8,869,9921,13,7,8.81,0,81.0,728045,5911,724051,0.02,0.01,0.12248148148148148,0.81,99.45
2022-06-11,Rajasthan,1432,18,1423,17888,4906,717,8.01,0,81.0,729477,5929,725474,6.06,0.89,0.2208395061728395,0.81,99.45
2022-06-12,Rajasthan,859,4,858,10685,4765,2496,8.04,0,81.0,730336,5933,726332,5.88,3.08,0.13191358024691358,0.81,99.45
2022-06-13,Rajasthan,1028,9,1022,12747,986,89,8.06,0,81.0,731364,5942,727354,1.22,0.11,0.15737037037037038,0.81,99.45
2022-06-14,Rajasthan,699,8,696,8959,2531,592,7.8,0,81.0,732063,5950,728050,3.12,0.73,0.11060493827160493,0.81,99.45
2022-06-15,Rajasthan,402,3,399,5311,2852,2347,7.57,0,81.0,732465,5953,728449,3.52,2.9,0.0655679012345679,0.81,99.45
2022-06-16,Rajasthan,891,4,891,11302,745,299,7.88,0,81.0,733356,5957,729340,0.92,0.37,0.13953086419753086,0.81,99.45
2022-06-17,Rajasthan,1530,15,1522,18896,4332,4219,8.1,0,81.0,734886,5972,730862,5.35,5.21,0.23328395061728396,0.81,99.45
2022-06-18,Rajasthan,184,2,184,2337,1843,1400,7.87,0,81.0,735070,5974,731046,2.28,1.73,0.02885185185185185,0.81,99.45
2022-06-19,Rajasthan,747,8,746,9487,1533,1149,7.87,0,81.0,735817,5982,731792,1.89,1.42,0.11712345679012345,0.81,99.45
2022-06-20,Rajasthan,522,5,514,6269,2453,1563,8.33,3,81.0,736339,5987,732306,3.03,1.93,0.07739506172839507,0.81,99.45
2022-06-21,Rajasthan,1350,5,1348,16710,3518,405,8.08,0,81.0,737689,5992,733654,4.34,0.5,0.20629629629629628,0.81,99.45
2022-06-22,Rajasthan,799,3,798,10311,1577,1307,7.75,0,81.0,738488,5995,734452,1.95,1.61,0.1272962962962963,0.81,99.45
2022-06-23,Rajasthan,464,2,463,6045,4928,1295,7.68,0,81.0,738952,5997,734915,6.08,1.6,0.07462962962962963,0.81,99.45
2022-06-24,Rajasthan,1273,18,1264,15897,4334,1171,8.01,0,81.0,740225,6015,736179,5.35,1.45,0.19625925925925927,0.81,99.45
2022-06-25,Rajasthan,1032,12,1024,12507,2510,910,8.25,0,81.0,741257,6027,737203,3.1,1.12,0.1544074074074074,0.81,99.45
2022-06-26,Rajasthan,114,0,112,1265,2345,1608,9.01,2,81.0,741371,6027,737315,2.9,1.99,0.015617283950617284,0.81,99.45
2022-06-27,Rajasthan,537,1,535,6539,1584,1582,8.21,1,81.0,741908,6028,737850,1.96,1.95,0.0807283950617284,0.81,99.45
2022-06-28,Rajasthan,206,1,206,2297,3311,1578,8.97,0,81.0,742114,6029,738056,4.09,1.95,0.028358024691358025,0.81,99.45
2022-06-29,Rajasthan,344,2,340,3956,4264,4143,8.7,2,81.0,742458,6031,738396,5.26,5.11,0.048839506172839504,0.81,99.45
2022-06-30,Rajasthan,1252,18,1244,15210,2582,1157,8.23,0,81.0,743710,6049,739640,3.19,1.43,0.18777777777777777,0.81,99.45
2022-07-01,Rajasthan,292,4,289,3807,1629,1109,7.67,0,81.0,744002,6053,739929,2.01,1.37,0.047,0.81,99.45
2022-07-02,Rajasthan,543,5,540,6547,4310,385,8.29,0,81.0,744545,6058,740469,5.32,0.48,0.08082716049382715,0.81,99.45
2022-07-03,Rajasthan,1595,5,1592,19933,1393,1000,8.0,0,81.0,746140,6063,742061,1.72,1.23,0.24608641975308643,0.81,99.45
2022-07-04,Rajasthan,900,8,900,10641,2201,715,8.46,0,81.0,747040,6071,742961,2.72,0.88,0.13137037037037036,0.81,99.45
2022-07-05,Rajasthan,1390,12,1387,17913,4621,4059,7.76,0,81.0,748430,6083,744348,5.7,5.01,0.22114814814814815,0.81,99.45
2022-07-06,Rajasthan,732,2,724,9126,3768,1949,8.02,6,81.0,749162,6085,745072,4.65,2.41,0.11266666666666666,0.81,99.45
2022-07-07,Rajasthan,1194,7,1193,14969,3456,2459,7.98,0,81.0,750356,6092,746265,4.27,3.04,0.18480246913580248,0.81,99.45
2022-07-08,Rajasthan,1033,15,1025,12949,3223,214,7.98,0,81.0,751389,6107,747290,3.98,0.26,0.1598641975308642,0.81,99.45
2022-07-09,Rajasthan,1394,9,1385,17550,2164,457,7.94,0,81.0,752783,6116,748675,2.67,0.56,0.21666666666666667,0.81,99.45
2022-07-10,Rajasthan,1220,6,1215,15503,1145,1131,7.87,0,81.0,754003,6122,749890,1.41,1.4,0.19139506172839507,0.81,99.45
2022-07-11,Rajasthan,1412,16,1412,17669,3299,2679,7.99,0,81.0,755415,6138,751302,4.07,3.31,0.2181358024691358,0.81,99.46
2022-07-12,Rajasthan,218,1,211,2418,973,151,9.02,6,81.0,755633,6139,751513,1.2,0.19,0.02985185185185185,0.81,99.45
2022-07-13,Rajasthan,1593,14,1586,19462,4665,776,8.19,0,81.0,757226,6153,753099,5.76,0.96,0.2402716049382716,0.81,99.45
2022-07-14,Rajasthan,472,4,472,5885,1226,519,8.02,0,81.0,757698,6157,753571,1.51,0.64,0.07265432098765433,0.81,99.46
2022-07-15,Rajasthan,461,3,458,5494,558,488,8.39,0,81.0,758159,6160,754029,0.69,0.6,0.06782716049382716,0.81,99.46
2022-07-16,Rajasthan,858,10,849,10589,2574,815,8.1,0,81.0,759017,6170,754878,3.18,1.01,0.1307283950617284,0.81,99.45
2022-07-17,Rajasthan,1589,13,1589,19785,1744,284,8.03,0,81.0,760606,6183,756467,2.15,0.35,0.24425925925925926,0.81,99.46
2022-07-18,Rajasthan,1393,16,1387,17417,4771,732,8.0,0,81.0,761999,6199,757854,5.89,0.9,0.21502469135802468,0.81,99.46
2022-07-19,Rajasthan,1206,17,1199,15279,4252,1465,7.89,0,81.0,763205,6216,759053,5.25,1.81,0.18862962962962962,0.81,99.46
2022-07-20,Rajasthan,292,1,290,3352,3017,990,8.71,1,81.0,763497,6217,759343,3.72,1.22,0.04138271604938271,0.81,99.46
2022-07-21,Rajasthan,149,1,144,2036,3030,1547,7.32,4,81.0,763646,6218,759487,3.74,1.91,0.025135802469135802,0.81,99.46
2022-07-22,Rajasthan,713,6,712,9033,4857,1053,7.89,0,81.0,764359,6224,760199,6.0,1.3,0.11151851851851852,0.81,99.46
2022-07-23,Rajasthan,241,0,237,3058,772,74,7.88,4,81.0,764600,6224,760436,0.95,0.09,0.037753086419753085,0.81,99.46
2022-07-24,Rajasthan,364,1,357,4531,4843,1404,8.03,6,81.0,764964,6225,760793,5.98,1.73,0.05593827160493827,0.81,99.45
2022-07-25,Rajasthan,1054,11,1050,13019,1573,1289,8.1,0,81.0,766018,6236,761843,1.94,1.59,0.1607283950617284,0.81,99.45
2022-07-26,Rajasthan,187,2,179,2584,377,289,7.24,6,81.0,766205,6238,762022,0.47,0.36,0.031901234567901234,0.81,99.45
2022-07-27,Rajasthan,406,4,401,5009,3895,270,8.11,1,81.0,766611,6242,762423,4.81,0.33,0.06183950617283951,0.81,99.45
2022-07-28,Rajasthan,995,13,993,12119,2476,164,8.21,0,81.0,767606,6255,763416,3.06,0.2,0.1496172839506173,0.81,99.45
2022-07-29,Rajasthan,466,2,461,6391,2782,1128,7.29,3,81.0,768072,6257,763877,3.43,1.39,0.07890123456790124,0.81,99.45
2022-07-30,Rajasthan,548,5,548,6612,3956,1117,8.29,0,81.0,768620,6262,764425,4.88,1.38,0.08162962962962964,0.81,99.45
2022-07-31,Rajasthan,1421,11,1420,17790,3958,152,7.99,0,81.0,770041,6273,765845,4.89,0.19,0.21962962962962962,0.81,99.46
2022-08-01,Rajasthan,1382,4,1378,16860,2478,1339,8.2,0,81.0,771423,6277,767223,3.06,1.65,0.20814814814814814,0.81,99.46
2022-08-02,Rajasthan,247,2,241,3742,974,658,6.6,4,81.0,771670,6279,767464,1.2,0.81,0.046197530864197534,0.81,99.45
2022-08-03,Rajasthan,569,4,568,7383,4690,1144,7.71,0,81.0,772239,6283,768032,5.79,1.41,0.09114814814814814,0.81,99.46
2022-08-04,Rajasthan,899,5,896,11254,238,143,7.99,0,81.0,773138,6288,768928,0.29,0.18,0.13893827160493827,0.81,99.46
2022-08-05,Rajasthan,702,5,696,8566,4174,1164,8.2,1,81.0,773840,6293,769624,5.15,1.44,0.10575308641975309,0.81,99.46
2022-08-06,Rajasthan,971,9,968,12461,391,130,7.79,0,81.0,774811,6302,770592,0.48,0.16,0.1538395061728395,0.81,99.46
2022-08-07,Rajasthan,1176,8,1173,14728,1180,538,7.98,0,81.0,775987,6310,771765,1.46,0.66,0.18182716049382716,0.81,99.46
2022-08-08,Rajasthan,334,3,333,3990,124,123,8.37,0,81.0,776321,6313,772098,0.15,0.15,0.04925925925925926,0.81,99.46
2022-08-09,Rajasthan,1309,16,1301,16572,1601,1450,7.9,0,81.0,777630,6329,773399,1.98,1.79,0.2045925925925926,0.81,99.46
2022-08-10,Rajasthan,109,0,106,1115,4846,2498,9.78,3,81.0,777739,6329,773505,5.98,3.08,0.013765432098765433,0.81,99.46
2022-08-11,Rajasthan,484,3,481,6219,1493,257,7.78,0,81.0,778223,6332,773986,1.84,0.32,0.07677777777777778,0.81,99.46
2022-08-12,Rajasthan,312,2,310,3777,3320,1181,8.26,0,81.0,778535,6334,774296,4.1,1.46,0.04662962962962963,0.81,99.46
2022-08-13,Rajasthan,1270,13,1270,15741,1522,70,8.07,0,81.0,779805,6347,775566,1.88,0.09,0.19433333333333333,0.81,99.46
2022-08-14,Rajasthan,1353,10,1348,17093,3014,1165,7.92,0,81.0,781158,6357,776914,3.72,1.44,0.21102469135802468,0.81,99.46
2022-08-15,Rajasthan,748,10,740,9165,1305,797,8.16,0,81.0,781906,6367,777654,1.61,0.98,0.11314814814814815,0.81,99.46
2022-08-16,Rajasthan,764,5,763,9661,1236,874,7.91,0,81.0,782670,6372,778417,1.53,1.08,0.1192716049382716,0.81,99.46
2022-08-17,Rajasthan,321,2,320,3926,3143,1508,8.18,0,81.0,782991,6374,778737,3.88,1.86,0.048469135802469136,0.81,99.46
2022-08-18,Rajasthan,1250,7,1248,15959,46,16,7.83,0,81.0,784241,6381,779985,0.06,0.02,0.1970246913580247,0.81,99.46
2022-08-19,Rajasthan,771,3,769,9328,1802,1346,8.27,0,81.0,785012,6384,780754,2.22,1.66,0.1151604938271605,0.81,99.46
2022-08-20,Rajasthan,1142,15,1134,14692,3301,2986,7.77,0,81.0,786154,6399,781888,4.08,3.69,0.18138271604938272,0.81,99.46
2022-08-21,Rajasthan,864,11,858,11116,3586,1944,7.77,0,81.0,787018,6410,782746,4.43,2.4,0.13723456790123456,0.81,99.46
2022-08-22,Rajasthan,779,3,779,9671,1519,1514,8.06,0,81.0,787797,6413,783525,1.88,1.87,0.11939506172839506,0.81,99.46
2022-08-23,Rajasthan,1027,8,1021,12669,535,494,8.11,0,81.0,788824,6421,784546,0.66,0.61,0.1564074074074074,0.81,99.46
2022-08-24,Rajasthan,1440,19,1440,18040,988,87,7.98,0,81.0,790264,6440,785986,1.22,0.11,0.22271604938271605,0.81,99.46
2022-08-25,Rajasthan,1425,15,1422,17850,2967,2122,7.98,0,81.0,791689,6455,787408,3.66,2.62,0.22037037037037038,0.82,99.46
2022-08-26,Rajasthan,1199,14,1190,14867,3501,1163,8.06,0,81.0,792888,6469,788598,4.32,1.44,0.1835432098765432,0.82,99.46
2022-08-27,Rajasthan,1095,16,1094,13839,1274,535,7.91,0,81.0,793983,6485,789692,1.57,0.66,0.17085185185185184,0.82,99.46
2022-08-28,Rajasthan,691,5,685,8862,3463,2986,7.8,1,81.0,794674,6490,790377,4.28,3.69,0.10940740740740741,0.82,99.46
2022-08-29,Rajasthan,744,8,739,9422,1604,367,7.9,0,81.0,795418,6498,791116,1.98,0.45,0.11632098765432099,0.82,99.46
2022-08-30,Rajasthan,224,0,222,3157,281,143,7.1,2,81.0,795642,6498,791338,0.35,0.18,0.038975308641975306,0.82,99.46
2022-08-31,Rajasthan,1006,6,997,12445,185,58,8.08,3,81.0,796648,6504,792335,0.23,0.07,0.153641975308642,0.82,99.46
2022-09-01,Rajasthan,938,8,931,11702,3625,3525,8.02,0,81.0,797586,6512,793266,4.48,4.35,0.14446913580246915,0.82,99.46
2022-09-02,Rajasthan,1300,8,1298,16267,1362,472,7.99,0,81.0,798886,6520,794564,1.68,0.58,0.20082716049382715,0.82,99.46
2022-09-03,Rajasthan,678,3,673,8240,3556,647,8.23,2,81.0,799564,6523,795237,4.39,0.8,0.1017283950617284,0.82,99.46
2022-09-04,Rajasthan,647,4,638,8347,3781,365,7.75,5,81.0,800211,6527,795875,4.67,0.45,0.10304938271604938,0.82,99.46
2022-09-05,Rajasthan,652,7,646,8387,4783,3872,7.77,0,81.0,800863,6534,796521,5.9,4.78,0.10354320987654321,0.82,99.46
2022-09-06,Rajasthan,1142,15,1137,13969,299,2,8.18,0,81.0,802005,6549,797658,0.37,0.0,0.1724567901234568,0.82,99.46
2022-09-07,Rajasthan,750,8,745,9406,4527,1601,7.97,0,81.0,802755,6557,798403,5.59,1.98,0.11612345679012345,0.82,99.46
2022-09-08,Rajasthan,1387,15,1378,18006,2310,1169,7.7,0,81.0,804142,6572,799781,2.85,1.44,0.2222962962962963,0.82,99.46
2022-09-09,Rajasthan,198,0,191,3260,3529,925,6.07,7,81.0,804340,6572,799972,4.36,1.14,0.040246913580246915,0.82,99.46
2022-09-10,Rajasthan,1115,5,1115,13793,86,45,8.08,0,81.0,805455,6577,801087,0.11,0.06,0.17028395061728396,0.82,99.46
2022-09-11,Rajasthan,1086,5,1081,14133,2617,32,7.68,0,81.0,806541,6582,802168,3.23,0.04,0.1744814814814815,0.82,99.46
2022-09-12,Rajasthan,1038,8,1029,13271,1353,1013,7.82,1,81.0,807579,6590,803197,1.67,1.25,0.16383950617283952,0.82,99.46
2022-09-13,Rajasthan,831,7,826,10442,3672,2506,7.96,0,81.0,808410,6597,804023,4.53,3.09,0.12891358024691357,0.82,99.46
2022-09-14,Rajasthan,424,2,419,5421,3828,1781,7.82,3,81.0,808834,6599,804442,4.73,2.2,0.06692592592592593,0.82,99.46
2022-09-15,Rajasthan,214,2,205,2523,1968,1386,8.48,7,81.0,809048,6601,804647,2.43,1.71,0.031148148148148147,0.82,99.46
2022-09-16,Rajasthan,792,7,789,9775,2434,1764,8.1,0,81.0,809840,6608,805436,3.0,2.18,0.12067901234567902,0.82,99.46
2022-09-17,Rajasthan,105,0,101,1422,774,576,7.38,4,81.0,809945,6608,805537,0.96,0.71,0.017555555555555557,0.82,99.46
2022-09-18,Rajasthan,1103,12,1102,13771,787,190,8.01,0,81.0,811048,6620,806639,0.97,0.23,0.17001234567901236,0.82,99.46
2022-09-19,Rajasthan,690,5,686,8308,4806,4017,8.31,0,81.0,811738,6625,807325,5.93,4.96,0.1025679012345679,0.82,99.46
2022-09-20,Rajasthan,684,7,682,8809,2607,356,7.76,0,81.0,812422,6632,808007,3.22,0.44,0.10875308641975309,0.82,99.46
2022-09-21,Rajasthan,700,4,695,8708,124,64,8.04,1,81.0,813122,6636,808702,0.15,0.08,0.10750617283950617,0.82,99.46
2022-09-22,Rajasthan,1143,11,1139,14402,1365,849,7.94,0,81.0,814265,6647,809841,1.69,1.05,0.17780246913580247,0.82,99.46
2022-09-23,Rajasthan,712,4,706,9193,4248,4050,7.75,2,81.0,814977,6651,810547,5.24,5.0,0.11349382716049383,0.82,99.46
2022-09-24,Rajasthan,1203,11,1196,15099,3842,1042,7.97,0,81.0,816180,6662,811743,4.74,1.29,0.1864074074074074,0.82,99.46
2022-09-25,Rajasthan,1437,6,1433,18034,3318,2899,7.97,0,81.0,817617,6668,813176,4.1,3.58,0.22264197530864197,0.82,99.46
2022-09-26,Rajasthan,52,0,50,927,829,468,5.61,2,81.0,817669,6668,813226,1.02,0.58,0.011444444444444445,0.82,99.46
2022-09-27,Rajasthan,1216,16,1212,15264,3250,3200,7.97,0,81.0,818885,6684,814438,4.01,3.95,0.18844444444444444,0.82,99.46
2022-09-28,Rajasthan,332,1,330,3709,2993,2426,8.95,1,81.0,819217,6685,814768,3.7,3.0,0.04579012345679012,0.82,99.46
2022-09-29,Rajasthan,1148,17,1143,14607,4477,3486,7.86,0,81.0,820365,6702,815911,5.53,4.3,0.18033333333333335,0.82,99.46
2022-09-30,Rajasthan,862,6,860,11033,3909,451,7.81,0,81.0,821227,6708,816771,4.83,0.56,0.13620987654320987,0.82,99.46
2022-10-01,Rajasthan,1152,12,1147,14173,805,38,8.13,0,81.0,822379,6720,817918,0.99,0.05,0.1749753086419753,0.82,99.46
2022-10-02,Rajasthan,1493,22,1491,18880,3948,3141,7.91,0,81.0,823872,6742,819409,4.87,3.88,0.23308641975308642,0.82,99.46
2022-10-03,Rajasthan,1077,13,1077,13286,4306,538,8.11,0,81.0,824949,6755,820486,5.32,0.66,0.1640246913580247,0.82,99.46
2022-10-04,Rajasthan,807,10,807,9968,2004,811,8.1,0,81.0,825756,6765,821293,2.47,1.0,0.12306172839506173,0.82,99.46
2022-10-05,Rajasthan,1184,8,1177,14962,1647,830,7.91,0,81.0,826940,6773,822470,2.03,1.02,0.18471604938271605,0.82,99.46
2022-10-06,Rajasthan,272,3,266,3627,3412,2585,7.5,3,81.0,827212,6776,822736,4.21,3.19,0.04477777777777778,0.82,99.46
2022-10-07,Rajasthan,191,0,184,2128,4707,2939,8.98,7,81.0,827403,6776,822920,5.81,3.63,0.026271604938271603,0.82,99.46
2022-10-08,Rajasthan,624,6,622,7535,4189,683,8.28,0,81.0,828027,6782,823542,5.17,0.84,0.09302469135802469,0.82,99.46
2022-10-09,Rajasthan,282,2,273,3584,3898,3596,7.87,7,81.0,828309,6784,823815,4.81,4.44,0.04424691358024691,0.82,99.46
2022-10-10,Rajasthan,94,1,87,1027,3498,1290,9.15,6,81.0,828403,6785,823902,4.32,1.59,0.012679012345679013,0.82,99.46
2022-10-11,Rajasthan,1246,7,1246,15441,2314,1888,8.07,0,81.0,829649,6792,825148,2.86,2.33,0.19062962962962962,0.82,99.46
2022-10-12,Rajasthan,1234,8,1227,15261,4035,1439,8.09,0,81.0,830883,6800,826375,4.98,1.78,0.1884074074074074,0.82,99.46
2022-10-13,Rajasthan,402,1,397,5899,3319,3193,6.81,4,81.0,831285,6801,826772,4.1,3.94,0.07282716049382716,0.82,99.46
2022-10-14,Rajasthan,163,1,160,2474,261,128,6.59,2,81.0,831448,6802,826932,0.32,0.16,0.03054320987654321,0.82,99.46
2022-10-15,Rajasthan,1311,17,1311,16443,2187,1099,7.97,0,81.0,832759,6819,828243,2.7,1.36,0.203,0.82,99.46
2022-10-16,Rajasthan,174,0,167,2426,3931,112,7.17,7,81.0,832933,6819,828410,4.85,0.14,0.02995061728395062,0.82,99.46
2022-10-17,Rajasthan,714,8,712,8745,2372,2059,8.16,0,81.0,833647,6827,829122,2.93,2.54,0.10796296296296297,0.82,99.46
2022-10-18,Rajasthan,896,7,887,11142,4166,2213,8.04,2,81.0,834543,6834,830009,5.14,2.73,0.13755555555555554,0.82,99.46
2022-10-19,Rajasthan,868,6,862,11101,4506,3542,7.82,0,81.0,835411,6840,830871,5.56,4.37,0.13704938271604938,0.82,99.46
2022-10-20,Rajasthan,88,0,81,1287,1862,1044,6.84,7,81.0,835499,6840,830952,2.3,1.29,0.01588888888888889,0.82,99.46
2022-10-21,Rajasthan,336,2,330,4351,2040,1431,7.72,4,81.0,835835,6842,831282,2.52,1.77,0.05371604938271605,0.82,99.46
2022-10-22,Rajasthan,438,3,434,5108,3608,2335,8.57,1,81.0,836273,6845,831716,4.45,2.88,0.06306172839506173,0.82,99.46
2022-10-23,Rajasthan,754,9,749,9040,174,9,8.34,0,81.0,837027,6854,832465,0.21,0.01,0.11160493827160493,0.82,99.45
2022-10-24,Rajasthan,650,7,641,7999,790,326,8.13,2,81.0,837677,6861,833106,0.98,0.4,0.09875308641975308,0.82,99.45
2022-10-25,Rajasthan,736,4,733,8835,4626,3851,8.33,0,81.0,838413,6865,833839,5.71,4.75,0.10907407407407407,0.82,99.45
2022-10-26,Rajasthan,436,3,432,5423,1184,769,8.04,1,81.0,838849,6868,834271,1.46,0.95,0.06695061728395062,0.82,99.45
2022-10-27,Rajasthan,905,10,898,11440,1836,807,7.91,0,81.0,839754,6878,835169,2.27,1.0,0.14123456790123456,0.82,99.45
2022-10-28,Rajasthan,1224,14,1223,15009,4033,1846,8.16,0,81.0,840978,6892,836392,4.98,2.28,0.1852962962962963,0.82,99.45
2022-10-29,Rajasthan,343,1,343,4282,1690,1119,8.01,0,81.0,841321,6893,836735,2.09,1.38,0.052864197530864195,0.82,99.45
2022-10-30,Rajasthan,729,10,721,9043,397,356,8.06,0,81.0,842050,6903,837456,0.49,0.44,0.11164197530864198,0.82,99.45
2022-10-31,Rajasthan,767,9,760,9495,1764,338,8.08,0,81.0,842817,6912,838216,2.18,0.42,0.11722222222222223,0.82,99.45
2022-11-01,Rajasthan,665,7,656,8114,3380,1251,8.2,2,81.0,843482,6919,838872,4.17,1.54,0.10017283950617284,0.82,99.45
2022-11-02,Rajasthan,1031,9,1029,13176,774,580,7.82,0,81.0,844513,6928,839901,0.96,0.72,0.16266666666666665,0.82,99.45
2022-11-03,Rajasthan,1320,8,1314,16611,912,608,7.95,0,81.0,845833,6936,841215,1.13,0.75,0.20507407407407408,0.82,99.45
2022-11-04,Rajasthan,129,0,129,1591,3728,749,8.11,0,81.0,845962,6936,841344,4.6,0.92,0.019641975308641976,0.82,99.45
2022-11-05,Rajasthan,772,4,769,9840,2787,1131,7.85,0,81.0,846734,6940,842113,3.44,1.4,0.12148148148148148,0.82,99.45
2022-11-06,Rajasthan,155,1,154,2186,2270,129,7.09,0,81.0,846889,6941,842267,2.8,0.16,0.026987654320987653,0.82,99.45
2022-11-07,Rajasthan,1186,11,1182,14811,106,13,8.01,0,81.0,848075,6952,843449,0.13,0.02,0.18285185185185185,0.82,99.45
2022-11-08,Rajasthan,606,8,601,7061,2202,1726,8.58,0,81.0,848681,6960,844050,2.72,2.13,0.08717283950617284,0.82,99.45
2022-11-09,Rajasthan,1336,14,1328,16458,1122,374,8.12,0,81.0,850017,6974,845378,1.39,0.46,0.2031851851851852,0.82,99.45
2022-11-10,Rajasthan,1504,13,1501,18666,2917,2689,8.06,0,81.0,851521,6987,846879,3.6,3.32,0.23044444444444445,0.82,99.45
2022-11-11,Rajasthan,24,0,16,757,3657,1726,3.17,8,81.0,851545,6987,846895,4.51,2.13,0.009345679012345679,0.82,99.45
2022-11-12,Rajasthan,1305,5,1297,16665,1700,1033,7.83,3,81.0,852850,6992,848192,2.1,1.28,0.20574074074074075,0.82,99.45
2022-11-13,Rajasthan,106,0,98,1229,3236,1286,8.62,8,81.0,852956,6992,848290,4.0,1.59,0.01517283950617284,0.82,99.45
2022-11-14,Rajasthan,423,3,414,5298,1899,172,7.98,6,81.0,853379,6995,848704,2.34,0.21,0.06540740740740741,0.82,99.45
2022-11-15,Rajasthan,80,0,71,649,1096,630,12.33,9,81.0,853459,6995,848775,1.35,0.78,0.008012345679012345,0.82,99.45
2022-11-16,Rajasthan,911,7,909,11514,1072,839,7.91,0,81.0,854370,7002,849684,1.32,1.04,0.14214814814814813,0.82,99.45
2022-11-17,Rajasthan,481,4,476,5642,575,49,8.53,1,81.0,854851,7006,850160,0.71,0.06,0.06965432098765433,0.82,99.45
2022-11-18,Rajasthan,1353,14,1350,16791,91,37,8.06,0,81.0,856204,7020,851510,0.11,0.05,0.20729629629629628,0.82,99.45
2022-11-19,Rajasthan,781,4,780,9516,415,282,8.21,0,81.0,856985,7024,852290,0.51,0.35,0.11748148148148148,0.82,99.45
2022-11-20,Rajasthan,1308,5,1305,16338,4110,330,8.01,0,81.0,858293,7029,853595,5.07,0.41,0.2017037037037037,0.82,99.45
2022-11-21,Rajasthan,985,3,981,12579,4541,3513,7.83,1,81.0,859278,7032,854576,5.61,4.34,0.1552962962962963,0.82,99.45
2022-11-22,Rajasthan,635,5,628,7526,2531,181,8.44,2,81.0,859913,7037,855204,3.12,0.22,0.09291358024691358,0.82,99.45
2022-11-23,Rajasthan,1118,6,1113,14215,1870,451,7.86,0,81.0,861031,7043,856317,2.31,0.56,0.17549382716049383,0.82,99.45
2022-11-24,Rajasthan,1296,6,1289,16507,4226,1656,7.85,1,81.0,862327,7049,857606,5.22,2.04,0.20379012345679012,0.82,99.45
2022-11-25,Rajasthan,367,1,359,4349,1479,249,8.44,7,81.0,862694,7050,857965,1.83,0.31,0.053691358024691355,0.82,99.45
2022-11-26,Rajasthan,1223,6,1220,15184,3871,3269,8.05,0,81.0,863917,7056,859185,4.78,4.04,0.18745679012345678,0.82,99.45
2022-11-27,Rajasthan,540,2,538,7043,3410,865,7.67,0,81.0,864457,7058,859723,4.21,1.07,0.08695061728395062,0.82,99.45
2022-11-28,Rajasthan,813,10,807,9774,4189,364,8.32,0,81.0,865270,7068,860530,5.17,0.45,0.12066666666666667,0.82,99.45
2022-11-29,Rajasthan,919,2,917,11597,4426,4001,7.92,0,81.0,866189,7070,861447,5.46,4.94,0.14317283950617285,0.82,99.45
2022-11-30,Rajasthan,579,7,579,7241,2541,2436,8.0,0,81.0,866768,7077,862026,3.14,3.01,0.08939506172839506,0.82,99.45
2022-12-01,Rajasthan,166,0,161,2046,4997,604,8.11,5,81.0,866934,7077,862187,6.17,0.75,0.02525925925925926,0.82,99.45
2022-12-02,Rajasthan,1344,10,1337,16887,4854,3136,7.96,0,81.0,868278,7087,863524,5.99,3.87,0.2084814814814815,0.82,99.45
2022-12-03,Rajasthan,117,1,112,1451,1080,291,8.06,4,81.0,868395,7088,863636,1.33,0.36,0.01791358024691358,0.82,99.45
2022-12-04,Rajasthan,1314,12,1309,16265,3039,1832,8.08,0,81.0,869709,7100,864945,3.75,2.26,0.20080246913580246,0.82,99.45
2022-12-05,Rajasthan,267,1,261,3544,388,85,7.53,5,81.0,869976,7101,865206,0.48,0.1,0.04375308641975308,0.82,99.45
2022-12-06,Rajasthan,192,1,192,2194,2007,1658,8.75,0,81.0,870168,7102,865398,2.48,2.05,0.02708641975308642,0.82,99.45
2022-12-07,Rajasthan,689,5,684,8572,411,181,8.04,0,81.0,870857,7107,866082,0.51,0.22,0.10582716049382716,0.82,99.45
2022-12-08,Rajasthan,1443,4,1434,17743,2046,1617,8.13,5,81.0,872300,7111,867516,2.53,2.0,0.21904938271604937,0.82,99.45
2022-12-09,Rajasthan,308,4,306,3946,3201,1412,7.81,0,81.0,872608,7115,867822,3.95,1.74,0.04871604938271605,0.82,99.45
2022-12-10,Rajasthan,1210,7,1203,15161,4231,1324,7.98,0,81.0,873818,7122,869025,5.22,1.63,0.18717283950617283,0.82,99.45
2022-12-11,Rajasthan,634,3,627,7692,3127,1792,8.24,4,81.0,874452,7125,869652,3.86,2.21,0.09496296296296296,0.81,99.45
2022-12-12,Rajasthan,1568,20,1561,19399,1076,255,8.08,0,81.0,876020,7145,871213,1.33,0.31,0.23949382716049383,0.82,99.45
2022-12-13,Rajasthan,106,1,102,1357,2862,2706,7.81,3,81.0,876126,7146,871315,3.53,3.34,0.016753086419753087,0.82,99.45
2022-12-14,Rajasthan,903,4,898,11455,681,145,7.88,1,81.0,877029,7150,872213,0.84,0.18,0.14141975308641974,0.82,99.45
2022-12-15,Rajasthan,528,1,527,6323,2109,2076,8.35,0,81.0,877557,7151,872740,2.6,2.56,0.07806172839506173,0.81,99.45
2022-12-16,Rajasthan,465,6,457,5459,2520,2455,8.52,2,81.0,878022,7157,873197,3.11,3.03,0.06739506172839506,0.82,99.45
2022-12-17,Rajasthan,1069,13,1061,13293,3563,1745,8.04,0,81.0,879091,7170,874258,4.4,2.15,0.16411111111111112,0.82,99.45
2022-12-18,Rajasthan,1213,12,1213,15836,3664,1820,7.66,0,81.0,880304,7182,875471,4.52,2.25,0.19550617283950616,0.82,99.45
2022-12-19,Rajasthan,836,3,831,10746,1767,851,7.78,2,81.0,881140,7185,876302,2.18,1.05,0.13266666666666665,0.82,99.45
2022-12-20,Rajasthan,393,1,388,5057,4614,4397,7.77,4,81.0,881533,7186,876690,5.7,5.43,0.0624320987654321,0.82,99.45
2022-12-21,Rajasthan,196,2,193,2147,1915,1224,9.13,1,81.0,881729,7188,876883,2.36,1.51,0.026506172839506174,0.82,99.45
2022-12-22,Rajasthan,1169,13,1167,14628,1851,1072,7.99,0,81.0,882898,7201,878050,2.29,1.32,0.18059259259259258,0.82,99.45
2022-12-23,Rajasthan,990,13,983,12297,2714,98,8.05,0,81.0,883888,7214,879033,3.35,0.12,0.15181481481481482,0.82,99.45
2022-12-24,Rajasthan,204,3,197,2341,2448,1231,8.71,4,81.0,884092,7217,879230,3.02,1.52,0.028901234567901234,0.82,99.45
2022-12-25,Rajasthan,759,4,757,9509,2423,1105,7.98,0,81.0,884851,7221,879987,2.99,1.36,0.11739506172839506,0.82,99.45
2022-12-26,Rajasthan,136,1,136,1610,1970,770,8.45,0,81.0,884987,7222,880123,2.43,0.95,0.019876543209876543,0.82,99.45
2022-12-27,Rajasthan,307,2,305,4169,1299,504,7.36,0,81.0,885294,7224,880428,1.6,0.62,0.05146913580246914,0.82,99.45
2022-12-28,Rajasthan,920,5,911,11368,2679,450,8.09,4,81.0,886214,7229,881339,3.31,0.56,0.14034567901234568,0.82,99.45
2022-12-29,Rajasthan,1256,14,1248,15811,1354,466,7.94,0,81.0,887470,7243,882587,1.67,0.58,0.19519753086419753,0.82,99.45
2022-12-30,Rajasthan,429,3,424,5295,3367,1212,8.1,2,81.0,887899,7246,883011,4.16,1.5,0.06537037037037037,0.82,99.45
2022-12-31,Rajasthan,294,4,286,4284,3348,1680,6.86,4,81.0,888193,7250,883297,4.13,2.07,0.05288888888888889,0.82,99.45
2020-01-01,Sikkim,288,3,284,3972,1781,902,7.25,1,0.7,288,3,284,254.43,128.86,5.674285714285714,1.04,98.61
2020-01-02,Sikkim,1141,16,1134,14225,3338,2570,8.02,0,0.7,1429,19,1418,476.86,367.14,20.321428571428573,1.33,99.23
2020-01-03,Sikkim,1218,14,1213,15392,3733,3345,7.91,0,0.7,2647,33,2631,533.29,477.86,21.98857142857143,1.25,99.4
2020-01-04,Sikkim,1162,10,1158,14799,4781,2722,7.85,0,0.7,3809,43,3789,683.0,388.86,21.14142857142857,1.13,99.47
2020-01-05,Sikkim,1466,12,1457,18152,2635,692,8.08,0,0.7,5275,55,5246,376.43,98.86,25.931428571428572,1.04,99.45
2020-01-06,Sikkim,632,3,628,7879,4270,1267,8.02,1,0.7,5907,58,5874,610.0,181.0,11.255714285714285,0.98,99.44
2020-01-07,Sikkim,1135,7,1134,14116,1317,1138,8.04,0,0.7,7042,65,7008,188.14,162.57,20.165714285714287,0.92,99.52
2020-01-08,Sikkim,431,5,425,5429,2930,1393,7.94,1,0.7,7473,70,7433,418.57,199.0,7.755714285714285,0.94,99.46
2020-01-09,Sikkim,1121,12,1114,14185,2670,1540,7.9,0,0.7,8594,82,8547,381.43,220.0,20.264285714285716,0.95,99.45
2020-01-10,Sikkim,543,3,543,6328,3021,586,8.58,0,0.7,9137,85,9090,431.57,83.71,9.04,0.93,99.49
2020-01-11,Sikkim,436,2,434,5351,871,190,8.15,0,0.7,9573,87,9524,124.43,27.14,7.644285714285714,0.91,99.49
2020-01-12,Sikkim,1409,9,1406,17973,918,854,7.84,0,0.7,10982,96,10930,131.14,122.0,25.675714285714285,0.87,99.53
2020-01-13,Sikkim,1321,5,1316,16912,4983,1303,7.81,0,0.7,12303,101,12246,711.86,186.14,24.16,0.82,99.54
2020-01-14,Sikkim,403,1,396,4753,3968,2966,8.48,6,0.7,12706,102,12642,566.86,423.71,6.79,0.8,99.5
2020-01-15,Sikkim,585,5,583,7381,696,213,7.93,0,0.7,13291,107,13225,99.43,30.43,10.544285714285714,0.81,99.5
2020-01-16,Sikkim,1550,15,1547,19367,533,230,8.0,0,0.7,14841,122,14772,76.14,32.86,27.667142857142856,0.82,99.54
2020-01-17,Sikkim,1444,10,1435,18130,1198,693,7.96,0,0.7,16285,132,16207,171.14,99.0,25.9,0.81,99.52
2020-01-18,Sikkim,318,3,311,4200,4310,3696,7.57,4,0.7,16603,135,16518,615.71,528.0,6.0,0.81,99.49
2020-01-19,Sikkim,1092,9,1089,13518,6,1,8.08,0,0.7,17695,144,17607,0.86,0.14,19.31142857142857,0.81,99.5
2020-01-20,Sikkim,624,5,619,7541,4178,1131,8.27,0,0.7,18319,149,18226,596.86,161.57,10.772857142857143,0.81,99.49
2020-01-21,Sikkim,502,2,501,6390,284,280,7.86,0,0.7,18821,151,18727,40.57,40.0,9.128571428571428,0.8,99.5
2020-01-22,Sikkim,1508,8,1500,18952,3109,891,7.96,0,0.7,20329,159,20227,444.14,127.29,27.074285714285715,0.78,99.5
2020-01-23,Sikkim,456,3,451,5742,2212,634,7.94,2,0.7,20785,162,20678,316.0,90.57,8.202857142857143,0.78,99.49
2020-01-24,Sikkim,1522,9,1515,19322,908,203,7.88,0,0.7,22307,171,22193,129.71,29.0,27.602857142857143,0.77,99.49
2020-01-25,Sikkim,1546,21,1541,19408,1309,966,7.97,0,0.7,23853,192,23734,187.0,138.0,27.725714285714286,0.8,99.5
2020-01-26,Sikkim,310,1,307,3750,3643,3425,8.27,2,0.7,24163,193,24041,520.43,489.29,5.357142857142857,0.8,99.5
2020-01-27,Sikkim,321,4,320,4118,1677,910,7.8,0,0.7,24484,197,24361,239.57,130.0,5.882857142857143,0.8,99.5
2020-01-28,Sikkim,153,1,153,1910,2536,829,8.01,0,0.7,24637,198,24514,362.29,118.43,2.7285714285714286,0.8,99.5
2020-01-29,Sikkim,267,2,265,3425,1609,1048,7.8,0,0.7,24904,200,24779,229.86,149.71,4.892857142857143,0.8,99.5
2020-01-30,Sikkim,624,5,619,7917,793,736,7.88,0,0.7,25528,205,25398,113.29,105.14,11.31,0.8,99.49
2020-01-31,Sikkim,1376,20,1374,17229,675,107,7.99,0,0.7,26904,225,26772,96.43,15.29,24.61285714285714,0.84,99.51
2020-02-01,Sikkim,1516,18,1514,18631,456,158,8.14,0,0.7,28420,243,28286,65.14,22.57,26.615714285714287,0.86,99.53
2020-02-02,Sikkim,1089,12,1083,13563,809,398,8.03,0,0.7,29509,255,29369,115.57,56.86,19.375714285714285,0.86,99.53
2020-02-03,Sikkim,338,4,332,4214,3698,1553,8.02,2,0.7,29847,259,29701,528.29,221.86,6.02,0.87,99.51
2020-02-04,Sikkim,30,0,30,540,1921,477,5.56,0,0.7,29877,259,29731,274.43,68.14,0.7714285714285715,0.87,99.51
2020-02-05,Sikkim,912,4,907,11461,2148,2146,7.96,1,0.7,30789,263,30638,306.86,306.57,16.372857142857143,0.85,99.51
2020-02-06,Sikkim,535,2,530,6711,3189,1880,7.97,3,0.7,31324,265,31168,455.57,268.57,9.587142857142856,0.85,99.5
2020-02-07,Sikkim,1266,3,1260,16032,3071,2502,7.9,3,0.7,32590,268,32428,438.71,357.43,22.902857142857144,0.82,99.5
2020-02-08,Sikkim,1394,7,1386,17659,2915,1027,7.89,1,0.7,33984,275,33814,416.43,146.71,25.22714285714286,0.81,99.5
2020-02-09,Sikkim,1064,9,1058,13238,308,152,8.04,0,0.7,35048,284,34872,44.0,21.71,18.911428571428573,0.81,99.5
2020-02-10,Sikkim,837,3,832,10370,1800,1407,8.07,2,0.7,35885,287,35704,257.14,201.0,14.814285714285715,0.8,99.5
2020-02-11,Sikkim,1157,10,1157,14567,3296,3159,7.94,0,0.7,37042,297,36861,470.86,451.29,20.81,0.8,99.51
2020-02-12,Sikkim,396,2,390,4817,2133,416,8.22,4,0.7,37438,299,37251,304.71,59.43,6.881428571428572,0.8,99.5
2020-02-13,Sikkim,710,6,701,8935,2759,2261,7.95,3,0.7,38148,305,37952,394.14,323.0,12.764285714285714,0.8,99.49
2020-02-14,Sikkim,194,1,191,2415,4767,3208,8.03,2,0.7,38342,306,38143,681.0,458.29,3.45,0.8,99.48
2020-02-15,Sikkim,30,0,30,601,1045,874,4.99,0,0.7,38372,306,38173,149.29,124.86,0.8585714285714285,0.8,99.48
2020-02-16,Sikkim,1525,17,1516,19501,1580,380,7.82,0,0.7,39897,323,39689,225.71,54.29,27.85857142857143,0.81,99.48
2020-02-17,Sikkim,716,7,709,8981,45,44,7.97,0,0.7,40613,330,40398,6.43,6.29,12.83,0.81,99.47
2020-02-18,Sikkim,1225,6,1224,15560,65,21,7.87,0,0.7,41838,336,41622,9.29,3.0,22.228571428571428,0.8,99.48
2020-02-19,Sikkim,900,2,891,11603,272,30,7.76,7,0.7,42738,338,42513,38.86,4.29,16.575714285714287,0.79,99.47
2020-02-20,Sikkim,172,1,172,2328,4816,3591,7.39,0,0.7,42910,339,42685,688.0,513.0,3.3257142857142856,0.79,99.48
2020-02-21,Sikkim,116,1,109,1581,3701,2684,7.34,6,0.7,43026,340,42794,528.71,383.43,2.2585714285714285,0.79,99.46
2020-02-22,Sikkim,584,2,581,7789,2348,344,7.5,1,0.7,43610,342,43375,335.43,49.14,11.127142857142857,0.78,99.46
2020-02-23,Sikkim,1506,16,1505,18715,2983,2855,8.05,0,0.7,45116,358,44880,426.14,407.86,26.735714285714284,0.79,99.48
2020-02-24,Sikkim,56,0,47,1204,3345,1063,4.65,9,0.7,45172,358,44927,477.86,151.86,1.72,0.79,99.46
2020-02-25,Sikkim,491,3,489,6202,1443,44,7.92,0,0.7,45663,361,45416,206.14,6.29,8.86,0.79,99.46
2020-02-26,Sikkim,1057,13,1053,13144,4218,3420,8.04,0,0.7,46720,374,46469,602.57,488.57,18.777142857142856,0.8,99.46
2020-02-27,Sikkim,631,8,623,8171,1124,798,7.72,0,0.7,47351,382,47092,160.57,114.0,11.672857142857143,0.81,99.45
2020-02-28,Sikkim,459,5,459,5744,4134,346,7.99,0,0.7,47810,387,47551,590.57,49.43,8.205714285714286,0.81,99.46
2020-02-29,Sikkim,1367,7,1363,17431,2795,680,7.84,0,0.7,49177,394,48914,399.29,97.14,24.90142857142857,0.8,99.47
2020-03-01,Sikkim,442,4,442,5827,54,39,7.59,0,0.7,49619,398,49356,7.71,5.57,8.324285714285715,0.8,99.47
2020-03-02,Sikkim,214,1,205,1911,971,907,11.2,8,0.7,49833,399,49561,138.71,129.57,2.73,0.8,99.45
2020-03-03,Sikkim,934,9,933,11561,748,123,8.08,0,0.7,50767,408,50494,106.86,17.57,16.515714285714285,0.8,99.46
2020-03-04,Sikkim,1330,4,1323,17075,2126,1255,7.79,3,0.7,52097,412,51817,303.71,179.29,24.392857142857142,0.79,99.46
2020-03-05,Sikkim,183,0,179,2509,2263,332,7.29,4,0.7,52280,412,51996,323.29,47.43,3.584285714285714,0.79,99.46
2020-03-06,Sikkim,173,1,167,2177,3895,1261,7.95,5,0.7,52453,413,52163,556.43,180.14,3.11,0.79,99.45
2020-03-07,Sikkim,437,5,429,5730,445,110,7.63,3,0.7,52890,418,52592,63.57,15.71,8.185714285714285,0.79,99.44
2020-03-08,Sikkim,89,0,87,886,4277,2406,10.05,2,0.7,52979,418,52679,611.0,343.71,1.2657142857142858,0.79,99.43
2020-03-09,Sikkim,709,2,703,8773,426,175,8.08,4,0.7,53688,420,53382,60.86,25.0,12.532857142857143,0.78,99.43
2020-03-10,Sikkim,1470,21,1461,18311,677,624,8.03,0,0.7,55158,441,54843,96.71,89.14,26.158571428571427,0.8,99.43
2020-03-11,Sikkim,1430,13,1426,18107,1767,589,7.9,0,0.7,56588,454,56269,252.43,84.14,25.867142857142856,0.8,99.44
2020-03-12,Sikkim,826,8,825,10081,3316,1165,8.19,0,0.7,57414,462,57094,473.71,166.43,14.401428571428571,0.8,99.44
2020-03-13,Sikkim,704,9,704,8903,4515,39,7.91,0,0.7,58118,471,57798,645.0,5.57,12.718571428571428,0.81,99.45
2020-03-14,Sikkim,919,5,918,11757,4902,4712,7.82,0,0.7,59037,476,58716,700.29,673.14,16.795714285714286,0.81,99.46
2020-03-15,Sikkim,516,2,513,6134,2963,1896,8.41,1,0.7,59553,478,59229,423.29,270.86,8.762857142857143,0.8,99.46
2020-03-16,Sikkim,707,4,701,9502,3447,1957,7.44,2,0.7,60260,482,59930,492.43,279.57,13.574285714285715,0.8,99.45
2020-03-17,Sikkim,1340,8,1332,16625,3088,1931,8.06,0,0.7,61600,490,61262,441.14,275.86,23.75,0.8,99.45
2020-03-18,Sikkim,1212,13,1212,14748,3530,1512,8.22,0,0.7,62812,503,62474,504.29,216.0,21.068571428571428,0.8,99.46
2020-03-19,Sikkim,979,8,979,12388,4301,908,7.9,0,0.7,63791,511,63453,614.43,129.71,17.697142857142858,0.8,99.47
2020-03-20,Sikkim,1345,19,1339,16797,4085,1637,8.01,0,0.7,65136,530,64792,583.57,233.86,23.995714285714286,0.81,99.47
2020-03-21,Sikkim,779,8,771,9580,2963,1771,8.13,0,0.7,65915,538,65563,423.29,253.0,13.685714285714285,0.82,99.47
2020-03-22,Sikkim,214,0,211,2931,3301,2087,7.3,3,0.7,66129,538,65774,471.57,298.14,4.187142857142857,0.81,99.46
2020-03-23,Sikkim,931,12,930,11532,2324,2179,8.07,0,0.7,67060,550,66704,332.0,311.29,16.474285714285713,0.82,99.47
2020-03-24,Sikkim,1314,8,1312,15926,1803,1069,8.25,0,0.7,68374,558,68016,257.57,152.71,22.751428571428573,0.82,99.48
2020-03-25,Sikkim,1560,20,1557,19604,4841,2658,7.96,0,0.7,69934,578,69573,691.57,379.71,28.005714285714287,0.83,99.48
2020-03-26,Sikkim,962,5,957,12262,2217,1147,7.85,0,0.7,70896,583,70530,316.71,163.86,17.517142857142858,0.82,99.48
2020-03-27,Sikkim,531,6,528,6879,4715,1075,7.72,0,0.7,71427,589,71058,673.57,153.57,9.827142857142857,0.82,99.48
2020-03-28,Sikkim,1057,10,1052,13703,1855,1502,7.71,0,0.7,72484,599,72110,265.0,214.57,19.575714285714287,0.83,99.48
2020-03-29,Sikkim,558,8,554,7168,3944,764,7.78,0,0.7,73042,607,72664,563.43,109.14,10.24,0.83,99.48
2020-03-30,Sikkim,345,3,342,4324,3486,2670,7.98,0,0.7,73387,610,73006,498.0,381.43,6.177142857142857,0.83,99.48
2020-03-31,Sikkim,919,2,916,11207,4548,4385,8.2,1,0.7,74306,612,73922,649.71,626.43,16.01,0.82,99.48
2020-04-01,Sikkim,482,3,475,6178,3743,357,7.8,4,0.7,74788,615,74397,534.71,51.0,8.825714285714286,0.82,99.48
2020-04-02,Sikkim,572,7,570,7014,4470,2160,8.16,0,0.7,75360,622,74967,638.57,308.57,10.02,0.83,99.48
2020-04-03,Sikkim,929,13,921,11530,4988,4930,8.06,0,0.7,76289,635,75888,712.57,704.29,16.47142857142857,0.83,99.47
2020-04-04,Sikkim,1430,15,1423,18136,3682,1554,7.88,0,0.7,77719,650,77311,526.0,222.0,25.908571428571427,0.84,99.48
2020-04-05,Sikkim,777,4,768,9595,3025,487,8.1,5,0.7,78496,654,78079,432.14,69.57,13.707142857142857,0.83,99.47
2020-04-06,Sikkim,1439,9,1433,17697,1147,614,8.13,0,0.7,79935,663,79512,163.86,87.71,25.28142857142857,0.83,99.47
2020-04-07,Sikkim,539,3,538,7261,901,341,7.42,0,0.7,80474,666,80050,128.71,48.71,10.372857142857143,0.83,99.47
2020-04-08,Sikkim,661,9,658,8112,3416,2738,8.15,0,0.7,81135,675,80708,488.0,391.14,11.588571428571429,0.83,99.47
2020-04-09,Sikkim,1216,5,1211,14834,3889,2398,8.2,0,0.7,82351,680,81919,555.57,342.57,21.19142857142857,0.83,99.48
2020-04-10,Sikkim,929,5,924,11160,4496,1412,8.32,0,0.7,83280,685,82843,642.29,201.71,15.942857142857143,0.82,99.48
2020-04-11,Sikkim,1517,10,1513,18506,4532,984,8.2,0,0.7,84797,695,84356,647.43,140.57,26.437142857142856,0.82,99.48
2020-04-12,Sikkim,1206,9,1206,14386,452,420,8.38,0,0.7,86003,704,85562,64.57,60.0,20.55142857142857,0.82,99.49
2020-04-13,Sikkim,186,0,179,1969,3506,940,9.45,7,0.7,86189,704,85741,500.86,134.29,2.8128571428571427,0.82,99.48
2020-04-14,Sikkim,816,6,811,10696,3034,1805,7.63,0,0.7,87005,710,86552,433.43,257.86,15.28,0.82,99.48
2020-04-15,Sikkim,583,8,574,7432,4414,2479,7.84,1,0.7,87588,718,87126,630.57,354.14,10.617142857142857,0.82,99.47
2020-04-16,Sikkim,293,3,291,3762,2672,1015,7.79,0,0.7,87881,721,87417,381.71,145.0,5.3742857142857146,0.82,99.47
2020-04-17,Sikkim,1612,8,1612,19971,883,598,8.07,0,0.7,89493,729,89029,126.14,85.43,28.53,0.81,99.48
2020-04-18,Sikkim,1295,11,1289,16348,698,20,7.92,0,0.7,90788,740,90318,99.71,2.86,23.354285714285716,0.82,99.48
2020-04-19,Sikkim,1606,16,1600,19638,4668,49,8.18,0,0.7,92394,756,91918,666.86,7.0,28.054285714285715,0.82,99.48
2020-04-20,Sikkim,828,12,826,10530,1454,611,7.86,0,0.7,93222,768,92744,207.71,87.29,15.042857142857143,0.82,99.49
2020-04-21,Sikkim,826,9,826,10350,2495,389,7.98,0,0.7,94048,777,93570,356.43,55.57,14.785714285714286,0.83,99.49
2020-04-22,Sikkim,910,6,906,11507,2923,194,7.91,0,0.7,94958,783,94476,417.57,27.71,16.43857142857143,0.82,99.49
2020-04-23,Sikkim,1083,8,1079,13256,1663,1043,8.17,0,0.7,96041,791,95555,237.57,149.0,18.937142857142856,0.82,99.49
2020-04-24,Sikkim,994,13,985,12474,4401,3658,7.97,0,0.7,97035,804,96540,628.71,522.57,17.82,0.83,99.49
2020-04-25,Sikkim,676,2,669,8293,3894,503,8.15,5,0.7,97711,806,97209,556.29,71.86,11.847142857142858,0.82,99.49
2020-04-26,Sikkim,1542,12,1537,19209,3023,1955,8.03,0,0.7,99253,818,98746,431.86,279.29,27.44142857142857,0.82,99.49
2020-04-27,Sikkim,1518,17,1512,18880,1713,1149,8.04,0,0.7,100771,835,100258,244.71,164.14,26.97142857142857,0.83,99.49
2020-04-28,Sikkim,1426,12,1421,18016,1470,522,7.92,0,0.7,102197,847,101679,210.0,74.57,25.737142857142857,0.83,99.49
2020-04-29,Sikkim,497,1,492,6293,1021,1003,7.9,4,0.7,102694,848,102171,145.86,143.29,8.99,0.83,99.49
2020-04-30,Sikkim,1370,7,1368,17189,371,249,7.97,0,0.7,104064,855,103539,53.0,35.57,24.555714285714284,0.82,99.5
2020-05-01,Sikkim,1058,4,1054,13235,2043,1687,7.99,0,0.7,105122,859,104593,291.86,241.0,18.90714285714286,0.82,99.5
2020-05-02,Sikkim,706,8,699,8778,2942,1485,8.04,0,0.7,105828,867,105292,420.29,212.14,12.54,0.82,99.49
2020-05-03,Sikkim,653,6,646,8131,3530,1323,8.03,1,0.7,106481,873,105938,504.29,189.0,11.615714285714287,0.82,99.49
2020-05-04,Sikkim,1062,6,1062,13568,4680,305,7.83,0,0.7,107543,879,107000,668.57,43.57,19.382857142857144,0.82,99.5
2020-05-05,Sikkim,544,3,539,7054,1692,995,7.71,2,0.7,108087,882,107539,241.71,142.14,10.077142857142857,0.82,99.49
2020-05-06,Sikkim,983,6,975,11944,1950,931,8.23,2,0.7,109070,888,108514,278.57,133.0,17.062857142857144,0.81,99.49
2020-05-07,Sikkim,1263,11,1261,15768,3226,59,8.01,0,0.7,110333,899,109775,460.86,8.43,22.525714285714287,0.81,99.49
2020-05-08,Sikkim,120,1,120,1495,2461,2122,8.03,0,0.7,110453,900,109895,351.57,303.14,2.1357142857142857,0.81,99.49
2020-05-09,Sikkim,1019,4,1019,12906,1959,1719,7.9,0,0.7,111472,904,110914,279.86,245.57,18.437142857142856,0.81,99.5
2020-05-10,Sikkim,1087,10,1087,13520,4284,3306,8.04,0,0.7,112559,914,112001,612.0,472.29,19.314285714285713,0.81,99.5
2020-05-11,Sikkim,1256,12,1248,15972,3817,1064,7.86,0,0.7,113815,926,113249,545.29,152.0,22.81714285714286,0.81,99.5
2020-05-12,Sikkim,433,1,424,5600,2558,722,7.73,8,0.7,114248,927,113673,365.43,103.14,8.0,0.81,99.5
2020-05-13,Sikkim,1402,5,1394,17456,3267,350,8.03,3,0.7,115650,932,115067,466.71,50.0,24.937142857142856,0.81,99.5
2020-05-14,Sikkim,1576,19,1575,19959,2263,844,7.9,0,0.7,117226,951,116642,323.29,120.57,28.512857142857143,0.81,99.5
2020-05-15,Sikkim,738,5,735,9527,1533,50,7.75,0,0.7,117964,956,117377,219.0,7.14,13.61,0.81,99.5
2020-05-16,Sikkim,594,1,593,7067,4926,880,8.41,0,0.7,118558,957,117970,703.71,125.71,10.095714285714285,0.81,99.5
2020-05-17,Sikkim,1166,9,1157,14598,337,161,7.99,0,0.7,119724,966,119127,48.14,23.0,20.854285714285716,0.81,99.5
2020-05-18,Sikkim,972,9,964,11901,232,73,8.17,0,0.7,120696,975,120091,33.14,10.43,17.001428571428573,0.81,99.5
2020-05-19,Sikkim,753,2,746,9227,3313,948,8.16,5,0.7,121449,977,120837,473.29,135.43,13.18142857142857,0.8,99.5
2020-05-20,Sikkim,575,5,571,7162,1285,309,8.03,0,0.7,122024,982,121408,183.57,44.14,10.231428571428571,0.8,99.5
2020-05-21,Sikkim,929,10,920,11610,1823,767,8.0,0,0.7,122953,992,122328,260.43,109.57,16.585714285714285,0.81,99.49
2020-05-22,Sikkim,506,5,499,6521,1622,115,7.76,2,0.7,123459,997,122827,231.71,16.43,9.315714285714286,0.81,99.49
2020-05-23,Sikkim,189,1,188,2352,3527,343,8.04,0,0.7,123648,998,123015,503.86,49.0,3.36,0.81,99.49
2020-05-24,Sikkim,647,9,642,8235,140,122,7.86,0,0.7,124295,1007,123657,20.0,17.43,11.764285714285714,0.81,99.49
2020-05-25,Sikkim,412,2,406,5004,2527,227,8.23,4,0.7,124707,1009,124063,361.0,32.43,7.148571428571429,0.81,99.48
2020-05-26,Sikkim,281,4,278,3167,2058,1150,8.87,0,0.7,124988,1013,124341,294.0,164.29,4.524285714285714,0.81,99.48
2020-05-27,Sikkim,219,0,215,2582,1607,1261,8.48,4,0.7,125207,1013,124556,229.57,180.14,3.6885714285714286,0.81,99.48
2020-05-28,Sikkim,130,1,124,1405,1725,484,9.25,5,0.7,125337,1014,124680,246.43,69.14,2.007142857142857,0.81,99.48
2020-05-29,Sikkim,979,11,978,11962,2532,1867,8.18,0,0.7,126316,1025,125658,361.71,266.71,17.088571428571427,0.81,99.48
2020-05-30,Sikkim,1253,18,1248,15336,2432,525,8.17,0,0.7,127569,1043,126906,347.43,75.0,21.908571428571427,0.82,99.48
2020-05-31,Sikkim,197,2,193,2587,704,585,7.61,2,0.7,127766,1045,127099,100.57,83.57,3.6957142857142857,0.82,99.48
2020-06-01,Sikkim,930,11,923,11640,1569,322,7.99,0,0.7,128696,1056,128022,224.14,46.0,16.62857142857143,0.82,99.48
2020-06-02,Sikkim,1378,14,1369,17271,355,343,7.98,0,0.7,130074,1070,129391,50.71,49.0,24.672857142857143,0.82,99.47
2020-06-03,Sikkim,1067,6,1063,13654,4868,1558,7.81,0,0.7,131141,1076,130454,695.43,222.57,19.505714285714287,0.82,99.48
2020-06-04,Sikkim,1534,14,1532,19330,1596,1052,7.94,0,0.7,132675,1090,131986,228.0,150.29,27.614285714285714,0.82,99.48
2020-06-05,Sikkim,867,11,859,10288,2493,1041,8.43,0,0.7,133542,1101,132845,356.14,148.71,14.697142857142858,0.82,99.48
2020-06-06,Sikkim,864,6,864,10842,1435,77,7.97,0,0.7,134406,1107,133709,205.0,11.0,15.48857142857143,0.82,99.48
2020-06-07,Sikkim,1090,4,1081,13530,358,47,8.06,5,0.7,135496,1111,134790,51.14,6.71,19.32857142857143,0.82,99.48
2020-06-08,Sikkim,1289,11,1287,16739,4509,3033,7.7,0,0.7,136785,1122,136077,644.14,433.29,23.912857142857142,0.82,99.48
2020-06-09,Sikkim,637,2,632,8112,2087,108,7.85,3,0.7,137422,1124,136709,298.14,15.43,11.588571428571429,0.82,99.48
2020-06-10,Sikkim,1096,8,1089,13874,1069,549,7.9,0,0.7,138518,1132,137798,152.71,78.43,19.82,0.82,99.48
2020-06-11,Sikkim,1154,6,1154,14269,3644,3344,8.09,0,0.7,139672,1138,138952,520.57,477.71,20.384285714285713,0.81,99.48
2020-06-12,Sikkim,1269,5,1264,15914,2181,1655,7.97,0,0.7,140941,1143,140216,311.57,236.43,22.734285714285715,0.81,99.49
2020-06-13,Sikkim,1332,7,1331,16834,3435,2461,7.91,0,0.7,142273,1150,141547,490.71,351.57,24.048571428571428,0.81,99.49
2020-06-14,Sikkim,488,2,488,6826,4785,1294,7.15,0,0.7,142761,1152,142035,683.57,184.86,9.751428571428571,0.81,99.49
2020-06-15,Sikkim,774,2,767,9382,4961,3941,8.25,5,0.7,143535,1154,142802,708.71,563.0,13.402857142857142,0.8,99.49
2020-06-16,Sikkim,1355,12,1347,17527,1536,184,7.73,0,0.7,144890,1166,144149,219.43,26.29,25.03857142857143,0.8,99.49
2020-06-17,Sikkim,710,7,701,8702,3483,1232,8.16,2,0.7,145600,1173,144850,497.57,176.0,12.43142857142857,0.81,99.48
2020-06-18,Sikkim,746,9,745,9525,660,508,7.83,0,0.7,146346,1182,145595,94.29,72.57,13.607142857142858,0.81,99.49
2020-06-19,Sikkim,1055,4,1048,13490,2895,1908,7.82,3,0.7,147401,1186,146643,413.57,272.57,19.271428571428572,0.8,99.49
2020-06-20,Sikkim,747,9,740,9329,2706,1283,8.01,0,0.7,148148,1195,147383,386.57,183.29,13.327142857142857,0.81,99.48
2020-06-21,Sikkim,1419,19,1415,17626,4182,3763,8.05,0,0.7,149567,1214,148798,597.43,537.57,25.18,0.81,99.49
2020-06-22,Sikkim,887,7,884,11023,2483,732,8.05,0,0.7,150454,1221,149682,354.71,104.57,15.747142857142856,0.81,99.49
2020-06-23,Sikkim,923,7,923,11941,2402,468,7.73,0,0.7,151377,1228,150605,343.14,66.86,17.05857142857143,0.81,99.49
2020-06-24,Sikkim,433,1,430,5167,3353,127,8.38,2,0.7,151810,1229,151035,479.0,18.14,7.381428571428572,0.81,99.49
2020-06-25,Sikkim,1547,12,1545,19424,1669,1642,7.96,0,0.7,153357,1241,152580,238.43,234.57,27.748571428571427,0.81,99.49
2020-06-26,Sikkim,1535,5,1529,18983,1485,705,8.09,1,0.7,154892,1246,154109,212.14,100.71,27.11857142857143,0.8,99.49
2020-06-27,Sikkim,374,4,368,4238,1463,1058,8.82,2,0.7,155266,1250,154477,209.0,151.14,6.054285714285714,0.81,99.49
2020-06-28,Sikkim,245,2,239,3219,3134,2319,7.61,4,0.7,155511,1252,154716,447.71,331.29,4.598571428571429,0.81,99.49
2020-06-29,Sikkim,171,1,169,1923,3874,2303,8.89,1,0.7,155682,1253,154885,553.43,329.0,2.7471428571428573,0.8,99.49
2020-06-30,Sikkim,983,13,983,12481,479,422,7.88,0,0.7,156665,1266,155868,68.43,60.29,17.83,0.81,99.49
2020-07-01,Sikkim,300,1,300,3486,90,24,8.61,0,0.7,156965,1267,156168,12.86,3.43,4.98,0.81,99.49
2020-07-02,Sikkim,1164,14,1158,14146,4542,1089,8.23,0,0.7,158129,1281,157326,648.86,155.57,20.208571428571428,0.81,99.49
2020-07-03,Sikkim,1271,18,1263,15808,669,560,8.04,0,0.7,159400,1299,158589,95.57,80.0,22.582857142857144,0.81,99.49
2020-07-04,Sikkim,1130,11,1126,14689,4433,610,7.69,0,0.7,160530,1310,159715,633.29,87.14,20.984285714285715,0.82,99.49
2020-07-05,Sikkim,338,1,338,4316,1439,118,7.83,0,0.7,160868,1311,160053,205.57,16.86,6.1657142857142855,0.81,99.49
2020-07-06,Sikkim,1470,15,1468,18777,244,214,7.83,0,0.7,162338,1326,161521,34.86,30.57,26.824285714285715,0.82,99.5
2020-07-07,Sikkim,1235,5,1227,15451,4956,2621,7.99,3,0.7,163573,1331,162748,708.0,374.43,22.072857142857142,0.81,99.5
2020-07-08,Sikkim,1014,11,1014,12495,1892,985,8.12,0,0.7,164587,1342,163762,270.29,140.71,17.85,0.82,99.5
2020-07-09,Sikkim,903,8,897,11260,4031,3077,8.02,0,0.7,165490,1350,164659,575.86,439.57,16.085714285714285,0.82,99.5
2020-07-10,Sikkim,102,1,99,1285,1950,127,7.94,2,0.7,165592,1351,164758,278.57,18.14,1.8357142857142856,0.82,99.5
2020-07-11,Sikkim,956,4,947,11934,3970,1433,8.01,5,0.7,166548,1355,165705,567.14,204.71,17.048571428571428,0.81,99.49
2020-07-12,Sikkim,1579,8,1571,19987,3431,1686,7.9,0,0.7,168127,1363,167276,490.14,240.86,28.552857142857142,0.81,99.49
2020-07-13,Sikkim,1322,4,1321,16233,2960,596,8.14,0,0.7,169449,1367,168597,422.86,85.14,23.19,0.81,99.5
2020-07-14,Sikkim,693,8,684,8733,2541,1853,7.94,1,0.7,170142,1375,169281,363.0,264.71,12.475714285714286,0.81,99.49
2020-07-15,Sikkim,691,5,689,8316,1229,49,8.31,0,0.7,170833,1380,169970,175.57,7.0,11.88,0.81,99.49
2020-07-16,Sikkim,1010,14,1008,12800,2942,2318,7.89,0,0.7,171843,1394,170978,420.29,331.14,18.285714285714285,0.81,99.5
2020-07-17,Sikkim,878,4,874,10946,333,90,8.02,0,0.7,172721,1398,171852,47.57,12.86,15.637142857142857,0.81,99.5
2020-07-18,Sikkim,608,6,600,7378,272,119,8.24,2,0.7,173329,1404,172452,38.86,17.0,10.54,0.81,99.49
2020-07-19,Sikkim,794,7,794,9911,1921,357,8.01,0,0.7,174123,1411,173246,274.43,51.0,14.15857142857143,0.81,99.5
2020-07-20,Sikkim,117,1,113,1382,178,32,8.47,3,0.7,174240,1412,173359,25.43,4.57,1.9742857142857142,0.81,99.49
2020-07-21,Sikkim,1437,18,1437,17684,3335,1790,8.13,0,0.7,175677,1430,174796,476.43,255.71,25.262857142857143,0.81,99.5
2020-07-22,Sikkim,29,0,22,736,2306,269,3.94,7,0.7,175706,1430,174818,329.43,38.43,1.0514285714285714,0.81,99.49
2020-07-23,Sikkim,939,7,937,12105,316,59,7.76,0,0.7,176645,1437,175755,45.14,8.43,17.292857142857144,0.81,99.5
2020-07-24,Sikkim,1489,16,1481,18781,2065,1436,7.93,0,0.7,178134,1453,177236,295.0,205.14,26.83,0.82,99.5
2020-07-25,Sikkim,911,12,906,11525,1971,377,7.9,0,0.7,179045,1465,178142,281.57,53.86,16.464285714285715,0.82,99.5
2020-07-26,Sikkim,500,5,495,6150,2833,59,8.13,0,0.7,179545,1470,178637,404.71,8.43,8.785714285714286,0.82,99.49
2020-07-27,Sikkim,1278,8,1274,15931,1900,528,8.02,0,0.7,180823,1478,179911,271.43,75.43,22.75857142857143,0.82,99.5
2020-07-28,Sikkim,1514,17,1507,18344,1574,831,8.25,0,0.7,182337,1495,181418,224.86,118.71,26.205714285714286,0.82,99.5
2020-07-29,Sikkim,505,3,496,5942,1876,1808,8.5,6,0.7,182842,1498,181914,268.0,258.29,8.48857142857143,0.82,99.49
2020-07-30,Sikkim,1031,14,1030,13071,3265,291,7.89,0,0.7,183873,1512,182944,466.43,41.57,18.672857142857143,0.82,99.49
2020-07-31,Sikkim,84,1,76,796,4367,932,10.55,7,0.7,183957,1513,183020,623.86,133.14,1.1371428571428572,0.82,99.49
2020-08-01,Sikkim,709,4,700,8805,3881,893,8.05,5,0.7,184666,1517,183720,554.43,127.57,12.57857142857143,0.82,99.49
2020-08-02,Sikkim,1238,16,1233,15798,3261,1607,7.84,0,0.7,185904,1533,184953,465.86,229.57,22.568571428571428,0.82,99.49
2020-08-03,Sikkim,592,4,590,7215,4446,3937,8.21,0,0.7,186496,1537,185543,635.14,562.43,10.307142857142857,0.82,99.49
2020-08-04,Sikkim,820,4,814,9904,2422,1597,8.28,2,0.7,187316,1541,186357,346.0,228.14,14.148571428571428,0.82,99.49
2020-08-05,Sikkim,247,3,242,3200,1143,927,7.72,2,0.7,187563,1544,186599,163.29,132.43,4.571428571428571,0.82,99.49
2020-08-06,Sikkim,483,2,475,6006,1444,522,8.04,6,0.7,188046,1546,187074,206.29,74.57,8.58,0.82,99.48
2020-08-07,Sikkim,315,2,308,3728,4630,497,8.45,5,0.7,188361,1548,187382,661.43,71.0,5.325714285714286,0.82,99.48
2020-08-08,Sikkim,278,3,273,3595,3228,228,7.73,2,0.7,188639,1551,187655,461.14,32.57,5.135714285714286,0.82,99.48
2020-08-09,Sikkim,532,2,529,6395,1447,891,8.32,1,0.7,189171,1553,188184,206.71,127.29,9.135714285714286,0.82,99.48
2020-08-10,Sikkim,1576,16,1573,19863,2779,2499,7.93,0,0.7,190747,1569,189757,397.0,357.0,28.375714285714285,0.82,99.48
2020-08-11,Sikkim,271,3,266,3635,2245,1020,7.46,2,0.7,191018,1572,190023,320.71,145.71,5.192857142857143,0.82,99.48
2020-08-12,Sikkim,370,1,369,4377,3797,441,8.45,0,0.7,191388,1573,190392,542.43,63.0,6.252857142857143,0.82,99.48
2020-08-13,Sikkim,878,11,877,11064,29,11,7.94,0,0.7,192266,1584,191269,4.14,1.57,15.805714285714286,0.82,99.48
2020-08-14,Sikkim,1549,5,1541,19012,3729,2272,8.15,3,0.7,193815,1589,192810,532.71,324.57,27.16,0.82,99.48
2020-08-15,Sikkim,1175,4,1170,14725,2182,183,7.98,1,0.7,194990,1593,193980,311.71,26.14,21.035714285714285,0.82,99.48
2020-08-16,Sikkim,815,9,807,10030,2275,1435,8.13,0,0.7,195805,1602,194787,325.0,205.0,14.32857142857143,0.82,99.48
2020-08-17,Sikkim,215,3,213,2396,305,241,8.97,0,0.7,196020,1605,195000,43.57,34.43,3.422857142857143,0.82,99.48
2020-08-18,Sikkim,1040,6,1033,12877,697,0,8.08,1,0.7,197060,1611,196033,99.57,0.0,18.395714285714284,0.82,99.48
2020-08-19,Sikkim,1167,8,1161,14275,3604,2030,8.18,0,0.7,198227,1619,197194,514.86,290.0,20.392857142857142,0.82,99.48
2020-08-20,Sikkim,1586,21,1580,19860,3524,1410,7.99,0,0.7,199813,1640,198774,503.43,201.43,28.37142857142857,0.82,99.48
2020-08-21,Sikkim,338,3,337,3957,2579,347,8.54,0,0.7,200151,1643,199111,368.43,49.57,5.652857142857143,0.82,99.48
2020-08-22,Sikkim,1097,15,1091,14225,4977,4698,7.71,0,0.7,201248,1658,200202,711.0,671.14,20.321428571428573,0.82,99.48
2020-08-23,Sikkim,833,8,830,9970,3048,2530,8.36,0,0.7,202081,1666,201032,435.43,361.43,14.242857142857142,0.82,99.48
2020-08-24,Sikkim,1094,7,1092,13791,4373,3203,7.93,0,0.7,203175,1673,202124,624.71,457.57,19.701428571428572,0.82,99.48
2020-08-25,Sikkim,95,0,92,1371,79,75,6.93,3,0.7,203270,1673,202216,11.29,10.71,1.9585714285714286,0.82,99.48
2020-08-26,Sikkim,698,3,695,8559,322,119,8.16,0,0.7,203968,1676,202911,46.0,17.0,12.227142857142857,0.82,99.48
2020-08-27,Sikkim,1272,4,1267,15690,600,292,8.11,1,0.7,205240,1680,204178,85.71,41.71,22.414285714285715,0.82,99.48
2020-08-28,Sikkim,300,2,292,3735,3747,1890,8.03,6,0.7,205540,1682,204470,535.29,270.0,5.335714285714285,0.82,99.48
2020-08-29,Sikkim,928,10,925,10955,2750,2005,8.47,0,0.7,206468,1692,205395,392.86,286.43,15.65,0.82,99.48
2020-08-30,Sikkim,1144,10,1135,14539,2663,1535,7.87,0,0.7,207612,1702,206530,380.43,219.29,20.77,0.82,99.48
2020-08-31,Sikkim,411,3,408,5529,2800,2598,7.43,0,0.7,208023,1705,206938,400.0,371.14,7.898571428571429,0.82,99.48
2020-09-01,Sikkim,396,1,389,4953,1305,1190,8.0,6,0.7,208419,1706,207327,186.43,170.0,7.075714285714286,0.82,99.48
2020-09-02,Sikkim,238,0,235,2662,4215,158,8.94,3,0.7,208657,1706,207562,602.14,22.57,3.802857142857143,0.82,99.48
2020-09-03,Sikkim,1284,11,1284,15830,2635,2285,8.11,0,0.7,209941,1717,208846,376.43,326.43,22.614285714285714,0.82,99.48
2020-09-04,Sikkim,437,5,436,5731,4406,1708,7.63,0,0.7,210378,1722,209282,629.43,244.0,8.187142857142858,0.82,99.48
2020-09-05,Sikkim,827,5,822,10228,3071,2500,8.09,0,0.7,211205,1727,210104,438.71,357.14,14.611428571428572,0.82,99.48
2020-09-06,Sikkim,1192,12,1188,14661,649,436,8.13,0,0.7,212397,1739,211292,92.71,62.29,20.944285714285716,0.82,99.48
2020-09-07,Sikkim,539,5,534,6937,1071,608,7.77,0,0.7,212936,1744,211826,153.0,86.86,9.91,0.82,99.48
2020-09-08,Sikkim,1455,8,1446,17847,1461,1123,8.15,1,0.7,214391,1752,213272,208.71,160.43,25.495714285714286,0.82,99.48
2020-09-09,Sikkim,804,2,799,10084,473,310,7.97,3,0.7,215195,1754,214071,67.57,44.29,14.405714285714286,0.82,99.48
2020-09-10,Sikkim,1138,11,1130,14433,4676,3949,7.88,0,0.7,216333,1765,215201,668.0,564.14,20.61857142857143,0.82,99.48
2020-09-11,Sikkim,330,3,328,4246,3812,823,7.77,0,0.7,216663,1768,215529,544.57,117.57,6.065714285714286,0.82,99.48
2020-09-12,Sikkim,79,1,77,1320,4488,2272,5.98,1,0.7,216742,1769,215606,641.14,324.57,1.8857142857142857,0.82,99.48
2020-09-13,Sikkim,834,4,833,10328,3275,1490,8.08,0,0.7,217576,1773,216439,467.86,212.86,14.754285714285714,0.81,99.48
2020-09-14,Sikkim,906,13,899,11834,859,365,7.66,0,0.7,218482,1786,217338,122.71,52.14,16.905714285714286,0.82,99.48
2020-09-15,Sikkim,475,1,466,6155,2489,1053,7.72,8,0.7,218957,1787,217804,355.57,150.43,8.792857142857143,0.82,99.47
2020-09-16,Sikkim,1063,7,1059,13516,1144,189,7.86,0,0.7,220020,1794,218863,163.43,27.0,19.30857142857143,0.82,99.47
2020-09-17,Sikkim,891,9,887,11167,4307,1969,7.98,0,0.7,220911,1803,219750,615.29,281.29,15.952857142857143,0.82,99.47
2020-09-18,Sikkim,1128,13,1122,14447,1931,141,7.81,0,0.7,222039,1816,220872,275.86,20.14,20.638571428571428,0.82,99.47
2020-09-19,Sikkim,79,0,79,972,1456,908,8.13,0,0.7,222118,1816,220951,208.0,129.71,1.3885714285714286,0.82,99.47
2020-09-20,Sikkim,202,2,199,2354,3116,391,8.58,1,0.7,222320,1818,221150,445.14,55.86,3.362857142857143,0.82,99.47
2020-09-21,Sikkim,760,5,757,9660,3381,1795,7.87,0,0.7,223080,1823,221907,483.0,256.43,13.8,0.82,99.47
2020-09-22,Sikkim,654,8,648,7741,3023,1897,8.45,0,0.7,223734,1831,222555,431.86,271.0,11.058571428571428,0.82,99.47
2020-09-23,Sikkim,911,4,907,11563,1487,360,7.88,0,0.7,224645,1835,223462,212.43,51.43,16.518571428571427,0.82,99.47
2020-09-24,Sikkim,783,4,774,9156,3204,861,8.55,5,0.7,225428,1839,224236,457.71,123.0,13.08,0.82,99.47
2020-09-25,Sikkim,287,3,284,4037,943,919,7.11,0,0.7,225715,1842,224520,134.71,131.29,5.767142857142857,0.82,99.47
2020-09-26,Sikkim,1613,12,1606,19716,169,63,8.18,0,0.7,227328,1854,226126,24.14,9.0,28.165714285714287,0.82,99.47
2020-09-27,Sikkim,862,5,862,10630,4769,4328,8.11,0,0.7,228190,1859,226988,681.29,618.29,15.185714285714285,0.81,99.47
2020-09-28,Sikkim,1114,8,1112,13748,3179,78,8.1,0,0.7,229304,1867,228100,454.14,11.14,19.64,0.81,99.47
2020-09-29,Sikkim,1579,22,1579,19522,4371,757,8.09,0,0.7,230883,1889,229679,624.43,108.14,27.888571428571428,0.82,99.48
2020-09-30,Sikkim,710,5,707,8304,3200,217,8.55,0,0.7,231593,1894,230386,457.14,31.0,11.862857142857143,0.82,99.48
2020-10-01,Sikkim,511,1,503,6567,193,77,7.78,7,0.7,232104,1895,230889,27.57,11.0,9.381428571428572,0.82,99.48
2020-10-02,Sikkim,620,8,618,7679,665,134,8.07,0,0.7,232724,1903,231507,95.0,19.14,10.97,0.82,99.48
2020-10-03,Sikkim,470,3,466,5851,1822,1561,8.03,1,0.7,233194,1906,231973,260.29,223.0,8.358571428571429,0.82,99.48
2020-10-04,Sikkim,1409,8,1400,17822,1091,741,7.91,1,0.7,234603,1914,233373,155.86,105.86,25.46,0.82,99.48
2020-10-05,Sikkim,817,5,814,9647,330,42,8.47,0,0.7,235420,1919,234187,47.14,6.0,13.781428571428572,0.82,99.48
2020-10-06,Sikkim,253,2,247,3400,4235,699,7.44,4,0.7,235673,1921,234434,605.0,99.86,4.857142857142857,0.82,99.47
2020-10-07,Sikkim,1205,7,1202,14606,2557,627,8.25,0,0.7,236878,1928,235636,365.29,89.57,20.865714285714287,0.81,99.48
2020-10-08,Sikkim,705,4,697,8798,3394,3142,8.01,4,0.7,237583,1932,236333,484.86,448.86,12.56857142857143,0.81,99.47
2020-10-09,Sikkim,743,3,739,9287,378,137,8.0,1,0.7,238326,1935,237072,54.0,19.57,13.267142857142858,0.81,99.47
2020-10-10,Sikkim,1472,18,1472,18194,1918,739,8.09,0,0.7,239798,1953,238544,274.0,105.57,25.99142857142857,0.81,99.48
2020-10-11,Sikkim,1304,5,1296,16556,3748,750,7.88,3,0.7,241102,1958,239840,535.43,107.14,23.65142857142857,0.81,99.48
2020-10-12,Sikkim,741,8,734,9330,2878,2768,7.94,0,0.7,241843,1966,240574,411.14,395.43,13.32857142857143,0.81,99.48
2020-10-13,Sikkim,1197,7,1197,15132,483,88,7.91,0,0.7,243040,1973,241771,69.0,12.57,21.617142857142856,0.81,99.48
2020-10-14,Sikkim,544,7,537,6855,3630,669,7.94,0,0.7,243584,1980,242308,518.57,95.57,9.792857142857143,0.81,99.48
2020-10-15,Sikkim,902,10,898,11327,1160,860,7.96,0,0.7,244486,1990,243206,165.71,122.86,16.181428571428572,0.81,99.48
2020-10-16,Sikkim,417,6,416,5505,2492,430,7.57,0,0.7,244903,1996,243622,356.0,61.43,7.864285714285714,0.82,99.48
2020-10-17,Sikkim,833,4,830,10177,2243,1975,8.19,0,0.7,245736,2000,244452,320.43,282.14,14.538571428571428,0.81,99.48
2020-10-18,Sikkim,256,3,252,3183,248,66,8.04,1,0.7,245992,2003,244704,35.43,9.43,4.547142857142857,0.81,99.48
2020-10-19,Sikkim,1004,8,1004,12487,636,323,8.04,0,0.7,246996,2011,245708,90.86,46.14,17.838571428571427,0.81,99.48
2020-10-20,Sikkim,806,2,801,10879,4217,4172,7.41,3,0.7,247802,2013,246509,602.43,596.0,15.541428571428572,0.81,99.48
2020-10-21,Sikkim,349,4,343,4480,2202,890,7.79,2,0.7,248151,2017,246852,314.57,127.14,6.4,0.81,99.48
2020-10-22,Sikkim,592,6,583,7235,3101,768,8.18,3,0.7,248743,2023,247435,443.0,109.71,10.335714285714285,0.81,99.47
2020-10-23,Sikkim,1534,20,1529,19256,4496,3756,7.97,0,0.7,250277,2043,248964,642.29,536.57,27.50857142857143,0.82,99.48
2020-10-24,Sikkim,538,2,533,6771,349,87,7.95,3,0.7,250815,2045,249497,49.86,12.43,9.672857142857143,0.82,99.47
2020-10-25,Sikkim,676,4,675,8555,3514,1656,7.9,0,0.7,251491,2049,250172,502.0,236.57,12.221428571428572,0.81,99.48
2020-10-26,Sikkim,1267,9,1259,15608,115,106,8.12,0,0.7,252758,2058,251431,16.43,15.14,22.297142857142855,0.81,99.47
2020-10-27,Sikkim,573,3,573,7224,1272,474,7.93,0,0.7,253331,2061,252004,181.71,67.71,10.32,0.81,99.48
2020-10-28,Sikkim,391,4,384,5148,3160,3143,7.6,3,0.7,253722,2065,252388,451.43,449.0,7.354285714285714,0.81,99.47
2020-10-29,Sikkim,598,6,595,7319,2730,1798,8.17,0,0.7,254320,2071,252983,390.0,256.86,10.455714285714286,0.81,99.47
2020-10-30,Sikkim,883,6,877,11174,409,164,7.9,0,0.7,255203,2077,253860,58.43,23.43,15.962857142857143,0.81,99.47
2020-10-31,Sikkim,113,1,108,1596,4560,3247,7.08,4,0.7,255316,2078,253968,651.43,463.86,2.28,0.81,99.47
2020-11-01,Sikkim,524,3,524,6531,1262,839,8.02,0,0.7,255840,2081,254492,180.29,119.86,9.33,0.81,99.47
2020-11-02,Sikkim,1454,12,1450,17907,3347,3264,8.12,0,0.7,257294,2093,255942,478.14,466.29,25.58142857142857,0.81,99.47
2020-11-03,Sikkim,596,2,596,7646,126,28,7.79,0,0.7,257890,2095,256538,18.0,4.0,10.922857142857143,0.81,99.48
2020-11-04,Sikkim,213,1,210,2712,2251,864,7.85,2,0.7,258103,2096,256748,321.57,123.43,3.874285714285714,0.81,99.48
2020-11-05,Sikkim,86,1,85,805,272,271,10.68,0,0.7,258189,2097,256833,38.86,38.71,1.15,0.81,99.47
2020-11-06,Sikkim,1533,16,1527,19320,3171,871,7.93,0,0.7,259722,2113,258360,453.0,124.43,27.6,0.81,99.48
2020-11-07,Sikkim,288,4,285,2856,585,433,10.08,0,0.7,260010,2117,258645,83.57,61.86,4.08,0.81,99.48
2020-11-08,Sikkim,880,8,876,11152,3650,140,7.89,0,0.7,260890,2125,259521,521.43,20.0,15.93142857142857,0.81,99.48
2020-11-09,Sikkim,1411,8,1410,17870,147,4,7.9,0,0.7,262301,2133,260931,21.0,0.57,25.52857142857143,0.81,99.48
2020-11-10,Sikkim,382,5,379,4488,4590,2942,8.51,0,0.7,262683,2138,261310,655.71,420.29,6.411428571428571,0.81,99.48
2020-11-11,Sikkim,448,3,443,5735,4514,558,7.81,2,0.7,263131,2141,261753,644.86,79.71,8.192857142857143,0.81,99.48
2020-11-12,Sikkim,1000,14,997,12528,1693,657,7.98,0,0.7,264131,2155,262750,241.86,93.86,17.897142857142857,0.82,99.48
2020-11-13,Sikkim,921,11,920,11931,4577,584,7.72,0,0.7,265052,2166,263670,653.86,83.43,17.044285714285714,0.82,99.48
2020-11-14,Sikkim,500,2,498,6271,4948,889,7.97,0,0.7,265552,2168,264168,706.86,127.0,8.958571428571428,0.82,99.48
2020-11-15,Sikkim,1339,10,1334,16840,411,292,7.95,0,0.7,266891,2178,265502,58.71,41.71,24.057142857142857,0.82,99.48
2020-11-16,Sikkim,743,3,739,9288,1186,325,8.0,1,0.7,267634,2181,266241,169.43,46.43,13.268571428571429,0.81,99.48
2020-11-17,Sikkim,727,8,722,9101,4655,2753,7.99,0,0.7,268361,2189,266963,665.0,393.29,13.001428571428571,0.82,99.48
2020-11-18,Sikkim,25,0,20,707,802,700,3.54,5,0.7,268386,2189,266983,114.57,100.0,1.01,0.82,99.48
2020-11-19,Sikkim,1223,6,1221,15106,570,329,8.1,0,0.7,269609,2195,268204,81.43,47.0,21.58,0.81,99.48
2020-11-20,Sikkim,697,3,696,8822,4838,295,7.9,0,0.7,270306,2198,268900,691.14,42.14,12.602857142857143,0.81,99.48
2020-11-21,Sikkim,772,10,763,10062,501,178,7.67,0,0.7,271078,2208,269663,71.57,25.43,14.374285714285714,0.81,99.48
2020-11-22,Sikkim,1106,8,1099,13876,1179,303,7.97,0,0.7,272184,2216,270762,168.43,43.29,19.822857142857142,0.81,99.48
2020-11-23,Sikkim,1290,18,1288,16527,3547,2067,7.81,0,0.7,273474,2234,272050,506.71,295.29,23.61,0.82,99.48
2020-11-24,Sikkim,733,4,724,9332,1973,419,7.85,5,0.7,274207,2238,272774,281.86,59.86,13.331428571428571,0.82,99.48
2020-11-25,Sikkim,380,5,376,4818,2413,763,7.89,0,0.7,274587,2243,273150,344.71,109.0,6.882857142857143,0.82,99.48
2020-11-26,Sikkim,1106,15,1097,14159,4881,324,7.81,0,0.7,275693,2258,274247,697.29,46.29,20.22714285714286,0.82,99.48
2020-11-27,Sikkim,331,4,324,4153,3249,1946,7.97,3,0.7,276024,2262,274571,464.14,278.0,5.932857142857143,0.82,99.47
2020-11-28,Sikkim,1065,14,1061,13032,1991,1871,8.17,0,0.7,277089,2276,275632,284.43,267.29,18.617142857142856,0.82,99.47
2020-11-29,Sikkim,604,8,596,7434,1972,923,8.12,0,0.7,277693,2284,276228,281.71,131.86,10.62,0.82,99.47
2020-11-30,Sikkim,1310,7,1301,16109,3919,193,8.13,2,0.7,279003,2291,277529,559.86,27.57,23.012857142857143,0.82,99.47
2020-12-01,Sikkim,152,1,145,1703,218,201,8.93,6,0.7,279155,2292,277674,31.14,28.71,2.432857142857143,0.82,99.47
2020-12-02,Sikkim,1080,6,1078,13473,2085,327,8.02,0,0.7,280235,2298,278752,297.86,46.71,19.247142857142858,0.82,99.47
2020-12-03,Sikkim,1214,6,1208,15046,3111,491,8.07,0,0.7,281449,2304,279960,444.43,70.14,21.494285714285713,0.82,99.47
2020-12-04,Sikkim,1254,11,1254,15607,3323,213,8.03,0,0.7,282703,2315,281214,474.71,30.43,22.295714285714286,0.82,99.47
2020-12-05,Sikkim,1002,5,994,12333,4296,1991,8.12,3,0.7,283705,2320,282208,613.71,284.43,17.61857142857143,0.82,99.47
2020-12-06,Sikkim,606,2,602,6933,1257,310,8.74,2,0.7,284311,2322,282810,179.57,44.29,9.904285714285715,0.82,99.47
2020-12-07,Sikkim,1287,17,1278,15827,1607,730,8.13,0,0.7,285598,2339,284088,229.57,104.29,22.61,0.82,99.47
2020-12-08,Sikkim,475,3,469,6102,4715,1711,7.78,3,0.7,286073,2342,284557,673.57,244.43,8.717142857142857,0.82,99.47
2020-12-09,Sikkim,1227,17,1220,14963,3465,999,8.2,0,0.7,287300,2359,285777,495.0,142.71,21.375714285714285,0.82,99.47
2020-12-10,Sikkim,270,2,264,3534,4462,2646,7.64,4,0.7,287570,2361,286041,637.43,378.0,5.048571428571429,0.82,99.47
2020-12-11,Sikkim,55,0,54,1077,3561,1033,5.11,1,0.7,287625,2361,286095,508.71,147.57,1.5385714285714285,0.82,99.47
2020-12-12,Sikkim,96,1,94,1409,2802,340,6.81,1,0.7,287721,2362,286189,400.29,48.57,2.012857142857143,0.82,99.47
2020-12-13,Sikkim,58,0,56,793,4309,1569,7.31,2,0.7,287779,2362,286245,615.57,224.14,1.1328571428571428,0.82,99.47
2020-12-14,Sikkim,119,1,119,1458,2823,690,8.16,0,0.7,287898,2363,286364,403.29,98.57,2.0828571428571427,0.82,99.47
2020-12-15,Sikkim,688,9,687,8545,283,18,8.05,0,0.7,288586,2372,287051,40.43,2.57,12.207142857142857,0.82,99.47
2020-12-16,Sikkim,963,5,959,11941,1947,1348,8.06,0,0.7,289549,2377,288010,278.14,192.57,17.05857142857143,0.82,99.47
2020-12-17,Sikkim,194,2,192,2393,4700,1632,8.11,0,0.7,289743,2379,288202,671.43,233.14,3.4185714285714286,0.82,99.47
2020-12-18,Sikkim,587,6,578,7460,3516,2106,7.87,3,0.7,290330,2385,288780,502.29,300.86,10.657142857142857,0.82,99.47
2020-12-19,Sikkim,1466,9,1462,18264,4947,3984,8.03,0,0.7,291796,2394,290242,706.71,569.14,26.091428571428573,0.82,99.47
2020-12-20,Sikkim,633,5,627,7551,894,516,8.38,1,0.7,292429,2399,290869,127.71,73.71,10.787142857142857,0.82,99.47
2020-12-21,Sikkim,24,0,23,643,923,679,3.73,1,0.7,292453,2399,290892,131.86,97.0,0.9185714285714286,0.82,99.47
2020-12-22,Sikkim,316,1,316,4142,2101,977,7.63,0,0.7,292769,2400,291208,300.14,139.57,5.917142857142857,0.82,99.47
2020-12-23,Sikkim,1320,4,1311,16286,144,74,8.11,5,0.7,294089,2404,292519,20.57,10.57,23.265714285714285,0.82,99.47
2020-12-24,Sikkim,1147,8,1138,14248,2203,1713,8.05,1,0.7,295236,2412,293657,314.71,244.71,20.354285714285716,0.82,99.47
2020-12-25,Sikkim,1072,16,1065,13735,3431,1878,7.8,0,0.7,296308,2428,294722,490.14,268.29,19.62142857142857,0.82,99.46
2020-12-26,Sikkim,568,7,561,7155,3163,385,7.94,0,0.7,296876,2435,295283,451.86,55.0,10.221428571428572,0.82,99.46
2020-12-27,Sikkim,469,3,460,6098,851,505,7.69,6,0.7,297345,2438,295743,121.57,72.14,8.711428571428572,0.82,99.46
2020-12-28,Sikkim,1182,12,1173,14849,3574,1040,7.96,0,0.7,298527,2450,296916,510.57,148.57,21.212857142857143,0.82,99.46
2020-12-29,Sikkim,925,2,919,11679,1564,108,7.92,4,0.7,299452,2452,297835,223.43,15.43,16.684285714285714,0.82,99.46
2020-12-30,Sikkim,698,2,691,8955,4930,3227,7.79,5,0.7,300150,2454,298526,704.29,461.0,12.792857142857143,0.82,99.46
2020-12-31,Sikkim,455,3,448,5876,453,409,7.74,4,0.7,300605,2457,298974,64.71,58.43,8.394285714285715,0.82,99.46
2021-01-01,Sikkim,1537,13,1537,19071,2538,1803,8.06,0,0.7,302142,2470,300511,362.57,257.57,27.244285714285713,0.82,99.46
2021-01-02,Sikkim,245,0,236,3084,2374,2045,7.94,9,0.7,302387,2470,300747,339.14,292.14,4.405714285714286,0.82,99.46
2021-01-03,Sikkim,1357,11,1350,17197,93,86,7.89,0,0.7,303744,2481,302097,13.29,12.29,24.56714285714286,0.82,99.46
2021-01-04,Sikkim,115,0,107,1566,3210,2853,7.34,8,0.7,303859,2481,302204,458.57,407.57,2.237142857142857,0.82,99.46
2021-01-05,Sikkim,1197,7,1196,14756,2448,2397,8.11,0,0.7,305056,2488,303400,349.71,342.43,21.08,0.82,99.46
2021-01-06,Sikkim,776,2,771,9895,2438,1071,7.84,3,0.7,305832,2490,304171,348.29,153.0,14.135714285714286,0.81,99.46
2021-01-07,Sikkim,113,1,110,1524,1787,796,7.41,2,0.7,305945,2491,304281,255.29,113.71,2.177142857142857,0.81,99.46
2021-01-08,Sikkim,668,4,659,8378,181,109,7.97,5,0.7,306613,2495,304940,25.86,15.57,11.968571428571428,0.81,99.45
2021-01-09,Sikkim,455,3,452,5723,1732,1018,7.95,0,0.7,307068,2498,305392,247.43,145.43,8.175714285714285,0.81,99.45
2021-01-10,Sikkim,233,3,231,3182,4492,3286,7.32,0,0.7,307301,2501,305623,641.71,469.43,4.545714285714285,0.81,99.45
2021-01-11,Sikkim,738,5,730,8896,452,2,8.3,3,0.7,308039,2506,306353,64.57,0.29,12.708571428571428,0.81,99.45
2021-01-12,Sikkim,1193,10,1191,15163,2161,510,7.87,0,0.7,309232,2516,307544,308.71,72.86,21.661428571428573,0.81,99.45
2021-01-13,Sikkim,521,5,512,6914,2563,352,7.54,4,0.7,309753,2521,308056,366.14,50.29,9.877142857142857,0.81,99.45
2021-01-14,Sikkim,505,7,499,6191,4688,2610,8.16,0,0.7,310258,2528,308555,669.71,372.86,8.844285714285714,0.81,99.45
2021-01-15,Sikkim,625,4,624,8309,2321,408,7.52,0,0.7,310883,2532,309179,331.57,58.29,11.87,0.81,99.45
2021-01-16,Sikkim,1385,19,1376,17092,1280,569,8.1,0,0.7,312268,2551,310555,182.86,81.29,24.417142857142856,0.82,99.45
2021-01-17,Sikkim,966,7,966,11784,2742,1443,8.2,0,0.7,313234,2558,311521,391.71,206.14,16.834285714285713,0.82,99.45
2021-01-18,Sikkim,1213,8,1208,15209,3686,639,7.98,0,0.7,314447,2566,312729,526.57,91.29,21.72714285714286,0.82,99.45
2021-01-19,Sikkim,1449,7,1447,18005,2272,1454,8.05,0,0.7,315896,2573,314176,324.57,207.71,25.72142857142857,0.81,99.46
2021-01-20,Sikkim,1464,13,1459,17954,632,464,8.15,0,0.7,317360,2586,315635,90.29,66.29,25.64857142857143,0.81,99.46
2021-01-21,Sikkim,888,10,883,10949,2319,2244,8.11,0,0.7,318248,2596,316518,331.29,320.57,15.641428571428571,0.82,99.46
2021-01-22,Sikkim,1308,5,1302,16243,2591,1427,8.05,1,0.7,319556,2601,317820,370.14,203.86,23.204285714285714,0.81,99.46
2021-01-23,Sikkim,540,7,538,6918,3690,1670,7.81,0,0.7,320096,2608,318358,527.14,238.57,9.882857142857143,0.81,99.46
2021-01-24,Sikkim,1466,9,1461,18140,3844,3489,8.08,0,0.7,321562,2617,319819,549.14,498.43,25.914285714285715,0.81,99.46
2021-01-25,Sikkim,431,2,423,5368,2409,371,8.03,6,0.7,321993,2619,320242,344.14,53.0,7.668571428571428,0.81,99.46
2021-01-26,Sikkim,222,2,222,3024,20,17,7.34,0,0.7,322215,2621,320464,2.86,2.43,4.32,0.81,99.46
2021-01-27,Sikkim,1241,3,1239,15236,658,542,8.15,0,0.7,323456,2624,321703,94.0,77.43,21.765714285714285,0.81,99.46
2021-01-28,Sikkim,115,0,113,1266,3970,1448,9.08,2,0.7,323571,2624,321816,567.14,206.86,1.8085714285714285,0.81,99.46
2021-01-29,Sikkim,1493,22,1490,18924,881,307,7.89,0,0.7,325064,2646,323306,125.86,43.86,27.034285714285716,0.81,99.46
2021-01-30,Sikkim,878,9,869,11272,4652,3028,7.79,0,0.7,325942,2655,324175,664.57,432.57,16.102857142857143,0.81,99.46
2021-01-31,Sikkim,862,3,858,10322,222,213,8.35,1,0.7,326804,2658,325033,31.71,30.43,14.745714285714286,0.81,99.46
2021-02-01,Sikkim,683,6,680,8747,2372,1289,7.81,0,0.7,327487,2664,325713,338.86,184.14,12.495714285714286,0.81,99.46
2021-02-02,Sikkim,931,13,928,11338,733,383,8.21,0,0.7,328418,2677,326641,104.71,54.71,16.197142857142858,0.82,99.46
2021-02-03,Sikkim,1475,15,1466,18533,837,71,7.96,0,0.7,329893,2692,328107,119.57,10.14,26.475714285714286,0.82,99.46
2021-02-04,Sikkim,129,0,125,1717,3123,1158,7.51,4,0.7,330022,2692,328232,446.14,165.43,2.452857142857143,0.82,99.46
2021-02-05,Sikkim,315,2,309,3929,952,337,8.02,4,0.7,330337,2694,328541,136.0,48.14,5.612857142857143,0.82,99.46
2021-02-06,Sikkim,716,6,710,8829,3326,603,8.11,0,0.7,331053,2700,329251,475.14,86.14,12.612857142857143,0.82,99.46
2021-02-07,Sikkim,649,5,648,8099,89,69,8.01,0,0.7,331702,2705,329899,12.71,9.86,11.57,0.82,99.46
2021-02-08,Sikkim,1296,8,1291,16228,2258,1576,7.99,0,0.7,332998,2713,331190,322.57,225.14,23.18285714285714,0.81,99.46
2021-02-09,Sikkim,1115,3,1109,13928,4359,2799,8.01,3,0.7,334113,2716,332299,622.71,399.86,19.897142857142857,0.81,99.46
2021-02-10,Sikkim,1249,4,1249,15403,4691,64,8.11,0,0.7,335362,2720,333548,670.14,9.14,22.004285714285714,0.81,99.46
2021-02-11,Sikkim,1378,5,1378,16907,3159,2186,8.15,0,0.7,336740,2725,334926,451.29,312.29,24.152857142857144,0.81,99.46
2021-02-12,Sikkim,1049,6,1040,13001,2884,2146,8.07,3,0.7,337789,2731,335966,412.0,306.57,18.572857142857142,0.81,99.46
2021-02-13,Sikkim,785,10,776,9878,2084,429,7.95,0,0.7,338574,2741,336742,297.71,61.29,14.111428571428572,0.81,99.46
2021-02-14,Sikkim,181,2,173,2376,162,75,7.62,6,0.7,338755,2743,336915,23.14,10.71,3.394285714285714,0.81,99.46
2021-02-15,Sikkim,877,12,870,11061,3960,3201,7.93,0,0.7,339632,2755,337785,565.71,457.29,15.801428571428572,0.81,99.46
2021-02-16,Sikkim,1262,6,1256,15711,2639,2328,8.03,0,0.7,340894,2761,339041,377.0,332.57,22.444285714285716,0.81,99.46
2021-02-17,Sikkim,579,6,572,7004,2050,546,8.27,1,0.7,341473,2767,339613,292.86,78.0,10.005714285714285,0.81,99.46
2021-02-18,Sikkim,502,4,500,6584,2380,2095,7.62,0,0.7,341975,2771,340113,340.0,299.29,9.405714285714286,0.81,99.46
2021-02-19,Sikkim,623,6,620,7920,336,25,7.87,0,0.7,342598,2777,340733,48.0,3.57,11.314285714285715,0.81,99.46
2021-02-20,Sikkim,1495,22,1494,18792,2634,590,7.96,0,0.7,344093,2799,342227,376.29,84.29,26.845714285714287,0.81,99.46
2021-02-21,Sikkim,1459,17,1458,18259,129,114,7.99,0,0.7,345552,2816,343685,18.43,16.29,26.084285714285713,0.81,99.46
2021-02-22,Sikkim,515,3,513,6409,4730,789,8.04,0,0.7,346067,2819,344198,675.71,112.71,9.155714285714286,0.81,99.46
2021-02-23,Sikkim,639,3,631,8403,2919,1311,7.6,5,0.7,346706,2822,344829,417.0,187.29,12.004285714285714,0.81,99.46
2021-02-24,Sikkim,1190,4,1182,14514,4767,1106,8.2,4,0.7,347896,2826,346011,681.0,158.0,20.734285714285715,0.81,99.46
2021-02-25,Sikkim,105,1,98,1517,3859,2785,6.92,6,0.7,348001,2827,346109,551.29,397.86,2.1671428571428573,0.81,99.46
2021-02-26,Sikkim,1168,14,1164,14458,4710,3819,8.08,0,0.7,349169,2841,347273,672.86,545.57,20.654285714285713,0.81,99.46
2021-02-27,Sikkim,422,1,414,5094,420,378,8.28,7,0.7,349591,2842,347687,60.0,54.0,7.277142857142858,0.81,99.46
2021-02-28,Sikkim,929,7,926,11998,3170,2752,7.74,0,0.7,350520,2849,348613,452.86,393.14,17.14,0.81,99.46
2021-03-01,Sikkim,1123,14,1115,14388,3264,971,7.81,0,0.7,351643,2863,349728,466.29,138.71,20.554285714285715,0.81,99.46
2021-03-02,Sikkim,251,1,244,3178,3586,1374,7.9,6,0.7,351894,2864,349972,512.29,196.29,4.54,0.81,99.45
2021-03-03,Sikkim,1362,9,1360,16998,2957,1614,8.01,0,0.7,353256,2873,351332,422.43,230.57,24.282857142857143,0.81,99.46
2021-03-04,Sikkim,1459,5,1453,18111,1077,727,8.06,1,0.7,354715,2878,352785,153.86,103.86,25.872857142857143,0.81,99.46
2021-03-05,Sikkim,379,1,373,4852,1143,586,7.81,5,0.7,355094,2879,353158,163.29,83.71,6.9314285714285715,0.81,99.45
2021-03-06,Sikkim,554,3,545,7133,2586,862,7.77,6,0.7,355648,2882,353703,369.43,123.14,10.19,0.81,99.45
2021-03-07,Sikkim,991,8,989,12113,1478,889,8.18,0,0.7,356639,2890,354692,211.14,127.0,17.304285714285715,0.81,99.45
2021-03-08,Sikkim,1408,11,1404,17738,1658,1213,7.94,0,0.7,358047,2901,356096,236.86,173.29,25.34,0.81,99.46
2021-03-09,Sikkim,1433,7,1432,18235,1633,1049,7.86,0,0.7,359480,2908,357528,233.29,149.86,26.05,0.81,99.46
2021-03-10,Sikkim,371,2,362,4782,4859,3588,7.76,7,0.7,359851,2910,357890,694.14,512.57,6.831428571428572,0.81,99.46
2021-03-11,Sikkim,54,0,45,593,2587,2011,9.11,9,0.7,359905,2910,357935,369.57,287.29,0.8471428571428572,0.81,99.45
2021-03-12,Sikkim,875,9,872,10536,3469,3033,8.3,0,0.7,360780,2919,358807,495.57,433.29,15.051428571428572,0.81,99.45
2021-03-13,Sikkim,1308,13,1306,16195,1294,342,8.08,0,0.7,362088,2932,360113,184.86,48.86,23.135714285714286,0.81,99.45
2021-03-14,Sikkim,761,8,757,9676,1637,444,7.86,0,0.7,362849,2940,360870,233.86,63.43,13.822857142857142,0.81,99.45
2021-03-15,Sikkim,265,3,262,3215,2916,1247,8.24,0,0.7,363114,2943,361132,416.57,178.14,4.5928571428571425,0.81,99.45
2021-03-16,Sikkim,247,2,247,2739,2617,940,9.02,0,0.7,363361,2945,361379,373.86,134.29,3.912857142857143,0.81,99.45
2021-03-17,Sikkim,427,6,418,5575,638,414,7.66,3,0.7,363788,2951,361797,91.14,59.14,7.964285714285714,0.81,99.45
2021-03-18,Sikkim,1474,17,1472,18362,584,200,8.03,0,0.7,365262,2968,363269,83.43,28.57,26.231428571428573,0.81,99.45
2021-03-19,Sikkim,622,9,615,7850,2036,2002,7.92,0,0.7,365884,2977,363884,290.86,286.0,11.214285714285714,0.81,99.45
2021-03-20,Sikkim,1020,7,1020,12970,1819,1187,7.86,0,0.7,366904,2984,364904,259.86,169.57,18.52857142857143,0.81,99.45
2021-03-21,Sikkim,1326,12,1320,16853,3226,34,7.87,0,0.7,368230,2996,366224,460.86,4.86,24.075714285714287,0.81,99.46
2021-03-22,Sikkim,490,2,483,6382,2911,1272,7.68,5,0.7,368720,2998,366707,415.86,181.71,9.117142857142857,0.81,99.45
2021-03-23,Sikkim,1147,4,1145,14506,3642,3388,7.91,0,0.7,369867,3002,367852,520.29,484.0,20.722857142857144,0.81,99.46
2021-03-24,Sikkim,209,0,208,2676,4216,1028,7.81,1,0.7,370076,3002,368060,602.29,146.86,3.822857142857143,0.81,99.46
2021-03-25,Sikkim,293,1,285,4225,2972,256,6.93,7,0.7,370369,3003,368345,424.57,36.57,6.035714285714286,0.81,99.45
2021-03-26,Sikkim,161,2,153,2405,1604,789,6.69,6,0.7,370530,3005,368498,229.14,112.71,3.4357142857142855,0.81,99.45
2021-03-27,Sikkim,1054,12,1054,13670,3650,2488,7.71,0,0.7,371584,3017,369552,521.43,355.43,19.52857142857143,0.81,99.45
2021-03-28,Sikkim,1010,5,1009,12254,1587,702,8.24,0,0.7,372594,3022,370561,226.71,100.29,17.505714285714287,0.81,99.45
2021-03-29,Sikkim,241,3,239,2922,2825,892,8.25,0,0.7,372835,3025,370800,403.57,127.43,4.174285714285714,0.81,99.45
2021-03-30,Sikkim,309,1,301,3814,1905,1460,8.1,7,0.7,373144,3026,371101,272.14,208.57,5.448571428571428,0.81,99.45
2021-03-31,Sikkim,481,4,475,5873,4678,3522,8.19,2,0.7,373625,3030,371576,668.29,503.14,8.39,0.81,99.45
2021-04-01,Sikkim,620,7,619,7782,2696,160,7.97,0,0.7,374245,3037,372195,385.14,22.86,11.117142857142857,0.81,99.45
2021-04-02,Sikkim,165,0,158,2383,2830,700,6.92,7,0.7,374410,3037,372353,404.29,100.0,3.4042857142857144,0.81,99.45
2021-04-03,Sikkim,1047,12,1040,13168,4062,1185,7.95,0,0.7,375457,3049,373393,580.29,169.29,18.81142857142857,0.81,99.45
2021-04-04,Sikkim,1430,5,1430,18005,283,38,7.94,0,0.7,376887,3054,374823,40.43,5.43,25.72142857142857,0.81,99.45
2021-04-05,Sikkim,627,8,624,7473,3572,617,8.39,0,0.7,377514,3062,375447,510.29,88.14,10.675714285714285,0.81,99.45
2021-04-06,Sikkim,544,4,539,6871,4264,3681,7.92,1,0.7,378058,3066,375986,609.14,525.86,9.815714285714286,0.81,99.45
2021-04-07,Sikkim,1103,10,1096,14051,1783,1335,7.85,0,0.7,379161,3076,377082,254.71,190.71,20.072857142857142,0.81,99.45
2021-04-08,Sikkim,217,1,217,2617,3132,854,8.29,0,0.7,379378,3077,377299,447.43,122.0,3.7385714285714284,0.81,99.45
2021-04-09,Sikkim,937,12,931,11448,2767,1300,8.18,0,0.7,380315,3089,378230,395.29,185.71,16.354285714285716,0.81,99.45
2021-04-10,Sikkim,639,3,637,8283,3080,18,7.71,0,0.7,380954,3092,378867,440.0,2.57,11.832857142857144,0.81,99.45
2021-04-11,Sikkim,1387,7,1380,17252,3703,1073,8.04,0,0.7,382341,3099,380247,529.0,153.29,24.645714285714284,0.81,99.45
2021-04-12,Sikkim,206,1,197,2616,3751,3363,7.87,8,0.7,382547,3100,380444,535.86,480.43,3.737142857142857,0.81,99.45
2021-04-13,Sikkim,1367,15,1359,17206,960,869,7.94,0,0.7,383914,3115,381803,137.14,124.14,24.58,0.81,99.45
2021-04-14,Sikkim,307,4,303,3956,4278,1990,7.76,0,0.7,384221,3119,382106,611.14,284.29,5.651428571428571,0.81,99.45
2021-04-15,Sikkim,1543,19,1538,19330,1388,196,7.98,0,0.7,385764,3138,383644,198.29,28.0,27.614285714285714,0.81,99.45
2021-04-16,Sikkim,376,3,369,4450,4393,2787,8.45,4,0.7,386140,3141,384013,627.57,398.14,6.357142857142857,0.81,99.45
2021-04-17,Sikkim,1420,16,1412,17951,4984,4651,7.91,0,0.7,387560,3157,385425,712.0,664.43,25.644285714285715,0.81,99.45
2021-04-18,Sikkim,684,10,677,8589,4861,990,7.96,0,0.7,388244,3167,386102,694.43,141.43,12.27,0.82,99.45
2021-04-19,Sikkim,1509,20,1500,18957,3787,1643,7.96,0,0.7,389753,3187,387602,541.0,234.71,27.08142857142857,0.82,99.45
2021-04-20,Sikkim,173,0,166,2547,121,27,6.79,7,0.7,389926,3187,387768,17.29,3.86,3.638571428571429,0.82,99.45
2021-04-21,Sikkim,1387,7,1387,17600,3871,3104,7.88,0,0.7,391313,3194,389155,553.0,443.43,25.142857142857142,0.82,99.45
2021-04-22,Sikkim,774,2,774,9602,610,578,8.06,0,0.7,392087,3196,389929,87.14,82.57,13.717142857142857,0.82,99.45
2021-04-23,Sikkim,864,12,862,10276,2284,2036,8.41,0,0.7,392951,3208,390791,326.29,290.86,14.68,0.82,99.45
2021-04-24,Sikkim,228,1,220,2604,627,438,8.76,7,0.7,393179,3209,391011,89.57,62.57,3.72,0.82,99.45
2021-04-25,Sikkim,489,6,480,5784,4856,161,8.45,3,0.7,393668,3215,391491,693.71,23.0,8.262857142857143,0.82,99.45
2021-04-26,Sikkim,143,1,142,1770,213,68,8.08,0,0.7,393811,3216,391633,30.43,9.71,2.5285714285714285,0.82,99.45
2021-04-27,Sikkim,1119,5,1111,14178,1320,951,7.89,3,0.7,394930,3221,392744,188.57,135.86,20.254285714285714,0.82,99.45
2021-04-28,Sikkim,1045,8,1040,12988,2354,232,8.05,0,0.7,395975,3229,393784,336.29,33.14,18.554285714285715,0.82,99.45
2021-04-29,Sikkim,611,6,608,7400,3233,1291,8.26,0,0.7,396586,3235,394392,461.86,184.43,10.571428571428571,0.82,99.45
2021-04-30,Sikkim,212,1,208,2795,4782,2166,7.58,3,0.7,396798,3236,394600,683.14,309.43,3.992857142857143,0.82,99.45
2021-05-01,Sikkim,638,5,634,7978,3776,1947,8.0,0,0.7,397436,3241,395234,539.43,278.14,11.397142857142857,0.82,99.45
2021-05-02,Sikkim,1169,15,1166,14732,4303,577,7.94,0,0.7,398605,3256,396400,614.71,82.43,21.045714285714286,0.82,99.45
2021-05-03,Sikkim,157,1,150,1726,2774,342,9.1,6,0.7,398762,3257,396550,396.29,48.86,2.4657142857142857,0.82,99.45
2021-05-04,Sikkim,1306,14,1302,16838,2192,9,7.76,0,0.7,400068,3271,397852,313.14,1.29,24.054285714285715,0.82,99.45
2021-05-05,Sikkim,439,4,430,5652,1787,1331,7.77,5,0.7,400507,3275,398282,255.29,190.14,8.074285714285715,0.82,99.44
2021-05-06,Sikkim,324,2,324,4139,1687,155,7.83,0,0.7,400831,3277,398606,241.0,22.14,5.912857142857143,0.82,99.44
2021-05-07,Sikkim,1563,6,1556,19816,4292,1782,7.89,1,0.7,402394,3283,400162,613.14,254.57,28.30857142857143,0.82,99.45
2021-05-08,Sikkim,94,0,88,1191,3462,1249,7.89,6,0.7,402488,3283,400250,494.57,178.43,1.7014285714285715,0.82,99.44
2021-05-09,Sikkim,263,2,261,3005,1708,968,8.75,0,0.7,402751,3285,400511,244.0,138.29,4.292857142857143,0.82,99.44
2021-05-10,Sikkim,1177,12,1176,14463,4609,2013,8.14,0,0.7,403928,3297,401687,658.43,287.57,20.661428571428573,0.82,99.45
2021-05-11,Sikkim,635,7,634,7926,649,370,8.01,0,0.7,404563,3304,402321,92.71,52.86,11.322857142857142,0.82,99.45
2021-05-12,Sikkim,1110,10,1108,13980,3709,1003,7.94,0,0.7,405673,3314,403429,529.86,143.29,19.97142857142857,0.82,99.45
2021-05-13,Sikkim,1385,17,1376,17353,842,300,7.98,0,0.7,407058,3331,404805,120.29,42.86,24.79,0.82,99.45
2021-05-14,Sikkim,140,1,137,2100,3043,2123,6.67,2,0.7,407198,3332,404942,434.71,303.29,3.0,0.82,99.45
2021-05-15,Sikkim,1119,3,1111,14066,425,250,7.96,5,0.7,408317,3335,406053,60.71,35.71,20.094285714285714,0.82,99.45
2021-05-16,Sikkim,1067,15,1061,13626,4146,1595,7.83,0,0.7,409384,3350,407114,592.29,227.86,19.465714285714284,0.82,99.45
2021-05-17,Sikkim,531,7,530,6461,4517,2310,8.22,0,0.7,409915,3357,407644,645.29,330.0,9.23,0.82,99.45
2021-05-18,Sikkim,284,2,275,3230,2014,826,8.79,7,0.7,410199,3359,407919,287.71,118.0,4.614285714285714,0.82,99.44
2021-05-19,Sikkim,731,4,728,9229,3922,2798,7.92,0,0.7,410930,3363,408647,560.29,399.71,13.184285714285714,0.82,99.44
2021-05-20,Sikkim,1117,14,1108,14349,2592,1059,7.78,0,0.7,412047,3377,409755,370.29,151.29,20.498571428571427,0.82,99.44
2021-05-21,Sikkim,629,2,621,7318,4754,1987,8.6,6,0.7,412676,3379,410376,679.14,283.86,10.454285714285714,0.82,99.44
2021-05-22,Sikkim,180,1,171,2175,769,340,8.28,8,0.7,412856,3380,410547,109.86,48.57,3.107142857142857,0.82,99.44
2021-05-23,Sikkim,430,5,428,5923,3020,1379,7.26,0,0.7,413286,3385,410975,431.43,197.0,8.461428571428572,0.82,99.44
2021-05-24,Sikkim,64,0,59,502,2075,1031,12.75,5,0.7,413350,3385,411034,296.43,147.29,0.7171428571428572,0.82,99.44
2021-05-25,Sikkim,931,4,929,11262,2107,1525,8.27,0,0.7,414281,3389,411963,301.0,217.86,16.088571428571427,0.82,99.44
2021-05-26,Sikkim,1115,5,1113,13945,3122,533,8.0,0,0.7,415396,3394,413076,446.0,76.14,19.92142857142857,0.82,99.44
2021-05-27,Sikkim,638,8,633,8259,2749,1909,7.72,0,0.7,416034,3402,413709,392.71,272.71,11.798571428571428,0.82,99.44
2021-05-28,Sikkim,248,3,244,3005,1245,860,8.25,1,0.7,416282,3405,413953,177.86,122.86,4.292857142857143,0.82,99.44
2021-05-29,Sikkim,274,3,270,2980,3335,1128,9.19,1,0.7,416556,3408,414223,476.43,161.14,4.257142857142857,0.82,99.44
2021-05-30,Sikkim,283,1,276,3643,2244,2143,7.77,6,0.7,416839,3409,414499,320.57,306.14,5.204285714285715,0.82,99.44
2021-05-31,Sikkim,1056,3,1048,12810,2093,1236,8.24,5,0.7,417895,3412,415547,299.0,176.57,18.3,0.82,99.44
2021-06-01,Sikkim,1199,5,1199,15441,2147,2005,7.77,0,0.7,419094,3417,416746,306.71,286.43,22.05857142857143,0.82,99.44
2021-06-02,Sikkim,1111,15,1103,14025,515,35,7.92,0,0.7,420205,3432,417849,73.57,5.0,20.035714285714285,0.82,99.44
2021-06-03,Sikkim,569,7,565,7370,3199,273,7.72,0,0.7,420774,3439,418414,457.0,39.0,10.528571428571428,0.82,99.44
2021-06-04,Sikkim,233,0,230,3056,651,623,7.62,3,0.7,421007,3439,418644,93.0,89.0,4.365714285714286,0.82,99.44
2021-06-05,Sikkim,1171,8,1165,14377,1726,1643,8.14,0,0.7,422178,3447,419809,246.57,234.71,20.53857142857143,0.82,99.44
2021-06-06,Sikkim,336,4,331,3950,1916,1797,8.51,1,0.7,422514,3451,420140,273.71,256.71,5.642857142857143,0.82,99.44
2021-06-07,Sikkim,182,1,174,2263,3849,2518,8.04,7,0.7,422696,3452,420314,549.86,359.71,3.2328571428571427,0.82,99.44
2021-06-08,Sikkim,1323,12,1316,17121,2178,975,7.73,0,0.7,424019,3464,421630,311.14,139.29,24.458571428571428,0.82,99.44
2021-06-09,Sikkim,1518,14,1511,19435,1817,632,7.81,0,0.7,425537,3478,423141,259.57,90.29,27.764285714285716,0.82,99.44
2021-06-10,Sikkim,526,2,518,6745,4708,3786,7.8,6,0.7,426063,3480,423659,672.57,540.86,9.635714285714286,0.82,99.44
2021-06-11,Sikkim,1575,7,1574,19781,4949,2655,7.96,0,0.7,427638,3487,425233,707.0,379.29,28.25857142857143,0.82,99.44
2021-06-12,Sikkim,1544,14,1539,19405,4610,587,7.96,0,0.7,429182,3501,426772,658.57,83.86,27.72142857142857,0.82,99.44
2021-06-13,Sikkim,222,3,213,2660,969,877,8.35,6,0.7,429404,3504,426985,138.43,125.29,3.8,0.82,99.44
2021-06-14,Sikkim,91,0,86,960,1536,1107,9.48,5,0.7,429495,3504,427071,219.43,158.14,1.3714285714285714,0.82,99.44
2021-06-15,Sikkim,1423,17,1420,17280,985,157,8.23,0,0.7,430918,3521,428491,140.71,22.43,24.685714285714287,0.82,99.44
2021-06-16,Sikkim,1321,15,1318,16708,462,299,7.91,0,0.7,432239,3536,429809,66.0,42.71,23.86857142857143,0.82,99.44
2021-06-17,Sikkim,396,4,392,4755,176,96,8.33,0,0.7,432635,3540,430201,25.14,13.71,6.792857142857143,0.82,99.44
2021-06-18,Sikkim,214,2,213,2692,3484,2991,7.95,0,0.7,432849,3542,430414,497.71,427.29,3.8457142857142856,0.82,99.44
2021-06-19,Sikkim,734,9,727,9379,1061,481,7.83,0,0.7,433583,3551,431141,151.57,68.71,13.398571428571428,0.82,99.44
2021-06-20,Sikkim,724,4,718,9070,4619,1451,7.98,2,0.7,434307,3555,431859,659.86,207.29,12.957142857142857,0.82,99.44
2021-06-21,Sikkim,1109,11,1103,14028,3350,992,7.91,0,0.7,435416,3566,432962,478.57,141.71,20.04,0.82,99.44
2021-06-22,Sikkim,894,7,890,11095,2658,1258,8.06,0,0.7,436310,3573,433852,379.71,179.71,15.85,0.82,99.44
2021-06-23,Sikkim,148,1,148,2227,1986,190,6.65,0,0.7,436458,3574,434000,283.71,27.14,3.1814285714285715,0.82,99.44
2021-06-24,Sikkim,1357,7,1356,17218,2266,1333,7.88,0,0.7,437815,3581,435356,323.71,190.43,24.597142857142856,0.82,99.44
2021-06-25,Sikkim,524,4,524,6032,2600,344,8.69,0,0.7,438339,3585,435880,371.43,49.14,8.617142857142857,0.82,99.44
2021-06-26,Sikkim,1388,7,1382,17543,3727,1027,7.91,0,0.7,439727,3592,437262,532.43,146.71,25.06142857142857,0.82,99.44
2021-06-27,Sikkim,124,1,123,1355,4191,758,9.15,0,0.7,439851,3593,437385,598.71,108.29,1.9357142857142857,0.82,99.44
2021-06-28,Sikkim,1066,4,1064,13283,4085,1183,8.03,0,0.7,440917,3597,438449,583.57,169.0,18.975714285714286,0.82,99.44
2021-06-29,Sikkim,1404,16,1402,17725,2894,117,7.92,0,0.7,442321,3613,439851,413.43,16.71,25.321428571428573,0.82,99.44
2021-06-30,Sikkim,406,3,402,4620,758,574,8.79,1,0.7,442727,3616,440253,108.29,82.0,6.6,0.82,99.44
2021-07-01,Sikkim,234,1,234,2747,3654,2855,8.52,0,0.7,442961,3617,440487,522.0,407.86,3.9242857142857144,0.82,99.44
2021-07-02,Sikkim,350,2,347,4252,2723,759,8.23,1,0.7,443311,3619,440834,389.0,108.43,6.074285714285714,0.82,99.44
2021-07-03,Sikkim,1422,18,1417,18266,1352,745,7.78,0,0.7,444733,3637,442251,193.14,106.43,26.094285714285714,0.82,99.44
2021-07-04,Sikkim,1016,11,1016,13013,4419,3845,7.81,0,0.7,445749,3648,443267,631.29,549.29,18.59,0.82,99.44
2021-07-05,Sikkim,927,7,920,11671,4869,4388,7.94,0,0.7,446676,3655,444187,695.57,626.86,16.672857142857143,0.82,99.44
2021-07-06,Sikkim,474,5,470,5945,213,58,7.97,0,0.7,447150,3660,444657,30.43,8.29,8.492857142857142,0.82,99.44
2021-07-07,Sikkim,460,2,453,5720,4842,2413,8.04,5,0.7,447610,3662,445110,691.71,344.71,8.17142857142857,0.82,99.44
2021-07-08,Sikkim,1431,18,1424,17221,2333,1352,8.31,0,0.7,449041,3680,446534,333.29,193.14,24.60142857142857,0.82,99.44
2021-07-09,Sikkim,307,1,304,3973,4691,2756,7.73,2,0.7,449348,3681,446838,670.14,393.71,5.675714285714286,0.82,99.44
2021-07-10,Sikkim,579,7,575,7151,2766,414,8.1,0,0.7,449927,3688,447413,395.14,59.14,10.215714285714286,0.82,99.44
2021-07-11,Sikkim,1274,9,1267,15646,2560,1713,8.14,0,0.7,451201,3697,448680,365.71,244.71,22.35142857142857,0.82,99.44
2021-07-12,Sikkim,797,6,796,10036,1025,615,7.94,0,0.7,451998,3703,449476,146.43,87.86,14.337142857142856,0.82,99.44
2021-07-13,Sikkim,1592,14,1588,19974,3239,235,7.97,0,0.7,453590,3717,451064,462.71,33.57,28.534285714285716,0.82,99.44
2021-07-14,Sikkim,289,3,281,3882,1190,277,7.44,5,0.7,453879,3720,451345,170.0,39.57,5.545714285714285,0.82,99.44
2021-07-15,Sikkim,635,8,632,8066,572,67,7.87,0,0.7,454514,3728,451977,81.71,9.57,11.522857142857143,0.82,99.44
2021-07-16,Sikkim,117,1,116,1857,596,470,6.3,0,0.7,454631,3729,452093,85.14,67.14,2.652857142857143,0.82,99.44
2021-07-17,Sikkim,138,1,134,1983,4038,1034,6.96,3,0.7,454769,3730,452227,576.86,147.71,2.8328571428571427,0.82,99.44
2021-07-18,Sikkim,317,1,314,4166,1806,133,7.61,2,0.7,455086,3731,452541,258.0,19.0,5.951428571428571,0.82,99.44
2021-07-19,Sikkim,947,6,941,12096,4520,2354,7.83,0,0.7,456033,3737,453482,645.71,336.29,17.28,0.82,99.44
2021-07-20,Sikkim,555,3,548,6604,1992,1589,8.4,4,0.7,456588,3740,454030,284.57,227.0,9.434285714285714,0.82,99.44
2021-07-21,Sikkim,1443,10,1442,18049,4332,909,7.99,0,0.7,458031,3750,455472,618.86,129.86,25.784285714285716,0.82,99.44
2021-07-22,Sikkim,343,3,337,4553,2443,1830,7.53,3,0.7,458374,3753,455809,349.0,261.43,6.5042857142857144,0.82,99.44
2021-07-23,Sikkim,772,7,764,9872,3823,1701,7.82,1,0.7,459146,3760,456573,546.14,243.0,14.102857142857143,0.82,99.44
2021-07-24,Sikkim,1510,5,1506,19120,953,836,7.9,0,0.7,460656,3765,458079,136.14,119.43,27.314285714285713,0.82,99.44
2021-07-25,Sikkim,805,5,800,9987,4391,2758,8.06,0,0.7,461461,3770,458879,627.29,394.0,14.267142857142858,0.82,99.44
2021-07-26,Sikkim,932,4,924,11524,3953,3199,8.09,4,0.7,462393,3774,459803,564.71,457.0,16.462857142857143,0.82,99.44
2021-07-27,Sikkim,816,10,809,10028,1615,639,8.14,0,0.7,463209,3784,460612,230.71,91.29,14.325714285714286,0.82,99.44
2021-07-28,Sikkim,1113,11,1110,13544,4482,2047,8.22,0,0.7,464322,3795,461722,640.29,292.43,19.34857142857143,0.82,99.44
2021-07-29,Sikkim,1024,3,1018,13264,959,477,7.72,3,0.7,465346,3798,462740,137.0,68.14,18.94857142857143,0.82,99.44
2021-07-30,Sikkim,149,2,149,1833,3282,1936,8.13,0,0.7,465495,3800,462889,468.86,276.57,2.6185714285714288,0.82,99.44
2021-07-31,Sikkim,165,0,158,2453,2734,1851,6.73,7,0.7,465660,3800,463047,390.57,264.43,3.5042857142857144,0.82,99.44
2021-08-01,Sikkim,985,10,983,12500,759,97,7.88,0,0.7,466645,3810,464030,108.43,13.86,17.857142857142858,0.82,99.44
2021-08-02,Sikkim,466,3,461,5903,2862,2612,7.89,2,0.7,467111,3813,464491,408.86,373.14,8.432857142857143,0.82,99.44
2021-08-03,Sikkim,1272,17,1268,16333,25,5,7.79,0,0.7,468383,3830,465759,3.57,0.71,23.332857142857144,0.82,99.44
2021-08-04,Sikkim,1221,8,1212,15451,1261,470,7.9,1,0.7,469604,3838,466971,180.14,67.14,22.072857142857142,0.82,99.44
2021-08-05,Sikkim,498,5,496,6284,3268,2054,7.92,0,0.7,470102,3843,467467,466.86,293.43,8.977142857142857,0.82,99.44
2021-08-06,Sikkim,575,7,566,7307,543,121,7.87,2,0.7,470677,3850,468033,77.57,17.29,10.438571428571429,0.82,99.44
2021-08-07,Sikkim,569,3,569,7135,3680,493,7.97,0,0.7,471246,3853,468602,525.71,70.43,10.192857142857143,0.82,99.44
2021-08-08,Sikkim,455,1,453,5911,1796,1791,7.7,1,0.7,471701,3854,469055,256.57,255.86,8.444285714285714,0.82,99.44
2021-08-09,Sikkim,142,1,135,1585,3091,169,8.96,6,0.7,471843,3855,469190,441.57,24.14,2.2642857142857142,0.82,99.44
2021-08-10,Sikkim,1107,16,1098,14315,4748,210,7.73,0,0.7,472950,3871,470288,678.29,30.0,20.45,0.82,99.44
2021-08-11,Sikkim,1305,8,1301,15934,791,383,8.19,0,0.7,474255,3879,471589,113.0,54.71,22.762857142857143,0.82,99.44
2021-08-12,Sikkim,1123,14,1122,14263,2382,1190,7.87,0,0.7,475378,3893,472711,340.29,170.0,20.375714285714285,0.82,99.44
2021-08-13,Sikkim,315,2,313,3749,1459,42,8.4,0,0.7,475693,3895,473024,208.43,6.0,5.355714285714286,0.82,99.44
2021-08-14,Sikkim,186,2,177,2448,2166,1307,7.6,7,0.7,475879,3897,473201,309.43,186.71,3.4971428571428573,0.82,99.44
2021-08-15,Sikkim,985,8,983,12344,757,561,7.98,0,0.7,476864,3905,474184,108.14,80.14,17.634285714285713,0.82,99.44
2021-08-16,Sikkim,1552,17,1549,19779,3036,822,7.85,0,0.7,478416,3922,475733,433.71,117.43,28.255714285714287,0.82,99.44
2021-08-17,Sikkim,1263,10,1260,16066,1296,876,7.86,0,0.7,479679,3932,476993,185.14,125.14,22.951428571428572,0.82,99.44
2021-08-18,Sikkim,1127,11,1119,14509,3797,3237,7.77,0,0.7,480806,3943,478112,542.43,462.43,20.72714285714286,0.82,99.44
2021-08-19,Sikkim,168,1,162,1820,2920,150,9.23,5,0.7,480974,3944,478274,417.14,21.43,2.6,0.82,99.44
2021-08-20,Sikkim,168,1,159,1846,1458,245,9.1,8,0.7,481142,3945,478433,208.29,35.0,2.637142857142857,0.82,99.44
2021-08-21,Sikkim,644,9,644,8168,246,90,7.88,0,0.7,481786,3954,479077,35.14,12.86,11.668571428571429,0.82,99.44
2021-08-22,Sikkim,1165,12,1161,14452,4215,3632,8.06,0,0.7,482951,3966,480238,602.14,518.86,20.645714285714284,0.82,99.44
2021-08-23,Sikkim,745,6,742,9100,1221,803,8.19,0,0.7,483696,3972,480980,174.43,114.71,13.0,0.82,99.44
2021-08-24,Sikkim,1178,5,1173,14545,2954,1629,8.1,0,0.7,484874,3977,482153,422.0,232.71,20.77857142857143,0.82,99.44
2021-08-25,Sikkim,191,2,185,2627,1507,748,7.27,4,0.7,485065,3979,482338,215.29,106.86,3.7528571428571427,0.82,99.44
2021-08-26,Sikkim,764,8,760,9757,3986,1889,7.83,0,0.7,485829,3987,483098,569.43,269.86,13.938571428571429,0.82,99.44
2021-08-27,Sikkim,1383,12,1375,17410,3958,2329,7.94,0,0.7,487212,3999,484473,565.43,332.71,24.87142857142857,0.82,99.44
2021-08-28,Sikkim,964,9,959,12377,3985,2615,7.79,0,0.7,488176,4008,485432,569.29,373.57,17.681428571428572,0.82,99.44
2021-08-29,Sikkim,772,9,764,10355,3588,701,7.46,0,0.7,488948,4017,486196,512.57,100.14,14.792857142857143,0.82,99.44
2021-08-30,Sikkim,794,7,791,9685,736,524,8.2,0,0.7,489742,4024,486987,105.14,74.86,13.835714285714285,0.82,99.44
2021-08-31,Sikkim,196,2,191,2517,4759,3768,7.79,3,0.7,489938,4026,487178,679.86,538.29,3.5957142857142856,0.82,99.44
2021-09-01,Sikkim,981,12,972,12633,427,229,7.77,0,0.7,490919,4038,488150,61.0,32.71,18.047142857142855,0.82,99.44
2021-09-02,Sikkim,560,6,551,7068,2532,1346,7.92,3,0.7,491479,4044,488701,361.71,192.29,10.097142857142858,0.82,99.43
2021-09-03,Sikkim,204,2,199,2373,4176,319,8.6,3,0.7,491683,4046,488900,596.57,45.57,3.39,0.82,99.43
2021-09-04,Sikkim,1190,6,1189,15349,3134,2563,7.75,0,0.7,492873,4052,490089,447.71,366.14,21.927142857142858,0.82,99.44
2021-09-05,Sikkim,352,3,343,4492,1469,1039,7.84,6,0.7,493225,4055,490432,209.86,148.43,6.417142857142857,0.82,99.43
2021-09-06,Sikkim,1503,19,1500,19186,3062,59,7.83,0,0.7,494728,4074,491932,437.43,8.43,27.408571428571427,0.82,99.43
2021-09-07,Sikkim,1053,9,1053,13512,3592,1171,7.79,0,0.7,495781,4083,492985,513.14,167.29,19.302857142857142,0.82,99.44
2021-09-08,Sikkim,730,2,726,9223,3407,442,7.91,2,0.7,496511,4085,493711,486.71,63.14,13.175714285714285,0.82,99.44
2021-09-09,Sikkim,1263,4,1258,15891,3346,1631,7.95,1,0.7,497774,4089,494969,478.0,233.0,22.701428571428572,0.82,99.44
2021-09-10,Sikkim,1545,19,1542,19065,4453,4384,8.1,0,0.7,499319,4108,496511,636.14,626.29,27.235714285714284,0.82,99.44
2021-09-11,Sikkim,748,7,745,9591,560,107,7.8,0,0.7,500067,4115,497256,80.0,15.29,13.701428571428572,0.82,99.44
2021-09-12,Sikkim,1418,19,1411,17703,2095,714,8.01,0,0.7,501485,4134,498667,299.29,102.0,25.29,0.82,99.44
2021-09-13,Sikkim,1591,22,1591,19689,1061,372,8.08,0,0.7,503076,4156,500258,151.57,53.14,28.127142857142857,0.83,99.44
2021-09-14,Sikkim,151,0,151,1574,3086,2233,9.59,0,0.7,503227,4156,500409,440.86,319.0,2.2485714285714287,0.83,99.44
2021-09-15,Sikkim,1333,19,1329,16431,49,34,8.11,0,0.7,504560,4175,501738,7.0,4.86,23.472857142857144,0.83,99.44
2021-09-16,Sikkim,56,0,55,865,585,172,6.47,1,0.7,504616,4175,501793,83.57,24.57,1.2357142857142858,0.83,99.44
2021-09-17,Sikkim,1366,7,1363,17336,2142,1884,7.88,0,0.7,505982,4182,503156,306.0,269.14,24.765714285714285,0.83,99.44
2021-09-18,Sikkim,1502,17,1496,18438,1741,1519,8.15,0,0.7,507484,4199,504652,248.71,217.0,26.34,0.83,99.44
2021-09-19,Sikkim,241,1,238,3103,1085,321,7.77,2,0.7,507725,4200,504890,155.0,45.86,4.432857142857143,0.83,99.44
2021-09-20,Sikkim,1430,13,1422,17439,3099,1774,8.2,0,0.7,509155,4213,506312,442.71,253.43,24.912857142857142,0.83,99.44
2021-09-21,Sikkim,890,5,884,11318,567,41,7.86,1,0.7,510045,4218,507196,81.0,5.86,16.16857142857143,0.83,99.44
2021-09-22,Sikkim,79,1,74,894,932,522,8.84,4,0.7,510124,4219,507270,133.14,74.57,1.2771428571428571,0.83,99.44
2021-09-23,Sikkim,1391,10,1385,17392,1345,465,8.0,0,0.7,511515,4229,508655,192.14,66.43,24.845714285714287,0.83,99.44
2021-09-24,Sikkim,78,0,75,832,2389,363,9.38,3,0.7,511593,4229,508730,341.29,51.86,1.1885714285714286,0.83,99.44
2021-09-25,Sikkim,429,3,421,4852,4790,3623,8.84,5,0.7,512022,4232,509151,684.29,517.57,6.9314285714285715,0.83,99.44
2021-09-26,Sikkim,545,2,544,6808,2962,862,8.01,0,0.7,512567,4234,509695,423.14,123.14,9.725714285714286,0.83,99.44
2021-09-27,Sikkim,1065,12,1064,13319,413,66,8.0,0,0.7,513632,4246,510759,59.0,9.43,19.027142857142856,0.83,99.44
2021-09-28,Sikkim,359,1,358,4408,3740,2919,8.14,0,0.7,513991,4247,511117,534.29,417.0,6.297142857142857,0.83,99.44
2021-09-29,Sikkim,199,1,197,2736,1659,1300,7.27,1,0.7,514190,4248,511314,237.0,185.71,3.9085714285714284,0.83,99.44
2021-09-30,Sikkim,766,10,765,9514,4633,2109,8.05,0,0.7,514956,4258,512079,661.86,301.29,13.59142857142857,0.83,99.44
2021-10-01,Sikkim,789,7,784,9893,1325,1293,7.98,0,0.7,515745,4265,512863,189.29,184.71,14.132857142857143,0.83,99.44
2021-10-02,Sikkim,1592,12,1583,19369,910,176,8.22,0,0.7,517337,4277,514446,130.0,25.14,27.67,0.83,99.44
2021-10-03,Sikkim,897,7,889,11292,202,194,7.94,1,0.7,518234,4284,515335,28.86,27.71,16.13142857142857,0.83,99.44
2021-10-04,Sikkim,1206,12,1206,14966,1775,1375,8.06,0,0.7,519440,4296,516541,253.57,196.43,21.38,0.83,99.44
2021-10-05,Sikkim,457,3,452,5256,4606,943,8.69,2,0.7,519897,4299,516993,658.0,134.71,7.508571428571429,0.83,99.44
2021-10-06,Sikkim,805,3,797,10158,587,110,7.92,5,0.7,520702,4302,517790,83.86,15.71,14.51142857142857,0.83,99.44
2021-10-07,Sikkim,1498,7,1490,18606,4610,3914,8.05,1,0.7,522200,4309,519280,658.57,559.14,26.58,0.83,99.44
2021-10-08,Sikkim,1055,14,1048,12645,2777,300,8.34,0,0.7,523255,4323,520328,396.71,42.86,18.064285714285713,0.83,99.44
2021-10-09,Sikkim,367,2,365,4503,1593,907,8.15,0,0.7,523622,4325,520693,227.57,129.57,6.432857142857143,0.83,99.44
2021-10-10,Sikkim,1306,8,1302,16092,618,376,8.12,0,0.7,524928,4333,521995,88.29,53.71,22.98857142857143,0.83,99.44
2021-10-11,Sikkim,1204,14,1198,15126,3484,162,7.96,0,0.7,526132,4347,523193,497.71,23.14,21.60857142857143,0.83,99.44
2021-10-12,Sikkim,821,11,815,10477,4062,3231,7.84,0,0.7,526953,4358,524008,580.29,461.57,14.967142857142857,0.83,99.44
2021-10-13,Sikkim,140,1,133,1707,1311,440,8.2,6,0.7,527093,4359,524141,187.29,62.86,2.4385714285714286,0.83,99.44
2021-10-14,Sikkim,976,13,974,12072,1293,88,8.08,0,0.7,528069,4372,525115,184.71,12.57,17.245714285714286,0.83,99.44
2021-10-15,Sikkim,534,2,534,6917,901,634,7.72,0,0.7,528603,4374,525649,128.71,90.57,9.881428571428572,0.83,99.44
2021-10-16,Sikkim,1044,5,1037,12950,2350,1741,8.06,2,0.7,529647,4379,526686,335.71,248.71,18.5,0.83,99.44
2021-10-17,Sikkim,81,0,78,1387,3826,3145,5.84,3,0.7,529728,4379,526764,546.57,449.29,1.9814285714285715,0.83,99.44
2021-10-18,Sikkim,756,4,754,9147,1566,906,8.27,0,0.7,530484,4383,527518,223.71,129.43,13.067142857142857,0.83,99.44
2021-10-19,Sikkim,1186,7,1181,14754,1463,1324,8.04,0,0.7,531670,4390,528699,209.0,189.14,21.077142857142857,0.83,99.44
2021-10-20,Sikkim,414,1,406,5742,1219,1106,7.21,7,0.7,532084,4391,529105,174.14,158.0,8.202857142857143,0.83,99.44
2021-10-21,Sikkim,520,6,516,6414,3248,2221,8.11,0,0.7,532604,4397,529621,464.0,317.29,9.162857142857144,0.83,99.44
2021-10-22,Sikkim,656,3,648,8650,1754,1340,7.58,5,0.7,533260,4400,530269,250.57,191.43,12.357142857142858,0.83,99.44
2021-10-23,Sikkim,1549,9,1546,18758,2950,1256,8.26,0,0.7,534809,4409,531815,421.43,179.43,26.797142857142855,0.82,99.44
2021-10-24,Sikkim,395,4,392,4853,2193,273,8.14,0,0.7,535204,4413,532207,313.29,39.0,6.932857142857143,0.82,99.44
2021-10-25,Sikkim,1422,14,1414,17821,3296,3282,7.98,0,0.7,536626,4427,533621,470.86,468.86,25.458571428571428,0.82,99.44
2021-10-26,Sikkim,464,4,456,5754,29,20,8.06,4,0.7,537090,4431,534077,4.14,2.86,8.22,0.83,99.44
2021-10-27,Sikkim,924,12,923,11300,3833,3746,8.18,0,0.7,538014,4443,535000,547.57,535.14,16.142857142857142,0.83,99.44
2021-10-28,Sikkim,1536,13,1528,19554,1792,1513,7.86,0,0.7,539550,4456,536528,256.0,216.14,27.934285714285714,0.83,99.44
2021-10-29,Sikkim,1531,19,1529,18898,2423,149,8.1,0,0.7,541081,4475,538057,346.14,21.29,26.997142857142858,0.83,99.44
2021-10-30,Sikkim,856,6,850,10748,2970,1158,7.96,0,0.7,541937,4481,538907,424.29,165.43,15.354285714285714,0.83,99.44
2021-10-31,Sikkim,549,2,547,6417,1517,1256,8.56,0,0.7,542486,4483,539454,216.71,179.43,9.167142857142856,0.83,99.44
2021-11-01,Sikkim,321,1,318,3866,2623,2321,8.3,2,0.7,542807,4484,539772,374.71,331.57,5.522857142857143,0.83,99.44
2021-11-02,Sikkim,496,7,487,6317,3144,929,7.85,2,0.7,543303,4491,540259,449.14,132.71,9.024285714285714,0.83,99.44
2021-11-03,Sikkim,883,9,882,11138,1016,753,7.93,0,0.7,544186,4500,541141,145.14,107.57,15.911428571428571,0.83,99.44
2021-11-04,Sikkim,255,2,250,2996,790,6,8.51,3,0.7,544441,4502,541391,112.86,0.86,4.28,0.83,99.44
2021-11-05,Sikkim,1091,5,1088,13620,2494,2105,8.01,0,0.7,545532,4507,542479,356.29,300.71,19.457142857142856,0.83,99.44
2021-11-06,Sikkim,510,1,504,6478,172,134,7.87,5,0.7,546042,4508,542983,24.57,19.14,9.254285714285714,0.83,99.44
2021-11-07,Sikkim,1396,8,1396,17312,1329,590,8.06,0,0.7,547438,4516,544379,189.86,84.29,24.731428571428573,0.82,99.44
2021-11-08,Sikkim,1405,16,1405,17476,4017,3018,8.04,0,0.7,548843,4532,545784,573.86,431.14,24.965714285714284,0.83,99.44
2021-11-09,Sikkim,807,6,801,9994,445,437,8.07,0,0.7,549650,4538,546585,63.57,62.43,14.277142857142858,0.83,99.44
2021-11-10,Sikkim,976,11,975,12101,4709,311,8.07,0,0.7,550626,4549,547560,672.71,44.43,17.287142857142857,0.83,99.44
2021-11-11,Sikkim,1333,9,1328,16594,3442,739,8.03,0,0.7,551959,4558,548888,491.71,105.57,23.705714285714286,0.83,99.44
2021-11-12,Sikkim,1292,16,1285,16013,3950,1156,8.07,0,0.7,553251,4574,550173,564.29,165.14,22.875714285714285,0.83,99.44
2021-11-13,Sikkim,613,8,607,7662,3035,1223,8.0,0,0.7,553864,4582,550780,433.57,174.71,10.945714285714285,0.83,99.44
2021-11-14,Sikkim,1192,16,1190,14713,602,307,8.1,0,0.7,555056,4598,551970,86.0,43.86,21.018571428571427,0.83,99.44
2021-11-15,Sikkim,795,8,794,10021,3031,2144,7.93,0,0.7,555851,4606,552764,433.0,306.29,14.315714285714286,0.83,99.44
2021-11-16,Sikkim,1428,19,1419,17537,758,493,8.14,0,0.7,557279,4625,554183,108.29,70.43,25.052857142857142,0.83,99.44
2021-11-17,Sikkim,969,13,965,12167,1295,269,7.96,0,0.7,558248,4638,555148,185.0,38.43,17.38142857142857,0.83,99.44
2021-11-18,Sikkim,564,2,560,6832,1889,403,8.26,2,0.7,558812,4640,555708,269.86,57.57,9.76,0.83,99.44
2021-11-19,Sikkim,781,8,775,9141,1952,1259,8.54,0,0.7,559593,4648,556483,278.86,179.86,13.058571428571428,0.83,99.44
2021-11-20,Sikkim,1249,13,1248,15414,2748,140,8.1,0,0.7,560842,4661,557731,392.57,20.0,22.02,0.83,99.45
2021-11-21,Sikkim,300,4,298,4021,569,93,7.46,0,0.7,561142,4665,558029,81.29,13.29,5.744285714285715,0.83,99.45
2021-11-22,Sikkim,1094,9,1089,13271,3887,2761,8.24,0,0.7,562236,4674,559118,555.29,394.43,18.958571428571428,0.83,99.45
2021-11-23,Sikkim,627,5,623,7858,4276,2350,7.98,0,0.7,562863,4679,559741,610.86,335.71,11.225714285714286,0.83,99.45
2021-11-24,Sikkim,1249,4,1248,15523,3991,1990,8.05,0,0.7,564112,4683,560989,570.14,284.29,22.175714285714285,0.83,99.45
2021-11-25,Sikkim,418,2,417,5237,3591,224,7.98,0,0.7,564530,4685,561406,513.0,32.0,7.481428571428571,0.83,99.45
2021-11-26,Sikkim,571,5,570,7128,3676,1680,8.01,0,0.7,565101,4690,561976,525.14,240.0,10.182857142857143,0.83,99.45
2021-11-27,Sikkim,256,1,252,3045,653,293,8.41,3,0.7,565357,4691,562228,93.29,41.86,4.35,0.83,99.45
2021-11-28,Sikkim,983,13,975,12363,834,412,7.95,0,0.7,566340,4704,563203,119.14,58.86,17.661428571428573,0.83,99.45
2021-11-29,Sikkim,263,0,258,2609,4728,1984,10.08,5,0.7,566603,4704,563461,675.43,283.43,3.7271428571428573,0.83,99.45
2021-11-30,Sikkim,793,5,792,9956,4329,4206,7.97,0,0.7,567396,4709,564253,618.43,600.86,14.222857142857142,0.83,99.45
2021-12-01,Sikkim,306,4,301,3514,1088,148,8.71,1,0.7,567702,4713,564554,155.43,21.14,5.02,0.83,99.45
2021-12-02,Sikkim,275,2,270,4310,1528,197,6.38,3,0.7,567977,4715,564824,218.29,28.14,6.1571428571428575,0.83,99.44
2021-12-03,Sikkim,1398,6,1392,18074,2465,685,7.73,0,0.7,569375,4721,566216,352.14,97.86,25.82,0.83,99.45
2021-12-04,Sikkim,301,2,295,3464,2861,2580,8.69,4,0.7,569676,4723,566511,408.71,368.57,4.948571428571428,0.83,99.44
2021-12-05,Sikkim,1421,6,1418,17660,2313,419,8.05,0,0.7,571097,4729,567929,330.43,59.86,25.228571428571428,0.83,99.45
2021-12-06,Sikkim,292,2,289,3725,713,155,7.84,1,0.7,571389,4731,568218,101.86,22.14,5.321428571428571,0.83,99.45
2021-12-07,Sikkim,1508,21,1508,18222,1181,1116,8.28,0,0.7,572897,4752,569726,168.71,159.43,26.03142857142857,0.83,99.45
2021-12-08,Sikkim,166,1,163,2195,2702,1351,7.56,2,0.7,573063,4753,569889,386.0,193.0,3.1357142857142857,0.83,99.45
2021-12-09,Sikkim,1518,19,1514,18526,3843,703,8.19,0,0.7,574581,4772,571403,549.0,100.43,26.465714285714284,0.83,99.45
2021-12-10,Sikkim,398,2,389,4774,1636,943,8.34,7,0.7,574979,4774,571792,233.71,134.71,6.82,0.83,99.45
2021-12-11,Sikkim,1297,9,1293,16198,2210,149,8.01,0,0.7,576276,4783,573085,315.71,21.29,23.14,0.83,99.45
2021-12-12,Sikkim,222,2,221,2821,662,361,7.87,0,0.7,576498,4785,573306,94.57,51.57,4.03,0.83,99.45
2021-12-13,Sikkim,335,3,330,4320,175,130,7.75,2,0.7,576833,4788,573636,25.0,18.57,6.171428571428572,0.83,99.45
2021-12-14,Sikkim,362,5,357,4433,1517,768,8.17,0,0.7,577195,4793,573993,216.71,109.71,6.332857142857143,0.83,99.45
2021-12-15,Sikkim,689,3,683,8648,793,741,7.97,3,0.7,577884,4796,574676,113.29,105.86,12.354285714285714,0.83,99.44
2021-12-16,Sikkim,489,2,484,6426,2425,1296,7.61,3,0.7,578373,4798,575160,346.43,185.14,9.18,0.83,99.44
2021-12-17,Sikkim,745,3,744,9761,477,269,7.63,0,0.7,579118,4801,575904,68.14,38.43,13.944285714285714,0.83,99.45
2021-12-18,Sikkim,1314,9,1311,16680,477,220,7.88,0,0.7,580432,4810,577215,68.14,31.43,23.82857142857143,0.83,99.45
2021-12-19,Sikkim,930,11,927,11342,1030,799,8.2,0,0.7,581362,4821,578142,147.14,114.14,16.202857142857145,0.83,99.45
2021-12-20,Sikkim,1080,9,1074,13404,3998,338,8.06,0,0.7,582442,4830,579216,571.14,48.29,19.14857142857143,0.83,99.45
2021-12-21,Sikkim,981,8,975,12207,2584,2063,8.04,0,0.7,583423,4838,580191,369.14,294.71,17.43857142857143,0.83,99.45
2021-12-22,Sikkim,316,4,308,3827,592,295,8.26,4,0.7,583739,4842,580499,84.57,42.14,5.467142857142857,0.83,99.44
2021-12-23,Sikkim,429,5,421,5060,583,102,8.48,3,0.7,584168,4847,580920,83.29,14.57,7.228571428571429,0.83,99.44
2021-12-24,Sikkim,105,0,102,721,3000,1012,14.56,3,0.7,584273,4847,581022,428.57,144.57,1.03,0.83,99.44
2021-12-25,Sikkim,726,9,723,8790,2186,875,8.26,0,0.7,584999,4856,581745,312.29,125.0,12.557142857142857,0.83,99.44
2021-12-26,Sikkim,1312,6,1307,16510,284,266,7.95,0,0.7,586311,4862,583052,40.57,38.0,23.585714285714285,0.83,99.44
2021-12-27,Sikkim,961,13,955,12280,1714,739,7.83,0,0.7,587272,4875,584007,244.86,105.57,17.542857142857144,0.83,99.44
2021-12-28,Sikkim,781,6,776,9942,583,372,7.86,0,0.7,588053,4881,584783,83.29,53.14,14.202857142857143,0.83,99.44
2021-12-29,Sikkim,292,4,292,3858,3775,625,7.57,0,0.7,588345,4885,585075,539.29,89.29,5.511428571428572,0.83,99.44
2021-12-30,Sikkim,963,13,963,12057,3392,1234,7.99,0,0.7,589308,4898,586038,484.57,176.29,17.224285714285713,0.83,99.45
2021-12-31,Sikkim,1039,14,1037,13121,2458,1426,7.92,0,0.7,590347,4912,587075,351.14,203.71,18.744285714285713,0.83,99.45
2022-01-01,Sikkim,1412,20,1405,17756,1282,93,7.95,0,0.7,591759,4932,588480,183.14,13.29,25.365714285714287,0.83,99.45
2022-01-02,Sikkim,1140,12,1132,14479,1480,322,7.87,0,0.7,592899,4944,589612,211.43,46.0,20.684285714285714,0.83,99.45
2022-01-03,Sikkim,541,6,533,7002,2546,139,7.73,2,0.7,593440,4950,590145,363.71,19.86,10.002857142857144,0.83,99.44
2022-01-04,Sikkim,890,6,889,10986,4064,564,8.1,0,0.7,594330,4956,591034,580.57,80.57,15.694285714285714,0.83,99.45
2022-01-05,Sikkim,1211,15,1205,15267,349,339,7.93,0,0.7,595541,4971,592239,49.86,48.43,21.81,0.83,99.45
2022-01-06,Sikkim,694,9,686,8970,432,308,7.74,0,0.7,596235,4980,592925,61.71,44.0,12.814285714285715,0.84,99.44
2022-01-07,Sikkim,1351,4,1345,16758,3980,941,8.06,2,0.7,597586,4984,594270,568.57,134.43,23.94,0.83,99.45
2022-01-08,Sikkim,1369,8,1368,17335,2415,328,7.9,0,0.7,598955,4992,595638,345.0,46.86,24.764285714285716,0.83,99.45
2022-01-09,Sikkim,1001,11,999,12426,574,550,8.06,0,0.7,599956,5003,596637,82.0,78.57,17.751428571428573,0.83,99.45
2022-01-10,Sikkim,241,2,234,2904,169,122,8.3,5,0.7,600197,5005,596871,24.14,17.43,4.148571428571429,0.83,99.45
2022-01-11,Sikkim,64,0,61,1024,4944,2834,6.25,3,0.7,600261,5005,596932,706.29,404.86,1.4628571428571429,0.83,99.45
2022-01-12,Sikkim,624,2,624,7979,2881,2048,7.82,0,0.7,600885,5007,597556,411.57,292.57,11.398571428571428,0.83,99.45
2022-01-13,Sikkim,617,5,613,7786,3663,985,7.92,0,0.7,601502,5012,598169,523.29,140.71,11.122857142857143,0.83,99.45
2022-01-14,Sikkim,897,10,888,11383,1323,683,7.88,0,0.7,602399,5022,599057,189.0,97.57,16.26142857142857,0.83,99.45
2022-01-15,Sikkim,624,9,623,7553,1974,948,8.26,0,0.7,603023,5031,599680,282.0,135.43,10.79,0.83,99.45
2022-01-16,Sikkim,175,0,166,2408,3852,3205,7.27,9,0.7,603198,5031,599846,550.29,457.86,3.44,0.83,99.44
2022-01-17,Sikkim,367,4,364,4542,1156,920,8.08,0,0.7,603565,5035,600210,165.14,131.43,6.488571428571428,0.83,99.44
2022-01-18,Sikkim,181,1,179,2409,2497,783,7.51,1,0.7,603746,5036,600389,356.71,111.86,3.4414285714285713,0.83,99.44
2022-01-19,Sikkim,1436,12,1429,17780,4977,87,8.08,0,0.7,605182,5048,601818,711.0,12.43,25.4,0.83,99.44
2022-01-20,Sikkim,1112,9,1104,14301,690,190,7.78,0,0.7,606294,5057,602922,98.57,27.14,20.43,0.83,99.44
2022-01-21,Sikkim,753,7,746,9558,4484,4200,7.88,0,0.7,607047,5064,603668,640.57,600.0,13.654285714285715,0.83,99.44
2022-01-22,Sikkim,1392,10,1392,17395,2407,1325,8.0,0,0.7,608439,5074,605060,343.86,189.29,24.85,0.83,99.44
2022-01-23,Sikkim,1375,5,1366,17396,2222,282,7.9,4,0.7,609814,5079,606426,317.43,40.29,24.85142857142857,0.83,99.44
2022-01-24,Sikkim,1403,13,1402,17442,1302,217,8.04,0,0.7,611217,5092,607828,186.0,31.0,24.917142857142856,0.83,99.45
2022-01-25,Sikkim,1008,3,1005,12801,3194,1746,7.87,0,0.7,612225,5095,608833,456.29,249.43,18.287142857142857,0.83,99.45
2022-01-26,Sikkim,194,1,188,2590,2951,1160,7.49,5,0.7,612419,5096,609021,421.57,165.71,3.7,0.83,99.45
2022-01-27,Sikkim,54,0,50,925,917,316,5.84,4,0.7,612473,5096,609071,131.0,45.14,1.3214285714285714,0.83,99.44
2022-01-28,Sikkim,305,4,305,3533,509,91,8.63,0,0.7,612778,5100,609376,72.71,13.0,5.047142857142857,0.83,99.44
2022-01-29,Sikkim,200,2,198,2401,3003,2628,8.33,0,0.7,612978,5102,609574,429.0,375.43,3.43,0.83,99.44
2022-01-30,Sikkim,1388,12,1381,17659,965,269,7.86,0,0.7,614366,5114,610955,137.86,38.43,25.22714285714286,0.83,99.44
2022-01-31,Sikkim,886,11,886,11074,3267,2798,8.0,0,0.7,615252,5125,611841,466.71,399.71,15.82,0.83,99.45
2022-02-01,Sikkim,834,10,827,10690,4852,1805,7.8,0,0.7,616086,5135,612668,693.14,257.86,15.271428571428572,0.83,99.45
2022-02-02,Sikkim,768,9,762,9722,4583,2461,7.9,0,0.7,616854,5144,613430,654.71,351.57,13.888571428571428,0.83,99.44
2022-02-03,Sikkim,339,2,332,4455,2341,1067,7.61,5,0.7,617193,5146,613762,334.43,152.43,6.364285714285714,0.83,99.44
2022-02-04,Sikkim,116,0,116,1836,1021,992,6.32,0,0.7,617309,5146,613878,145.86,141.71,2.6228571428571428,0.83,99.44
2022-02-05,Sikkim,1263,8,1260,15897,15,13,7.94,0,0.7,618572,5154,615138,2.14,1.86,22.71,0.83,99.44
2022-02-06,Sikkim,1041,5,1039,12859,4956,4245,8.1,0,0.7,619613,5159,616177,708.0,606.43,18.37,0.83,99.45
2022-02-07,Sikkim,805,7,802,10382,4767,1021,7.75,0,0.7,620418,5166,616979,681.0,145.86,14.831428571428571,0.83,99.45
2022-02-08,Sikkim,271,1,269,2953,363,62,9.18,1,0.7,620689,5167,617248,51.86,8.86,4.218571428571429,0.83,99.45
2022-02-09,Sikkim,47,0,39,579,3826,3717,8.12,8,0.7,620736,5167,617287,546.57,531.0,0.8271428571428572,0.83,99.44
2022-02-10,Sikkim,908,12,908,11593,286,152,7.83,0,0.7,621644,5179,618195,40.86,21.71,16.56142857142857,0.83,99.45
2022-02-11,Sikkim,1341,18,1335,17428,805,403,7.69,0,0.7,622985,5197,619530,115.0,57.57,24.897142857142857,0.83,99.45
2022-02-12,Sikkim,1111,7,1106,13864,3736,3704,8.01,0,0.7,624096,5204,620636,533.71,529.14,19.805714285714284,0.83,99.45
2022-02-13,Sikkim,86,0,82,1607,4155,3146,5.35,4,0.7,624182,5204,620718,593.57,449.43,2.295714285714286,0.83,99.45
2022-02-14,Sikkim,1105,4,1099,14241,3106,256,7.76,2,0.7,625287,5208,621817,443.71,36.57,20.344285714285714,0.83,99.45
2022-02-15,Sikkim,1168,17,1162,14899,53,31,7.84,0,0.7,626455,5225,622979,7.57,4.43,21.284285714285716,0.83,99.45
2022-02-16,Sikkim,387,3,384,4986,666,231,7.76,0,0.7,626842,5228,623363,95.14,33.0,7.122857142857143,0.83,99.44
2022-02-17,Sikkim,294,0,286,3733,3975,3406,7.88,8,0.7,627136,5228,623649,567.86,486.57,5.332857142857143,0.83,99.44
2022-02-18,Sikkim,1437,6,1437,18103,4207,1198,7.94,0,0.7,628573,5234,625086,601.0,171.14,25.861428571428572,0.83,99.45
2022-02-19,Sikkim,674,6,666,8330,2371,2248,8.09,2,0.7,629247,5240,625752,338.71,321.14,11.9,0.83,99.44
2022-02-20,Sikkim,195,1,194,2417,2077,1671,8.07,0,0.7,629442,5241,625946,296.71,238.71,3.452857142857143,0.83,99.44
2022-02-21,Sikkim,62,0,58,1270,1621,407,4.88,4,0.7,629504,5241,626004,231.57,58.14,1.8142857142857143,0.83,99.44
2022-02-22,Sikkim,1166,14,1162,14602,3969,3310,7.99,0,0.7,630670,5255,627166,567.0,472.86,20.86,0.83,99.44
2022-02-23,Sikkim,623,7,622,7961,4276,802,7.83,0,0.7,631293,5262,627788,610.86,114.57,11.372857142857143,0.83,99.44
2022-02-24,Sikkim,1065,10,1056,12884,232,114,8.27,0,0.7,632358,5272,628844,33.14,16.29,18.405714285714286,0.83,99.44
2022-02-25,Sikkim,1577,20,1569,19388,193,28,8.13,0,0.7,633935,5292,630413,27.57,4.0,27.697142857142858,0.83,99.44
2022-02-26,Sikkim,871,12,862,10798,3025,2332,8.07,0,0.7,634806,5304,631275,432.14,333.14,15.425714285714285,0.84,99.44
2022-02-27,Sikkim,1208,17,1201,15273,2919,93,7.91,0,0.7,636014,5321,632476,417.0,13.29,21.818571428571428,0.84,99.44
2022-02-28,Sikkim,1181,11,1179,14844,2786,1457,7.96,0,0.7,637195,5332,633655,398.0,208.14,21.205714285714286,0.84,99.44
2022-03-01,Sikkim,487,3,486,6312,1329,807,7.72,0,0.7,637682,5335,634141,189.86,115.29,9.017142857142858,0.84,99.44
2022-03-02,Sikkim,1442,13,1433,17949,1320,738,8.03,0,0.7,639124,5348,635574,188.57,105.43,25.64142857142857,0.84,99.44
2022-03-03,Sikkim,1128,15,1127,14117,4096,1525,7.99,0,0.7,640252,5363,636701,585.14,217.86,20.167142857142856,0.84,99.45
2022-03-04,Sikkim,251,1,245,3209,3584,2110,7.82,5,0.7,640503,5364,636946,512.0,301.43,4.5842857142857145,0.84,99.44
2022-03-05,Sikkim,128,1,119,1909,3532,348,6.71,8,0.7,640631,5365,637065,504.57,49.71,2.7271428571428573,0.84,99.44
2022-03-06,Sikkim,107,0,98,823,4005,35,13.0,9,0.7,640738,5365,637163,572.14,5.0,1.1757142857142857,0.84,99.44
2022-03-07,Sikkim,332,1,324,4218,3895,655,7.87,7,0.7,641070,5366,637487,556.43,93.57,6.025714285714286,0.84,99.44
2022-03-08,Sikkim,564,7,562,6843,2476,1462,8.24,0,0.7,641634,5373,638049,353.71,208.86,9.775714285714285,0.84,99.44
2022-03-09,Sikkim,796,7,795,9908,3898,3764,8.03,0,0.7,642430,5380,638844,556.86,537.71,14.154285714285715,0.84,99.44
2022-03-10,Sikkim,101,0,92,1177,4924,4867,8.58,9,0.7,642531,5380,638936,703.43,695.29,1.6814285714285715,0.84,99.44
2022-03-11,Sikkim,478,3,478,5608,3117,2608,8.52,0,0.7,643009,5383,639414,445.29,372.57,8.01142857142857,0.84,99.44
2022-03-12,Sikkim,541,7,536,6952,837,301,7.78,0,0.7,643550,5390,639950,119.57,43.0,9.93142857142857,0.84,99.44
2022-03-13,Sikkim,307,1,298,3400,4321,1898,9.03,8,0.7,643857,5391,640248,617.29,271.14,4.857142857142857,0.84,99.44
2022-03-14,Sikkim,1255,16,1249,14949,2769,57,8.4,0,0.7,645112,5407,641497,395.57,8.14,21.355714285714285,0.84,99.44
2022-03-15,Sikkim,135,0,135,1853,4594,4482,7.29,0,0.7,645247,5407,641632,656.29,640.29,2.6471428571428572,0.84,99.44
2022-03-16,Sikkim,150,0,148,1997,4629,3215,7.51,2,0.7,645397,5407,641780,661.29,459.29,2.8528571428571428,0.84,99.44
2022-03-17,Sikkim,1228,15,1226,15757,75,21,7.79,0,0.7,646625,5422,643006,10.71,3.0,22.51,0.84,99.44
2022-03-18,Sikkim,867,9,865,11065,148,92,7.84,0,0.7,647492,5431,643871,21.14,13.14,15.807142857142857,0.84,99.44
2022-03-19,Sikkim,325,1,316,4507,2519,1183,7.21,8,0.7,647817,5432,644187,359.86,169.0,6.438571428571429,0.84,99.44
2022-03-20,Sikkim,269,1,261,3267,3827,1592,8.23,7,0.7,648086,5433,644448,546.71,227.43,4.667142857142857,0.84,99.44
2022-03-21,Sikkim,1345,6,1340,16973,4426,566,7.92,0,0.7,649431,5439,645788,632.29,80.86,24.247142857142858,0.84,99.44
2022-03-22,Sikkim,1338,13,1335,17068,2688,1796,7.84,0,0.7,650769,5452,647123,384.0,256.57,24.382857142857144,0.84,99.44
2022-03-23,Sikkim,1362,9,1359,16978,255,191,8.02,0,0.7,652131,5461,648482,36.43,27.29,24.254285714285714,0.84,99.44
2022-03-24,Sikkim,1171,14,1164,14665,1830,1280,7.98,0,0.7,653302,5475,649646,261.43,182.86,20.95,0.84,99.44
2022-03-25,Sikkim,1398,8,1393,17653,3683,3580,7.92,0,0.7,654700,5483,651039,526.14,511.43,25.21857142857143,0.84,99.44
2022-03-26,Sikkim,639,6,632,7709,1969,1661,8.29,1,0.7,655339,5489,651671,281.29,237.29,11.012857142857143,0.84,99.44
2022-03-27,Sikkim,756,3,747,9433,25,8,8.01,6,0.7,656095,5492,652418,3.57,1.14,13.475714285714286,0.84,99.44
2022-03-28,Sikkim,800,7,797,9848,4298,1907,8.12,0,0.7,656895,5499,653215,614.0,272.43,14.06857142857143,0.84,99.44
2022-03-29,Sikkim,130,0,127,1600,3598,2110,8.12,3,0.7,657025,5499,653342,514.0,301.43,2.2857142857142856,0.84,99.44
2022-03-30,Sikkim,483,1,477,6244,3535,2431,7.74,5,0.7,657508,5500,653819,505.0,347.29,8.92,0.84,99.44
2022-03-31,Sikkim,1142,15,1139,14420,2509,1751,7.92,0,0.7,658650,5515,654958,358.43,250.14,20.6,0.84,99.44
2022-04-01,Sikkim,1119,13,1118,14127,4911,1223,7.92,0,0.7,659769,5528,656076,701.57,174.71,20.181428571428572,0.84,99.44
2022-04-02,Sikkim,1197,3,1197,15327,1575,1089,7.81,0,0.7,660966,5531,657273,225.0,155.57,21.895714285714284,0.84,99.44
2022-04-03,Sikkim,448,3,440,5282,3295,2355,8.48,5,0.7,661414,5534,657713,470.71,336.43,7.545714285714285,0.84,99.44
2022-04-04,Sikkim,1016,7,1009,12637,1717,1101,8.04,0,0.7,662430,5541,658722,245.29,157.29,18.052857142857142,0.84,99.44
2022-04-05,Sikkim,215,1,215,2853,3184,1823,7.54,0,0.7,662645,5542,658937,454.86,260.43,4.075714285714286,0.84,99.44
2022-04-06,Sikkim,304,3,303,4056,1402,286,7.5,0,0.7,662949,5545,659240,200.29,40.86,5.7942857142857145,0.84,99.44
2022-04-07,Sikkim,1537,15,1535,18678,3501,595,8.23,0,0.7,664486,5560,660775,500.14,85.0,26.68285714285714,0.84,99.44
2022-04-08,Sikkim,1032,12,1023,12483,1722,1469,8.27,0,0.7,665518,5572,661798,246.0,209.86,17.832857142857144,0.84,99.44
2022-04-09,Sikkim,1122,5,1122,14398,3042,2875,7.79,0,0.7,666640,5577,662920,434.57,410.71,20.568571428571428,0.84,99.44
2022-04-10,Sikkim,814,4,809,9930,4194,3606,8.2,1,0.7,667454,5581,663729,599.14,515.14,14.185714285714285,0.84,99.44
2022-04-11,Sikkim,1272,10,1271,15916,1611,196,7.99,0,0.7,668726,5591,665000,230.14,28.0,22.737142857142857,0.84,99.44
2022-04-12,Sikkim,893,9,891,11678,3648,976,7.65,0,0.7,669619,5600,665891,521.14,139.43,16.68285714285714,0.84,99.44
2022-04-13,Sikkim,352,5,351,4306,2790,594,8.17,0,0.7,669971,5605,666242,398.57,84.86,6.151428571428571,0.84,99.44
2022-04-14,Sikkim,242,2,242,3168,3209,1973,7.64,0,0.7,670213,5607,666484,458.43,281.86,4.525714285714286,0.84,99.44
2022-04-15,Sikkim,285,0,281,3600,721,367,7.92,4,0.7,670498,5607,666765,103.0,52.43,5.142857142857143,0.84,99.44
2022-04-16,Sikkim,1305,6,1302,16126,4570,2161,8.09,0,0.7,671803,5613,668067,652.86,308.71,23.037142857142857,0.84,99.44
2022-04-17,Sikkim,805,7,799,10173,1415,1182,7.91,0,0.7,672608,5620,668866,202.14,168.86,14.532857142857143,0.84,99.44
2022-04-18,Sikkim,1311,12,1307,16095,358,220,8.15,0,0.7,673919,5632,670173,51.14,31.43,22.992857142857144,0.84,99.44
2022-04-19,Sikkim,1361,16,1359,17313,1641,1500,7.86,0,0.7,675280,5648,671532,234.43,214.29,24.732857142857142,0.84,99.44
2022-04-20,Sikkim,1612,17,1612,19994,4437,717,8.06,0,0.7,676892,5665,673144,633.86,102.43,28.562857142857144,0.84,99.45
2022-04-21,Sikkim,454,2,453,5556,1411,1115,8.17,0,0.7,677346,5667,673597,201.57,159.29,7.937142857142857,0.84,99.45
2022-04-22,Sikkim,1479,7,1470,18331,3552,313,8.07,2,0.7,678825,5674,675067,507.43,44.71,26.187142857142856,0.84,99.45
2022-04-23,Sikkim,872,12,865,10998,4755,3652,7.93,0,0.7,679697,5686,675932,679.29,521.71,15.711428571428572,0.84,99.45
2022-04-24,Sikkim,759,5,750,9275,1835,794,8.18,4,0.7,680456,5691,676682,262.14,113.43,13.25,0.84,99.45
2022-04-25,Sikkim,727,9,718,8837,512,188,8.23,0,0.7,681183,5700,677400,73.14,26.86,12.624285714285714,0.84,99.44
2022-04-26,Sikkim,650,1,643,8327,1804,827,7.81,6,0.7,681833,5701,678043,257.71,118.14,11.895714285714286,0.84,99.44
2022-04-27,Sikkim,1341,10,1339,16759,1684,594,8.0,0,0.7,683174,5711,679382,240.57,84.86,23.94142857142857,0.84,99.44
2022-04-28,Sikkim,1248,6,1243,15192,4438,2147,8.21,0,0.7,684422,5717,680625,634.0,306.71,21.702857142857145,0.84,99.45
2022-04-29,Sikkim,967,11,961,12120,2605,1523,7.98,0,0.7,685389,5728,681586,372.14,217.57,17.314285714285713,0.84,99.45
2022-04-30,Sikkim,938,13,938,12097,323,255,7.75,0,0.7,686327,5741,682524,46.14,36.43,17.28142857142857,0.84,99.45
2022-05-01,Sikkim,1012,10,1012,12439,49,23,8.14,0,0.7,687339,5751,683536,7.0,3.29,17.77,0.84,99.45
2022-05-02,Sikkim,418,2,415,5246,181,166,7.97,1,0.7,687757,5753,683951,25.86,23.71,7.494285714285715,0.84,99.45
2022-05-03,Sikkim,1450,5,1443,18272,1343,967,7.94,2,0.7,689207,5758,685394,191.86,138.14,26.102857142857143,0.84,99.45
2022-05-04,Sikkim,131,1,129,1664,2138,1279,7.87,1,0.7,689338,5759,685523,305.43,182.71,2.3771428571428572,0.84,99.45
2022-05-05,Sikkim,730,5,722,9217,1969,1234,7.92,3,0.7,690068,5764,686245,281.29,176.29,13.167142857142856,0.84,99.45
2022-05-06,Sikkim,250,2,249,3076,4274,1465,8.13,0,0.7,690318,5766,686494,610.57,209.29,4.394285714285714,0.84,99.45
2022-05-07,Sikkim,777,8,768,9857,2476,954,7.88,1,0.7,691095,5774,687262,353.71,136.29,14.081428571428571,0.84,99.45
2022-05-08,Sikkim,1058,3,1056,12774,2898,2321,8.28,0,0.7,692153,5777,688318,414.0,331.57,18.248571428571427,0.83,99.45
2022-05-09,Sikkim,1121,6,1118,13775,2070,1999,8.14,0,0.7,693274,5783,689436,295.71,285.57,19.678571428571427,0.83,99.45
2022-05-10,Sikkim,701,9,698,8978,952,644,7.81,0,0.7,693975,5792,690134,136.0,92.0,12.825714285714286,0.83,99.45
2022-05-11,Sikkim,1147,8,1139,14258,3085,1033,8.04,0,0.7,695122,5800,691273,440.71,147.57,20.36857142857143,0.83,99.45
2022-05-12,Sikkim,938,9,938,11501,3173,2541,8.16,0,0.7,696060,5809,692211,453.29,363.0,16.43,0.83,99.45
2022-05-13,Sikkim,516,3,511,6012,3851,2544,8.58,2,0.7,696576,5812,692722,550.14,363.43,8.588571428571429,0.83,99.45
2022-05-14,Sikkim,732,5,725,9150,3268,121,8.0,2,0.7,697308,5817,693447,466.86,17.29,13.071428571428571,0.83,99.45
2022-05-15,Sikkim,92,0,86,1096,1890,1411,8.39,6,0.7,697400,5817,693533,270.0,201.57,1.5657142857142856,0.83,99.45
2022-05-16,Sikkim,319,3,319,4015,3361,2796,7.95,0,0.7,697719,5820,693852,480.14,399.43,5.735714285714286,0.83,99.45
2022-05-17,Sikkim,1581,6,1579,19882,478,20,7.95,0,0.7,699300,5826,695431,68.29,2.86,28.402857142857144,0.83,99.45
2022-05-18,Sikkim,1174,16,1168,14776,4364,719,7.95,0,0.7,700474,5842,696599,623.43,102.71,21.10857142857143,0.83,99.45
2022-05-19,Sikkim,852,4,848,10677,240,144,7.98,0,0.7,701326,5846,697447,34.29,20.57,15.252857142857144,0.83,99.45
2022-05-20,Sikkim,618,2,614,7167,1229,1222,8.62,2,0.7,701944,5848,698061,175.57,174.57,10.23857142857143,0.83,99.45
2022-05-21,Sikkim,1384,5,1381,17106,2241,355,8.09,0,0.7,703328,5853,699442,320.14,50.71,24.437142857142856,0.83,99.45
2022-05-22,Sikkim,727,7,724,9027,2331,532,8.05,0,0.7,704055,5860,700166,333.0,76.0,12.895714285714286,0.83,99.45
2022-05-23,Sikkim,210,1,205,2819,1517,462,7.45,4,0.7,704265,5861,700371,216.71,66.0,4.027142857142858,0.83,99.45
2022-05-24,Sikkim,112,0,112,1685,2386,1227,6.65,0,0.7,704377,5861,700483,340.86,175.29,2.407142857142857,0.83,99.45
2022-05-25,Sikkim,877,12,870,11098,1710,1154,7.9,0,0.7,705254,5873,701353,244.29,164.86,15.854285714285714,0.83,99.45
2022-05-26,Sikkim,665,7,663,8288,448,102,8.02,0,0.7,705919,5880,702016,64.0,14.57,11.84,0.83,99.45
2022-05-27,Sikkim,1568,8,1566,19244,4230,2312,8.15,0,0.7,707487,5888,703582,604.29,330.29,27.49142857142857,0.83,99.45
2022-05-28,Sikkim,1412,14,1408,17970,2680,1105,7.86,0,0.7,708899,5902,704990,382.86,157.86,25.67142857142857,0.83,99.45
2022-05-29,Sikkim,1233,5,1233,15238,2501,1689,8.09,0,0.7,710132,5907,706223,357.29,241.29,21.768571428571427,0.83,99.45
2022-05-30,Sikkim,808,11,799,9873,953,90,8.18,0,0.7,710940,5918,707022,136.14,12.86,14.104285714285714,0.83,99.45
2022-05-31,Sikkim,1015,10,1006,12529,3903,2592,8.1,0,0.7,711955,5928,708028,557.57,370.29,17.89857142857143,0.83,99.45
2022-06-01,Sikkim,783,11,781,9923,2412,549,7.89,0,0.7,712738,5939,708809,344.57,78.43,14.175714285714285,0.83,99.45
2022-06-02,Sikkim,1468,10,1465,18268,1257,399,8.04,0,0.7,714206,5949,710274,179.57,57.0,26.097142857142856,0.83,99.45
2022-06-03,Sikkim,747,2,747,9629,4434,4377,7.76,0,0.7,714953,5951,711021,633.43,625.29,13.755714285714285,0.83,99.45
2022-06-04,Sikkim,673,3,664,8628,2094,521,7.8,6,0.7,715626,5954,711685,299.14,74.43,12.325714285714286,0.83,99.45
2022-06-05,Sikkim,1428,6,1425,17956,4311,1067,7.95,0,0.7,717054,5960,713110,615.86,152.43,25.65142857142857,0.83,99.45
2022-06-06,Sikkim,1235,17,1231,14919,2755,1820,8.28,0,0.7,718289,5977,714341,393.57,260.0,21.312857142857144,0.83,99.45
2022-06-07,Sikkim,1201,13,1193,15140,2389,1596,7.93,0,0.7,719490,5990,715534,341.29,228.0,21.62857142857143,0.83,99.45
2022-06-08,Sikkim,101,0,95,1452,3470,2269,6.96,6,0.7,719591,5990,715629,495.71,324.14,2.0742857142857143,0.83,99.45
2022-06-09,Sikkim,704,8,697,8627,770,70,8.16,0,0.7,720295,5998,716326,110.0,10.0,12.324285714285715,0.83,99.45
2022-06-10,Sikkim,414,2,414,5176,4991,3444,8.0,0,0.7,720709,6000,716740,713.0,492.0,7.394285714285714,0.83,99.45
2022-06-11,Sikkim,1240,10,1233,15700,1672,9,7.9,0,0.7,721949,6010,717973,238.86,1.29,22.428571428571427,0.83,99.45
2022-06-12,Sikkim,665,8,665,8126,4393,3026,8.18,0,0.7,722614,6018,718638,627.57,432.29,11.608571428571429,0.83,99.45
2022-06-13,Sikkim,440,3,433,5664,62,51,7.77,4,0.7,723054,6021,719071,8.86,7.29,8.09142857142857,0.83,99.45
2022-06-14,Sikkim,758,9,753,9402,2444,1943,8.06,0,0.7,723812,6030,719824,349.14,277.57,13.43142857142857,0.83,99.45
2022-06-15,Sikkim,1451,8,1442,18123,3816,3816,8.01,1,0.7,725263,6038,721266,545.14,545.14,25.89,0.83,99.45
2022-06-16,Sikkim,263,1,256,2943,4191,132,8.94,6,0.7,725526,6039,721522,598.71,18.86,4.204285714285715,0.83,99.45
2022-06-17,Sikkim,941,2,939,11665,4087,2657,8.07,0,0.7,726467,6041,722461,583.86,379.57,16.664285714285715,0.83,99.45
2022-06-18,Sikkim,1060,9,1060,13221,2558,2013,8.02,0,0.7,727527,6050,723521,365.43,287.57,18.88714285714286,0.83,99.45
2022-06-19,Sikkim,745,9,745,9490,2954,1190,7.85,0,0.7,728272,6059,724266,422.0,170.0,13.557142857142857,0.83,99.45
2022-06-20,Sikkim,655,6,646,8009,4485,2545,8.18,3,0.7,728927,6065,724912,640.71,363.57,11.441428571428572,0.83,99.45
2022-06-21,Sikkim,658,3,658,8322,4658,80,7.91,0,0.7,729585,6068,725570,665.43,11.43,11.888571428571428,0.83,99.45
2022-06-22,Sikkim,469,5,462,6448,1623,495,7.27,2,0.7,730054,6073,726032,231.86,70.71,9.211428571428572,0.83,99.45
2022-06-23,Sikkim,932,9,926,11584,940,495,8.05,0,0.7,730986,6082,726958,134.29,70.71,16.548571428571428,0.83,99.45
2022-06-24,Sikkim,1625,13,1618,19990,840,539,8.13,0,0.7,732611,6095,728576,120.0,77.0,28.557142857142857,0.83,99.45
2022-06-25,Sikkim,941,6,938,11928,4650,761,7.89,0,0.7,733552,6101,729514,664.29,108.71,17.04,0.83,99.45
2022-06-26,Sikkim,1502,7,1500,18725,1428,287,8.02,0,0.7,735054,6108,731014,204.0,41.0,26.75,0.83,99.45
2022-06-27,Sikkim,596,3,593,7762,286,26,7.68,0,0.7,735650,6111,731607,40.86,3.71,11.088571428571429,0.83,99.45
2022-06-28,Sikkim,762,5,760,9917,4903,4090,7.68,0,0.7,736412,6116,732367,700.43,584.29,14.167142857142856,0.83,99.45
2022-06-29,Sikkim,1425,19,1420,18229,807,346,7.82,0,0.7,737837,6135,733787,115.29,49.43,26.041428571428572,0.83,99.45
2022-06-30,Sikkim,560,4,554,6814,1188,1005,8.22,2,0.7,738397,6139,734341,169.71,143.57,9.734285714285715,0.83,99.45
2022-07-01,Sikkim,726,9,723,9213,589,523,7.88,0,0.7,739123,6148,735064,84.14,74.71,13.161428571428571,0.83,99.45
2022-07-02,Sikkim,591,8,584,7122,4054,626,8.3,0,0.7,739714,6156,735648,579.14,89.43,10.174285714285714,0.83,99.45
2022-07-03,Sikkim,854,6,848,11236,919,900,7.6,0,0.7,740568,6162,736496,131.29,128.57,16.05142857142857,0.83,99.45
2022-07-04,Sikkim,753,9,745,9060,1929,1556,8.31,0,0.7,741321,6171,737241,275.57,222.29,12.942857142857143,0.83,99.45
2022-07-05,Sikkim,1371,5,1366,17027,3466,358,8.05,0,0.7,742692,6176,738607,495.14,51.14,24.324285714285715,0.83,99.45
2022-07-06,Sikkim,1086,5,1084,13927,76,14,7.8,0,0.7,743778,6181,739691,10.86,2.0,19.895714285714284,0.83,99.45
2022-07-07,Sikkim,472,6,463,6004,3360,473,7.86,3,0.7,744250,6187,740154,480.0,67.57,8.577142857142857,0.83,99.45
2022-07-08,Sikkim,969,3,961,12189,2198,2151,7.95,5,0.7,745219,6190,741115,314.0,307.29,17.412857142857142,0.83,99.45
2022-07-09,Sikkim,1157,7,1153,14754,2422,776,7.84,0,0.7,746376,6197,742268,346.0,110.86,21.077142857142857,0.83,99.45
2022-07-10,Sikkim,202,0,195,2411,2068,1945,8.38,7,0.7,746578,6197,742463,295.43,277.86,3.4442857142857144,0.83,99.45
2022-07-11,Sikkim,912,4,907,11359,4328,534,8.03,1,0.7,747490,6201,743370,618.29,76.29,16.22714285714286,0.83,99.45
2022-07-12,Sikkim,382,4,382,4802,3546,1692,7.96,0,0.7,747872,6205,743752,506.57,241.71,6.86,0.83,99.45
2022-07-13,Sikkim,1143,12,1138,14448,524,107,7.91,0,0.7,749015,6217,744890,74.86,15.29,20.64,0.83,99.45
2022-07-14,Sikkim,726,9,722,9405,1397,1078,7.72,0,0.7,749741,6226,745612,199.57,154.0,13.435714285714285,0.83,99.45
2022-07-15,Sikkim,80,1,76,787,3142,810,10.17,3,0.7,749821,6227,745688,448.86,115.71,1.1242857142857143,0.83,99.45
2022-07-16,Sikkim,864,5,855,11214,67,51,7.7,4,0.7,750685,6232,746543,9.57,7.29,16.02,0.83,99.45
2022-07-17,Sikkim,1172,12,1164,14633,2129,1487,8.01,0,0.7,751857,6244,747707,304.14,212.43,20.904285714285713,0.83,99.45
2022-07-18,Sikkim,979,7,972,12084,1304,155,8.1,0,0.7,752836,6251,748679,186.29,22.14,17.262857142857143,0.83,99.45
2022-07-19,Sikkim,1347,14,1338,16606,4960,4859,8.11,0,0.7,754183,6265,750017,708.57,694.14,23.722857142857144,0.83,99.45
2022-07-20,Sikkim,345,2,338,4301,4222,3321,8.02,5,0.7,754528,6267,750355,603.14,474.43,6.144285714285714,0.83,99.45
2022-07-21,Sikkim,1216,13,1209,15165,4595,772,8.02,0,0.7,755744,6280,751564,656.43,110.29,21.664285714285715,0.83,99.45
2022-07-22,Sikkim,398,4,397,4869,379,25,8.17,0,0.7,756142,6284,751961,54.14,3.57,6.9557142857142855,0.83,99.45
2022-07-23,Sikkim,457,1,456,5214,1195,1073,8.76,0,0.7,756599,6285,752417,170.71,153.29,7.448571428571428,0.83,99.45
2022-07-24,Sikkim,103,0,100,1494,1137,946,6.89,3,0.7,756702,6285,752517,162.43,135.14,2.1342857142857143,0.83,99.45
2022-07-25,Sikkim,381,4,379,5399,2643,174,7.06,0,0.7,757083,6289,752896,377.57,24.86,7.712857142857143,0.83,99.45
2022-07-26,Sikkim,1472,4,1463,18321,2328,2116,8.03,5,0.7,758555,6293,754359,332.57,302.29,26.172857142857143,0.83,99.45
2022-07-27,Sikkim,1035,6,1030,12742,173,1,8.12,0,0.7,759590,6299,755389,24.71,0.14,18.202857142857145,0.83,99.45
2022-07-28,Sikkim,168,2,165,2800,2173,1343,6.0,1,0.7,759758,6301,755554,310.43,191.86,4.0,0.83,99.45
2022-07-29,Sikkim,1463,11,1460,18624,414,45,7.86,0,0.7,761221,6312,757014,59.14,6.43,26.605714285714285,0.83,99.45
2022-07-30,Sikkim,638,6,629,8259,3033,2776,7.72,3,0.7,761859,6318,757643,433.29,396.57,11.798571428571428,0.83,99.45
2022-07-31,Sikkim,1330,5,1330,16961,1662,1050,7.84,0,0.7,763189,6323,758973,237.43,150.0,24.23,0.83,99.45
2022-08-01,Sikkim,1160,7,1159,14329,3400,1671,8.1,0,0.7,764349,6330,760132,485.71,238.71,20.47,0.83,99.45
2022-08-02,Sikkim,1186,4,1185,14467,4803,4534,8.2,0,0.7,765535,6334,761317,686.14,647.71,20.667142857142856,0.83,99.45
2022-08-03,Sikkim,865,7,858,10709,1768,1520,8.08,0,0.7,766400,6341,762175,252.57,217.14,15.298571428571428,0.83,99.45
2022-08-04,Sikkim,720,9,715,8984,3706,740,8.01,0,0.7,767120,6350,762890,529.43,105.71,12.834285714285715,0.83,99.45
2022-08-05,Sikkim,501,4,496,6434,1180,452,7.79,1,0.7,767621,6354,763386,168.57,64.57,9.191428571428572,0.83,99.45
2022-08-06,Sikkim,927,12,924,11897,4342,2484,7.79,0,0.7,768548,6366,764310,620.29,354.86,16.995714285714286,0.83,99.45
2022-08-07,Sikkim,245,3,237,2686,1564,1554,9.12,5,0.7,768793,6369,764547,223.43,222.0,3.837142857142857,0.83,99.45
2022-08-08,Sikkim,739,4,733,9383,764,111,7.88,2,0.7,769532,6373,765280,109.14,15.86,13.404285714285715,0.83,99.45
2022-08-09,Sikkim,1245,10,1243,15803,368,333,7.88,0,0.7,770777,6383,766523,52.57,47.57,22.575714285714287,0.83,99.45
2022-08-10,Sikkim,1169,11,1165,14746,2524,1847,7.93,0,0.7,771946,6394,767688,360.57,263.86,21.065714285714286,0.83,99.45
2022-08-11,Sikkim,1179,8,1170,14316,2134,696,8.24,1,0.7,773125,6402,768858,304.86,99.43,20.451428571428572,0.83,99.45
2022-08-12,Sikkim,162,1,160,1694,2836,2305,9.56,1,0.7,773287,6403,769018,405.14,329.29,2.42,0.83,99.45
2022-08-13,Sikkim,1462,8,1458,18507,2019,1698,7.9,0,0.7,774749,6411,770476,288.43,242.57,26.43857142857143,0.83,99.45
2022-08-14,Sikkim,583,6,582,7467,4149,239,7.81,0,0.7,775332,6417,771058,592.71,34.14,10.667142857142856,0.83,99.45
2022-08-15,Sikkim,1091,9,1089,13919,1452,634,7.84,0,0.7,776423,6426,772147,207.43,90.57,19.884285714285713,0.83,99.45
2022-08-16,Sikkim,308,3,299,3697,3180,1254,8.33,6,0.7,776731,6429,772446,454.29,179.14,5.281428571428571,0.83,99.45
2022-08-17,Sikkim,1148,11,1139,14456,1619,464,7.94,0,0.7,777879,6440,773585,231.29,66.29,20.65142857142857,0.83,99.45
2022-08-18,Sikkim,946,9,937,11925,1300,508,7.93,0,0.7,778825,6449,774522,185.71,72.57,17.035714285714285,0.83,99.45
2022-08-19,Sikkim,1446,7,1438,18460,764,144,7.83,1,0.7,780271,6456,775960,109.14,20.57,26.37142857142857,0.83,99.45
2022-08-20,Sikkim,845,5,845,10682,4710,475,7.91,0,0.7,781116,6461,776805,672.86,67.86,15.26,0.83,99.45
2022-08-21,Sikkim,177,2,174,1857,4465,3966,9.53,1,0.7,781293,6463,776979,637.86,566.57,2.652857142857143,0.83,99.45
2022-08-22,Sikkim,785,6,776,9818,3405,871,8.0,3,0.7,782078,6469,777755,486.43,124.43,14.025714285714285,0.83,99.45
2022-08-23,Sikkim,667,2,665,8544,3052,1539,7.81,0,0.7,782745,6471,778420,436.0,219.86,12.205714285714286,0.83,99.45
2022-08-24,Sikkim,730,6,730,8919,4450,828,8.18,0,0.7,783475,6477,779150,635.71,118.29,12.741428571428571,0.83,99.45
2022-08-25,Sikkim,661,9,656,8461,3025,2038,7.81,0,0.7,784136,6486,779806,432.14,291.14,12.087142857142856,0.83,99.45
2022-08-26,Sikkim,87,0,81,946,1365,688,9.2,6,0.7,784223,6486,779887,195.0,98.29,1.3514285714285714,0.83,99.45
2022-08-27,Sikkim,271,3,262,3487,3407,2774,7.77,6,0.7,784494,6489,780149,486.71,396.29,4.981428571428571,0.83,99.45
2022-08-28,Sikkim,719,2,715,8899,3985,2404,8.08,2,0.7,785213,6491,780864,569.29,343.43,12.712857142857143,0.83,99.45
2022-08-29,Sikkim,163,1,161,2055,4496,225,7.93,1,0.7,785376,6492,781025,642.29,32.14,2.9357142857142855,0.83,99.45
2022-08-30,Sikkim,1019,10,1019,12599,1787,1301,8.09,0,0.7,786395,6502,782044,255.29,185.86,17.998571428571427,0.83,99.45
2022-08-31,Sikkim,1128,13,1121,13959,2389,933,8.08,0,0.7,787523,6515,783165,341.29,133.29,19.94142857142857,0.83,99.45
2022-09-01,Sikkim,415,6,407,4987,455,148,8.32,2,0.7,787938,6521,783572,65.0,21.14,7.1242857142857146,0.83,99.45
2022-09-02,Sikkim,382,1,382,4671,4472,712,8.18,0,0.7,788320,6522,783954,638.86,101.71,6.672857142857143,0.83,99.45
2022-09-03,Sikkim,553,2,546,6863,2422,236,8.06,5,0.7,788873,6524,784500,346.0,33.71,9.804285714285715,0.83,99.45
2022-09-04,Sikkim,98,0,90,1415,3179,616,6.93,8,0.7,788971,6524,784590,454.14,88.0,2.0214285714285714,0.83,99.44
2022-09-05,Sikkim,1442,18,1434,18002,2797,1690,8.01,0,0.7,790413,6542,786024,399.57,241.43,25.717142857142857,0.83,99.44
2022-09-06,Sikkim,596,8,592,7137,4485,4054,8.35,0,0.7,791009,6550,786616,640.71,579.14,10.195714285714285,0.83,99.44
2022-09-07,Sikkim,1330,6,1322,16457,1891,559,8.08,2,0.7,792339,6556,787938,270.14,79.86,23.51,0.83,99.44
2022-09-08,Sikkim,1111,4,1102,13660,637,512,8.13,5,0.7,793450,6560,789040,91.0,73.14,19.514285714285716,0.83,99.44
2022-09-09,Sikkim,296,1,296,3536,2100,198,8.37,0,0.7,793746,6561,789336,300.0,28.29,5.051428571428572,0.83,99.44
2022-09-10,Sikkim,628,6,624,8019,3801,2660,7.83,0,0.7,794374,6567,789960,543.0,380.0,11.455714285714286,0.83,99.44
2022-09-11,Sikkim,748,6,740,9385,2121,67,7.97,2,0.7,795122,6573,790700,303.0,9.57,13.407142857142857,0.83,99.44
2022-09-12,Sikkim,804,7,803,10207,2407,547,7.88,0,0.7,795926,6580,791503,343.86,78.14,14.581428571428571,0.83,99.44
2022-09-13,Sikkim,1459,9,1453,18073,1668,1591,8.07,0,0.7,797385,6589,792956,238.29,227.29,25.818571428571428,0.83,99.44
2022-09-14,Sikkim,535,3,531,7263,4472,4427,7.37,1,0.7,797920,6592,793487,638.86,632.43,10.375714285714286,0.83,99.44
2022-09-15,Sikkim,293,1,292,3731,2581,1421,7.85,0,0.7,798213,6593,793779,368.71,203.0,5.33,0.83,99.44
2022-09-16,Sikkim,361,2,354,4322,1970,1422,8.35,5,0.7,798574,6595,794133,281.43,203.14,6.174285714285714,0.83,99.44
2022-09-17,Sikkim,1069,8,1063,13424,196,54,7.96,0,0.7,799643,6603,795196,28.0,7.71,19.177142857142858,0.83,99.44
2022-09-18,Sikkim,1266,17,1265,15907,2645,509,7.96,0,0.7,800909,6620,796461,377.86,72.71,22.724285714285713,0.83,99.44
2022-09-19,Sikkim,647,5,647,8071,3050,1403,8.02,0,0.7,801556,6625,797108,435.71,200.43,11.53,0.83,99.45
2022-09-20,Sikkim,207,0,203,2468,1013,858,8.39,4,0.7,801763,6625,797311,144.71,122.57,3.525714285714286,0.83,99.44
2022-09-21,Sikkim,181,0,181,2320,3144,349,7.8,0,0.7,801944,6625,797492,449.14,49.86,3.3142857142857145,0.83,99.44
2022-09-22,Sikkim,345,1,339,4430,4214,2121,7.79,5,0.7,802289,6626,797831,602.0,303.0,6.328571428571428,0.83,99.44
2022-09-23,Sikkim,912,6,906,11384,1667,1580,8.01,0,0.7,803201,6632,798737,238.14,225.71,16.262857142857143,0.83,99.44
2022-09-24,Sikkim,1173,3,1168,14670,2802,713,8.0,2,0.7,804374,6635,799905,400.29,101.86,20.957142857142856,0.82,99.44
2022-09-25,Sikkim,958,6,950,11782,4712,4270,8.13,2,0.7,805332,6641,800855,673.14,610.0,16.83142857142857,0.82,99.44
2022-09-26,Sikkim,991,8,983,12204,4061,1674,8.12,0,0.7,806323,6649,801838,580.14,239.14,17.434285714285714,0.82,99.44
2022-09-27,Sikkim,449,2,448,5344,1328,432,8.4,0,0.7,806772,6651,802286,189.71,61.71,7.634285714285714,0.82,99.44
2022-09-28,Sikkim,97,1,88,1425,1363,1134,6.81,8,0.7,806869,6652,802374,194.71,162.0,2.0357142857142856,0.82,99.44
2022-09-29,Sikkim,1426,14,1426,17771,1743,291,8.02,0,0.7,808295,6666,803800,249.0,41.57,25.38714285714286,0.82,99.44
2022-09-30,Sikkim,1455,12,1451,18196,3437,290,8.0,0,0.7,809750,6678,805251,491.0,41.43,25.994285714285713,0.82,99.44
2022-10-01,Sikkim,443,5,437,5348,2436,1879,8.28,1,0.7,810193,6683,805688,348.0,268.43,7.64,0.82,99.44
2022-10-02,Sikkim,815,7,807,9871,1289,522,8.26,1,0.7,811008,6690,806495,184.14,74.57,14.101428571428572,0.82,99.44
2022-10-03,Sikkim,969,9,966,12387,4824,2442,7.82,0,0.7,811977,6699,807461,689.14,348.86,17.695714285714285,0.83,99.44
2022-10-04,Sikkim,184,2,180,2491,901,504,7.39,2,0.7,812161,6701,807641,128.71,72.0,3.5585714285714287,0.83,99.44
2022-10-05,Sikkim,991,6,987,12297,3067,1475,8.06,0,0.7,813152,6707,808628,438.14,210.71,17.56714285714286,0.82,99.44
2022-10-06,Sikkim,1036,6,1036,12727,568,256,8.14,0,0.7,814188,6713,809664,81.14,36.57,18.181428571428572,0.82,99.44
2022-10-07,Sikkim,351,4,349,4303,229,13,8.16,0,0.7,814539,6717,810013,32.71,1.86,6.147142857142857,0.82,99.44
2022-10-08,Sikkim,976,7,970,11989,1926,1129,8.14,0,0.7,815515,6724,810983,275.14,161.29,17.127142857142857,0.82,99.44
2022-10-09,Sikkim,1171,16,1171,14767,3418,2702,7.93,0,0.7,816686,6740,812154,488.29,386.0,21.095714285714287,0.83,99.45
2022-10-10,Sikkim,584,5,582,7086,3450,691,8.24,0,0.7,817270,6745,812736,492.86,98.71,10.122857142857143,0.83,99.45
2022-10-11,Sikkim,1068,11,1062,12915,3729,2631,8.27,0,0.7,818338,6756,813798,532.71,375.86,18.45,0.83,99.45
2022-10-12,Sikkim,1245,13,1238,15768,2768,1056,7.9,0,0.7,819583,6769,815036,395.43,150.86,22.525714285714287,0.83,99.45
2022-10-13,Sikkim,274,3,268,3567,4784,2067,7.68,3,0.7,819857,6772,815304,683.43,295.29,5.095714285714286,0.83,99.44
2022-10-14,Sikkim,793,3,788,9356,1670,429,8.48,2,0.7,820650,6775,816092,238.57,61.29,13.365714285714287,0.83,99.44
2022-10-15,Sikkim,540,4,538,6881,2206,546,7.85,0,0.7,821190,6779,816630,315.14,78.0,9.83,0.83,99.44
2022-10-16,Sikkim,1471,6,1469,18639,2962,1437,7.89,0,0.7,822661,6785,818099,423.14,205.29,26.627142857142857,0.82,99.45
2022-10-17,Sikkim,584,8,575,7450,295,17,7.84,1,0.7,823245,6793,818674,42.14,2.43,10.642857142857142,0.83,99.44
2022-10-18,Sikkim,1110,15,1105,14187,629,187,7.82,0,0.7,824355,6808,819779,89.86,26.71,20.267142857142858,0.83,99.44
2022-10-19,Sikkim,441,1,434,5446,2594,1633,8.1,6,0.7,824796,6809,820213,370.57,233.29,7.78,0.83,99.44
2022-10-20,Sikkim,947,10,938,11358,1248,83,8.34,0,0.7,825743,6819,821151,178.29,11.86,16.225714285714286,0.83,99.44
2022-10-21,Sikkim,616,6,607,7751,4904,2407,7.95,3,0.7,826359,6825,821758,700.57,343.86,11.072857142857142,0.83,99.44
2022-10-22,Sikkim,1474,15,1474,18228,4441,4290,8.09,0,0.7,827833,6840,823232,634.43,612.86,26.04,0.83,99.44
2022-10-23,Sikkim,1167,15,1161,14483,2621,182,8.06,0,0.7,829000,6855,824393,374.43,26.0,20.69,0.83,99.44
2022-10-24,Sikkim,1422,11,1418,17697,3727,1516,8.04,0,0.7,830422,6866,825811,532.43,216.57,25.28142857142857,0.83,99.44
2022-10-25,Sikkim,908,7,901,11297,3912,1299,8.04,0,0.7,831330,6873,826712,558.86,185.57,16.138571428571428,0.83,99.44
2022-10-26,Sikkim,781,10,777,9703,3517,1925,8.05,0,0.7,832111,6883,827489,502.43,275.0,13.861428571428572,0.83,99.44
2022-10-27,Sikkim,11,0,4,585,2258,347,1.88,7,0.7,832122,6883,827493,322.57,49.57,0.8357142857142857,0.83,99.44
2022-10-28,Sikkim,616,3,608,7699,4561,1670,8.0,5,0.7,832738,6886,828101,651.57,238.57,10.998571428571429,0.83,99.44
2022-10-29,Sikkim,593,2,584,7296,118,37,8.13,7,0.7,833331,6888,828685,16.86,5.29,10.422857142857143,0.83,99.44
2022-10-30,Sikkim,938,5,932,11751,444,114,7.98,1,0.7,834269,6893,829617,63.43,16.29,16.787142857142857,0.83,99.44
2022-10-31,Sikkim,471,3,468,5769,1872,1733,8.16,0,0.7,834740,6896,830085,267.43,247.57,8.241428571428571,0.83,99.44
2022-11-01,Sikkim,1262,10,1253,15433,2267,1822,8.18,0,0.7,836002,6906,831338,323.86,260.29,22.047142857142855,0.83,99.44
2022-11-02,Sikkim,1480,15,1476,18097,4628,2929,8.18,0,0.7,837482,6921,832814,661.14,418.43,25.852857142857143,0.83,99.44
2022-11-03,Sikkim,794,6,789,9934,3223,1888,7.99,0,0.7,838276,6927,833603,460.43,269.71,14.191428571428572,0.83,99.44
2022-11-04,Sikkim,103,0,100,1049,3293,1313,9.82,3,0.7,838379,6927,833703,470.43,187.57,1.4985714285714287,0.83,99.44
2022-11-05,Sikkim,734,6,731,9109,3020,2904,8.06,0,0.7,839113,6933,834434,431.43,414.86,13.012857142857143,0.83,99.44
2022-11-06,Sikkim,1498,16,1496,19233,1130,995,7.79,0,0.7,840611,6949,835930,161.43,142.14,27.475714285714286,0.83,99.44
2022-11-07,Sikkim,1520,6,1514,19251,2060,1195,7.9,0,0.7,842131,6955,837444,294.29,170.71,27.501428571428573,0.83,99.44
2022-11-08,Sikkim,468,6,462,5776,489,368,8.1,0,0.7,842599,6961,837906,69.86,52.57,8.251428571428571,0.83,99.44
2022-11-09,Sikkim,531,5,528,6638,3468,2035,8.0,0,0.7,843130,6966,838434,495.43,290.71,9.482857142857142,0.83,99.44
2022-11-10,Sikkim,1573,4,1569,19944,2502,373,7.89,0,0.7,844703,6970,840003,357.43,53.29,28.49142857142857,0.83,99.44
2022-11-11,Sikkim,1515,21,1511,18924,3864,2560,8.01,0,0.7,846218,6991,841514,552.0,365.71,27.034285714285716,0.83,99.44
2022-11-12,Sikkim,150,1,149,1709,2826,2078,8.78,0,0.7,846368,6992,841663,403.71,296.86,2.4414285714285713,0.83,99.44
2022-11-13,Sikkim,1324,12,1316,16195,98,75,8.18,0,0.7,847692,7004,842979,14.0,10.71,23.135714285714286,0.83,99.44
2022-11-14,Sikkim,443,6,440,5671,207,53,7.81,0,0.7,848135,7010,843419,29.57,7.57,8.101428571428572,0.83,99.44
2022-11-15,Sikkim,1502,16,1495,18628,1080,630,8.06,0,0.7,849637,7026,844914,154.29,90.0,26.611428571428572,0.83,99.44
2022-11-16,Sikkim,1578,17,1578,19948,1401,1074,7.91,0,0.7,851215,7043,846492,200.14,153.43,28.497142857142858,0.83,99.45
2022-11-17,Sikkim,1213,8,1209,14598,4145,1880,8.31,0,0.7,852428,7051,847701,592.14,268.57,20.854285714285716,0.83,99.45
2022-11-18,Sikkim,431,3,424,5313,1641,1543,8.11,4,0.7,852859,7054,848125,234.43,220.43,7.59,0.83,99.44
2022-11-19,Sikkim,616,4,615,7556,2671,661,8.15,0,0.7,853475,7058,848740,381.57,94.43,10.794285714285714,0.83,99.45
2022-11-20,Sikkim,245,3,236,3018,434,0,8.12,6,0.7,853720,7061,848976,62.0,0.0,4.311428571428571,0.83,99.44
2022-11-21,Sikkim,1342,9,1335,16756,4835,1428,8.01,0,0.7,855062,7070,850311,690.71,204.0,23.937142857142856,0.83,99.44
2022-11-22,Sikkim,1066,6,1062,13294,1103,62,8.02,0,0.7,856128,7076,851373,157.57,8.86,18.99142857142857,0.83,99.44
2022-11-23,Sikkim,100,1,99,1001,1574,1442,9.99,0,0.7,856228,7077,851472,224.86,206.0,1.43,0.83,99.44
2022-11-24,Sikkim,1007,5,1000,12882,1023,762,7.82,2,0.7,857235,7082,852472,146.14,108.86,18.402857142857144,0.83,99.44
2022-11-25,Sikkim,557,6,551,6881,3288,1405,8.09,0,0.7,857792,7088,853023,469.71,200.71,9.83,0.83,99.44
2022-11-26,Sikkim,87,0,83,1235,3397,1337,7.04,4,0.7,857879,7088,853106,485.29,191.0,1.7642857142857142,0.83,99.44
2022-11-27,Sikkim,273,1,267,3426,1799,844,7.97,5,0.7,858152,7089,853373,257.0,120.57,4.894285714285714,0.83,99.44
2022-11-28,Sikkim,1098,11,1097,13418,1971,166,8.18,0,0.7,859250,7100,854470,281.57,23.71,19.16857142857143,0.83,99.44
2022-11-29,Sikkim,115,0,112,1290,3542,2097,8.91,3,0.7,859365,7100,854582,506.0,299.57,1.8428571428571427,0.83,99.44
2022-11-30,Sikkim,783,2,782,9532,1529,610,8.21,0,0.7,860148,7102,855364,218.43,87.14,13.617142857142857,0.83,99.44
2022-12-01,Sikkim,569,7,560,6539,882,674,8.7,2,0.7,860717,7109,855924,126.0,96.29,9.34142857142857,0.83,99.44
2022-12-02,Sikkim,163,2,162,2128,1747,1649,7.66,0,0.7,860880,7111,856086,249.57,235.57,3.04,0.83,99.44
2022-12-03,Sikkim,824,11,824,10311,1005,558,7.99,0,0.7,861704,7122,856910,143.57,79.71,14.73,0.83,99.44
2022-12-04,Sikkim,1131,13,1130,14174,1702,498,7.98,0,0.7,862835,7135,858040,243.14,71.14,20.248571428571427,0.83,99.44
2022-12-05,Sikkim,1514,15,1514,19176,3222,221,7.9,0,0.7,864349,7150,859554,460.29,31.57,27.394285714285715,0.83,99.45
2022-12-06,Sikkim,516,1,515,6616,1282,819,7.8,0,0.7,864865,7151,860069,183.14,117.0,9.451428571428572,0.83,99.45
2022-12-07,Sikkim,1215,3,1213,15231,4987,4964,7.98,0,0.7,866080,7154,861282,712.43,709.14,21.75857142857143,0.83,99.45
2022-12-08,Sikkim,572,6,569,6902,3256,1099,8.29,0,0.7,866652,7160,861851,465.14,157.0,9.86,0.83,99.45
2022-12-09,Sikkim,1105,4,1105,13655,1075,524,8.09,0,0.7,867757,7164,862956,153.57,74.86,19.507142857142856,0.83,99.45
2022-12-10,Sikkim,912,4,910,11466,1387,1323,7.95,0,0.7,868669,7168,863866,198.14,189.0,16.38,0.83,99.45
2022-12-11,Sikkim,57,0,51,1056,3939,1636,5.4,6,0.7,868726,7168,863917,562.71,233.71,1.5085714285714287,0.83,99.45
2022-12-12,Sikkim,495,5,492,6067,3039,3002,8.16,0,0.7,869221,7173,864409,434.14,428.86,8.667142857142856,0.83,99.45
2022-12-13,Sikkim,221,2,217,2809,4405,668,7.87,2,0.7,869442,7175,864626,629.29,95.43,4.0128571428571425,0.83,99.45
2022-12-14,Sikkim,1193,14,1192,14485,4861,1518,8.24,0,0.7,870635,7189,865818,694.43,216.86,20.692857142857143,0.83,99.45
2022-12-15,Sikkim,1075,10,1068,13664,2524,1499,7.87,0,0.7,871710,7199,866886,360.57,214.14,19.52,0.83,99.45
2022-12-16,Sikkim,1555,21,1546,18828,4975,91,8.26,0,0.7,873265,7220,868432,710.71,13.0,26.897142857142857,0.83,99.45
2022-12-17,Sikkim,747,3,744,9180,25,6,8.14,0,0.7,874012,7223,869176,3.57,0.86,13.114285714285714,0.83,99.45
2022-12-18,Sikkim,164,0,159,1950,4303,3531,8.41,5,0.7,874176,7223,869335,614.71,504.43,2.7857142857142856,0.83,99.45
2022-12-19,Sikkim,1008,8,1002,12060,3387,852,8.36,0,0.7,875184,7231,870337,483.86,121.71,17.228571428571428,0.83,99.45
2022-12-20,Sikkim,1567,20,1563,19637,3978,3070,7.98,0,0.7,876751,7251,871900,568.29,438.57,28.052857142857142,0.83,99.45
2022-12-21,Sikkim,1212,9,1209,15273,1707,89,7.94,0,0.7,877963,7260,873109,243.86,12.71,21.818571428571428,0.83,99.45
2022-12-22,Sikkim,1573,6,1567,19799,1591,1432,7.94,0,0.7,879536,7266,874676,227.29,204.57,28.284285714285716,0.83,99.45
2022-12-23,Sikkim,1483,7,1476,18205,2997,640,8.15,0,0.7,881019,7273,876152,428.14,91.43,26.007142857142856,0.83,99.45
2022-12-24,Sikkim,473,4,464,6083,2761,2245,7.78,5,0.7,881492,7277,876616,394.43,320.71,8.69,0.83,99.45
2022-12-25,Sikkim,877,12,870,10986,2065,220,7.98,0,0.7,882369,7289,877486,295.0,31.43,15.694285714285714,0.83,99.45
2022-12-26,Sikkim,253,1,249,3057,3840,3020,8.28,3,0.7,882622,7290,877735,548.57,431.43,4.367142857142857,0.83,99.45
2022-12-27,Sikkim,1374,15,1371,17548,3178,892,7.83,0,0.7,883996,7305,879106,454.0,127.43,25.068571428571428,0.83,99.45
2022-12-28,Sikkim,287,1,287,3801,969,323,7.55,0,0.7,884283,7306,879393,138.43,46.14,5.43,0.83,99.45
2022-12-29,Sikkim,1364,18,1361,16871,1160,1014,8.08,0,0.7,885647,7324,880754,165.71,144.86,24.10142857142857,0.83,99.45
2022-12-30,Sikkim,623,5,615,7992,3776,799,7.8,3,0.7,886270,7329,881369,539.43,114.14,11.417142857142856,0.83,99.45
2022-12-31,Sikkim,93,0,86,1132,998,388,8.22,7,0.7,886363,7329,881455,142.57,55.43,1.6171428571428572,0.83,99.45
2020-01-01,Tamil Nadu,782,6,776,10082,2377,924,7.76,0,78.8,782,6,776,3.02,1.17,0.12794416243654821,0.77,99.23
2020-01-02,Tamil Nadu,1469,20,1467,18358,3824,1093,8.0,0,78.8,2251,26,2243,4.85,1.39,0.2329695431472081,1.16,99.64
2020-01-03,Tamil Nadu,1244,11,1236,15683,4231,2281,7.93,0,78.8,3495,37,3479,5.37,2.89,0.1990228426395939,1.06,99.54
2020-01-04,Tamil Nadu,707,2,700,8476,2189,1956,8.34,5,78.8,4202,39,4179,2.78,2.48,0.10756345177664975,0.93,99.45
2020-01-05,Tamil Nadu,1515,11,1515,19146,2472,1736,7.91,0,78.8,5717,50,5694,3.14,2.2,0.24296954314720812,0.87,99.6
2020-01-06,Tamil Nadu,365,3,357,4889,150,146,7.47,5,78.8,6082,53,6051,0.19,0.19,0.062043147208121825,0.87,99.49
2020-01-07,Tamil Nadu,791,8,791,10266,501,370,7.71,0,78.8,6873,61,6842,0.64,0.47,0.1302791878172589,0.89,99.55
2020-01-08,Tamil Nadu,367,4,366,4133,4664,2912,8.88,0,78.8,7240,65,7208,5.92,3.7,0.0524492385786802,0.9,99.56
2020-01-09,Tamil Nadu,253,1,247,3439,3081,2899,7.36,5,78.8,7493,66,7455,3.91,3.68,0.04364213197969543,0.88,99.49
2020-01-10,Tamil Nadu,690,6,681,8526,2667,655,8.09,3,78.8,8183,72,8136,3.38,0.83,0.10819796954314721,0.88,99.43
2020-01-11,Tamil Nadu,1016,13,1016,12416,4891,3508,8.18,0,78.8,9199,85,9152,6.21,4.45,0.15756345177664974,0.92,99.49
2020-01-12,Tamil Nadu,138,1,135,1297,286,125,10.64,2,78.8,9337,86,9287,0.36,0.16,0.01645939086294416,0.92,99.46
2020-01-13,Tamil Nadu,98,0,97,1501,892,324,6.53,1,78.8,9435,86,9384,1.13,0.41,0.019048223350253808,0.91,99.46
2020-01-14,Tamil Nadu,1398,14,1393,17589,3301,450,7.95,0,78.8,10833,100,10777,4.19,0.57,0.22321065989847716,0.92,99.48
2020-01-15,Tamil Nadu,199,1,198,2057,2422,1253,9.67,0,78.8,11032,101,10975,3.07,1.59,0.026104060913705585,0.92,99.48
2020-01-16,Tamil Nadu,1268,4,1263,15831,3762,289,8.01,1,78.8,12300,105,12238,4.77,0.37,0.2009010152284264,0.85,99.5
2020-01-17,Tamil Nadu,1462,11,1459,18076,4771,3895,8.09,0,78.8,13762,116,13697,6.05,4.94,0.22939086294416244,0.84,99.53
2020-01-18,Tamil Nadu,782,7,776,9659,853,178,8.1,0,78.8,14544,123,14473,1.08,0.23,0.12257614213197969,0.85,99.51
2020-01-19,Tamil Nadu,1357,13,1350,17086,115,26,7.94,0,78.8,15901,136,15823,0.15,0.03,0.2168274111675127,0.86,99.51
2020-01-20,Tamil Nadu,348,4,342,4394,1135,13,7.92,2,78.8,16249,140,16165,1.44,0.02,0.05576142131979695,0.86,99.48
2020-01-21,Tamil Nadu,1405,11,1400,17433,1383,1208,8.06,0,78.8,17654,151,17565,1.76,1.53,0.22123096446700508,0.86,99.5
2020-01-22,Tamil Nadu,825,3,822,10250,3143,1187,8.05,0,78.8,18479,154,18387,3.99,1.51,0.13007614213197968,0.83,99.5
2020-01-23,Tamil Nadu,1259,16,1252,15687,1000,322,8.03,0,78.8,19738,170,19639,1.27,0.41,0.1990736040609137,0.86,99.5
2020-01-24,Tamil Nadu,872,8,868,11079,4829,3717,7.87,0,78.8,20610,178,20507,6.13,4.72,0.1405964467005076,0.86,99.5
2020-01-25,Tamil Nadu,198,2,197,2337,2993,531,8.47,0,78.8,20808,180,20704,3.8,0.67,0.02965736040609137,0.87,99.5
2020-01-26,Tamil Nadu,336,3,335,4354,1030,210,7.72,0,78.8,21144,183,21039,1.31,0.27,0.05525380710659898,0.87,99.5
2020-01-27,Tamil Nadu,1326,11,1317,16707,2707,265,7.94,0,78.8,22470,194,22356,3.44,0.34,0.21201776649746193,0.86,99.49
2020-01-28,Tamil Nadu,1569,10,1566,19608,1221,240,8.0,0,78.8,24039,204,23922,1.55,0.3,0.24883248730964466,0.85,99.51
2020-01-29,Tamil Nadu,434,1,432,5556,4282,1170,7.81,1,78.8,24473,205,24354,5.43,1.48,0.07050761421319797,0.84,99.51
2020-01-30,Tamil Nadu,1416,5,1407,17701,3078,874,8.0,4,78.8,25889,210,25761,3.91,1.11,0.22463197969543147,0.81,99.51
2020-01-31,Tamil Nadu,1481,6,1476,18157,394,25,8.16,0,78.8,27370,216,27237,0.5,0.03,0.23041878172588834,0.79,99.51
2020-02-01,Tamil Nadu,534,7,529,6840,3856,2060,7.81,0,78.8,27904,223,27766,4.89,2.61,0.0868020304568528,0.8,99.51
2020-02-02,Tamil Nadu,838,2,835,10337,755,343,8.11,1,78.8,28742,225,28601,0.96,0.44,0.13118020304568528,0.78,99.51
2020-02-03,Tamil Nadu,97,0,93,1164,2507,376,8.33,4,78.8,28839,225,28694,3.18,0.48,0.014771573604060914,0.78,99.5
2020-02-04,Tamil Nadu,683,5,678,7958,2397,981,8.58,0,78.8,29522,230,29372,3.04,1.24,0.10098984771573605,0.78,99.49
2020-02-05,Tamil Nadu,853,3,852,10861,956,190,7.85,0,78.8,30375,233,30224,1.21,0.24,0.1378299492385787,0.77,99.5
2020-02-06,Tamil Nadu,951,9,949,12062,553,430,7.88,0,78.8,31326,242,31173,0.7,0.55,0.1530710659898477,0.77,99.51
2020-02-07,Tamil Nadu,1319,17,1316,16205,935,95,8.14,0,78.8,32645,259,32489,1.19,0.12,0.2056472081218274,0.79,99.52
2020-02-08,Tamil Nadu,1461,14,1459,18749,3170,2690,7.79,0,78.8,34106,273,33948,4.02,3.41,0.2379314720812183,0.8,99.54
2020-02-09,Tamil Nadu,790,10,784,9745,968,543,8.11,0,78.8,34896,283,34732,1.23,0.69,0.12366751269035534,0.81,99.53
2020-02-10,Tamil Nadu,116,1,107,1481,2689,1521,7.83,8,78.8,35012,284,34839,3.41,1.93,0.018794416243654823,0.81,99.51
2020-02-11,Tamil Nadu,1097,9,1097,13510,4263,2624,8.12,0,78.8,36109,293,35936,5.41,3.33,0.1714467005076142,0.81,99.52
2020-02-12,Tamil Nadu,298,4,295,3458,252,30,8.62,0,78.8,36407,297,36231,0.32,0.04,0.04388324873096447,0.82,99.52
2020-02-13,Tamil Nadu,1049,15,1042,13110,246,0,8.0,0,78.8,37456,312,37273,0.31,0.0,0.16637055837563453,0.83,99.51
2020-02-14,Tamil Nadu,1093,8,1085,12981,3146,83,8.42,0,78.8,38549,320,38358,3.99,0.11,0.16473350253807106,0.83,99.5
2020-02-15,Tamil Nadu,1006,12,999,12302,4793,3509,8.18,0,78.8,39555,332,39357,6.08,4.45,0.15611675126903554,0.84,99.5
2020-02-16,Tamil Nadu,425,5,417,5106,3133,2187,8.32,3,78.8,39980,337,39774,3.98,2.78,0.06479695431472081,0.84,99.48
2020-02-17,Tamil Nadu,140,2,134,1715,656,81,8.16,4,78.8,40120,339,39908,0.83,0.1,0.021763959390862946,0.84,99.47
2020-02-18,Tamil Nadu,722,10,716,9420,1648,557,7.66,0,78.8,40842,349,40624,2.09,0.71,0.11954314720812183,0.85,99.47
2020-02-19,Tamil Nadu,923,5,916,11345,2460,2321,8.14,2,78.8,41765,354,41540,3.12,2.95,0.14397208121827412,0.85,99.46
2020-02-20,Tamil Nadu,1016,9,1016,12408,984,245,8.19,0,78.8,42781,363,42556,1.25,0.31,0.15746192893401015,0.85,99.47
2020-02-21,Tamil Nadu,871,10,863,10804,1666,314,8.06,0,78.8,43652,373,43419,2.11,0.4,0.13710659898477157,0.85,99.47
2020-02-22,Tamil Nadu,1222,9,1222,15619,86,52,7.82,0,78.8,44874,382,44641,0.11,0.07,0.19821065989847717,0.85,99.48
2020-02-23,Tamil Nadu,227,1,222,3072,2853,1663,7.39,4,78.8,45101,383,44863,3.62,2.11,0.03898477157360406,0.85,99.47
2020-02-24,Tamil Nadu,233,1,231,2899,4759,28,8.04,1,78.8,45334,384,45094,6.04,0.04,0.03678934010152284,0.85,99.47
2020-02-25,Tamil Nadu,1257,8,1252,15497,2705,16,8.11,0,78.8,46591,392,46346,3.43,0.02,0.19666243654822335,0.84,99.47
2020-02-26,Tamil Nadu,82,0,76,1191,2645,2621,6.88,6,78.8,46673,392,46422,3.36,3.33,0.015114213197969543,0.84,99.46
2020-02-27,Tamil Nadu,362,2,360,5103,1211,503,7.09,0,78.8,47035,394,46782,1.54,0.64,0.06475888324873097,0.84,99.46
2020-02-28,Tamil Nadu,1257,14,1253,15656,1324,755,8.03,0,78.8,48292,408,48035,1.68,0.96,0.1986802030456853,0.84,99.47
2020-02-29,Tamil Nadu,366,2,365,4898,724,354,7.47,0,78.8,48658,410,48400,0.92,0.45,0.06215736040609137,0.84,99.47
2020-03-01,Tamil Nadu,1326,15,1317,16160,3694,2782,8.21,0,78.8,49984,425,49717,4.69,3.53,0.2050761421319797,0.85,99.47
2020-03-02,Tamil Nadu,1457,17,1449,18349,2358,1940,7.94,0,78.8,51441,442,51166,2.99,2.46,0.23285532994923858,0.86,99.47
2020-03-03,Tamil Nadu,876,11,876,10723,1902,1122,8.17,0,78.8,52317,453,52042,2.41,1.42,0.1360786802030457,0.87,99.47
2020-03-04,Tamil Nadu,269,3,269,3530,3250,2385,7.62,0,78.8,52586,456,52311,4.12,3.03,0.04479695431472081,0.87,99.48
2020-03-05,Tamil Nadu,1189,12,1186,14259,4221,770,8.34,0,78.8,53775,468,53497,5.36,0.98,0.18095177664974618,0.87,99.48
2020-03-06,Tamil Nadu,1131,10,1128,13953,4062,1805,8.11,0,78.8,54906,478,54625,5.15,2.29,0.17706852791878172,0.87,99.49
2020-03-07,Tamil Nadu,936,4,936,11949,3738,1774,7.83,0,78.8,55842,482,55561,4.74,2.25,0.15163705583756346,0.86,99.5
2020-03-08,Tamil Nadu,1465,21,1465,18234,678,163,8.03,0,78.8,57307,503,57026,0.86,0.21,0.2313959390862944,0.88,99.51
2020-03-09,Tamil Nadu,269,4,269,3526,2432,503,7.63,0,78.8,57576,507,57295,3.09,0.64,0.04474619289340102,0.88,99.51
2020-03-10,Tamil Nadu,1308,4,1299,16480,1356,687,7.94,5,78.8,58884,511,58594,1.72,0.87,0.20913705583756345,0.87,99.51
2020-03-11,Tamil Nadu,879,10,870,10671,1370,337,8.24,0,78.8,59763,521,59464,1.74,0.43,0.13541878172588834,0.87,99.5
2020-03-12,Tamil Nadu,1438,7,1438,17494,2985,2308,8.22,0,78.8,61201,528,60902,3.79,2.93,0.22200507614213197,0.86,99.51
2020-03-13,Tamil Nadu,1158,10,1151,14737,2976,1882,7.86,0,78.8,62359,538,62053,3.78,2.39,0.18701776649746193,0.86,99.51
2020-03-14,Tamil Nadu,494,3,492,6392,2045,1672,7.73,0,78.8,62853,541,62545,2.6,2.12,0.08111675126903553,0.86,99.51
2020-03-15,Tamil Nadu,1452,19,1448,17944,1480,635,8.09,0,78.8,64305,560,63993,1.88,0.81,0.22771573604060913,0.87,99.51
2020-03-16,Tamil Nadu,1361,14,1360,16536,4253,67,8.23,0,78.8,65666,574,65353,5.4,0.09,0.2098477157360406,0.87,99.52
2020-03-17,Tamil Nadu,806,6,800,10225,1711,1175,7.88,0,78.8,66472,580,66153,2.17,1.49,0.12975888324873097,0.87,99.52
2020-03-18,Tamil Nadu,375,4,375,4701,827,173,7.98,0,78.8,66847,584,66528,1.05,0.22,0.05965736040609137,0.87,99.52
2020-03-19,Tamil Nadu,409,1,401,5128,2120,440,7.98,7,78.8,67256,585,66929,2.69,0.56,0.0650761421319797,0.87,99.51
2020-03-20,Tamil Nadu,223,2,215,2774,4945,4527,8.04,6,78.8,67479,587,67144,6.28,5.74,0.03520304568527919,0.87,99.5
2020-03-21,Tamil Nadu,1509,14,1507,18580,3894,1372,8.12,0,78.8,68988,601,68651,4.94,1.74,0.23578680203045685,0.87,99.51
2020-03-22,Tamil Nadu,518,4,512,6298,3804,2345,8.22,2,78.8,69506,605,69163,4.83,2.98,0.07992385786802031,0.87,99.51
2020-03-23,Tamil Nadu,724,6,716,8847,199,44,8.18,2,78.8,70230,611,69879,0.25,0.06,0.11227157360406091,0.87,99.5
2020-03-24,Tamil Nadu,318,1,310,4006,4574,951,7.94,7,78.8,70548,612,70189,5.8,1.21,0.05083756345177665,0.87,99.49
2020-03-25,Tamil Nadu,193,1,192,2422,2811,2114,7.97,0,78.8,70741,613,70381,3.57,2.68,0.030736040609137056,0.87,99.49
2020-03-26,Tamil Nadu,209,2,200,2723,3546,291,7.68,7,78.8,70950,615,70581,4.5,0.37,0.03455583756345178,0.87,99.48
2020-03-27,Tamil Nadu,519,7,517,6653,2479,2319,7.8,0,78.8,71469,622,71098,3.15,2.94,0.08442893401015228,0.87,99.48
2020-03-28,Tamil Nadu,509,7,500,6021,1684,209,8.45,2,78.8,71978,629,71598,2.14,0.27,0.07640862944162437,0.87,99.47
2020-03-29,Tamil Nadu,690,8,684,8929,425,248,7.73,0,78.8,72668,637,72282,0.54,0.31,0.11331218274111675,0.88,99.47
2020-03-30,Tamil Nadu,1279,8,1271,15546,739,486,8.23,0,78.8,73947,645,73553,0.94,0.62,0.19728426395939086,0.87,99.47
2020-03-31,Tamil Nadu,85,1,77,910,4218,1744,9.34,7,78.8,74032,646,73630,5.35,2.21,0.011548223350253807,0.87,99.46
2020-04-01,Tamil Nadu,386,4,379,4744,3602,3519,8.14,3,78.8,74418,650,74009,4.57,4.47,0.06020304568527919,0.87,99.45
2020-04-02,Tamil Nadu,1596,19,1593,19799,2578,1233,8.06,0,78.8,76014,669,75602,3.27,1.56,0.251256345177665,0.88,99.46
2020-04-03,Tamil Nadu,127,0,122,1688,2558,1506,7.52,5,78.8,76141,669,75724,3.25,1.91,0.021421319796954316,0.88,99.45
2020-04-04,Tamil Nadu,922,3,915,11501,4984,1698,8.02,4,78.8,77063,672,76639,6.32,2.15,0.1459517766497462,0.87,99.45
2020-04-05,Tamil Nadu,671,9,668,8351,4270,1963,8.03,0,78.8,77734,681,77307,5.42,2.49,0.1059771573604061,0.88,99.45
2020-04-06,Tamil Nadu,627,4,623,7501,3583,140,8.36,0,78.8,78361,685,77930,4.55,0.18,0.09519035532994924,0.87,99.45
2020-04-07,Tamil Nadu,202,1,193,2378,3155,167,8.49,8,78.8,78563,686,78123,4.0,0.21,0.030177664974619288,0.87,99.44
2020-04-08,Tamil Nadu,600,6,597,7519,1374,226,7.98,0,78.8,79163,692,78720,1.74,0.29,0.09541878172588833,0.87,99.44
2020-04-09,Tamil Nadu,1486,20,1482,18494,1724,1022,8.04,0,78.8,80649,712,80202,2.19,1.3,0.23469543147208122,0.88,99.45
2020-04-10,Tamil Nadu,114,1,114,1675,3133,2190,6.81,0,78.8,80763,713,80316,3.98,2.78,0.021256345177664976,0.88,99.45
2020-04-11,Tamil Nadu,111,0,103,1359,2834,1907,8.17,8,78.8,80874,713,80419,3.6,2.42,0.017246192893401017,0.88,99.44
2020-04-12,Tamil Nadu,362,3,356,5031,2026,1584,7.2,3,78.8,81236,716,80775,2.57,2.01,0.06384517766497462,0.88,99.43
2020-04-13,Tamil Nadu,510,5,502,6544,4516,3888,7.79,3,78.8,81746,721,81277,5.73,4.93,0.08304568527918782,0.88,99.43
2020-04-14,Tamil Nadu,337,1,335,3866,4732,4296,8.72,1,78.8,82083,722,81612,6.01,5.45,0.049060913705583756,0.88,99.43
2020-04-15,Tamil Nadu,776,7,768,10223,1083,264,7.59,1,78.8,82859,729,82380,1.37,0.34,0.12973350253807106,0.88,99.42
2020-04-16,Tamil Nadu,1095,10,1091,13702,2102,243,7.99,0,78.8,83954,739,83471,2.67,0.31,0.17388324873096447,0.88,99.42
2020-04-17,Tamil Nadu,674,2,669,8745,4643,2440,7.71,3,78.8,84628,741,84140,5.89,3.1,0.11097715736040609,0.88,99.42
2020-04-18,Tamil Nadu,1388,7,1382,17417,690,348,7.97,0,78.8,86016,748,85522,0.88,0.44,0.2210279187817259,0.87,99.43
2020-04-19,Tamil Nadu,469,4,468,5719,3297,619,8.2,0,78.8,86485,752,85990,4.18,0.79,0.0725761421319797,0.87,99.43
2020-04-20,Tamil Nadu,301,2,299,3654,338,161,8.24,0,78.8,86786,754,86289,0.43,0.2,0.046370558375634516,0.87,99.43
2020-04-21,Tamil Nadu,467,1,466,6384,2956,1744,7.32,0,78.8,87253,755,86755,3.75,2.21,0.08101522842639594,0.87,99.43
2020-04-22,Tamil Nadu,1396,20,1394,17551,4315,2262,7.95,0,78.8,88649,775,88149,5.48,2.87,0.2227284263959391,0.87,99.44
2020-04-23,Tamil Nadu,1173,12,1164,14279,3274,2229,8.21,0,78.8,89822,787,89313,4.15,2.83,0.18120558375634518,0.88,99.43
2020-04-24,Tamil Nadu,722,9,720,9120,3326,1765,7.92,0,78.8,90544,796,90033,4.22,2.24,0.11573604060913706,0.88,99.44
2020-04-25,Tamil Nadu,1306,5,1298,16407,4681,2527,7.96,3,78.8,91850,801,91331,5.94,3.21,0.20821065989847715,0.87,99.43
2020-04-26,Tamil Nadu,514,4,506,6305,687,399,8.15,4,78.8,92364,805,91837,0.87,0.51,0.08001269035532994,0.87,99.43
2020-04-27,Tamil Nadu,1234,11,1232,15720,2946,2407,7.85,0,78.8,93598,816,93069,3.74,3.05,0.19949238578680203,0.87,99.43
2020-04-28,Tamil Nadu,427,2,423,4922,4938,1877,8.68,2,78.8,94025,818,93492,6.27,2.38,0.062461928934010154,0.87,99.43
2020-04-29,Tamil Nadu,773,5,773,9806,143,9,7.88,0,78.8,94798,823,94265,0.18,0.01,0.12444162436548223,0.87,99.44
2020-04-30,Tamil Nadu,1057,10,1055,12760,3845,1684,8.28,0,78.8,95855,833,95320,4.88,2.14,0.1619289340101523,0.87,99.44
2020-05-01,Tamil Nadu,622,2,616,7379,200,34,8.43,4,78.8,96477,835,95936,0.25,0.04,0.09364213197969543,0.87,99.44
2020-05-02,Tamil Nadu,1030,11,1021,12160,3757,3158,8.47,0,78.8,97507,846,96957,4.77,4.01,0.15431472081218275,0.87,99.44
2020-05-03,Tamil Nadu,1169,6,1164,14857,573,21,7.87,0,78.8,98676,852,98121,0.73,0.03,0.18854060913705584,0.86,99.44
2020-05-04,Tamil Nadu,898,8,891,11198,3916,252,8.02,0,78.8,99574,860,99012,4.97,0.32,0.14210659898477157,0.86,99.44
2020-05-05,Tamil Nadu,20,0,19,624,3352,2272,3.21,1,78.8,99594,860,99031,4.25,2.88,0.007918781725888325,0.86,99.43
2020-05-06,Tamil Nadu,1441,5,1439,17921,995,981,8.04,0,78.8,101035,865,100470,1.26,1.24,0.2274238578680203,0.86,99.44
2020-05-07,Tamil Nadu,1426,9,1424,18099,2940,385,7.88,0,78.8,102461,874,101894,3.73,0.49,0.22968274111675127,0.85,99.45
2020-05-08,Tamil Nadu,1174,13,1168,14549,2863,633,8.07,0,78.8,103635,887,103062,3.63,0.8,0.18463197969543146,0.86,99.45
2020-05-09,Tamil Nadu,260,0,255,3203,62,50,8.12,5,78.8,103895,887,103317,0.08,0.06,0.04064720812182741,0.85,99.44
2020-05-10,Tamil Nadu,230,2,221,2834,948,232,8.12,7,78.8,104125,889,103538,1.2,0.29,0.03596446700507614,0.85,99.44
2020-05-11,Tamil Nadu,945,9,937,11615,785,699,8.14,0,78.8,105070,898,104475,1.0,0.89,0.1473984771573604,0.85,99.43
2020-05-12,Tamil Nadu,1561,15,1555,19524,4452,4236,8.0,0,78.8,106631,913,106030,5.65,5.38,0.24776649746192894,0.86,99.44
2020-05-13,Tamil Nadu,1327,12,1320,16400,1914,1634,8.09,0,78.8,107958,925,107350,2.43,2.07,0.20812182741116753,0.86,99.44
2020-05-14,Tamil Nadu,605,7,596,7575,1376,436,7.99,2,78.8,108563,932,107946,1.75,0.55,0.09612944162436549,0.86,99.43
2020-05-15,Tamil Nadu,892,6,890,11021,1718,441,8.09,0,78.8,109455,938,108836,2.18,0.56,0.13986040609137057,0.86,99.43
2020-05-16,Tamil Nadu,1516,8,1508,19048,4255,3773,7.96,0,78.8,110971,946,110344,5.4,4.79,0.2417258883248731,0.85,99.43
2020-05-17,Tamil Nadu,161,1,154,2036,2013,497,7.91,6,78.8,111132,947,110498,2.55,0.63,0.025837563451776648,0.85,99.43
2020-05-18,Tamil Nadu,1411,20,1410,17774,3333,1020,7.94,0,78.8,112543,967,111908,4.23,1.29,0.22555837563451778,0.86,99.44
2020-05-19,Tamil Nadu,1446,19,1437,17951,294,193,8.06,0,78.8,113989,986,113345,0.37,0.24,0.22780456852791878,0.86,99.44
2020-05-20,Tamil Nadu,155,1,154,1852,1640,1406,8.37,0,78.8,114144,987,113499,2.08,1.78,0.02350253807106599,0.86,99.43
2020-05-21,Tamil Nadu,756,5,747,9521,2932,95,7.94,4,78.8,114900,992,114246,3.72,0.12,0.1208248730964467,0.86,99.43
2020-05-22,Tamil Nadu,1334,8,1331,16509,3030,1775,8.08,0,78.8,116234,1000,115577,3.85,2.25,0.20950507614213199,0.86,99.43
2020-05-23,Tamil Nadu,1113,5,1110,13630,862,832,8.17,0,78.8,117347,1005,116687,1.09,1.06,0.1729695431472081,0.86,99.44
2020-05-24,Tamil Nadu,1334,8,1331,16679,1421,1139,8.0,0,78.8,118681,1013,118018,1.8,1.45,0.21166243654822334,0.85,99.44
2020-05-25,Tamil Nadu,1465,20,1461,18802,4710,3424,7.79,0,78.8,120146,1033,119479,5.98,4.35,0.2386040609137056,0.86,99.44
2020-05-26,Tamil Nadu,837,5,834,10292,2472,1271,8.13,0,78.8,120983,1038,120313,3.14,1.61,0.13060913705583757,0.86,99.45
2020-05-27,Tamil Nadu,877,10,872,11194,3027,60,7.83,0,78.8,121860,1048,121185,3.84,0.08,0.14205583756345178,0.86,99.45
2020-05-28,Tamil Nadu,375,3,367,4613,855,839,8.13,5,78.8,122235,1051,121552,1.09,1.06,0.05854060913705584,0.86,99.44
2020-05-29,Tamil Nadu,689,6,681,8568,2002,1763,8.04,2,78.8,122924,1057,122233,2.54,2.24,0.10873096446700507,0.86,99.44
2020-05-30,Tamil Nadu,165,2,165,2127,2132,305,7.76,0,78.8,123089,1059,122398,2.71,0.39,0.02699238578680203,0.86,99.44
2020-05-31,Tamil Nadu,255,2,250,3239,4044,1657,7.87,3,78.8,123344,1061,122648,5.13,2.1,0.04110406091370558,0.86,99.44
2020-06-01,Tamil Nadu,965,3,959,11728,3515,1498,8.23,3,78.8,124309,1064,123607,4.46,1.9,0.14883248730964466,0.86,99.44
2020-06-02,Tamil Nadu,1477,11,1468,18530,269,258,7.97,0,78.8,125786,1075,125075,0.34,0.33,0.2351522842639594,0.85,99.43
2020-06-03,Tamil Nadu,501,3,497,6392,99,65,7.84,1,78.8,126287,1078,125572,0.13,0.08,0.08111675126903553,0.85,99.43
2020-06-04,Tamil Nadu,759,7,753,9672,3788,3723,7.85,0,78.8,127046,1085,126325,4.81,4.72,0.12274111675126903,0.85,99.43
2020-06-05,Tamil Nadu,80,0,75,855,4821,1481,9.36,5,78.8,127126,1085,126400,6.12,1.88,0.0108502538071066,0.85,99.43
2020-06-06,Tamil Nadu,551,1,547,7416,4005,3199,7.43,3,78.8,127677,1086,126947,5.08,4.06,0.09411167512690355,0.85,99.43
2020-06-07,Tamil Nadu,1200,16,1197,14633,4427,3322,8.2,0,78.8,128877,1102,128144,5.62,4.22,0.1856979695431472,0.86,99.43
2020-06-08,Tamil Nadu,1066,15,1063,13184,4994,4286,8.09,0,78.8,129943,1117,129207,6.34,5.44,0.16730964467005077,0.86,99.43
2020-06-09,Tamil Nadu,1539,6,1538,19341,253,78,7.96,0,78.8,131482,1123,130745,0.32,0.1,0.24544416243654824,0.85,99.44
2020-06-10,Tamil Nadu,682,9,673,8768,2985,888,7.78,0,78.8,132164,1132,131418,3.79,1.13,0.11126903553299493,0.86,99.44
2020-06-11,Tamil Nadu,1568,8,1568,18960,4429,101,8.27,0,78.8,133732,1140,132986,5.62,0.13,0.24060913705583756,0.85,99.44
2020-06-12,Tamil Nadu,403,3,396,5101,1341,854,7.9,4,78.8,134135,1143,133382,1.7,1.08,0.06473350253807107,0.85,99.44
2020-06-13,Tamil Nadu,366,4,364,5022,3428,801,7.29,0,78.8,134501,1147,133746,4.35,1.02,0.06373096446700507,0.85,99.44
2020-06-14,Tamil Nadu,369,4,363,4820,1004,174,7.66,2,78.8,134870,1151,134109,1.27,0.22,0.06116751269035533,0.85,99.44
2020-06-15,Tamil Nadu,1292,6,1285,16228,133,132,7.96,1,78.8,136162,1157,135394,0.17,0.17,0.20593908629441623,0.85,99.44
2020-06-16,Tamil Nadu,1447,12,1440,18011,4250,902,8.03,0,78.8,137609,1169,136834,5.39,1.14,0.22856598984771573,0.85,99.44
2020-06-17,Tamil Nadu,806,8,805,9965,536,438,8.09,0,78.8,138415,1177,137639,0.68,0.56,0.12645939086294417,0.85,99.44
2020-06-18,Tamil Nadu,1553,12,1546,19529,4933,1403,7.95,0,78.8,139968,1189,139185,6.26,1.78,0.24782994923857868,0.85,99.44
2020-06-19,Tamil Nadu,1028,4,1026,13428,4513,450,7.66,0,78.8,140996,1193,140211,5.73,0.57,0.17040609137055837,0.85,99.44
2020-06-20,Tamil Nadu,1461,16,1454,18391,220,86,7.94,0,78.8,142457,1209,141665,0.28,0.11,0.23338832487309644,0.85,99.44
2020-06-21,Tamil Nadu,1162,11,1153,13972,3234,828,8.32,0,78.8,143619,1220,142818,4.1,1.05,0.17730964467005075,0.85,99.44
2020-06-22,Tamil Nadu,799,9,794,9599,3859,2888,8.32,0,78.8,144418,1229,143612,4.9,3.66,0.12181472081218274,0.85,99.44
2020-06-23,Tamil Nadu,218,1,218,2395,2431,2364,9.1,0,78.8,144636,1230,143830,3.09,3.0,0.030393401015228427,0.85,99.44
2020-06-24,Tamil Nadu,1505,16,1502,18735,1134,780,8.03,0,78.8,146141,1246,145332,1.44,0.99,0.237753807106599,0.85,99.45
2020-06-25,Tamil Nadu,1559,6,1552,19240,953,35,8.1,1,78.8,147700,1252,146884,1.21,0.04,0.24416243654822334,0.85,99.45
2020-06-26,Tamil Nadu,1367,10,1366,17068,2711,2038,8.01,0,78.8,149067,1262,148250,3.44,2.59,0.2165989847715736,0.85,99.45
2020-06-27,Tamil Nadu,207,1,200,2605,2670,1499,7.95,6,78.8,149274,1263,148450,3.39,1.9,0.033058375634517766,0.85,99.45
2020-06-28,Tamil Nadu,1167,3,1161,14440,4928,3922,8.08,3,78.8,150441,1266,149611,6.25,4.98,0.183248730964467,0.84,99.45
2020-06-29,Tamil Nadu,850,8,845,11283,2673,143,7.53,0,78.8,151291,1274,150456,3.39,0.18,0.14318527918781726,0.84,99.45
2020-06-30,Tamil Nadu,1065,15,1060,13725,4852,3401,7.76,0,78.8,152356,1289,151516,6.16,4.32,0.1741751269035533,0.85,99.45
2020-07-01,Tamil Nadu,1322,15,1321,16315,4139,2768,8.1,0,78.8,153678,1304,152837,5.25,3.51,0.20704314720812184,0.85,99.45
2020-07-02,Tamil Nadu,976,5,974,12591,4924,2261,7.75,0,78.8,154654,1309,153811,6.25,2.87,0.15978426395939085,0.85,99.45
2020-07-03,Tamil Nadu,425,1,425,5446,2576,950,7.8,0,78.8,155079,1310,154236,3.27,1.21,0.06911167512690355,0.84,99.46
2020-07-04,Tamil Nadu,1086,15,1081,13391,4548,3298,8.11,0,78.8,156165,1325,155317,5.77,4.19,0.16993654822335025,0.85,99.46
2020-07-05,Tamil Nadu,1207,14,1207,15226,342,57,7.93,0,78.8,157372,1339,156524,0.43,0.07,0.1932233502538071,0.85,99.46
2020-07-06,Tamil Nadu,1080,12,1075,13654,1712,886,7.91,0,78.8,158452,1351,157599,2.17,1.12,0.1732741116751269,0.85,99.46
2020-07-07,Tamil Nadu,335,3,330,3854,1240,111,8.69,2,78.8,158787,1354,157929,1.57,0.14,0.048908629441624364,0.85,99.46
2020-07-08,Tamil Nadu,1141,9,1132,14098,4725,3615,8.09,0,78.8,159928,1363,159061,6.0,4.59,0.17890862944162436,0.85,99.46
2020-07-09,Tamil Nadu,277,3,268,3430,7,0,8.08,6,78.8,160205,1366,159329,0.01,0.0,0.04352791878172589,0.85,99.45
2020-07-10,Tamil Nadu,1324,7,1315,16469,2679,2154,8.04,2,78.8,161529,1373,160644,3.4,2.73,0.208997461928934,0.85,99.45
2020-07-11,Tamil Nadu,251,1,248,3194,320,256,7.86,2,78.8,161780,1374,160892,0.41,0.32,0.04053299492385787,0.85,99.45
2020-07-12,Tamil Nadu,787,4,782,10369,3758,3335,7.59,1,78.8,162567,1378,161674,4.77,4.23,0.13158629441624364,0.85,99.45
2020-07-13,Tamil Nadu,1050,6,1049,13254,1934,1038,7.92,0,78.8,163617,1384,162723,2.45,1.32,0.1681979695431472,0.85,99.45
2020-07-14,Tamil Nadu,51,0,42,522,680,9,9.77,9,78.8,163668,1384,162765,0.86,0.01,0.006624365482233502,0.85,99.45
2020-07-15,Tamil Nadu,1102,15,1097,14236,3126,270,7.74,0,78.8,164770,1399,163862,3.97,0.34,0.18065989847715735,0.85,99.45
2020-07-16,Tamil Nadu,742,5,738,9471,3151,2696,7.83,0,78.8,165512,1404,164600,4.0,3.42,0.12019035532994923,0.85,99.45
2020-07-17,Tamil Nadu,159,1,158,1685,4410,725,9.44,0,78.8,165671,1405,164758,5.6,0.92,0.021383248730964467,0.85,99.45
2020-07-18,Tamil Nadu,719,6,717,9138,536,115,7.87,0,78.8,166390,1411,165475,0.68,0.15,0.11596446700507614,0.85,99.45
2020-07-19,Tamil Nadu,780,10,779,9570,1329,95,8.15,0,78.8,167170,1421,166254,1.69,0.12,0.12144670050761422,0.85,99.45
2020-07-20,Tamil Nadu,710,4,701,8721,4427,1917,8.14,5,78.8,167880,1425,166955,5.62,2.43,0.1106725888324873,0.85,99.45
2020-07-21,Tamil Nadu,695,9,687,8629,2313,1641,8.05,0,78.8,168575,1434,167642,2.94,2.08,0.10950507614213198,0.85,99.45
2020-07-22,Tamil Nadu,387,1,387,4745,4931,2736,8.16,0,78.8,168962,1435,168029,6.26,3.47,0.06021573604060914,0.85,99.45
2020-07-23,Tamil Nadu,1506,10,1501,19089,1930,175,7.89,0,78.8,170468,1445,169530,2.45,0.22,0.24224619289340102,0.85,99.45
2020-07-24,Tamil Nadu,975,11,968,12091,1878,1246,8.06,0,78.8,171443,1456,170498,2.38,1.58,0.15343908629441624,0.85,99.45
2020-07-25,Tamil Nadu,1069,9,1063,13245,1082,373,8.07,0,78.8,172512,1465,171561,1.37,0.47,0.16808375634517767,0.85,99.45
2020-07-26,Tamil Nadu,1206,11,1197,15685,4084,3736,7.69,0,78.8,173718,1476,172758,5.18,4.74,0.1990482233502538,0.85,99.45
2020-07-27,Tamil Nadu,1484,11,1483,18811,4235,810,7.89,0,78.8,175202,1487,174241,5.37,1.03,0.23871827411167512,0.85,99.45
2020-07-28,Tamil Nadu,815,9,808,10057,4708,407,8.1,0,78.8,176017,1496,175049,5.97,0.52,0.1276269035532995,0.85,99.45
2020-07-29,Tamil Nadu,1397,16,1395,17690,1811,1383,7.9,0,78.8,177414,1512,176444,2.3,1.76,0.22449238578680203,0.85,99.45
2020-07-30,Tamil Nadu,192,1,188,2693,1977,775,7.13,3,78.8,177606,1513,176632,2.51,0.98,0.0341751269035533,0.85,99.45
2020-07-31,Tamil Nadu,242,2,233,3272,4593,2617,7.4,7,78.8,177848,1515,176865,5.83,3.32,0.04152284263959391,0.85,99.45
2020-08-01,Tamil Nadu,1245,10,1239,16096,1032,435,7.73,0,78.8,179093,1525,178104,1.31,0.55,0.20426395939086295,0.85,99.45
2020-08-02,Tamil Nadu,528,4,521,6561,3356,2982,8.05,3,78.8,179621,1529,178625,4.26,3.78,0.08326142131979695,0.85,99.45
2020-08-03,Tamil Nadu,133,0,132,1476,2248,276,9.01,1,78.8,179754,1529,178757,2.85,0.35,0.018730964467005076,0.85,99.45
2020-08-04,Tamil Nadu,204,1,199,2771,1014,410,7.36,4,78.8,179958,1530,178956,1.29,0.52,0.03516497461928934,0.85,99.44
2020-08-05,Tamil Nadu,505,6,496,6275,1417,212,8.05,3,78.8,180463,1536,179452,1.8,0.27,0.07963197969543147,0.85,99.44
2020-08-06,Tamil Nadu,766,11,765,9625,3958,3427,7.96,0,78.8,181229,1547,180217,5.02,4.35,0.12214467005076142,0.85,99.44
2020-08-07,Tamil Nadu,400,4,396,5040,4918,1273,7.94,0,78.8,181629,1551,180613,6.24,1.62,0.06395939086294417,0.85,99.44
2020-08-08,Tamil Nadu,286,3,284,3692,3323,489,7.75,0,78.8,181915,1554,180897,4.22,0.62,0.04685279187817259,0.85,99.44
2020-08-09,Tamil Nadu,212,2,211,2735,3783,3777,7.75,0,78.8,182127,1556,181108,4.8,4.79,0.03470812182741117,0.85,99.44
2020-08-10,Tamil Nadu,665,2,659,8317,3241,2718,8.0,4,78.8,182792,1558,181767,4.11,3.45,0.10554568527918781,0.85,99.44
2020-08-11,Tamil Nadu,766,3,762,9826,3795,3783,7.8,1,78.8,183558,1561,182529,4.82,4.8,0.12469543147208122,0.85,99.44
2020-08-12,Tamil Nadu,338,1,338,4296,1245,393,7.87,0,78.8,183896,1562,182867,1.58,0.5,0.05451776649746193,0.85,99.44
2020-08-13,Tamil Nadu,1332,7,1330,16458,382,358,8.09,0,78.8,185228,1569,184197,0.48,0.45,0.20885786802030457,0.85,99.44
2020-08-14,Tamil Nadu,391,2,390,4215,4882,1284,9.28,0,78.8,185619,1571,184587,6.2,1.63,0.05348984771573604,0.85,99.44
2020-08-15,Tamil Nadu,292,4,285,3212,3305,562,9.09,3,78.8,185911,1575,184872,4.19,0.71,0.04076142131979695,0.85,99.44
2020-08-16,Tamil Nadu,188,2,184,2121,4360,2960,8.86,2,78.8,186099,1577,185056,5.53,3.76,0.026916243654822335,0.85,99.44
2020-08-17,Tamil Nadu,1038,12,1031,13161,2548,1491,7.89,0,78.8,187137,1589,186087,3.23,1.89,0.16701776649746192,0.85,99.44
2020-08-18,Tamil Nadu,1215,16,1212,15224,3870,2475,7.98,0,78.8,188352,1605,187299,4.91,3.14,0.19319796954314722,0.85,99.44
2020-08-19,Tamil Nadu,1081,13,1073,13277,3455,733,8.14,0,78.8,189433,1618,188372,4.38,0.93,0.16848984771573605,0.85,99.44
2020-08-20,Tamil Nadu,554,6,550,7017,3461,2240,7.9,0,78.8,189987,1624,188922,4.39,2.84,0.08904822335025381,0.85,99.44
2020-08-21,Tamil Nadu,1014,15,1005,12787,2325,1024,7.93,0,78.8,191001,1639,189927,2.95,1.3,0.16227157360406091,0.86,99.44
2020-08-22,Tamil Nadu,1074,11,1074,13147,3055,680,8.17,0,78.8,192075,1650,191001,3.88,0.86,0.16684010152284265,0.86,99.44
2020-08-23,Tamil Nadu,1023,13,1017,12384,3190,3050,8.26,0,78.8,193098,1663,192018,4.05,3.87,0.15715736040609138,0.86,99.44
2020-08-24,Tamil Nadu,435,2,429,5592,2860,1063,7.78,4,78.8,193533,1665,192447,3.63,1.35,0.07096446700507614,0.86,99.44
2020-08-25,Tamil Nadu,279,4,273,3049,1643,815,9.15,2,78.8,193812,1669,192720,2.09,1.03,0.03869289340101523,0.86,99.44
2020-08-26,Tamil Nadu,73,0,67,1005,393,7,7.26,6,78.8,193885,1669,192787,0.5,0.01,0.012753807106598986,0.86,99.43
2020-08-27,Tamil Nadu,580,2,580,7163,1750,1311,8.1,0,78.8,194465,1671,193367,2.22,1.66,0.09090101522842639,0.86,99.44
2020-08-28,Tamil Nadu,1395,8,1395,17462,87,62,7.99,0,78.8,195860,1679,194762,0.11,0.08,0.2215989847715736,0.86,99.44
2020-08-29,Tamil Nadu,639,5,631,7898,3456,1921,8.09,3,78.8,196499,1684,195393,4.39,2.44,0.10022842639593908,0.86,99.44
2020-08-30,Tamil Nadu,1209,14,1202,14871,2587,2405,8.13,0,78.8,197708,1698,196595,3.28,3.05,0.18871827411167513,0.86,99.44
2020-08-31,Tamil Nadu,566,6,560,7085,3326,2607,7.99,0,78.8,198274,1704,197155,4.22,3.31,0.08991116751269035,0.86,99.44
2020-09-01,Tamil Nadu,1367,15,1360,17006,2113,1845,8.04,0,78.8,199641,1719,198515,2.68,2.34,0.21581218274111674,0.86,99.44
2020-09-02,Tamil Nadu,309,3,308,3838,291,214,8.05,0,78.8,199950,1722,198823,0.37,0.27,0.04870558375634518,0.86,99.44
2020-09-03,Tamil Nadu,837,8,832,10079,4674,1691,8.3,0,78.8,200787,1730,199655,5.93,2.15,0.1279060913705584,0.86,99.44
2020-09-04,Tamil Nadu,956,10,955,12274,4442,2183,7.79,0,78.8,201743,1740,200610,5.64,2.77,0.15576142131979695,0.86,99.44
2020-09-05,Tamil Nadu,961,14,961,11727,2114,1164,8.19,0,78.8,202704,1754,201571,2.68,1.48,0.14881979695431471,0.87,99.44
2020-09-06,Tamil Nadu,927,12,923,11965,71,52,7.75,0,78.8,203631,1766,202494,0.09,0.07,0.15184010152284264,0.87,99.44
2020-09-07,Tamil Nadu,37,0,35,989,900,342,3.74,2,78.8,203668,1766,202529,1.14,0.43,0.012550761421319797,0.87,99.44
2020-09-08,Tamil Nadu,1000,8,997,12511,4718,4315,7.99,0,78.8,204668,1774,203526,5.99,5.48,0.15876903553299493,0.87,99.44
2020-09-09,Tamil Nadu,68,0,60,646,3508,1180,10.53,8,78.8,204736,1774,203586,4.45,1.5,0.008197969543147209,0.87,99.44
2020-09-10,Tamil Nadu,1183,14,1181,14750,74,24,8.02,0,78.8,205919,1788,204767,0.09,0.03,0.18718274111675126,0.87,99.44
2020-09-11,Tamil Nadu,662,8,661,8281,828,44,7.99,0,78.8,206581,1796,205428,1.05,0.06,0.10508883248730964,0.87,99.44
2020-09-12,Tamil Nadu,844,5,841,10366,1037,1024,8.14,0,78.8,207425,1801,206269,1.32,1.3,0.13154822335025382,0.87,99.44
2020-09-13,Tamil Nadu,714,9,708,8924,4496,3865,8.0,0,78.8,208139,1810,206977,5.71,4.9,0.113248730964467,0.87,99.44
2020-09-14,Tamil Nadu,1378,11,1371,17061,3196,2190,8.08,0,78.8,209517,1821,208348,4.06,2.78,0.21651015228426396,0.87,99.44
2020-09-15,Tamil Nadu,974,11,974,11910,1788,1136,8.18,0,78.8,210491,1832,209322,2.27,1.44,0.15114213197969542,0.87,99.44
2020-09-16,Tamil Nadu,1518,11,1518,19054,1264,261,7.97,0,78.8,212009,1843,210840,1.6,0.33,0.24180203045685278,0.87,99.45
2020-09-17,Tamil Nadu,1500,21,1498,18567,3068,1780,8.08,0,78.8,213509,1864,212338,3.89,2.26,0.23562182741116752,0.87,99.45
2020-09-18,Tamil Nadu,1327,17,1320,16741,3677,3614,7.93,0,78.8,214836,1881,213658,4.67,4.59,0.2124492385786802,0.88,99.45
2020-09-19,Tamil Nadu,168,2,161,1557,2038,1532,10.79,5,78.8,215004,1883,213819,2.59,1.94,0.019758883248730964,0.88,99.45
2020-09-20,Tamil Nadu,937,5,937,12145,4694,4584,7.72,0,78.8,215941,1888,214756,5.96,5.82,0.15412436548223352,0.87,99.45
2020-09-21,Tamil Nadu,1322,4,1319,16685,967,24,7.92,0,78.8,217263,1892,216075,1.23,0.03,0.21173857868020304,0.87,99.45
2020-09-22,Tamil Nadu,1383,9,1378,16973,2972,1005,8.15,0,78.8,218646,1901,217453,3.77,1.28,0.21539340101522841,0.87,99.45
2020-09-23,Tamil Nadu,1574,16,1565,19687,3292,1088,8.0,0,78.8,220220,1917,219018,4.18,1.38,0.24983502538071067,0.87,99.45
2020-09-24,Tamil Nadu,1216,16,1209,14696,1121,127,8.27,0,78.8,221436,1933,220227,1.42,0.16,0.18649746192893402,0.87,99.45
2020-09-25,Tamil Nadu,1324,12,1315,16378,2917,320,8.08,0,78.8,222760,1945,221542,3.7,0.41,0.20784263959390864,0.87,99.45
2020-09-26,Tamil Nadu,1548,4,1543,19006,3081,906,8.14,1,78.8,224308,1949,223085,3.91,1.15,0.24119289340101524,0.87,99.45
2020-09-27,Tamil Nadu,587,4,584,7528,627,224,7.8,0,78.8,224895,1953,223669,0.8,0.28,0.09553299492385786,0.87,99.45
2020-09-28,Tamil Nadu,1125,4,1124,13685,1335,989,8.22,0,78.8,226020,1957,224793,1.69,1.26,0.17366751269035532,0.87,99.46
2020-09-29,Tamil Nadu,379,1,376,5020,3214,886,7.55,2,78.8,226399,1958,225169,4.08,1.12,0.06370558375634518,0.86,99.46
2020-09-30,Tamil Nadu,1261,6,1252,15747,4483,4300,8.01,3,78.8,227660,1964,226421,5.69,5.46,0.19983502538071066,0.86,99.46
2020-10-01,Tamil Nadu,1249,12,1245,15890,937,694,7.86,0,78.8,228909,1976,227666,1.19,0.88,0.20164974619289341,0.86,99.46
2020-10-02,Tamil Nadu,279,2,270,3736,3473,769,7.47,7,78.8,229188,1978,227936,4.41,0.98,0.04741116751269035,0.86,99.45
2020-10-03,Tamil Nadu,380,2,371,4577,3934,1792,8.3,7,78.8,229568,1980,228307,4.99,2.27,0.058083756345177665,0.86,99.45
2020-10-04,Tamil Nadu,59,0,54,1073,2679,2149,5.5,5,78.8,229627,1980,228361,3.4,2.73,0.013616751269035533,0.86,99.45
2020-10-05,Tamil Nadu,294,2,285,3476,3497,2103,8.46,7,78.8,229921,1982,228646,4.44,2.67,0.04411167512690355,0.86,99.45
2020-10-06,Tamil Nadu,660,6,651,8246,2589,1713,8.0,3,78.8,230581,1988,229297,3.29,2.17,0.10464467005076142,0.86,99.44
2020-10-07,Tamil Nadu,637,3,628,7718,3264,853,8.25,6,78.8,231218,1991,229925,4.14,1.08,0.09794416243654823,0.86,99.44
2020-10-08,Tamil Nadu,294,4,288,3603,1626,287,8.16,2,78.8,231512,1995,230213,2.06,0.36,0.0457233502538071,0.86,99.44
2020-10-09,Tamil Nadu,1557,17,1557,19570,2682,1443,7.96,0,78.8,233069,2012,231770,3.4,1.83,0.2483502538071066,0.86,99.44
2020-10-10,Tamil Nadu,1230,12,1222,15607,3341,429,7.88,0,78.8,234299,2024,232992,4.24,0.54,0.19805837563451775,0.86,99.44
2020-10-11,Tamil Nadu,146,2,140,1805,1015,293,8.09,4,78.8,234445,2026,233132,1.29,0.37,0.022906091370558376,0.86,99.44
2020-10-12,Tamil Nadu,1462,19,1458,18077,2382,220,8.09,0,78.8,235907,2045,234590,3.02,0.28,0.22940355329949239,0.87,99.44
2020-10-13,Tamil Nadu,422,6,420,5564,1239,1237,7.58,0,78.8,236329,2051,235010,1.57,1.57,0.07060913705583756,0.87,99.44
2020-10-14,Tamil Nadu,431,4,428,5424,2149,1303,7.95,0,78.8,236760,2055,235438,2.73,1.65,0.06883248730964467,0.87,99.44
2020-10-15,Tamil Nadu,93,0,90,1074,2723,450,8.66,3,78.8,236853,2055,235528,3.46,0.57,0.013629441624365482,0.87,99.44
2020-10-16,Tamil Nadu,779,4,774,10091,862,819,7.72,1,78.8,237632,2059,236302,1.09,1.04,0.12805837563451777,0.87,99.44
2020-10-17,Tamil Nadu,302,1,294,3648,795,64,8.28,7,78.8,237934,2060,236596,1.01,0.08,0.04629441624365482,0.87,99.44
2020-10-18,Tamil Nadu,785,7,785,9965,1928,418,7.88,0,78.8,238719,2067,237381,2.45,0.53,0.12645939086294417,0.87,99.44
2020-10-19,Tamil Nadu,1452,12,1449,17898,1811,582,8.11,0,78.8,240171,2079,238830,2.3,0.74,0.22713197969543147,0.87,99.44
2020-10-20,Tamil Nadu,1234,12,1226,15159,424,136,8.14,0,78.8,241405,2091,240056,0.54,0.17,0.1923730964467005,0.87,99.44
2020-10-21,Tamil Nadu,1283,6,1283,16153,77,34,7.94,0,78.8,242688,2097,241339,0.1,0.04,0.20498730964467005,0.86,99.44
2020-10-22,Tamil Nadu,1336,12,1328,16948,3382,3066,7.88,0,78.8,244024,2109,242667,4.29,3.89,0.2150761421319797,0.86,99.44
2020-10-23,Tamil Nadu,997,13,989,12507,4773,4074,7.97,0,78.8,245021,2122,243656,6.06,5.17,0.15871827411167513,0.87,99.44
2020-10-24,Tamil Nadu,1310,18,1309,16453,987,261,7.96,0,78.8,246331,2140,244965,1.25,0.33,0.20879441624365483,0.87,99.45
2020-10-25,Tamil Nadu,598,7,592,7410,3502,237,8.07,0,78.8,246929,2147,245557,4.44,0.3,0.09403553299492386,0.87,99.44
2020-10-26,Tamil Nadu,1213,16,1204,15124,724,569,8.02,0,78.8,248142,2163,246761,0.92,0.72,0.1919289340101523,0.87,99.44
2020-10-27,Tamil Nadu,1397,10,1395,17659,3224,2029,7.91,0,78.8,249539,2173,248156,4.09,2.57,0.2240989847715736,0.87,99.45
2020-10-28,Tamil Nadu,369,2,367,4436,3144,1953,8.32,0,78.8,249908,2175,248523,3.99,2.48,0.056294416243654825,0.87,99.45
2020-10-29,Tamil Nadu,1525,15,1519,18909,2512,2031,8.06,0,78.8,251433,2190,250042,3.19,2.58,0.23996192893401017,0.87,99.45
2020-10-30,Tamil Nadu,149,1,142,1577,2590,1021,9.45,6,78.8,251582,2191,250184,3.29,1.3,0.02001269035532995,0.87,99.44
2020-10-31,Tamil Nadu,184,2,181,1899,4496,4219,9.69,1,78.8,251766,2193,250365,5.71,5.35,0.024098984771573604,0.87,99.44
2020-11-01,Tamil Nadu,52,0,49,1035,3133,571,5.02,3,78.8,251818,2193,250414,3.98,0.72,0.013134517766497463,0.87,99.44
2020-11-02,Tamil Nadu,1468,14,1467,18061,1337,494,8.13,0,78.8,253286,2207,251881,1.7,0.63,0.2292005076142132,0.87,99.45
2020-11-03,Tamil Nadu,501,2,492,6178,4260,2889,8.11,7,78.8,253787,2209,252373,5.41,3.67,0.0784010152284264,0.87,99.44
2020-11-04,Tamil Nadu,552,2,550,6667,4630,1243,8.28,0,78.8,254339,2211,252923,5.88,1.58,0.08460659898477157,0.87,99.44
2020-11-05,Tamil Nadu,899,10,896,11319,3524,1610,7.94,0,78.8,255238,2221,253819,4.47,2.04,0.14364213197969544,0.87,99.44
2020-11-06,Tamil Nadu,1503,15,1502,18898,2529,2102,7.95,0,78.8,256741,2236,255321,3.21,2.67,0.23982233502538072,0.87,99.45
2020-11-07,Tamil Nadu,1038,13,1029,12858,4994,1764,8.07,0,78.8,257779,2249,256350,6.34,2.24,0.1631725888324873,0.87,99.45
2020-11-08,Tamil Nadu,1280,6,1280,16215,1772,1203,7.89,0,78.8,259059,2255,257630,2.25,1.53,0.2057741116751269,0.87,99.45
2020-11-09,Tamil Nadu,1215,8,1213,15302,877,436,7.94,0,78.8,260274,2263,258843,1.11,0.55,0.19418781725888326,0.87,99.45
2020-11-10,Tamil Nadu,456,3,448,5599,3865,2665,8.14,5,78.8,260730,2266,259291,4.9,3.38,0.07105329949238579,0.87,99.45
2020-11-11,Tamil Nadu,965,6,965,11852,572,10,8.14,0,78.8,261695,2272,260256,0.73,0.01,0.15040609137055838,0.87,99.45
2020-11-12,Tamil Nadu,846,4,841,10938,2270,373,7.73,1,78.8,262541,2276,261097,2.88,0.47,0.13880710659898476,0.87,99.45
2020-11-13,Tamil Nadu,1393,10,1387,17626,3455,1966,7.9,0,78.8,263934,2286,262484,4.38,2.49,0.22368020304568528,0.87,99.45
2020-11-14,Tamil Nadu,1399,8,1395,17965,3328,832,7.79,0,78.8,265333,2294,263879,4.22,1.06,0.22798223350253807,0.86,99.45
2020-11-15,Tamil Nadu,820,9,814,9756,2493,2081,8.41,0,78.8,266153,2303,264693,3.16,2.64,0.12380710659898476,0.87,99.45
2020-11-16,Tamil Nadu,185,1,179,2268,213,188,8.16,5,78.8,266338,2304,264872,0.27,0.24,0.028781725888324873,0.87,99.45
2020-11-17,Tamil Nadu,757,8,751,9472,2565,2407,7.99,0,78.8,267095,2312,265623,3.26,3.05,0.12020304568527919,0.87,99.45
2020-11-18,Tamil Nadu,445,5,440,5535,3220,2837,8.04,0,78.8,267540,2317,266063,4.09,3.6,0.07024111675126904,0.87,99.45
2020-11-19,Tamil Nadu,1422,6,1414,17677,3865,2503,8.04,2,78.8,268962,2323,267477,4.9,3.18,0.2243274111675127,0.86,99.45
2020-11-20,Tamil Nadu,369,3,362,4370,1774,526,8.44,4,78.8,269331,2326,267839,2.25,0.67,0.055456852791878175,0.86,99.45
2020-11-21,Tamil Nadu,254,3,252,3145,432,86,8.08,0,78.8,269585,2329,268091,0.55,0.11,0.03991116751269035,0.86,99.45
2020-11-22,Tamil Nadu,940,13,937,12182,2749,807,7.72,0,78.8,270525,2342,269028,3.49,1.02,0.1545939086294416,0.87,99.45
2020-11-23,Tamil Nadu,195,1,195,2519,708,547,7.74,0,78.8,270720,2343,269223,0.9,0.69,0.031967005076142134,0.87,99.45
2020-11-24,Tamil Nadu,581,3,573,7274,2491,692,7.99,5,78.8,271301,2346,269796,3.16,0.88,0.09230964467005076,0.86,99.45
2020-11-25,Tamil Nadu,480,4,473,5548,2367,1046,8.65,3,78.8,271781,2350,270269,3.0,1.33,0.07040609137055838,0.86,99.44
2020-11-26,Tamil Nadu,390,4,383,5030,3233,68,7.75,3,78.8,272171,2354,270652,4.1,0.09,0.06383248730964466,0.86,99.44
2020-11-27,Tamil Nadu,926,2,924,11309,859,230,8.19,0,78.8,273097,2356,271576,1.09,0.29,0.14351522842639594,0.86,99.44
2020-11-28,Tamil Nadu,356,3,348,4470,2531,2114,7.96,5,78.8,273453,2359,271924,3.21,2.68,0.056725888324873096,0.86,99.44
2020-11-29,Tamil Nadu,119,0,117,1020,3976,2461,11.67,2,78.8,273572,2359,272041,5.05,3.12,0.012944162436548223,0.86,99.44
2020-11-30,Tamil Nadu,90,0,86,1054,1288,96,8.54,4,78.8,273662,2359,272127,1.63,0.12,0.013375634517766497,0.86,99.44
2020-12-01,Tamil Nadu,755,6,754,8831,2685,553,8.55,0,78.8,274417,2365,272881,3.41,0.7,0.11206852791878173,0.86,99.44
2020-12-02,Tamil Nadu,1344,5,1337,16694,3747,1547,8.05,2,78.8,275761,2370,274218,4.76,1.96,0.21185279187817257,0.86,99.44
2020-12-03,Tamil Nadu,892,5,886,10941,894,727,8.15,1,78.8,276653,2375,275104,1.13,0.92,0.13884517766497462,0.86,99.44
2020-12-04,Tamil Nadu,1556,19,1550,19456,1136,514,8.0,0,78.8,278209,2394,276654,1.44,0.65,0.24690355329949237,0.86,99.44
2020-12-05,Tamil Nadu,498,5,495,6218,3168,2226,8.01,0,78.8,278707,2399,277149,4.02,2.82,0.07890862944162437,0.86,99.44
2020-12-06,Tamil Nadu,1467,12,1461,18089,2130,540,8.11,0,78.8,280174,2411,278610,2.7,0.69,0.22955583756345177,0.86,99.44
2020-12-07,Tamil Nadu,771,10,765,9183,2687,2277,8.4,0,78.8,280945,2421,279375,3.41,2.89,0.11653553299492386,0.86,99.44
2020-12-08,Tamil Nadu,366,5,359,4236,3676,1966,8.64,2,78.8,281311,2426,279734,4.66,2.49,0.05375634517766498,0.86,99.44
2020-12-09,Tamil Nadu,343,3,343,4070,2069,571,8.43,0,78.8,281654,2429,280077,2.63,0.72,0.0516497461928934,0.86,99.44
2020-12-10,Tamil Nadu,713,9,713,8723,2058,1195,8.17,0,78.8,282367,2438,280790,2.61,1.52,0.11069796954314721,0.86,99.44
2020-12-11,Tamil Nadu,340,3,334,4208,1757,1338,8.08,3,78.8,282707,2441,281124,2.23,1.7,0.0534010152284264,0.86,99.44
2020-12-12,Tamil Nadu,819,7,812,10443,2561,515,7.84,0,78.8,283526,2448,281936,3.25,0.65,0.1325253807106599,0.86,99.44
2020-12-13,Tamil Nadu,250,2,245,2815,1345,240,8.88,3,78.8,283776,2450,282181,1.71,0.3,0.03572335025380711,0.86,99.44
2020-12-14,Tamil Nadu,61,0,53,1194,173,165,5.11,8,78.8,283837,2450,282234,0.22,0.21,0.015152284263959391,0.86,99.44
2020-12-15,Tamil Nadu,615,6,606,7434,3381,1915,8.27,3,78.8,284452,2456,282840,4.29,2.43,0.09434010152284264,0.86,99.43
2020-12-16,Tamil Nadu,573,5,572,7271,2145,363,7.88,0,78.8,285025,2461,283412,2.72,0.46,0.09227157360406091,0.86,99.43
2020-12-17,Tamil Nadu,1160,8,1156,14460,4380,3938,8.02,0,78.8,286185,2469,284568,5.56,5.0,0.18350253807106598,0.86,99.43
2020-12-18,Tamil Nadu,1542,14,1534,18910,4300,1754,8.15,0,78.8,287727,2483,286102,5.46,2.23,0.2399746192893401,0.86,99.44
2020-12-19,Tamil Nadu,900,6,893,11418,1140,1053,7.88,1,78.8,288627,2489,286995,1.45,1.34,0.1448984771573604,0.86,99.43
2020-12-20,Tamil Nadu,827,8,823,10166,2253,1829,8.13,0,78.8,289454,2497,287818,2.86,2.32,0.12901015228426396,0.86,99.43
2020-12-21,Tamil Nadu,327,1,320,4181,2387,1853,7.82,6,78.8,289781,2498,288138,3.03,2.35,0.05305837563451777,0.86,99.43
2020-12-22,Tamil Nadu,1191,9,1189,14736,703,166,8.08,0,78.8,290972,2507,289327,0.89,0.21,0.187005076142132,0.86,99.43
2020-12-23,Tamil Nadu,67,0,60,790,866,858,8.48,7,78.8,291039,2507,289387,1.1,1.09,0.010025380710659898,0.86,99.43
2020-12-24,Tamil Nadu,1308,8,1304,16355,355,221,8.0,0,78.8,292347,2515,290691,0.45,0.28,0.20755076142131978,0.86,99.43
2020-12-25,Tamil Nadu,783,2,781,9627,3835,1048,8.13,0,78.8,293130,2517,291472,4.87,1.33,0.12217005076142132,0.86,99.43
2020-12-26,Tamil Nadu,1434,13,1432,18219,3244,916,7.87,0,78.8,294564,2530,292904,4.12,1.16,0.23120558375634517,0.86,99.44
2020-12-27,Tamil Nadu,543,4,543,6691,4900,1336,8.12,0,78.8,295107,2534,293447,6.22,1.7,0.08491116751269036,0.86,99.44
2020-12-28,Tamil Nadu,1209,13,1205,15255,3840,727,7.93,0,78.8,296316,2547,294652,4.87,0.92,0.19359137055837564,0.86,99.44
2020-12-29,Tamil Nadu,991,5,990,12136,1509,70,8.17,0,78.8,297307,2552,295642,1.91,0.09,0.15401015228426396,0.86,99.44
2020-12-30,Tamil Nadu,142,0,134,1916,2100,1714,7.41,8,78.8,297449,2552,295776,2.66,2.18,0.024314720812182743,0.86,99.44
2020-12-31,Tamil Nadu,333,3,330,3950,3710,2095,8.43,0,78.8,297782,2555,296106,4.71,2.66,0.05012690355329949,0.86,99.44
2021-01-01,Tamil Nadu,1495,21,1491,18446,1049,787,8.1,0,78.8,299277,2576,297597,1.33,1.0,0.23408629441624365,0.86,99.44
2021-01-02,Tamil Nadu,739,8,732,9429,4055,1087,7.84,0,78.8,300016,2584,298329,5.15,1.38,0.11965736040609137,0.86,99.44
2021-01-03,Tamil Nadu,1044,9,1041,13686,845,161,7.63,0,78.8,301060,2593,299370,1.07,0.2,0.17368020304568527,0.86,99.44
2021-01-04,Tamil Nadu,1082,13,1078,13331,402,320,8.12,0,78.8,302142,2606,300448,0.51,0.41,0.1691751269035533,0.86,99.44
2021-01-05,Tamil Nadu,72,0,67,909,4689,867,7.92,5,78.8,302214,2606,300515,5.95,1.1,0.011535532994923858,0.86,99.44
2021-01-06,Tamil Nadu,532,2,525,6722,712,99,7.91,5,78.8,302746,2608,301040,0.9,0.13,0.08530456852791878,0.86,99.44
2021-01-07,Tamil Nadu,646,5,640,8417,3017,1002,7.67,1,78.8,303392,2613,301680,3.83,1.27,0.10681472081218274,0.86,99.44
2021-01-08,Tamil Nadu,344,2,341,4352,902,665,7.9,1,78.8,303736,2615,302021,1.14,0.84,0.055228426395939084,0.86,99.44
2021-01-09,Tamil Nadu,1367,4,1365,17120,2907,350,7.98,0,78.8,305103,2619,303386,3.69,0.44,0.21725888324873097,0.86,99.44
2021-01-10,Tamil Nadu,322,2,313,4249,2361,496,7.58,7,78.8,305425,2621,303699,3.0,0.63,0.05392131979695432,0.86,99.43
2021-01-11,Tamil Nadu,75,0,71,961,539,172,7.8,4,78.8,305500,2621,303770,0.68,0.22,0.012195431472081217,0.86,99.43
2021-01-12,Tamil Nadu,826,9,820,10201,2416,662,8.1,0,78.8,306326,2630,304590,3.07,0.84,0.12945431472081217,0.86,99.43
2021-01-13,Tamil Nadu,1316,17,1312,16396,2726,432,8.03,0,78.8,307642,2647,305902,3.46,0.55,0.2080710659898477,0.86,99.43
2021-01-14,Tamil Nadu,801,11,796,10155,4652,3198,7.89,0,78.8,308443,2658,306698,5.9,4.06,0.12887055837563452,0.86,99.43
2021-01-15,Tamil Nadu,1032,5,1026,12929,4185,1666,7.98,1,78.8,309475,2663,307724,5.31,2.11,0.1640736040609137,0.86,99.43
2021-01-16,Tamil Nadu,862,5,853,10461,1895,1781,8.24,4,78.8,310337,2668,308577,2.4,2.26,0.13275380710659898,0.86,99.43
2021-01-17,Tamil Nadu,1250,11,1248,15677,4873,4096,7.97,0,78.8,311587,2679,309825,6.18,5.2,0.1989467005076142,0.86,99.43
2021-01-18,Tamil Nadu,542,7,535,6331,4313,138,8.56,0,78.8,312129,2686,310360,5.47,0.18,0.08034263959390862,0.86,99.43
2021-01-19,Tamil Nadu,1024,5,1020,12389,2371,1171,8.27,0,78.8,313153,2691,311380,3.01,1.49,0.15722081218274112,0.86,99.43
2021-01-20,Tamil Nadu,462,5,456,5305,1363,74,8.71,1,78.8,313615,2696,311836,1.73,0.09,0.06732233502538071,0.86,99.43
2021-01-21,Tamil Nadu,287,2,278,3586,4354,4092,8.0,7,78.8,313902,2698,312114,5.53,5.19,0.04550761421319797,0.86,99.43
2021-01-22,Tamil Nadu,1471,17,1466,18780,4143,2290,7.83,0,78.8,315373,2715,313580,5.26,2.91,0.2383248730964467,0.86,99.43
2021-01-23,Tamil Nadu,179,2,174,2305,3052,2094,7.77,3,78.8,315552,2717,313754,3.87,2.66,0.029251269035532997,0.86,99.43
2021-01-24,Tamil Nadu,454,2,453,5646,2194,2071,8.04,0,78.8,316006,2719,314207,2.78,2.63,0.0716497461928934,0.86,99.43
2021-01-25,Tamil Nadu,820,3,819,10540,3922,2130,7.78,0,78.8,316826,2722,315026,4.98,2.7,0.13375634517766496,0.86,99.43
2021-01-26,Tamil Nadu,1149,8,1140,14531,2916,1261,7.91,1,78.8,317975,2730,316166,3.7,1.6,0.18440355329949237,0.86,99.43
2021-01-27,Tamil Nadu,410,4,406,5129,809,136,7.99,0,78.8,318385,2734,316572,1.03,0.17,0.06508883248730965,0.86,99.43
2021-01-28,Tamil Nadu,958,11,951,11470,3102,1944,8.35,0,78.8,319343,2745,317523,3.94,2.47,0.14555837563451776,0.86,99.43
2021-01-29,Tamil Nadu,1130,5,1125,13549,4109,19,8.34,0,78.8,320473,2750,318648,5.21,0.02,0.17194162436548224,0.86,99.43
2021-01-30,Tamil Nadu,871,9,866,10704,723,404,8.14,0,78.8,321344,2759,319514,0.92,0.51,0.13583756345177664,0.86,99.43
2021-01-31,Tamil Nadu,716,9,715,9180,1012,18,7.8,0,78.8,322060,2768,320229,1.28,0.02,0.11649746192893401,0.86,99.43
2021-02-01,Tamil Nadu,1326,10,1326,15926,476,433,8.33,0,78.8,323386,2778,321555,0.6,0.55,0.20210659898477157,0.86,99.43
2021-02-02,Tamil Nadu,1406,19,1397,17363,654,554,8.1,0,78.8,324792,2797,322952,0.83,0.7,0.22034263959390862,0.86,99.43
2021-02-03,Tamil Nadu,1108,15,1107,13996,4250,1066,7.92,0,78.8,325900,2812,324059,5.39,1.35,0.17761421319796955,0.86,99.44
2021-02-04,Tamil Nadu,215,0,206,2754,4068,235,7.81,9,78.8,326115,2812,324265,5.16,0.3,0.0349492385786802,0.86,99.43
2021-02-05,Tamil Nadu,513,4,505,5999,2081,1568,8.55,4,78.8,326628,2816,324770,2.64,1.99,0.07612944162436548,0.86,99.43
2021-02-06,Tamil Nadu,582,3,580,7512,4567,2494,7.75,0,78.8,327210,2819,325350,5.8,3.16,0.09532994923857868,0.86,99.43
2021-02-07,Tamil Nadu,347,4,344,4472,3930,1196,7.76,0,78.8,327557,2823,325694,4.99,1.52,0.05675126903553299,0.86,99.43
2021-02-08,Tamil Nadu,1092,8,1084,13952,1320,516,7.83,0,78.8,328649,2831,326778,1.68,0.65,0.17705583756345178,0.86,99.43
2021-02-09,Tamil Nadu,55,0,48,1332,287,66,4.13,7,78.8,328704,2831,326826,0.36,0.08,0.016903553299492387,0.86,99.43
2021-02-10,Tamil Nadu,328,2,323,4448,111,72,7.37,3,78.8,329032,2833,327149,0.14,0.09,0.05644670050761421,0.86,99.43
2021-02-11,Tamil Nadu,1438,15,1431,17465,1811,1556,8.23,0,78.8,330470,2848,328580,2.3,1.97,0.22163705583756346,0.86,99.43
2021-02-12,Tamil Nadu,758,5,758,9664,4740,864,7.84,0,78.8,331228,2853,329338,6.02,1.1,0.12263959390862944,0.86,99.43
2021-02-13,Tamil Nadu,1425,7,1420,18033,1751,1096,7.9,0,78.8,332653,2860,330758,2.22,1.39,0.22884517766497461,0.86,99.43
2021-02-14,Tamil Nadu,684,7,678,8727,3634,3463,7.84,0,78.8,333337,2867,331436,4.61,4.39,0.11074873096446701,0.86,99.43
2021-02-15,Tamil Nadu,80,0,76,1038,4571,4116,7.71,4,78.8,333417,2867,331512,5.8,5.22,0.013172588832487309,0.86,99.43
2021-02-16,Tamil Nadu,1567,15,1561,19425,856,837,8.07,0,78.8,334984,2882,333073,1.09,1.06,0.24651015228426396,0.86,99.43
2021-02-17,Tamil Nadu,1067,9,1066,13188,3381,1356,8.09,0,78.8,336051,2891,334139,4.29,1.72,0.16736040609137057,0.86,99.43
2021-02-18,Tamil Nadu,800,3,797,9640,4665,452,8.3,0,78.8,336851,2894,334936,5.92,0.57,0.12233502538071066,0.86,99.43
2021-02-19,Tamil Nadu,702,4,701,8747,893,122,8.03,0,78.8,337553,2898,335637,1.13,0.15,0.11100253807106598,0.86,99.43
2021-02-20,Tamil Nadu,1033,5,1029,12571,2534,1991,8.22,0,78.8,338586,2903,336666,3.22,2.53,0.15953045685279188,0.86,99.43
2021-02-21,Tamil Nadu,795,11,795,10471,3626,1590,7.59,0,78.8,339381,2914,337461,4.6,2.02,0.13288071065989848,0.86,99.43
2021-02-22,Tamil Nadu,474,5,466,6092,795,126,7.78,3,78.8,339855,2919,337927,1.01,0.16,0.07730964467005076,0.86,99.43
2021-02-23,Tamil Nadu,1368,6,1361,16953,4849,4775,8.07,1,78.8,341223,2925,339288,6.15,6.06,0.21513959390862944,0.86,99.43
2021-02-24,Tamil Nadu,252,1,244,2960,2836,1704,8.51,7,78.8,341475,2926,339532,3.6,2.16,0.03756345177664975,0.86,99.43
2021-02-25,Tamil Nadu,1432,7,1429,17782,4613,2463,8.05,0,78.8,342907,2933,340961,5.85,3.13,0.22565989847715737,0.86,99.43
2021-02-26,Tamil Nadu,1046,9,1041,12931,209,95,8.09,0,78.8,343953,2942,342002,0.27,0.12,0.1640989847715736,0.86,99.43
2021-02-27,Tamil Nadu,117,1,108,1861,2805,150,6.29,8,78.8,344070,2943,342110,3.56,0.19,0.023616751269035532,0.86,99.43
2021-02-28,Tamil Nadu,374,4,370,4791,4843,2843,7.81,0,78.8,344444,2947,342480,6.15,3.61,0.0607994923857868,0.86,99.43
2021-03-01,Tamil Nadu,1299,13,1295,15915,3923,16,8.16,0,78.8,345743,2960,343775,4.98,0.02,0.20196700507614213,0.86,99.43
2021-03-02,Tamil Nadu,1133,11,1125,14735,3781,3341,7.69,0,78.8,346876,2971,344900,4.8,4.24,0.18699238578680202,0.86,99.43
2021-03-03,Tamil Nadu,150,0,142,1969,1957,1955,7.62,8,78.8,347026,2971,345042,2.48,2.48,0.02498730964467005,0.86,99.43
2021-03-04,Tamil Nadu,376,1,368,4502,308,54,8.35,7,78.8,347402,2972,345410,0.39,0.07,0.05713197969543147,0.86,99.43
2021-03-05,Tamil Nadu,432,4,431,5694,3897,3609,7.59,0,78.8,347834,2976,345841,4.95,4.58,0.07225888324873096,0.86,99.43
2021-03-06,Tamil Nadu,945,8,944,11859,2791,877,7.97,0,78.8,348779,2984,346785,3.54,1.11,0.15049492385786803,0.86,99.43
2021-03-07,Tamil Nadu,1316,15,1309,16746,4919,109,7.86,0,78.8,350095,2999,348094,6.24,0.14,0.21251269035532994,0.86,99.43
2021-03-08,Tamil Nadu,891,4,886,11123,3186,3058,8.01,1,78.8,350986,3003,348980,4.04,3.88,0.14115482233502538,0.86,99.43
2021-03-09,Tamil Nadu,1279,16,1279,15698,4580,2661,8.15,0,78.8,352265,3019,350259,5.81,3.38,0.19921319796954315,0.86,99.43
2021-03-10,Tamil Nadu,670,6,670,8681,4771,2271,7.72,0,78.8,352935,3025,350929,6.05,2.88,0.11016497461928934,0.86,99.43
2021-03-11,Tamil Nadu,549,4,546,6723,660,47,8.17,0,78.8,353484,3029,351475,0.84,0.06,0.08531725888324873,0.86,99.43
2021-03-12,Tamil Nadu,324,1,324,3886,2579,1715,8.34,0,78.8,353808,3030,351799,3.27,2.18,0.049314720812182744,0.86,99.43
2021-03-13,Tamil Nadu,440,3,438,5305,4691,3242,8.29,0,78.8,354248,3033,352237,5.95,4.11,0.06732233502538071,0.86,99.43
2021-03-14,Tamil Nadu,909,4,909,11405,1442,1370,7.97,0,78.8,355157,3037,353146,1.83,1.74,0.14473350253807107,0.86,99.43
2021-03-15,Tamil Nadu,707,10,704,9033,4106,3288,7.83,0,78.8,355864,3047,353850,5.21,4.17,0.11463197969543147,0.86,99.43
2021-03-16,Tamil Nadu,789,3,783,9643,2204,603,8.18,3,78.8,356653,3050,354633,2.8,0.77,0.12237309644670051,0.86,99.43
2021-03-17,Tamil Nadu,233,2,230,3126,1303,352,7.45,1,78.8,356886,3052,354863,1.65,0.45,0.03967005076142132,0.86,99.43
2021-03-18,Tamil Nadu,91,0,83,881,1248,964,10.33,8,78.8,356977,3052,354946,1.58,1.22,0.01118020304568528,0.85,99.43
2021-03-19,Tamil Nadu,461,1,454,5592,4646,976,8.24,6,78.8,357438,3053,355400,5.9,1.24,0.07096446700507614,0.85,99.43
2021-03-20,Tamil Nadu,1450,12,1442,18117,43,19,8.0,0,78.8,358888,3065,356842,0.05,0.02,0.22991116751269036,0.85,99.43
2021-03-21,Tamil Nadu,1170,12,1166,14752,2823,616,7.93,0,78.8,360058,3077,358008,3.58,0.78,0.18720812182741117,0.85,99.43
2021-03-22,Tamil Nadu,499,4,494,6380,626,211,7.82,1,78.8,360557,3081,358502,0.79,0.27,0.08096446700507615,0.85,99.43
2021-03-23,Tamil Nadu,1494,4,1491,18830,4193,2570,7.93,0,78.8,362051,3085,359993,5.32,3.26,0.23895939086294415,0.85,99.43
2021-03-24,Tamil Nadu,15,0,7,576,3085,1588,2.6,8,78.8,362066,3085,360000,3.91,2.02,0.007309644670050761,0.85,99.43
2021-03-25,Tamil Nadu,677,3,673,8365,1034,450,8.09,1,78.8,362743,3088,360673,1.31,0.57,0.10615482233502538,0.85,99.43
2021-03-26,Tamil Nadu,1583,11,1578,19491,2017,1848,8.12,0,78.8,364326,3099,362251,2.56,2.35,0.2473477157360406,0.85,99.43
2021-03-27,Tamil Nadu,741,8,734,9409,384,146,7.88,0,78.8,365067,3107,362985,0.49,0.19,0.11940355329949238,0.85,99.43
2021-03-28,Tamil Nadu,1417,13,1413,17390,797,224,8.15,0,78.8,366484,3120,364398,1.01,0.28,0.22068527918781725,0.85,99.43
2021-03-29,Tamil Nadu,1028,9,1021,13128,1772,250,7.83,0,78.8,367512,3129,365419,2.25,0.32,0.16659898477157362,0.85,99.43
2021-03-30,Tamil Nadu,1363,15,1361,16208,4401,3052,8.41,0,78.8,368875,3144,366780,5.59,3.87,0.20568527918781726,0.85,99.43
2021-03-31,Tamil Nadu,1388,13,1379,17229,1700,761,8.06,0,78.8,370263,3157,368159,2.16,0.97,0.21864213197969543,0.85,99.43
2021-04-01,Tamil Nadu,1375,18,1372,17226,1434,779,7.98,0,78.8,371638,3175,369531,1.82,0.99,0.21860406091370557,0.85,99.43
2021-04-02,Tamil Nadu,708,4,708,8656,1815,1436,8.18,0,78.8,372346,3179,370239,2.3,1.82,0.10984771573604062,0.85,99.43
2021-04-03,Tamil Nadu,129,0,122,1373,72,3,9.4,7,78.8,372475,3179,370361,0.09,0.0,0.017423857868020306,0.85,99.43
2021-04-04,Tamil Nadu,951,12,950,12016,372,149,7.91,0,78.8,373426,3191,371311,0.47,0.19,0.15248730964467005,0.85,99.43
2021-04-05,Tamil Nadu,720,10,717,9198,1164,597,7.83,0,78.8,374146,3201,372028,1.48,0.76,0.1167258883248731,0.86,99.43
2021-04-06,Tamil Nadu,1084,11,1081,13618,2357,803,7.96,0,78.8,375230,3212,373109,2.99,1.02,0.17281725888324873,0.86,99.43
2021-04-07,Tamil Nadu,1516,12,1512,18942,2216,1379,8.0,0,78.8,376746,3224,374621,2.81,1.75,0.24038071065989847,0.86,99.44
2021-04-08,Tamil Nadu,649,8,649,8138,3768,2486,7.97,0,78.8,377395,3232,375270,4.78,3.15,0.1032741116751269,0.86,99.44
2021-04-09,Tamil Nadu,43,0,35,826,1012,907,5.21,8,78.8,377438,3232,375305,1.28,1.15,0.01048223350253807,0.86,99.43
2021-04-10,Tamil Nadu,1560,8,1559,19523,736,235,7.99,0,78.8,378998,3240,376864,0.93,0.3,0.24775380710659897,0.85,99.44
2021-04-11,Tamil Nadu,755,6,748,9548,722,648,7.91,1,78.8,379753,3246,377612,0.92,0.82,0.12116751269035533,0.85,99.44
2021-04-12,Tamil Nadu,378,1,371,4831,19,8,7.82,6,78.8,380131,3247,377983,0.02,0.01,0.06130710659898477,0.85,99.43
2021-04-13,Tamil Nadu,339,3,330,4291,2793,1278,7.9,6,78.8,380470,3250,378313,3.54,1.62,0.054454314720812184,0.85,99.43
2021-04-14,Tamil Nadu,1470,17,1462,18625,659,177,7.89,0,78.8,381940,3267,379775,0.84,0.22,0.23635786802030456,0.86,99.43
2021-04-15,Tamil Nadu,1566,10,1559,19402,2317,4,8.07,0,78.8,383506,3277,381334,2.94,0.01,0.24621827411167513,0.85,99.43
2021-04-16,Tamil Nadu,1538,12,1534,19003,42,34,8.09,0,78.8,385044,3289,382868,0.05,0.04,0.2411548223350254,0.85,99.43
2021-04-17,Tamil Nadu,1089,13,1083,13422,685,508,8.11,0,78.8,386133,3302,383951,0.87,0.64,0.1703299492385787,0.86,99.43
2021-04-18,Tamil Nadu,1257,6,1248,15670,4198,1872,8.02,3,78.8,387390,3308,385199,5.33,2.38,0.19885786802030456,0.85,99.43
2021-04-19,Tamil Nadu,444,1,437,5340,1002,283,8.31,6,78.8,387834,3309,385636,1.27,0.36,0.06776649746192893,0.85,99.43
2021-04-20,Tamil Nadu,1073,3,1071,13087,4712,1768,8.2,0,78.8,388907,3312,386707,5.98,2.24,0.1660786802030457,0.85,99.43
2021-04-21,Tamil Nadu,322,3,318,4249,1196,953,7.58,1,78.8,389229,3315,387025,1.52,1.21,0.05392131979695432,0.85,99.43
2021-04-22,Tamil Nadu,1086,16,1082,13731,1207,263,7.91,0,78.8,390315,3331,388107,1.53,0.33,0.174251269035533,0.85,99.43
2021-04-23,Tamil Nadu,246,3,239,3019,4031,1558,8.15,4,78.8,390561,3334,388346,5.12,1.98,0.03831218274111675,0.85,99.43
2021-04-24,Tamil Nadu,705,3,701,8779,4856,2785,8.03,1,78.8,391266,3337,389047,6.16,3.53,0.11140862944162437,0.85,99.43
2021-04-25,Tamil Nadu,1130,3,1121,14036,46,33,8.05,6,78.8,392396,3340,390168,0.06,0.04,0.1781218274111675,0.85,99.43
2021-04-26,Tamil Nadu,137,1,131,1786,3638,1916,7.67,5,78.8,392533,3341,390299,4.62,2.43,0.02266497461928934,0.85,99.43
2021-04-27,Tamil Nadu,1436,5,1431,17693,3368,2214,8.12,0,78.8,393969,3346,391730,4.27,2.81,0.22453045685279188,0.85,99.43
2021-04-28,Tamil Nadu,610,1,602,7601,1942,420,8.03,7,78.8,394579,3347,392332,2.46,0.53,0.09645939086294417,0.85,99.43
2021-04-29,Tamil Nadu,631,3,623,8219,986,309,7.68,5,78.8,395210,3350,392955,1.25,0.39,0.1043020304568528,0.85,99.43
2021-04-30,Tamil Nadu,1053,7,1052,13405,2021,264,7.86,0,78.8,396263,3357,394007,2.56,0.34,0.17011421319796954,0.85,99.43
2021-05-01,Tamil Nadu,117,0,114,1652,4457,913,7.08,3,78.8,396380,3357,394121,5.66,1.16,0.02096446700507614,0.85,99.43
2021-05-02,Tamil Nadu,177,1,171,2188,1631,1565,8.09,5,78.8,396557,3358,394292,2.07,1.99,0.027766497461928934,0.85,99.43
2021-05-03,Tamil Nadu,258,2,257,2984,116,103,8.65,0,78.8,396815,3360,394549,0.15,0.13,0.037868020304568525,0.85,99.43
2021-05-04,Tamil Nadu,974,4,972,12182,1943,549,8.0,0,78.8,397789,3364,395521,2.47,0.7,0.1545939086294416,0.85,99.43
2021-05-05,Tamil Nadu,648,8,648,8145,4010,3640,7.96,0,78.8,398437,3372,396169,5.09,4.62,0.10336294416243655,0.85,99.43
2021-05-06,Tamil Nadu,1027,11,1024,13114,3301,414,7.83,0,78.8,399464,3383,397193,4.19,0.53,0.16642131979695432,0.85,99.43
2021-05-07,Tamil Nadu,591,5,585,7072,3167,2212,8.36,1,78.8,400055,3388,397778,4.02,2.81,0.08974619289340101,0.85,99.43
2021-05-08,Tamil Nadu,976,3,973,12263,4380,2737,7.96,0,78.8,401031,3391,398751,5.56,3.47,0.1556218274111675,0.85,99.43
2021-05-09,Tamil Nadu,703,3,702,8216,1183,898,8.56,0,78.8,401734,3394,399453,1.5,1.14,0.10426395939086294,0.84,99.43
2021-05-10,Tamil Nadu,291,3,285,3725,4363,1189,7.81,3,78.8,402025,3397,399738,5.54,1.51,0.04727157360406092,0.84,99.43
2021-05-11,Tamil Nadu,1624,22,1623,19882,3122,1112,8.17,0,78.8,403649,3419,401361,3.96,1.41,0.25230964467005074,0.85,99.43
2021-05-12,Tamil Nadu,1093,15,1084,13872,3937,2385,7.88,0,78.8,404742,3434,402445,5.0,3.03,0.17604060913705583,0.85,99.43
2021-05-13,Tamil Nadu,1026,5,1023,12449,51,14,8.24,0,78.8,405768,3439,403468,0.06,0.02,0.15798223350253807,0.85,99.43
2021-05-14,Tamil Nadu,1489,21,1489,18477,3333,1626,8.06,0,78.8,407257,3460,404957,4.23,2.06,0.23447969543147207,0.85,99.44
2021-05-15,Tamil Nadu,288,3,288,3827,3416,2690,7.53,0,78.8,407545,3463,405245,4.34,3.41,0.048565989847715735,0.85,99.44
2021-05-16,Tamil Nadu,1443,20,1435,18263,279,9,7.9,0,78.8,408988,3483,406680,0.35,0.01,0.23176395939086294,0.85,99.44
2021-05-17,Tamil Nadu,842,5,836,10436,1310,610,8.07,1,78.8,409830,3488,407516,1.66,0.77,0.13243654822335024,0.85,99.44
2021-05-18,Tamil Nadu,1437,17,1437,18159,491,466,7.91,0,78.8,411267,3505,408953,0.62,0.59,0.23044416243654822,0.85,99.44
2021-05-19,Tamil Nadu,334,1,327,4431,2323,680,7.54,6,78.8,411601,3506,409280,2.95,0.86,0.056230964467005075,0.85,99.44
2021-05-20,Tamil Nadu,1317,6,1312,16342,1618,1083,8.06,0,78.8,412918,3512,410592,2.05,1.37,0.20738578680203046,0.85,99.44
2021-05-21,Tamil Nadu,1236,11,1227,15457,913,907,8.0,0,78.8,414154,3523,411819,1.16,1.15,0.19615482233502538,0.85,99.44
2021-05-22,Tamil Nadu,345,2,341,4137,2779,2385,8.34,2,78.8,414499,3525,412160,3.53,3.03,0.0525,0.85,99.44
2021-05-23,Tamil Nadu,375,2,366,4556,4958,1581,8.23,7,78.8,414874,3527,412526,6.29,2.01,0.057817258883248734,0.85,99.43
2021-05-24,Tamil Nadu,966,14,965,12053,171,8,8.01,0,78.8,415840,3541,413491,0.22,0.01,0.15295685279187818,0.85,99.44
2021-05-25,Tamil Nadu,1009,6,1008,12867,376,99,7.84,0,78.8,416849,3547,414499,0.48,0.13,0.16328680203045684,0.85,99.44
2021-05-26,Tamil Nadu,1359,14,1359,17107,3104,610,7.94,0,78.8,418208,3561,415858,3.94,0.77,0.2170939086294416,0.85,99.44
2021-05-27,Tamil Nadu,288,3,281,3624,2987,107,7.95,4,78.8,418496,3564,416139,3.79,0.14,0.04598984771573604,0.85,99.44
2021-05-28,Tamil Nadu,403,4,398,5088,1535,361,7.92,1,78.8,418899,3568,416537,1.95,0.46,0.06456852791878173,0.85,99.44
2021-05-29,Tamil Nadu,440,2,437,5397,4041,4040,8.15,1,78.8,419339,3570,416974,5.13,5.13,0.06848984771573605,0.85,99.44
2021-05-30,Tamil Nadu,1044,12,1040,13397,4182,733,7.79,0,78.8,420383,3582,418014,5.31,0.93,0.17001269035532995,0.85,99.44
2021-05-31,Tamil Nadu,1477,15,1477,18342,3098,2123,8.05,0,78.8,421860,3597,419491,3.93,2.69,0.23276649746192893,0.85,99.44
2021-06-01,Tamil Nadu,974,9,966,12596,2598,1423,7.73,0,78.8,422834,3606,420457,3.3,1.81,0.15984771573604062,0.85,99.44
2021-06-02,Tamil Nadu,197,1,189,2823,4541,3065,6.98,7,78.8,423031,3607,420646,5.76,3.89,0.0358248730964467,0.85,99.44
2021-06-03,Tamil Nadu,416,2,416,5316,4367,3699,7.83,0,78.8,423447,3609,421062,5.54,4.69,0.06746192893401015,0.85,99.44
2021-06-04,Tamil Nadu,628,7,626,7751,898,222,8.1,0,78.8,424075,3616,421688,1.14,0.28,0.09836294416243654,0.85,99.44
2021-06-05,Tamil Nadu,671,5,662,8443,2829,1854,7.95,4,78.8,424746,3621,422350,3.59,2.35,0.10714467005076142,0.85,99.44
2021-06-06,Tamil Nadu,83,0,74,805,2192,769,10.31,9,78.8,424829,3621,422424,2.78,0.98,0.010215736040609137,0.85,99.43
2021-06-07,Tamil Nadu,383,4,379,4543,3814,2989,8.43,0,78.8,425212,3625,422803,4.84,3.79,0.057652284263959394,0.85,99.43
2021-06-08,Tamil Nadu,433,3,424,5366,1961,983,8.07,6,78.8,425645,3628,423227,2.49,1.25,0.06809644670050762,0.85,99.43
2021-06-09,Tamil Nadu,727,9,723,9218,3779,615,7.89,0,78.8,426372,3637,423950,4.8,0.78,0.11697969543147207,0.85,99.43
2021-06-10,Tamil Nadu,1593,19,1586,19896,440,193,8.01,0,78.8,427965,3656,425536,0.56,0.24,0.25248730964467003,0.85,99.43
2021-06-11,Tamil Nadu,1208,16,1200,15403,5,4,7.84,0,78.8,429173,3672,426736,0.01,0.01,0.19546954314720813,0.86,99.43
2021-06-12,Tamil Nadu,905,10,898,11392,2875,2359,7.94,0,78.8,430078,3682,427634,3.65,2.99,0.14456852791878172,0.86,99.43
2021-06-13,Tamil Nadu,863,9,856,10632,1616,531,8.12,0,78.8,430941,3691,428490,2.05,0.67,0.1349238578680203,0.86,99.43
2021-06-14,Tamil Nadu,1401,11,1394,17369,250,132,8.07,0,78.8,432342,3702,429884,0.32,0.17,0.22041878172588833,0.86,99.43
2021-06-15,Tamil Nadu,1627,22,1626,19990,3079,949,8.14,0,78.8,433969,3724,431510,3.91,1.2,0.2536802030456853,0.86,99.43
2021-06-16,Tamil Nadu,980,13,978,11909,2234,536,8.23,0,78.8,434949,3737,432488,2.84,0.68,0.15112944162436548,0.86,99.43
2021-06-17,Tamil Nadu,1461,6,1458,18291,119,0,7.99,0,78.8,436410,3743,433946,0.15,0.0,0.23211928934010154,0.86,99.44
2021-06-18,Tamil Nadu,480,4,476,6026,4537,3063,7.97,0,78.8,436890,3747,434422,5.76,3.89,0.07647208121827412,0.86,99.44
2021-06-19,Tamil Nadu,1385,6,1380,17499,3707,186,7.91,0,78.8,438275,3753,435802,4.7,0.24,0.22206852791878173,0.86,99.44
2021-06-20,Tamil Nadu,556,4,556,7221,1825,1107,7.7,0,78.8,438831,3757,436358,2.32,1.4,0.09163705583756346,0.86,99.44
2021-06-21,Tamil Nadu,259,3,257,3055,1281,1267,8.48,0,78.8,439090,3760,436615,1.63,1.61,0.038769035532994926,0.86,99.44
2021-06-22,Tamil Nadu,1216,9,1210,15309,3394,2574,7.94,0,78.8,440306,3769,437825,4.31,3.27,0.19427664974619288,0.86,99.44
2021-06-23,Tamil Nadu,767,9,760,9583,4165,2448,8.0,0,78.8,441073,3778,438585,5.29,3.11,0.12161167512690356,0.86,99.44
2021-06-24,Tamil Nadu,484,3,483,6390,2678,2585,7.57,0,78.8,441557,3781,439068,3.4,3.28,0.08109137055837563,0.86,99.44
2021-06-25,Tamil Nadu,611,3,611,7853,2056,1353,7.78,0,78.8,442168,3784,439679,2.61,1.72,0.09965736040609137,0.86,99.44
2021-06-26,Tamil Nadu,540,7,540,6511,678,329,8.29,0,78.8,442708,3791,440219,0.86,0.42,0.08262690355329949,0.86,99.44
2021-06-27,Tamil Nadu,65,0,65,868,4571,2879,7.49,0,78.8,442773,3791,440284,5.8,3.65,0.01101522842639594,0.86,99.44
2021-06-28,Tamil Nadu,1012,9,1003,12626,1740,1248,8.02,0,78.8,443785,3800,441287,2.21,1.58,0.1602284263959391,0.86,99.44
2021-06-29,Tamil Nadu,908,11,903,11202,1253,1120,8.11,0,78.8,444693,3811,442190,1.59,1.42,0.14215736040609137,0.86,99.44
2021-06-30,Tamil Nadu,519,3,519,6551,4052,1967,7.92,0,78.8,445212,3814,442709,5.14,2.5,0.08313451776649747,0.86,99.44
2021-07-01,Tamil Nadu,1178,8,1174,14766,3726,3107,7.98,0,78.8,446390,3822,443883,4.73,3.94,0.18738578680203047,0.86,99.44
2021-07-02,Tamil Nadu,586,5,582,7381,2512,1563,7.94,0,78.8,446976,3827,444465,3.19,1.98,0.09366751269035534,0.86,99.44
2021-07-03,Tamil Nadu,479,2,476,5850,1498,709,8.19,1,78.8,447455,3829,444941,1.9,0.9,0.07423857868020305,0.86,99.44
2021-07-04,Tamil Nadu,974,12,966,12263,4170,3878,7.94,0,78.8,448429,3841,445907,5.29,4.92,0.1556218274111675,0.86,99.44
2021-07-05,Tamil Nadu,674,8,666,8625,1426,1243,7.81,0,78.8,449103,3849,446573,1.81,1.58,0.10945431472081218,0.86,99.44
2021-07-06,Tamil Nadu,1330,12,1326,16274,599,528,8.17,0,78.8,450433,3861,447899,0.76,0.67,0.20652284263959392,0.86,99.44
2021-07-07,Tamil Nadu,1491,21,1489,18512,988,185,8.05,0,78.8,451924,3882,449388,1.25,0.23,0.2349238578680203,0.86,99.44
2021-07-08,Tamil Nadu,744,9,743,9182,3160,2325,8.1,0,78.8,452668,3891,450131,4.01,2.95,0.11652284263959391,0.86,99.44
2021-07-09,Tamil Nadu,677,5,671,8708,3513,2144,7.77,1,78.8,453345,3896,450802,4.46,2.72,0.11050761421319796,0.86,99.44
2021-07-10,Tamil Nadu,1123,16,1121,14300,2249,1,7.85,0,78.8,454468,3912,451923,2.85,0.0,0.1814720812182741,0.86,99.44
2021-07-11,Tamil Nadu,569,6,567,7201,4801,4376,7.9,0,78.8,455037,3918,452490,6.09,5.55,0.09138324873096447,0.86,99.44
2021-07-12,Tamil Nadu,1602,20,1594,19893,721,461,8.05,0,78.8,456639,3938,454084,0.91,0.59,0.2524492385786802,0.86,99.44
2021-07-13,Tamil Nadu,380,2,372,4577,3959,821,8.3,6,78.8,457019,3940,454456,5.02,1.04,0.058083756345177665,0.86,99.44
2021-07-14,Tamil Nadu,318,2,311,3972,685,343,8.01,5,78.8,457337,3942,454767,0.87,0.44,0.050406091370558376,0.86,99.44
2021-07-15,Tamil Nadu,364,4,359,4318,2923,2464,8.43,1,78.8,457701,3946,455126,3.71,3.13,0.054796954314720814,0.86,99.44
2021-07-16,Tamil Nadu,579,4,576,7345,225,19,7.88,0,78.8,458280,3950,455702,0.29,0.02,0.09321065989847716,0.86,99.44
2021-07-17,Tamil Nadu,1213,17,1212,15553,1307,877,7.8,0,78.8,459493,3967,456914,1.66,1.11,0.1973730964467005,0.86,99.44
2021-07-18,Tamil Nadu,305,1,297,4007,3162,2496,7.61,7,78.8,459798,3968,457211,4.01,3.17,0.0508502538071066,0.86,99.44
2021-07-19,Tamil Nadu,1352,12,1344,17095,3471,1896,7.91,0,78.8,461150,3980,458555,4.4,2.41,0.21694162436548223,0.86,99.44
2021-07-20,Tamil Nadu,1547,14,1547,19225,316,61,8.05,0,78.8,462697,3994,460102,0.4,0.08,0.2439720812182741,0.86,99.44
2021-07-21,Tamil Nadu,730,10,729,9190,4404,4371,7.94,0,78.8,463427,4004,460831,5.59,5.55,0.1166243654822335,0.86,99.44
2021-07-22,Tamil Nadu,640,5,632,7888,4795,2815,8.11,3,78.8,464067,4009,461463,6.09,3.57,0.1001015228426396,0.86,99.44
2021-07-23,Tamil Nadu,197,1,194,2406,1785,62,8.19,2,78.8,464264,4010,461657,2.27,0.08,0.03053299492385787,0.86,99.44
2021-07-24,Tamil Nadu,254,1,248,2742,920,561,9.26,5,78.8,464518,4011,461905,1.17,0.71,0.03479695431472081,0.86,99.44
2021-07-25,Tamil Nadu,1418,18,1416,17942,48,34,7.9,0,78.8,465936,4029,463321,0.06,0.04,0.22769035532994925,0.86,99.44
2021-07-26,Tamil Nadu,1012,9,1011,13177,480,365,7.68,0,78.8,466948,4038,464332,0.61,0.46,0.16722081218274112,0.86,99.44
2021-07-27,Tamil Nadu,314,2,307,3623,1088,846,8.67,5,78.8,467262,4040,464639,1.38,1.07,0.04597715736040609,0.86,99.44
2021-07-28,Tamil Nadu,1419,15,1411,17461,4830,1179,8.13,0,78.8,468681,4055,466050,6.13,1.5,0.22158629441624367,0.87,99.44
2021-07-29,Tamil Nadu,470,2,463,5570,72,35,8.44,5,78.8,469151,4057,466513,0.09,0.04,0.07068527918781727,0.86,99.44
2021-07-30,Tamil Nadu,902,5,897,10825,3556,2229,8.33,0,78.8,470053,4062,467410,4.51,2.83,0.1373730964467005,0.86,99.44
2021-07-31,Tamil Nadu,737,11,731,9366,4360,2009,7.87,0,78.8,470790,4073,468141,5.53,2.55,0.11885786802030457,0.87,99.44
2021-08-01,Tamil Nadu,852,2,847,11004,1066,540,7.74,3,78.8,471642,4075,468988,1.35,0.69,0.13964467005076142,0.86,99.44
2021-08-02,Tamil Nadu,371,2,363,4998,3190,2105,7.42,6,78.8,472013,4077,469351,4.05,2.67,0.06342639593908629,0.86,99.44
2021-08-03,Tamil Nadu,1204,4,1195,15221,1354,1311,7.91,5,78.8,473217,4081,470546,1.72,1.66,0.19315989847715737,0.86,99.44
2021-08-04,Tamil Nadu,682,4,682,8502,151,151,8.02,0,78.8,473899,4085,471228,0.19,0.19,0.10789340101522843,0.86,99.44
2021-08-05,Tamil Nadu,1268,17,1263,16026,2605,1310,7.91,0,78.8,475167,4102,472491,3.31,1.66,0.2033756345177665,0.86,99.44
2021-08-06,Tamil Nadu,1207,14,1206,14771,4104,1981,8.17,0,78.8,476374,4116,473697,5.21,2.51,0.1874492385786802,0.86,99.44
2021-08-07,Tamil Nadu,1205,11,1199,14941,2925,1197,8.07,0,78.8,477579,4127,474896,3.71,1.52,0.18960659898477158,0.86,99.44
2021-08-08,Tamil Nadu,140,0,131,1696,3428,2044,8.25,9,78.8,477719,4127,475027,4.35,2.59,0.02152284263959391,0.86,99.44
2021-08-09,Tamil Nadu,267,1,266,3317,899,409,8.05,0,78.8,477986,4128,475293,1.14,0.52,0.04209390862944162,0.86,99.44
2021-08-10,Tamil Nadu,1012,8,1006,12627,4581,2445,8.01,0,78.8,478998,4136,476299,5.81,3.1,0.16024111675126904,0.86,99.44
2021-08-11,Tamil Nadu,1027,4,1023,12640,4200,4127,8.12,0,78.8,480025,4140,477322,5.33,5.24,0.16040609137055836,0.86,99.44
2021-08-12,Tamil Nadu,1375,14,1373,16983,1175,340,8.1,0,78.8,481400,4154,478695,1.49,0.43,0.21552030456852792,0.86,99.44
2021-08-13,Tamil Nadu,1144,8,1137,14368,2052,617,7.96,0,78.8,482544,4162,479832,2.6,0.78,0.18233502538071067,0.86,99.44
2021-08-14,Tamil Nadu,65,0,61,834,383,253,7.79,4,78.8,482609,4162,479893,0.49,0.32,0.010583756345177666,0.86,99.44
2021-08-15,Tamil Nadu,1302,5,1293,16350,153,12,7.96,4,78.8,483911,4167,481186,0.19,0.02,0.20748730964467005,0.86,99.44
2021-08-16,Tamil Nadu,376,5,369,4670,3933,3016,8.05,2,78.8,484287,4172,481555,4.99,3.83,0.059263959390862944,0.86,99.44
2021-08-17,Tamil Nadu,297,1,296,3777,3320,3040,7.86,0,78.8,484584,4173,481851,4.21,3.86,0.04793147208121827,0.86,99.44
2021-08-18,Tamil Nadu,1310,18,1309,16883,2499,1794,7.76,0,78.8,485894,4191,483160,3.17,2.28,0.214251269035533,0.86,99.44
2021-08-19,Tamil Nadu,210,2,206,2733,2020,366,7.68,2,78.8,486104,4193,483366,2.56,0.46,0.03468274111675127,0.86,99.44
2021-08-20,Tamil Nadu,1065,8,1056,12987,2921,1766,8.2,1,78.8,487169,4201,484422,3.71,2.24,0.16480964467005077,0.86,99.44
2021-08-21,Tamil Nadu,287,3,286,3753,684,325,7.65,0,78.8,487456,4204,484708,0.87,0.41,0.047626903553299495,0.86,99.44
2021-08-22,Tamil Nadu,1171,3,1170,15007,4289,90,7.8,0,78.8,488627,4207,485878,5.44,0.11,0.19044416243654821,0.86,99.44
2021-08-23,Tamil Nadu,595,6,594,7200,108,105,8.26,0,78.8,489222,4213,486472,0.14,0.13,0.09137055837563451,0.86,99.44
2021-08-24,Tamil Nadu,388,1,379,4765,1508,1499,8.14,8,78.8,489610,4214,486851,1.91,1.9,0.06046954314720812,0.86,99.44
2021-08-25,Tamil Nadu,275,3,275,3676,2246,766,7.48,0,78.8,489885,4217,487126,2.85,0.97,0.0466497461928934,0.86,99.44
2021-08-26,Tamil Nadu,1255,16,1248,15454,628,520,8.12,0,78.8,491140,4233,488374,0.8,0.66,0.19611675126903552,0.86,99.44
2021-08-27,Tamil Nadu,297,3,293,3842,4285,166,7.73,1,78.8,491437,4236,488667,5.44,0.21,0.04875634517766497,0.86,99.44
2021-08-28,Tamil Nadu,368,5,367,4699,4529,3508,7.83,0,78.8,491805,4241,489034,5.75,4.45,0.05963197969543147,0.86,99.44
2021-08-29,Tamil Nadu,586,3,577,6851,353,51,8.55,6,78.8,492391,4244,489611,0.45,0.06,0.08694162436548224,0.86,99.44
2021-08-30,Tamil Nadu,839,7,830,10289,2019,1277,8.15,2,78.8,493230,4251,490441,2.56,1.62,0.13057106598984772,0.86,99.43
2021-08-31,Tamil Nadu,808,5,803,10207,842,811,7.92,0,78.8,494038,4256,491244,1.07,1.03,0.12953045685279188,0.86,99.43
2021-09-01,Tamil Nadu,404,3,395,4985,1954,1258,8.1,6,78.8,494442,4259,491639,2.48,1.6,0.06326142131979695,0.86,99.43
2021-09-02,Tamil Nadu,1406,14,1397,17378,2984,2365,8.09,0,78.8,495848,4273,493036,3.79,3.0,0.22053299492385786,0.86,99.43
2021-09-03,Tamil Nadu,1059,4,1053,13540,888,837,7.82,2,78.8,496907,4277,494089,1.13,1.06,0.17182741116751268,0.86,99.43
2021-09-04,Tamil Nadu,1477,8,1468,18360,63,23,8.04,1,78.8,498384,4285,495557,0.08,0.03,0.23299492385786802,0.86,99.43
2021-09-05,Tamil Nadu,169,2,167,1865,3235,2559,9.06,0,78.8,498553,4287,495724,4.11,3.25,0.02366751269035533,0.86,99.43
2021-09-06,Tamil Nadu,662,8,660,8406,4474,58,7.88,0,78.8,499215,4295,496384,5.68,0.07,0.1066751269035533,0.86,99.43
2021-09-07,Tamil Nadu,1146,12,1139,13821,4184,1344,8.29,0,78.8,500361,4307,497523,5.31,1.71,0.17539340101522843,0.86,99.43
2021-09-08,Tamil Nadu,940,8,940,11705,4267,1979,8.03,0,78.8,501301,4315,498463,5.41,2.51,0.14854060913705583,0.86,99.43
2021-09-09,Tamil Nadu,603,2,598,7500,3468,2880,8.04,3,78.8,501904,4317,499061,4.4,3.65,0.09517766497461928,0.86,99.43
2021-09-10,Tamil Nadu,1420,7,1419,17514,3706,572,8.11,0,78.8,503324,4324,500480,4.7,0.73,0.22225888324873097,0.86,99.43
2021-09-11,Tamil Nadu,1008,13,999,12670,2151,656,7.96,0,78.8,504332,4337,501479,2.73,0.83,0.16078680203045687,0.86,99.43
2021-09-12,Tamil Nadu,1454,15,1453,18095,3023,652,8.04,0,78.8,505786,4352,502932,3.84,0.83,0.22963197969543148,0.86,99.44
2021-09-13,Tamil Nadu,193,0,190,2505,4098,3834,7.7,3,78.8,505979,4352,503122,5.2,4.87,0.031789340101522845,0.86,99.44
2021-09-14,Tamil Nadu,168,1,159,2323,1644,690,7.23,8,78.8,506147,4353,503281,2.09,0.88,0.02947969543147208,0.86,99.43
2021-09-15,Tamil Nadu,1357,4,1351,17017,3044,2043,7.97,2,78.8,507504,4357,504632,3.86,2.59,0.21595177664974619,0.86,99.43
2021-09-16,Tamil Nadu,67,0,60,1048,3813,3067,6.39,7,78.8,507571,4357,504692,4.84,3.89,0.013299492385786801,0.86,99.43
2021-09-17,Tamil Nadu,1553,20,1551,19994,4780,4121,7.77,0,78.8,509124,4377,506243,6.07,5.23,0.25373096446700505,0.86,99.43
2021-09-18,Tamil Nadu,973,13,964,12361,424,117,7.87,0,78.8,510097,4390,507207,0.54,0.15,0.15686548223350255,0.86,99.43
2021-09-19,Tamil Nadu,213,0,207,2671,28,15,7.97,6,78.8,510310,4390,507414,0.04,0.02,0.033895939086294416,0.86,99.43
2021-09-20,Tamil Nadu,916,11,912,11370,2689,261,8.06,0,78.8,511226,4401,508326,3.41,0.33,0.14428934010152283,0.86,99.43
2021-09-21,Tamil Nadu,535,5,532,6462,1495,135,8.28,0,78.8,511761,4406,508858,1.9,0.17,0.08200507614213198,0.86,99.43
2021-09-22,Tamil Nadu,695,2,688,9119,637,260,7.62,5,78.8,512456,4408,509546,0.81,0.33,0.1157233502538071,0.86,99.43
2021-09-23,Tamil Nadu,640,3,638,7959,3511,1832,8.04,0,78.8,513096,4411,510184,4.46,2.32,0.10100253807106599,0.86,99.43
2021-09-24,Tamil Nadu,1481,22,1477,18556,1673,1599,7.98,0,78.8,514577,4433,511661,2.12,2.03,0.23548223350253808,0.86,99.43
2021-09-25,Tamil Nadu,1015,8,1008,12758,3288,885,7.96,0,78.8,515592,4441,512669,4.17,1.12,0.16190355329949238,0.86,99.43
2021-09-26,Tamil Nadu,1307,6,1301,16494,4524,83,7.92,0,78.8,516899,4447,513970,5.74,0.11,0.20931472081218275,0.86,99.43
2021-09-27,Tamil Nadu,1144,14,1138,14264,701,422,8.02,0,78.8,518043,4461,515108,0.89,0.54,0.18101522842639595,0.86,99.43
2021-09-28,Tamil Nadu,375,3,375,4446,793,121,8.43,0,78.8,518418,4464,515483,1.01,0.15,0.05642131979695431,0.86,99.43
2021-09-29,Tamil Nadu,1232,16,1232,15675,4386,3849,7.86,0,78.8,519650,4480,516715,5.57,4.88,0.19892131979695432,0.86,99.44
2021-09-30,Tamil Nadu,562,2,558,6791,1513,755,8.28,2,78.8,520212,4482,517273,1.92,0.96,0.08618020304568529,0.86,99.44
2021-10-01,Tamil Nadu,611,6,606,7862,1338,266,7.77,0,78.8,520823,4488,517879,1.7,0.34,0.09977157360406091,0.86,99.43
2021-10-02,Tamil Nadu,416,4,410,4727,1129,1006,8.8,2,78.8,521239,4492,518289,1.43,1.28,0.05998730964467005,0.86,99.43
2021-10-03,Tamil Nadu,1121,10,1116,14095,3555,1124,7.95,0,78.8,522360,4502,519405,4.51,1.43,0.1788705583756345,0.86,99.43
2021-10-04,Tamil Nadu,346,4,340,4403,4385,655,7.86,2,78.8,522706,4506,519745,5.56,0.83,0.0558756345177665,0.86,99.43
2021-10-05,Tamil Nadu,780,2,778,9974,3123,2278,7.82,0,78.8,523486,4508,520523,3.96,2.89,0.1265736040609137,0.86,99.43
2021-10-06,Tamil Nadu,628,2,627,7747,524,328,8.11,0,78.8,524114,4510,521150,0.66,0.42,0.09831218274111675,0.86,99.43
2021-10-07,Tamil Nadu,1507,7,1507,18899,517,366,7.97,0,78.8,525621,4517,522657,0.66,0.46,0.23983502538071066,0.86,99.44
2021-10-08,Tamil Nadu,694,3,689,8755,1577,292,7.93,2,78.8,526315,4520,523346,2.0,0.37,0.11110406091370559,0.86,99.44
2021-10-09,Tamil Nadu,52,0,43,597,1612,610,8.71,9,78.8,526367,4520,523389,2.05,0.77,0.0075761421319796955,0.86,99.43
2021-10-10,Tamil Nadu,1537,8,1528,19708,2282,1632,7.8,1,78.8,527904,4528,524917,2.9,2.07,0.2501015228426396,0.86,99.43
2021-10-11,Tamil Nadu,1135,8,1132,14222,3560,2867,7.98,0,78.8,529039,4536,526049,4.52,3.64,0.18048223350253806,0.86,99.43
2021-10-12,Tamil Nadu,1588,12,1580,19913,128,69,7.97,0,78.8,530627,4548,527629,0.16,0.09,0.2527030456852792,0.86,99.44
2021-10-13,Tamil Nadu,226,2,224,2709,3869,3539,8.34,0,78.8,530853,4550,527853,4.91,4.49,0.03437817258883249,0.86,99.43
2021-10-14,Tamil Nadu,715,3,714,9334,4349,186,7.66,0,78.8,531568,4553,528567,5.52,0.24,0.1184517766497462,0.86,99.44
2021-10-15,Tamil Nadu,1554,22,1546,19304,1113,95,8.05,0,78.8,533122,4575,530113,1.41,0.12,0.2449746192893401,0.86,99.44
2021-10-16,Tamil Nadu,1382,12,1382,17132,2549,891,8.07,0,78.8,534504,4587,531495,3.23,1.13,0.21741116751269035,0.86,99.44
2021-10-17,Tamil Nadu,646,6,638,8382,1101,791,7.71,2,78.8,535150,4593,532133,1.4,1.0,0.10637055837563451,0.86,99.44
2021-10-18,Tamil Nadu,1371,15,1370,17502,2897,250,7.83,0,78.8,536521,4608,533503,3.68,0.32,0.22210659898477159,0.86,99.44
2021-10-19,Tamil Nadu,1540,21,1540,19043,3196,2724,8.09,0,78.8,538061,4629,535043,4.06,3.46,0.24166243654822336,0.86,99.44
2021-10-20,Tamil Nadu,1343,4,1340,16588,2998,1424,8.1,0,78.8,539404,4633,536383,3.8,1.81,0.21050761421319797,0.86,99.44
2021-10-21,Tamil Nadu,694,7,685,8830,4844,1416,7.86,2,78.8,540098,4640,537068,6.15,1.8,0.11205583756345178,0.86,99.44
2021-10-22,Tamil Nadu,643,5,637,7919,792,203,8.12,1,78.8,540741,4645,537705,1.01,0.26,0.10049492385786803,0.86,99.44
2021-10-23,Tamil Nadu,1279,5,1277,16145,700,605,7.92,0,78.8,542020,4650,538982,0.89,0.77,0.20488578680203046,0.86,99.44
2021-10-24,Tamil Nadu,1487,20,1478,18343,3661,3182,8.11,0,78.8,543507,4670,540460,4.65,4.04,0.23277918781725887,0.86,99.44
2021-10-25,Tamil Nadu,159,0,157,1838,1020,95,8.65,2,78.8,543666,4670,540617,1.29,0.12,0.0233248730964467,0.86,99.44
2021-10-26,Tamil Nadu,1362,17,1358,16750,2384,2284,8.13,0,78.8,545028,4687,541975,3.03,2.9,0.21256345177664976,0.86,99.44
2021-10-27,Tamil Nadu,30,0,23,534,1912,1040,5.62,7,78.8,545058,4687,541998,2.43,1.32,0.006776649746192893,0.86,99.44
2021-10-28,Tamil Nadu,911,3,910,11824,949,69,7.7,0,78.8,545969,4690,542908,1.2,0.09,0.1500507614213198,0.86,99.44
2021-10-29,Tamil Nadu,641,2,640,7841,2838,315,8.17,0,78.8,546610,4692,543548,3.6,0.4,0.09950507614213198,0.86,99.44
2021-10-30,Tamil Nadu,952,4,947,11913,208,121,7.99,1,78.8,547562,4696,544495,0.26,0.15,0.15118020304568527,0.86,99.44
2021-10-31,Tamil Nadu,1470,13,1465,18545,848,789,7.93,0,78.8,549032,4709,545960,1.08,1.0,0.23534263959390864,0.86,99.44
2021-11-01,Tamil Nadu,834,4,834,10746,3215,1618,7.76,0,78.8,549866,4713,546794,4.08,2.05,0.13637055837563453,0.86,99.44
2021-11-02,Tamil Nadu,369,1,364,4499,2066,1400,8.2,4,78.8,550235,4714,547158,2.62,1.78,0.05709390862944162,0.86,99.44
2021-11-03,Tamil Nadu,1515,9,1515,18951,1328,229,7.99,0,78.8,551750,4723,548673,1.69,0.29,0.24049492385786803,0.86,99.44
2021-11-04,Tamil Nadu,433,4,430,5382,828,553,8.05,0,78.8,552183,4727,549103,1.05,0.7,0.06829949238578681,0.86,99.44
2021-11-05,Tamil Nadu,1609,9,1601,19744,3011,1571,8.15,0,78.8,553792,4736,550704,3.82,1.99,0.25055837563451777,0.86,99.44
2021-11-06,Tamil Nadu,603,5,595,7501,3245,1912,8.04,3,78.8,554395,4741,551299,4.12,2.43,0.09519035532994924,0.86,99.44
2021-11-07,Tamil Nadu,840,4,833,10258,2568,1407,8.19,3,78.8,555235,4745,552132,3.26,1.79,0.1301776649746193,0.85,99.44
2021-11-08,Tamil Nadu,1072,13,1067,13522,4963,684,7.93,0,78.8,556307,4758,553199,6.3,0.87,0.1715989847715736,0.86,99.44
2021-11-09,Tamil Nadu,282,2,276,3469,3658,419,8.13,4,78.8,556589,4760,553475,4.64,0.53,0.04402284263959391,0.86,99.44
2021-11-10,Tamil Nadu,521,5,520,6790,1606,1577,7.67,0,78.8,557110,4765,553995,2.04,2.0,0.08616751269035533,0.86,99.44
2021-11-11,Tamil Nadu,1026,7,1025,13042,1505,1440,7.87,0,78.8,558136,4772,555020,1.91,1.83,0.16550761421319796,0.85,99.44
2021-11-12,Tamil Nadu,663,6,661,8164,2271,1525,8.12,0,78.8,558799,4778,555681,2.88,1.94,0.10360406091370558,0.86,99.44
2021-11-13,Tamil Nadu,1506,20,1503,19004,984,890,7.92,0,78.8,560305,4798,557184,1.25,1.13,0.24116751269035533,0.86,99.44
2021-11-14,Tamil Nadu,120,1,117,1704,2000,373,7.04,2,78.8,560425,4799,557301,2.54,0.47,0.021624365482233503,0.86,99.44
2021-11-15,Tamil Nadu,613,7,607,7974,1445,321,7.69,0,78.8,561038,4806,557908,1.83,0.41,0.10119289340101523,0.86,99.44
2021-11-16,Tamil Nadu,988,3,988,12405,4804,2017,7.96,0,78.8,562026,4809,558896,6.1,2.56,0.1574238578680203,0.86,99.44
2021-11-17,Tamil Nadu,907,3,902,11513,611,532,7.88,2,78.8,562933,4812,559798,0.78,0.68,0.1461040609137056,0.85,99.44
2021-11-18,Tamil Nadu,919,9,913,11567,2877,1258,7.95,0,78.8,563852,4821,560711,3.65,1.6,0.14678934010152284,0.86,99.44
2021-11-19,Tamil Nadu,1151,12,1149,14172,3586,2056,8.12,0,78.8,565003,4833,561860,4.55,2.61,0.1798477157360406,0.86,99.44
2021-11-20,Tamil Nadu,800,7,792,10210,4672,1191,7.84,1,78.8,565803,4840,562652,5.93,1.51,0.12956852791878173,0.86,99.44
2021-11-21,Tamil Nadu,881,7,877,10958,1054,441,8.04,0,78.8,566684,4847,563529,1.34,0.56,0.13906091370558377,0.86,99.44
2021-11-22,Tamil Nadu,602,5,602,7894,3001,2112,7.63,0,78.8,567286,4852,564131,3.81,2.68,0.10017766497461929,0.86,99.44
2021-11-23,Tamil Nadu,1449,13,1445,18099,905,591,8.01,0,78.8,568735,4865,565576,1.15,0.75,0.22968274111675127,0.86,99.44
2021-11-24,Tamil Nadu,1102,16,1093,13449,953,55,8.19,0,78.8,569837,4881,566669,1.21,0.07,0.17067258883248732,0.86,99.44
2021-11-25,Tamil Nadu,238,3,235,2986,3955,3901,7.97,0,78.8,570075,4884,566904,5.02,4.95,0.03789340101522843,0.86,99.44
2021-11-26,Tamil Nadu,121,1,118,2060,3234,1387,5.87,2,78.8,570196,4885,567022,4.1,1.76,0.02614213197969543,0.86,99.44
2021-11-27,Tamil Nadu,570,5,567,7345,445,253,7.76,0,78.8,570766,4890,567589,0.56,0.32,0.09321065989847716,0.86,99.44
2021-11-28,Tamil Nadu,1183,17,1181,14615,786,290,8.09,0,78.8,571949,4907,568770,1.0,0.37,0.18546954314720812,0.86,99.44
2021-11-29,Tamil Nadu,108,0,108,880,6,6,12.27,0,78.8,572057,4907,568878,0.01,0.01,0.01116751269035533,0.86,99.44
2021-11-30,Tamil Nadu,654,4,653,8413,545,539,7.77,0,78.8,572711,4911,569531,0.69,0.68,0.10676395939086294,0.86,99.44
2021-12-01,Tamil Nadu,907,12,902,11633,3305,2493,7.8,0,78.8,573618,4923,570433,4.19,3.16,0.1476269035532995,0.86,99.44
2021-12-02,Tamil Nadu,1093,4,1092,13671,1519,839,8.0,0,78.8,574711,4927,571525,1.93,1.06,0.17348984771573603,0.86,99.45
2021-12-03,Tamil Nadu,1492,13,1491,19130,2019,1342,7.8,0,78.8,576203,4940,573016,2.56,1.7,0.24276649746192894,0.86,99.45
2021-12-04,Tamil Nadu,383,5,381,5003,4044,3569,7.66,0,78.8,576586,4945,573397,5.13,4.53,0.06348984771573604,0.86,99.45
2021-12-05,Tamil Nadu,568,6,560,6873,3588,980,8.26,2,78.8,577154,4951,573957,4.55,1.24,0.08722081218274112,0.86,99.45
2021-12-06,Tamil Nadu,414,3,412,5308,2516,722,7.8,0,78.8,577568,4954,574369,3.19,0.92,0.06736040609137056,0.86,99.45
2021-12-07,Tamil Nadu,1457,12,1448,18195,4736,4430,8.01,0,78.8,579025,4966,575817,6.01,5.62,0.2309010152284264,0.86,99.45
2021-12-08,Tamil Nadu,1304,4,1299,16230,4763,97,8.03,1,78.8,580329,4970,577116,6.04,0.12,0.20596446700507615,0.86,99.45
2021-12-09,Tamil Nadu,1397,19,1397,17342,1138,759,8.06,0,78.8,581726,4989,578513,1.44,0.96,0.2200761421319797,0.86,99.45
2021-12-10,Tamil Nadu,575,3,574,7283,4870,1734,7.9,0,78.8,582301,4992,579087,6.18,2.2,0.0924238578680203,0.86,99.45
2021-12-11,Tamil Nadu,716,4,708,8843,4449,751,8.1,4,78.8,583017,4996,579795,5.65,0.95,0.11222081218274112,0.86,99.45
2021-12-12,Tamil Nadu,784,8,782,9970,4428,3644,7.86,0,78.8,583801,5004,580577,5.62,4.62,0.1265228426395939,0.86,99.45
2021-12-13,Tamil Nadu,662,3,656,7969,350,24,8.31,3,78.8,584463,5007,581233,0.44,0.03,0.10112944162436548,0.86,99.45
2021-12-14,Tamil Nadu,387,4,385,4938,1430,1269,7.84,0,78.8,584850,5011,581618,1.81,1.61,0.06266497461928934,0.86,99.45
2021-12-15,Tamil Nadu,1222,12,1222,15386,4966,3055,7.94,0,78.8,586072,5023,582840,6.3,3.88,0.19525380710659898,0.86,99.45
2021-12-16,Tamil Nadu,47,0,42,665,3749,3661,7.07,5,78.8,586119,5023,582882,4.76,4.65,0.008439086294416243,0.86,99.45
2021-12-17,Tamil Nadu,986,7,977,12483,1405,1343,7.9,2,78.8,587105,5030,583859,1.78,1.7,0.15841370558375634,0.86,99.45
2021-12-18,Tamil Nadu,1373,12,1372,17004,1059,869,8.07,0,78.8,588478,5042,585231,1.34,1.1,0.21578680203045686,0.86,99.45
2021-12-19,Tamil Nadu,231,2,223,3182,3364,1470,7.26,6,78.8,588709,5044,585454,4.27,1.87,0.040380710659898476,0.86,99.45
2021-12-20,Tamil Nadu,1209,9,1202,15378,2,1,7.86,0,78.8,589918,5053,586656,0.0,0.0,0.1951522842639594,0.86,99.45
2021-12-21,Tamil Nadu,1329,6,1329,16855,1943,974,7.88,0,78.8,591247,5059,587985,2.47,1.24,0.21389593908629442,0.86,99.45
2021-12-22,Tamil Nadu,931,9,927,11677,3161,1314,7.97,0,78.8,592178,5068,588912,4.01,1.67,0.14818527918781726,0.86,99.45
2021-12-23,Tamil Nadu,1211,4,1203,15289,3276,910,7.92,4,78.8,593389,5072,590115,4.16,1.15,0.1940228426395939,0.85,99.45
2021-12-24,Tamil Nadu,1332,15,1324,16720,3380,2398,7.97,0,78.8,594721,5087,591439,4.29,3.04,0.21218274111675126,0.86,99.45
2021-12-25,Tamil Nadu,733,6,726,8487,3564,3068,8.64,1,78.8,595454,5093,592165,4.52,3.89,0.10770304568527919,0.86,99.45
2021-12-26,Tamil Nadu,785,7,778,10094,865,424,7.78,0,78.8,596239,5100,592943,1.1,0.54,0.12809644670050763,0.86,99.45
2021-12-27,Tamil Nadu,933,13,924,12284,2870,2214,7.6,0,78.8,597172,5113,593867,3.64,2.81,0.15588832487309645,0.86,99.45
2021-12-28,Tamil Nadu,533,6,531,7026,2193,1760,7.59,0,78.8,597705,5119,594398,2.78,2.23,0.08916243654822335,0.86,99.45
2021-12-29,Tamil Nadu,1575,19,1569,19656,50,40,8.01,0,78.8,599280,5138,595967,0.06,0.05,0.24944162436548223,0.86,99.45
2021-12-30,Tamil Nadu,285,1,278,3169,3646,3145,8.99,6,78.8,599565,5139,596245,4.63,3.99,0.040215736040609136,0.86,99.45
2021-12-31,Tamil Nadu,82,0,80,565,1249,910,14.51,2,78.8,599647,5139,596325,1.59,1.15,0.00717005076142132,0.86,99.45
2022-01-01,Tamil Nadu,801,10,799,10016,4796,4574,8.0,0,78.8,600448,5149,597124,6.09,5.8,0.12710659898477158,0.86,99.45
2022-01-02,Tamil Nadu,1259,11,1252,16075,1667,368,7.83,0,78.8,601707,5160,598376,2.12,0.47,0.203997461928934,0.86,99.45
2022-01-03,Tamil Nadu,247,0,241,3345,2766,2672,7.38,6,78.8,601954,5160,598617,3.51,3.39,0.0424492385786802,0.86,99.45
2022-01-04,Tamil Nadu,382,4,379,4986,1238,258,7.66,0,78.8,602336,5164,598996,1.57,0.33,0.0632741116751269,0.86,99.45
2022-01-05,Tamil Nadu,126,1,120,2125,987,33,5.93,5,78.8,602462,5165,599116,1.25,0.04,0.026967005076142133,0.86,99.44
2022-01-06,Tamil Nadu,1408,13,1407,17572,4888,3858,8.01,0,78.8,603870,5178,600523,6.2,4.9,0.222994923857868,0.86,99.45
2022-01-07,Tamil Nadu,1226,15,1217,15581,2352,1979,7.87,0,78.8,605096,5193,601740,2.98,2.51,0.1977284263959391,0.86,99.45
2022-01-08,Tamil Nadu,1442,17,1433,18115,2053,74,7.96,0,78.8,606538,5210,603173,2.61,0.09,0.22988578680203045,0.86,99.45
2022-01-09,Tamil Nadu,1300,10,1300,16256,3828,1859,8.0,0,78.8,607838,5220,604473,4.86,2.36,0.20629441624365483,0.86,99.45
2022-01-10,Tamil Nadu,643,2,643,7711,2496,885,8.34,0,78.8,608481,5222,605116,3.17,1.12,0.09785532994923858,0.86,99.45
2022-01-11,Tamil Nadu,1430,10,1421,17565,323,16,8.14,0,78.8,609911,5232,606537,0.41,0.02,0.22290609137055836,0.86,99.45
2022-01-12,Tamil Nadu,984,5,982,12154,4844,479,8.1,0,78.8,610895,5237,607519,6.15,0.61,0.15423857868020305,0.86,99.45
2022-01-13,Tamil Nadu,1554,13,1554,19341,1360,243,8.03,0,78.8,612449,5250,609073,1.73,0.31,0.24544416243654824,0.86,99.45
2022-01-14,Tamil Nadu,563,8,560,7255,1628,1075,7.76,0,78.8,613012,5258,609633,2.07,1.36,0.09206852791878173,0.86,99.45
2022-01-15,Tamil Nadu,230,2,224,2643,1464,212,8.7,4,78.8,613242,5260,609857,1.86,0.27,0.03354060913705584,0.86,99.45
2022-01-16,Tamil Nadu,459,2,454,5482,1937,995,8.37,3,78.8,613701,5262,610311,2.46,1.26,0.06956852791878172,0.86,99.45
2022-01-17,Tamil Nadu,1177,3,1170,14514,4138,1524,8.11,4,78.8,614878,5265,611481,5.25,1.93,0.18418781725888325,0.86,99.45
2022-01-18,Tamil Nadu,217,0,209,3016,4702,2215,7.19,8,78.8,615095,5265,611690,5.97,2.81,0.038274111675126905,0.86,99.45
2022-01-19,Tamil Nadu,668,5,662,8192,1042,999,8.15,1,78.8,615763,5270,612352,1.32,1.27,0.10395939086294416,0.86,99.45
2022-01-20,Tamil Nadu,976,14,968,12470,4381,1446,7.83,0,78.8,616739,5284,613320,5.56,1.84,0.158248730964467,0.86,99.45
2022-01-21,Tamil Nadu,194,1,189,2553,1127,402,7.6,4,78.8,616933,5285,613509,1.43,0.51,0.032398477157360404,0.86,99.44
2022-01-22,Tamil Nadu,606,3,606,7688,3370,1488,7.88,0,78.8,617539,5288,614115,4.28,1.89,0.09756345177664974,0.86,99.45
2022-01-23,Tamil Nadu,269,2,262,3191,3540,318,8.43,5,78.8,617808,5290,614377,4.49,0.4,0.04049492385786802,0.86,99.44
2022-01-24,Tamil Nadu,1187,12,1181,14783,2868,1757,8.03,0,78.8,618995,5302,615558,3.64,2.23,0.1876015228426396,0.86,99.44
2022-01-25,Tamil Nadu,471,4,470,5501,1305,4,8.56,0,78.8,619466,5306,616028,1.66,0.01,0.06980964467005076,0.86,99.45
2022-01-26,Tamil Nadu,807,11,799,10095,3668,1343,7.99,0,78.8,620273,5317,616827,4.65,1.7,0.12810913705583757,0.86,99.44
2022-01-27,Tamil Nadu,934,13,928,11887,2169,1637,7.86,0,78.8,621207,5330,617755,2.75,2.08,0.1508502538071066,0.86,99.44
2022-01-28,Tamil Nadu,1217,17,1215,15088,2135,856,8.07,0,78.8,622424,5347,618970,2.71,1.09,0.1914720812182741,0.86,99.45
2022-01-29,Tamil Nadu,221,2,216,2758,4627,95,8.01,3,78.8,622645,5349,619186,5.87,0.12,0.035,0.86,99.44
2022-01-30,Tamil Nadu,1113,14,1107,14282,891,633,7.79,0,78.8,623758,5363,620293,1.13,0.8,0.18124365482233504,0.86,99.44
2022-01-31,Tamil Nadu,1611,21,1610,19961,4515,1334,8.07,0,78.8,625369,5384,621903,5.73,1.69,0.2533121827411168,0.86,99.45
2022-02-01,Tamil Nadu,69,0,63,872,1628,1570,7.91,6,78.8,625438,5384,621966,2.07,1.99,0.011065989847715736,0.86,99.44
2022-02-02,Tamil Nadu,334,1,331,3977,2177,54,8.4,2,78.8,625772,5385,622297,2.76,0.07,0.05046954314720812,0.86,99.44
2022-02-03,Tamil Nadu,1487,16,1486,18714,4461,4056,7.95,0,78.8,627259,5401,623783,5.66,5.15,0.23748730964467005,0.86,99.45
2022-02-04,Tamil Nadu,1053,5,1044,12999,1265,10,8.1,4,78.8,628312,5406,624827,1.61,0.01,0.16496192893401015,0.86,99.45
2022-02-05,Tamil Nadu,465,1,456,6130,3535,3143,7.59,8,78.8,628777,5407,625283,4.49,3.99,0.07779187817258883,0.86,99.44
2022-02-06,Tamil Nadu,372,2,372,4172,1324,830,8.92,0,78.8,629149,5409,625655,1.68,1.05,0.052944162436548224,0.86,99.44
2022-02-07,Tamil Nadu,332,4,332,4038,1677,445,8.22,0,78.8,629481,5413,625987,2.13,0.56,0.051243654822335026,0.86,99.44
2022-02-08,Tamil Nadu,330,1,321,4313,4715,1222,7.65,8,78.8,629811,5414,626308,5.98,1.55,0.05473350253807106,0.86,99.44
2022-02-09,Tamil Nadu,1262,6,1262,16301,2910,2309,7.74,0,78.8,631073,5420,627570,3.69,2.93,0.20686548223350254,0.86,99.44
2022-02-10,Tamil Nadu,556,7,556,6977,2839,2749,7.97,0,78.8,631629,5427,628126,3.6,3.49,0.08854060913705583,0.86,99.45
2022-02-11,Tamil Nadu,1027,4,1023,12543,2390,1837,8.19,0,78.8,632656,5431,629149,3.03,2.33,0.1591751269035533,0.86,99.45
2022-02-12,Tamil Nadu,1165,5,1160,14478,800,415,8.05,0,78.8,633821,5436,630309,1.02,0.53,0.18373096446700507,0.86,99.45
2022-02-13,Tamil Nadu,980,11,974,12282,3048,438,7.98,0,78.8,634801,5447,631283,3.87,0.56,0.15586294416243654,0.86,99.45
2022-02-14,Tamil Nadu,1364,13,1363,16289,656,3,8.37,0,78.8,636165,5460,632646,0.83,0.0,0.20671319796954316,0.86,99.45
2022-02-15,Tamil Nadu,220,0,215,2417,3539,2271,9.1,5,78.8,636385,5460,632861,4.49,2.88,0.03067258883248731,0.86,99.45
2022-02-16,Tamil Nadu,612,3,610,8195,4731,1364,7.47,0,78.8,636997,5463,633471,6.0,1.73,0.10399746192893401,0.86,99.45
2022-02-17,Tamil Nadu,520,6,513,6694,1455,489,7.77,1,78.8,637517,5469,633984,1.85,0.62,0.0849492385786802,0.86,99.45
2022-02-18,Tamil Nadu,1291,8,1282,15457,1782,1298,8.35,1,78.8,638808,5477,635266,2.26,1.65,0.19615482233502538,0.86,99.45
2022-02-19,Tamil Nadu,806,8,806,10313,4135,2685,7.82,0,78.8,639614,5485,636072,5.25,3.41,0.1308756345177665,0.86,99.45
2022-02-20,Tamil Nadu,245,1,241,3696,2617,490,6.63,3,78.8,639859,5486,636313,3.32,0.62,0.04690355329949238,0.86,99.45
2022-02-21,Tamil Nadu,1492,9,1492,18382,527,76,8.12,0,78.8,641351,5495,637805,0.67,0.1,0.2332741116751269,0.86,99.45
2022-02-22,Tamil Nadu,864,6,860,10608,1146,644,8.14,0,78.8,642215,5501,638665,1.45,0.82,0.13461928934010153,0.86,99.45
2022-02-23,Tamil Nadu,1429,19,1429,17650,3676,1339,8.1,0,78.8,643644,5520,640094,4.66,1.7,0.22398477157360405,0.86,99.45
2022-02-24,Tamil Nadu,271,3,269,3541,1049,564,7.65,0,78.8,643915,5523,640363,1.33,0.72,0.044936548223350255,0.86,99.45
2022-02-25,Tamil Nadu,733,5,731,9567,2729,1567,7.66,0,78.8,644648,5528,641094,3.46,1.99,0.12140862944162437,0.86,99.45
2022-02-26,Tamil Nadu,936,4,929,11440,268,118,8.18,3,78.8,645584,5532,642023,0.34,0.15,0.14517766497461929,0.86,99.45
2022-02-27,Tamil Nadu,849,7,845,10474,1321,199,8.11,0,78.8,646433,5539,642868,1.68,0.25,0.13291878172588834,0.86,99.45
2022-02-28,Tamil Nadu,297,1,297,3562,256,38,8.34,0,78.8,646730,5540,643165,0.32,0.05,0.045203045685279185,0.86,99.45
2022-03-01,Tamil Nadu,122,1,122,890,283,93,13.71,0,78.8,646852,5541,643287,0.36,0.12,0.011294416243654822,0.86,99.45
2022-03-02,Tamil Nadu,1259,8,1250,15802,546,354,7.97,1,78.8,648111,5549,644537,0.69,0.45,0.20053299492385787,0.86,99.45
2022-03-03,Tamil Nadu,1071,11,1069,13500,2775,1853,7.93,0,78.8,649182,5560,645606,3.52,2.35,0.1713197969543147,0.86,99.45
2022-03-04,Tamil Nadu,586,4,582,7238,4672,1805,8.1,0,78.8,649768,5564,646188,5.93,2.29,0.0918527918781726,0.86,99.45
2022-03-05,Tamil Nadu,832,11,827,10400,445,443,8.0,0,78.8,650600,5575,647015,0.56,0.56,0.1319796954314721,0.86,99.45
2022-03-06,Tamil Nadu,758,10,751,9534,3641,3564,7.95,0,78.8,651358,5585,647766,4.62,4.52,0.12098984771573604,0.86,99.45
2022-03-07,Tamil Nadu,277,2,272,3443,2204,892,8.05,3,78.8,651635,5587,648038,2.8,1.13,0.04369289340101523,0.86,99.45
2022-03-08,Tamil Nadu,26,0,25,648,3739,619,4.01,1,78.8,651661,5587,648063,4.74,0.79,0.008223350253807106,0.86,99.45
2022-03-09,Tamil Nadu,1394,14,1393,17138,4363,765,8.13,0,78.8,653055,5601,649456,5.54,0.97,0.21748730964467006,0.86,99.45
2022-03-10,Tamil Nadu,652,6,650,8011,2242,648,8.14,0,78.8,653707,5607,650106,2.85,0.82,0.10166243654822335,0.86,99.45
2022-03-11,Tamil Nadu,776,10,776,9485,296,110,8.18,0,78.8,654483,5617,650882,0.38,0.14,0.12036802030456853,0.86,99.45
2022-03-12,Tamil Nadu,1370,17,1362,16950,4826,4550,8.08,0,78.8,655853,5634,652244,6.12,5.77,0.2151015228426396,0.86,99.45
2022-03-13,Tamil Nadu,359,4,350,4635,2409,1374,7.75,5,78.8,656212,5638,652594,3.06,1.74,0.05881979695431472,0.86,99.45
2022-03-14,Tamil Nadu,688,5,679,8699,2590,760,7.91,4,78.8,656900,5643,653273,3.29,0.96,0.11039340101522843,0.86,99.45
2022-03-15,Tamil Nadu,175,0,173,1976,2638,2192,8.86,2,78.8,657075,5643,653446,3.35,2.78,0.025076142131979694,0.86,99.45
2022-03-16,Tamil Nadu,383,5,374,4482,1963,1617,8.55,4,78.8,657458,5648,653820,2.49,2.05,0.05687817258883249,0.86,99.45
2022-03-17,Tamil Nadu,1243,10,1234,15620,1261,857,7.96,0,78.8,658701,5658,655054,1.6,1.09,0.1982233502538071,0.86,99.45
2022-03-18,Tamil Nadu,917,6,917,11799,620,490,7.77,0,78.8,659618,5664,655971,0.79,0.62,0.14973350253807108,0.86,99.45
2022-03-19,Tamil Nadu,704,7,700,8636,4956,4033,8.15,0,78.8,660322,5671,656671,6.29,5.12,0.10959390862944163,0.86,99.45
2022-03-20,Tamil Nadu,1419,7,1418,17808,972,686,7.97,0,78.8,661741,5678,658089,1.23,0.87,0.22598984771573605,0.86,99.45
2022-03-21,Tamil Nadu,1087,13,1084,13333,4580,1824,8.15,0,78.8,662828,5691,659173,5.81,2.31,0.1692005076142132,0.86,99.45
2022-03-22,Tamil Nadu,665,6,656,8402,1839,1299,7.91,3,78.8,663493,5697,659829,2.33,1.65,0.1066243654822335,0.86,99.45
2022-03-23,Tamil Nadu,31,0,22,510,4063,3368,6.08,9,78.8,663524,5697,659851,5.16,4.27,0.006472081218274112,0.86,99.45
2022-03-24,Tamil Nadu,638,5,635,8070,1808,1754,7.91,0,78.8,664162,5702,660486,2.29,2.23,0.10241116751269036,0.86,99.45
2022-03-25,Tamil Nadu,453,2,450,5925,821,617,7.65,1,78.8,664615,5704,660936,1.04,0.78,0.07519035532994923,0.86,99.45
2022-03-26,Tamil Nadu,497,3,489,6421,4345,281,7.74,5,78.8,665112,5707,661425,5.51,0.36,0.08148477157360406,0.86,99.45
2022-03-27,Tamil Nadu,883,8,878,11584,4880,78,7.62,0,78.8,665995,5715,662303,6.19,0.1,0.14700507614213199,0.86,99.45
2022-03-28,Tamil Nadu,839,4,835,10445,2018,114,8.03,0,78.8,666834,5719,663138,2.56,0.14,0.1325507614213198,0.86,99.45
2022-03-29,Tamil Nadu,1366,6,1361,17281,4548,3743,7.9,0,78.8,668200,5725,664499,5.77,4.75,0.2193020304568528,0.86,99.45
2022-03-30,Tamil Nadu,1434,18,1429,18171,4316,652,7.89,0,78.8,669634,5743,665928,5.48,0.83,0.2305964467005076,0.86,99.45
2022-03-31,Tamil Nadu,474,4,471,5854,2479,1085,8.1,0,78.8,670108,5747,666399,3.15,1.38,0.07428934010152284,0.86,99.45
2022-04-01,Tamil Nadu,881,6,873,11128,2047,1762,7.92,2,78.8,670989,5753,667272,2.6,2.24,0.14121827411167512,0.86,99.45
2022-04-02,Tamil Nadu,1424,7,1422,17676,2926,787,8.06,0,78.8,672413,5760,668694,3.71,1.0,0.22431472081218273,0.86,99.45
2022-04-03,Tamil Nadu,499,2,492,5840,3020,1064,8.54,5,78.8,672912,5762,669186,3.83,1.35,0.07411167512690356,0.86,99.45
2022-04-04,Tamil Nadu,467,1,459,5740,1793,719,8.14,7,78.8,673379,5763,669645,2.28,0.91,0.07284263959390863,0.86,99.45
2022-04-05,Tamil Nadu,541,2,540,6726,4515,773,8.04,0,78.8,673920,5765,670185,5.73,0.98,0.08535532994923858,0.86,99.45
2022-04-06,Tamil Nadu,1120,4,1112,14061,1917,1209,7.97,4,78.8,675040,5769,671297,2.43,1.53,0.17843908629441624,0.85,99.45
2022-04-07,Tamil Nadu,145,1,136,1346,2914,1644,10.77,8,78.8,675185,5770,671433,3.7,2.09,0.017081218274111677,0.85,99.44
2022-04-08,Tamil Nadu,1569,20,1567,19524,2833,2303,8.04,0,78.8,676754,5790,673000,3.6,2.92,0.24776649746192894,0.86,99.45
2022-04-09,Tamil Nadu,1394,18,1386,17653,4996,1694,7.9,0,78.8,678148,5808,674386,6.34,2.15,0.2240228426395939,0.86,99.45
2022-04-10,Tamil Nadu,137,1,136,1908,2497,407,7.18,0,78.8,678285,5809,674522,3.17,0.52,0.024213197969543146,0.86,99.45
2022-04-11,Tamil Nadu,1494,19,1486,18052,425,229,8.28,0,78.8,679779,5828,676008,0.54,0.29,0.22908629441624365,0.86,99.45
2022-04-12,Tamil Nadu,753,5,752,9240,4818,1880,8.15,0,78.8,680532,5833,676760,6.11,2.39,0.11725888324873096,0.86,99.45
2022-04-13,Tamil Nadu,1613,22,1607,19878,103,17,8.11,0,78.8,682145,5855,678367,0.13,0.02,0.25225888324873097,0.86,99.45
2022-04-14,Tamil Nadu,348,3,348,3951,4016,2499,8.81,0,78.8,682493,5858,678715,5.1,3.17,0.05013959390862944,0.86,99.45
2022-04-15,Tamil Nadu,715,4,709,9037,3501,2190,7.91,2,78.8,683208,5862,679424,4.44,2.78,0.11468274111675127,0.86,99.45
2022-04-16,Tamil Nadu,333,4,331,4279,821,194,7.78,0,78.8,683541,5866,679755,1.04,0.25,0.05430203045685279,0.86,99.45
2022-04-17,Tamil Nadu,1404,8,1402,17294,1925,1458,8.12,0,78.8,684945,5874,681157,2.44,1.85,0.21946700507614214,0.86,99.45
2022-04-18,Tamil Nadu,1424,18,1423,17961,1074,588,7.93,0,78.8,686369,5892,682580,1.36,0.75,0.22793147208121828,0.86,99.45
2022-04-19,Tamil Nadu,188,2,187,2386,2609,886,7.88,0,78.8,686557,5894,682767,3.31,1.12,0.030279187817258885,0.86,99.45
2022-04-20,Tamil Nadu,189,2,180,2543,1367,1018,7.43,7,78.8,686746,5896,682947,1.73,1.29,0.03227157360406091,0.86,99.45
2022-04-21,Tamil Nadu,960,9,957,12018,2926,1736,7.99,0,78.8,687706,5905,683904,3.71,2.2,0.15251269035532994,0.86,99.45
2022-04-22,Tamil Nadu,647,7,643,7966,2233,2032,8.12,0,78.8,688353,5912,684547,2.83,2.58,0.10109137055837564,0.86,99.45
2022-04-23,Tamil Nadu,368,3,364,4876,866,29,7.55,1,78.8,688721,5915,684911,1.1,0.04,0.061878172588832485,0.86,99.45
2022-04-24,Tamil Nadu,1291,12,1286,16625,271,20,7.77,0,78.8,690012,5927,686197,0.34,0.03,0.2109771573604061,0.86,99.45
2022-04-25,Tamil Nadu,815,10,806,10637,2589,1390,7.66,0,78.8,690827,5937,687003,3.29,1.76,0.13498730964467004,0.86,99.45
2022-04-26,Tamil Nadu,65,0,60,1292,2089,823,5.03,5,78.8,690892,5937,687063,2.65,1.04,0.016395939086294418,0.86,99.45
2022-04-27,Tamil Nadu,847,12,844,10658,1367,90,7.95,0,78.8,691739,5949,687907,1.73,0.11,0.13525380710659898,0.86,99.45
2022-04-28,Tamil Nadu,1304,17,1295,16460,2500,542,7.92,0,78.8,693043,5966,689202,3.17,0.69,0.20888324873096448,0.86,99.45
2022-04-29,Tamil Nadu,750,2,741,9336,1176,514,8.03,7,78.8,693793,5968,689943,1.49,0.65,0.1184771573604061,0.86,99.45
2022-04-30,Tamil Nadu,516,4,508,6571,826,551,7.85,4,78.8,694309,5972,690451,1.05,0.7,0.08338832487309644,0.86,99.44
2022-05-01,Tamil Nadu,433,6,433,5502,214,138,7.87,0,78.8,694742,5978,690884,0.27,0.18,0.06982233502538071,0.86,99.44
2022-05-02,Tamil Nadu,108,1,108,1613,4773,4579,6.7,0,78.8,694850,5979,690992,6.06,5.81,0.02046954314720812,0.86,99.44
2022-05-03,Tamil Nadu,357,2,354,4604,1987,1905,7.75,1,78.8,695207,5981,691346,2.52,2.42,0.058426395939086294,0.86,99.44
2022-05-04,Tamil Nadu,1541,19,1536,19217,49,4,8.02,0,78.8,696748,6000,692882,0.06,0.01,0.2438705583756345,0.86,99.45
2022-05-05,Tamil Nadu,523,6,521,6526,2314,89,8.01,0,78.8,697271,6006,693403,2.94,0.11,0.08281725888324873,0.86,99.45
2022-05-06,Tamil Nadu,719,4,710,9350,963,746,7.69,5,78.8,697990,6010,694113,1.22,0.95,0.11865482233502538,0.86,99.44
2022-05-07,Tamil Nadu,845,6,838,10219,1538,910,8.27,1,78.8,698835,6016,694951,1.95,1.15,0.12968274111675127,0.86,99.44
2022-05-08,Tamil Nadu,826,8,822,10285,2835,427,8.03,0,78.8,699661,6024,695773,3.6,0.54,0.13052030456852792,0.86,99.44
2022-05-09,Tamil Nadu,564,8,559,6954,4065,2421,8.11,0,78.8,700225,6032,696332,5.16,3.07,0.088248730964467,0.86,99.44
2022-05-10,Tamil Nadu,958,8,955,11960,3619,1539,8.01,0,78.8,701183,6040,697287,4.59,1.95,0.1517766497461929,0.86,99.44
2022-05-11,Tamil Nadu,264,3,255,2964,2447,951,8.91,6,78.8,701447,6043,697542,3.11,1.21,0.037614213197969544,0.86,99.44
2022-05-12,Tamil Nadu,1543,17,1542,19312,2533,827,7.99,0,78.8,702990,6060,699084,3.21,1.05,0.2450761421319797,0.86,99.44
2022-05-13,Tamil Nadu,655,8,650,8650,2758,962,7.57,0,78.8,703645,6068,699734,3.5,1.22,0.10977157360406091,0.86,99.44
2022-05-14,Tamil Nadu,542,2,538,7015,1972,287,7.73,2,78.8,704187,6070,700272,2.5,0.36,0.08902284263959391,0.86,99.44
2022-05-15,Tamil Nadu,258,3,255,3373,4286,517,7.65,0,78.8,704445,6073,700527,5.44,0.66,0.04280456852791878,0.86,99.44
2022-05-16,Tamil Nadu,777,5,777,9432,3063,603,8.24,0,78.8,705222,6078,701304,3.89,0.77,0.11969543147208121,0.86,99.44
2022-05-17,Tamil Nadu,1335,8,1333,16867,2637,1828,7.91,0,78.8,706557,6086,702637,3.35,2.32,0.2140482233502538,0.86,99.45
2022-05-18,Tamil Nadu,186,2,182,2963,1340,495,6.28,2,78.8,706743,6088,702819,1.7,0.63,0.037601522842639595,0.86,99.44
2022-05-19,Tamil Nadu,587,6,581,7281,4999,847,8.06,0,78.8,707330,6094,703400,6.34,1.07,0.09239847715736041,0.86,99.44
2022-05-20,Tamil Nadu,1072,4,1070,13624,768,266,7.87,0,78.8,708402,6098,704470,0.97,0.34,0.17289340101522843,0.86,99.44
2022-05-21,Tamil Nadu,373,4,364,4766,1237,439,7.83,5,78.8,708775,6102,704834,1.57,0.56,0.06048223350253807,0.86,99.44
2022-05-22,Tamil Nadu,1465,9,1456,18024,4148,758,8.13,0,78.8,710240,6111,706290,5.26,0.96,0.22873096446700508,0.86,99.44
2022-05-23,Tamil Nadu,1413,9,1406,17549,3781,109,8.05,0,78.8,711653,6120,707696,4.8,0.14,0.22270304568527918,0.86,99.44
2022-05-24,Tamil Nadu,1021,4,1020,12975,2951,435,7.87,0,78.8,712674,6124,708716,3.74,0.55,0.16465736040609136,0.86,99.44
2022-05-25,Tamil Nadu,1021,9,1015,12929,1838,730,7.9,0,78.8,713695,6133,709731,2.33,0.93,0.1640736040609137,0.86,99.44
2022-05-26,Tamil Nadu,1045,7,1036,13037,2394,1977,8.02,2,78.8,714740,6140,710767,3.04,2.51,0.16544416243654822,0.86,99.44
2022-05-27,Tamil Nadu,378,5,377,4698,69,69,8.05,0,78.8,715118,6145,711144,0.09,0.09,0.05961928934010152,0.86,99.44
2022-05-28,Tamil Nadu,1390,15,1386,17394,3982,1081,7.99,0,78.8,716508,6160,712530,5.05,1.37,0.22073604060913707,0.86,99.44
2022-05-29,Tamil Nadu,1372,17,1369,17442,2652,1653,7.87,0,78.8,717880,6177,713899,3.37,2.1,0.2213451776649746,0.86,99.45
2022-05-30,Tamil Nadu,352,4,349,4158,1218,164,8.47,0,78.8,718232,6181,714248,1.55,0.21,0.052766497461928935,0.86,99.45
2022-05-31,Tamil Nadu,368,3,366,4697,4569,3568,7.83,0,78.8,718600,6184,714614,5.8,4.53,0.059606598984771574,0.86,99.45
2022-06-01,Tamil Nadu,1203,17,1202,14926,534,351,8.06,0,78.8,719803,6201,715816,0.68,0.45,0.18941624365482235,0.86,99.45
2022-06-02,Tamil Nadu,747,7,738,9085,3974,1268,8.22,2,78.8,720550,6208,716554,5.04,1.61,0.11529187817258883,0.86,99.45
2022-06-03,Tamil Nadu,631,4,631,7956,3550,2034,7.93,0,78.8,721181,6212,717185,4.51,2.58,0.10096446700507614,0.86,99.45
2022-06-04,Tamil Nadu,1087,12,1079,13386,2554,1506,8.12,0,78.8,722268,6224,718264,3.24,1.91,0.1698730964467005,0.86,99.45
2022-06-05,Tamil Nadu,354,4,345,4236,3060,3045,8.36,5,78.8,722622,6228,718609,3.88,3.86,0.05375634517766498,0.86,99.44
2022-06-06,Tamil Nadu,682,8,675,8239,852,545,8.28,0,78.8,723304,6236,719284,1.08,0.69,0.10455583756345177,0.86,99.44
2022-06-07,Tamil Nadu,91,0,83,1164,4503,3780,7.82,8,78.8,723395,6236,719367,5.71,4.8,0.014771573604060914,0.86,99.44
2022-06-08,Tamil Nadu,1097,5,1094,13626,764,124,8.05,0,78.8,724492,6241,720461,0.97,0.16,0.17291878172588832,0.86,99.44
2022-06-09,Tamil Nadu,317,3,311,3904,3472,139,8.12,3,78.8,724809,6244,720772,4.41,0.18,0.04954314720812183,0.86,99.44
2022-06-10,Tamil Nadu,38,0,33,684,2215,1323,5.56,5,78.8,724847,6244,720805,2.81,1.68,0.00868020304568528,0.86,99.44
2022-06-11,Tamil Nadu,1381,9,1375,17120,3493,2531,8.07,0,78.8,726228,6253,722180,4.43,3.21,0.21725888324873097,0.86,99.44
2022-06-12,Tamil Nadu,1082,11,1076,13462,4258,1185,8.04,0,78.8,727310,6264,723256,5.4,1.5,0.17083756345177664,0.86,99.44
2022-06-13,Tamil Nadu,392,1,389,5057,1716,602,7.75,2,78.8,727702,6265,723645,2.18,0.76,0.0641751269035533,0.86,99.44
2022-06-14,Tamil Nadu,666,6,659,8286,3507,2259,8.04,1,78.8,728368,6271,724304,4.45,2.87,0.1051522842639594,0.86,99.44
2022-06-15,Tamil Nadu,1088,8,1086,13734,521,482,7.92,0,78.8,729456,6279,725390,0.66,0.61,0.17428934010152283,0.86,99.44
2022-06-16,Tamil Nadu,504,6,497,6001,1583,985,8.4,1,78.8,729960,6285,725887,2.01,1.25,0.07615482233502538,0.86,99.44
2022-06-17,Tamil Nadu,542,5,541,6335,557,175,8.56,0,78.8,730502,6290,726428,0.71,0.22,0.08039340101522843,0.86,99.44
2022-06-18,Tamil Nadu,868,8,862,10825,3184,1140,8.02,0,78.8,731370,6298,727290,4.04,1.45,0.1373730964467005,0.86,99.44
2022-06-19,Tamil Nadu,1226,13,1222,15144,744,27,8.1,0,78.8,732596,6311,728512,0.94,0.03,0.19218274111675127,0.86,99.44
2022-06-20,Tamil Nadu,1136,7,1130,14256,3847,495,7.97,0,78.8,733732,6318,729642,4.88,0.63,0.18091370558375636,0.86,99.44
2022-06-21,Tamil Nadu,922,6,922,11556,3455,954,7.98,0,78.8,734654,6324,730564,4.38,1.21,0.1466497461928934,0.86,99.44
2022-06-22,Tamil Nadu,1480,9,1471,18576,4298,699,7.97,0,78.8,736134,6333,732035,5.45,0.89,0.23573604060913705,0.86,99.44
2022-06-23,Tamil Nadu,1515,17,1513,19287,4641,3026,7.86,0,78.8,737649,6350,733548,5.89,3.84,0.24475888324873096,0.86,99.44
2022-06-24,Tamil Nadu,1483,5,1483,18483,4264,3385,8.02,0,78.8,739132,6355,735031,5.41,4.3,0.23455583756345177,0.86,99.45
2022-06-25,Tamil Nadu,538,3,537,6758,4625,2642,7.96,0,78.8,739670,6358,735568,5.87,3.35,0.08576142131979696,0.86,99.45
2022-06-26,Tamil Nadu,497,4,493,6263,3936,3269,7.94,0,78.8,740167,6362,736061,4.99,4.15,0.07947969543147208,0.86,99.45
2022-06-27,Tamil Nadu,1267,10,1263,15529,344,242,8.16,0,78.8,741434,6372,737324,0.44,0.31,0.19706852791878174,0.86,99.45
2022-06-28,Tamil Nadu,956,10,956,12397,3791,1568,7.71,0,78.8,742390,6382,738280,4.81,1.99,0.1573223350253807,0.86,99.45
2022-06-29,Tamil Nadu,352,1,346,4586,3507,1758,7.68,5,78.8,742742,6383,738626,4.45,2.23,0.05819796954314721,0.86,99.45
2022-06-30,Tamil Nadu,697,8,692,8539,2563,930,8.16,0,78.8,743439,6391,739318,3.25,1.18,0.10836294416243655,0.86,99.45
2022-07-01,Tamil Nadu,549,2,543,6861,3195,739,8.0,4,78.8,743988,6393,739861,4.05,0.94,0.08706852791878172,0.86,99.45
2022-07-02,Tamil Nadu,917,10,911,11906,4524,2422,7.7,0,78.8,744905,6403,740772,5.74,3.07,0.15109137055837563,0.86,99.45
2022-07-03,Tamil Nadu,831,11,828,10326,3734,2898,8.05,0,78.8,745736,6414,741600,4.74,3.68,0.13104060913705584,0.86,99.45
2022-07-04,Tamil Nadu,739,8,732,9150,4645,2959,8.08,0,78.8,746475,6422,742332,5.89,3.76,0.11611675126903553,0.86,99.44
2022-07-05,Tamil Nadu,1150,11,1145,14313,2784,1872,8.03,0,78.8,747625,6433,743477,3.53,2.38,0.18163705583756345,0.86,99.45
2022-07-06,Tamil Nadu,1559,14,1555,19391,379,338,8.04,0,78.8,749184,6447,745032,0.48,0.43,0.24607868020304569,0.86,99.45
2022-07-07,Tamil Nadu,326,3,322,3851,3750,2481,8.47,1,78.8,749510,6450,745354,4.76,3.15,0.04887055837563452,0.86,99.45
2022-07-08,Tamil Nadu,1537,16,1528,18948,3051,398,8.11,0,78.8,751047,6466,746882,3.87,0.51,0.24045685279187817,0.86,99.45
2022-07-09,Tamil Nadu,912,11,908,11868,623,394,7.68,0,78.8,751959,6477,747790,0.79,0.5,0.15060913705583756,0.86,99.45
2022-07-10,Tamil Nadu,1334,4,1327,16376,1933,152,8.15,3,78.8,753293,6481,749117,2.45,0.19,0.20781725888324873,0.86,99.45
2022-07-11,Tamil Nadu,320,4,313,3806,525,426,8.41,3,78.8,753613,6485,749430,0.67,0.54,0.048299492385786805,0.86,99.44
2022-07-12,Tamil Nadu,1271,9,1270,16137,732,264,7.88,0,78.8,754884,6494,750700,0.93,0.34,0.20478426395939087,0.86,99.45
2022-07-13,Tamil Nadu,630,8,623,7831,4479,2564,8.04,0,78.8,755514,6502,751323,5.68,3.25,0.09937817258883248,0.86,99.45
2022-07-14,Tamil Nadu,232,0,223,2952,3319,1837,7.86,9,78.8,755746,6502,751546,4.21,2.33,0.03746192893401015,0.86,99.44
2022-07-15,Tamil Nadu,693,6,691,7897,2315,1356,8.78,0,78.8,756439,6508,752237,2.94,1.72,0.10021573604060914,0.86,99.44
2022-07-16,Tamil Nadu,760,10,760,9464,3037,2797,8.03,0,78.8,757199,6518,752997,3.85,3.55,0.1201015228426396,0.86,99.45
2022-07-17,Tamil Nadu,1098,7,1093,13864,4993,32,7.92,0,78.8,758297,6525,754090,6.34,0.04,0.17593908629441624,0.86,99.45
2022-07-18,Tamil Nadu,419,4,416,5444,2207,523,7.7,0,78.8,758716,6529,754506,2.8,0.66,0.06908629441624366,0.86,99.45
2022-07-19,Tamil Nadu,1530,17,1530,18470,1346,1149,8.28,0,78.8,760246,6546,756036,1.71,1.46,0.23439086294416245,0.86,99.45
2022-07-20,Tamil Nadu,117,0,111,1406,189,47,8.32,6,78.8,760363,6546,756147,0.24,0.06,0.01784263959390863,0.86,99.45
2022-07-21,Tamil Nadu,384,5,383,4857,4205,3201,7.91,0,78.8,760747,6551,756530,5.34,4.06,0.06163705583756345,0.86,99.45
2022-07-22,Tamil Nadu,1473,4,1470,17776,4328,52,8.29,0,78.8,762220,6555,758000,5.49,0.07,0.22558375634517766,0.86,99.45
2022-07-23,Tamil Nadu,880,4,878,10872,2951,1552,8.09,0,78.8,763100,6559,758878,3.74,1.97,0.13796954314720813,0.86,99.45
2022-07-24,Tamil Nadu,823,11,823,10328,2414,1789,7.97,0,78.8,763923,6570,759701,3.06,2.27,0.13106598984771572,0.86,99.45
2022-07-25,Tamil Nadu,347,4,345,4888,4514,1598,7.1,0,78.8,764270,6574,760046,5.73,2.03,0.062030456852791876,0.86,99.45
2022-07-26,Tamil Nadu,387,2,385,4426,4976,3007,8.74,0,78.8,764657,6576,760431,6.31,3.82,0.05616751269035533,0.86,99.45
2022-07-27,Tamil Nadu,572,5,563,7452,1457,941,7.68,4,78.8,765229,6581,760994,1.85,1.19,0.09456852791878173,0.86,99.45
2022-07-28,Tamil Nadu,364,4,355,4640,2677,2071,7.84,5,78.8,765593,6585,761349,3.4,2.63,0.05888324873096447,0.86,99.45
2022-07-29,Tamil Nadu,177,2,173,2238,3022,1473,7.91,2,78.8,765770,6587,761522,3.84,1.87,0.028401015228426398,0.86,99.45
2022-07-30,Tamil Nadu,930,13,926,11294,4758,429,8.23,0,78.8,766700,6600,762448,6.04,0.54,0.1433248730964467,0.86,99.45
2022-07-31,Tamil Nadu,496,5,487,6278,2292,894,7.9,4,78.8,767196,6605,762935,2.91,1.13,0.07967005076142132,0.86,99.44
2022-08-01,Tamil Nadu,519,6,510,6175,4369,4295,8.4,3,78.8,767715,6611,763445,5.54,5.45,0.07836294416243655,0.86,99.44
2022-08-02,Tamil Nadu,323,2,322,4042,4562,1836,7.99,0,78.8,768038,6613,763767,5.79,2.33,0.05129441624365482,0.86,99.44
2022-08-03,Tamil Nadu,451,3,447,5288,2072,1824,8.53,1,78.8,768489,6616,764214,2.63,2.31,0.06710659898477157,0.86,99.44
2022-08-04,Tamil Nadu,172,0,167,2266,3286,488,7.59,5,78.8,768661,6616,764381,4.17,0.62,0.028756345177664976,0.86,99.44
2022-08-05,Tamil Nadu,239,1,237,2810,177,59,8.51,1,78.8,768900,6617,764618,0.22,0.07,0.03565989847715736,0.86,99.44
2022-08-06,Tamil Nadu,1053,15,1047,12961,1023,625,8.12,0,78.8,769953,6632,765665,1.3,0.79,0.1644796954314721,0.86,99.44
2022-08-07,Tamil Nadu,1389,14,1388,17068,2959,1678,8.14,0,78.8,771342,6646,767053,3.76,2.13,0.2165989847715736,0.86,99.44
2022-08-08,Tamil Nadu,446,3,445,5596,3355,1219,7.97,0,78.8,771788,6649,767498,4.26,1.55,0.07101522842639595,0.86,99.44
2022-08-09,Tamil Nadu,634,3,632,8097,2592,2384,7.83,0,78.8,772422,6652,768130,3.29,3.03,0.10275380710659898,0.86,99.44
2022-08-10,Tamil Nadu,746,8,742,9317,2681,269,8.01,0,78.8,773168,6660,768872,3.4,0.34,0.11823604060913706,0.86,99.44
2022-08-11,Tamil Nadu,1606,19,1599,19900,873,481,8.07,0,78.8,774774,6679,770471,1.11,0.61,0.25253807106598986,0.86,99.44
2022-08-12,Tamil Nadu,162,1,161,2275,4880,1523,7.12,0,78.8,774936,6680,770632,6.19,1.93,0.028870558375634518,0.86,99.44
2022-08-13,Tamil Nadu,1384,16,1377,17472,1320,1128,7.92,0,78.8,776320,6696,772009,1.68,1.43,0.22172588832487308,0.86,99.44
2022-08-14,Tamil Nadu,935,7,932,11532,2113,1458,8.11,0,78.8,777255,6703,772941,2.68,1.85,0.14634517766497462,0.86,99.44
2022-08-15,Tamil Nadu,1384,14,1383,17637,3258,1463,7.85,0,78.8,778639,6717,774324,4.13,1.86,0.22381979695431473,0.86,99.45
2022-08-16,Tamil Nadu,1402,12,1401,17801,4117,1574,7.88,0,78.8,780041,6729,775725,5.22,2.0,0.2259010152284264,0.86,99.45
2022-08-17,Tamil Nadu,97,0,96,1463,1297,1202,6.63,1,78.8,780138,6729,775821,1.65,1.53,0.018565989847715736,0.86,99.45
2022-08-18,Tamil Nadu,556,5,555,7161,745,645,7.76,0,78.8,780694,6734,776376,0.95,0.82,0.0908756345177665,0.86,99.45
2022-08-19,Tamil Nadu,1076,15,1068,13450,626,438,8.0,0,78.8,781770,6749,777444,0.79,0.56,0.17068527918781726,0.86,99.45
2022-08-20,Tamil Nadu,1093,10,1091,13845,2456,587,7.89,0,78.8,782863,6759,778535,3.12,0.74,0.1756979695431472,0.86,99.45
2022-08-21,Tamil Nadu,51,0,50,757,1675,1514,6.74,1,78.8,782914,6759,778585,2.13,1.92,0.009606598984771574,0.86,99.45
2022-08-22,Tamil Nadu,668,2,661,8108,4048,1410,8.24,5,78.8,783582,6761,779246,5.14,1.79,0.10289340101522843,0.86,99.45
2022-08-23,Tamil Nadu,67,0,61,1453,2937,2073,4.61,6,78.8,783649,6761,779307,3.73,2.63,0.018439086294416245,0.86,99.45
2022-08-24,Tamil Nadu,646,7,640,8144,3210,2235,7.93,0,78.8,784295,6768,779947,4.07,2.84,0.10335025380710659,0.86,99.45
2022-08-25,Tamil Nadu,1135,7,1134,14212,214,214,7.99,0,78.8,785430,6775,781081,0.27,0.27,0.18035532994923859,0.86,99.45
2022-08-26,Tamil Nadu,434,4,433,5253,1786,839,8.26,0,78.8,785864,6779,781514,2.27,1.06,0.06666243654822335,0.86,99.45
2022-08-27,Tamil Nadu,741,9,734,9208,4407,1131,8.05,0,78.8,786605,6788,782248,5.59,1.44,0.11685279187817259,0.86,99.45
2022-08-28,Tamil Nadu,135,1,128,1928,1024,181,7.0,6,78.8,786740,6789,782376,1.3,0.23,0.02446700507614213,0.86,99.45
2022-08-29,Tamil Nadu,1098,9,1098,13350,2942,2748,8.22,0,78.8,787838,6798,783474,3.73,3.49,0.16941624365482233,0.86,99.45
2022-08-30,Tamil Nadu,475,2,466,5734,4434,1736,8.28,7,78.8,788313,6800,783940,5.63,2.2,0.07276649746192894,0.86,99.45
2022-08-31,Tamil Nadu,761,7,756,9642,1114,191,7.89,0,78.8,789074,6807,784696,1.41,0.24,0.12236040609137055,0.86,99.45
2022-09-01,Tamil Nadu,153,1,150,2301,1764,647,6.65,2,78.8,789227,6808,784846,2.24,0.82,0.029200507614213198,0.86,99.44
2022-09-02,Tamil Nadu,358,4,353,4847,848,201,7.39,1,78.8,789585,6812,785199,1.08,0.26,0.06151015228426396,0.86,99.44
2022-09-03,Tamil Nadu,1532,20,1529,19218,3764,96,7.97,0,78.8,791117,6832,786728,4.78,0.12,0.24388324873096448,0.86,99.45
2022-09-04,Tamil Nadu,1478,21,1476,18628,2125,25,7.93,0,78.8,792595,6853,788204,2.7,0.03,0.23639593908629442,0.86,99.45
2022-09-05,Tamil Nadu,460,3,458,5799,3759,1548,7.93,0,78.8,793055,6856,788662,4.77,1.96,0.07359137055837564,0.86,99.45
2022-09-06,Tamil Nadu,802,5,795,9878,4072,2385,8.12,2,78.8,793857,6861,789457,5.17,3.03,0.1253553299492386,0.86,99.45
2022-09-07,Tamil Nadu,1154,16,1154,14504,3489,3137,7.96,0,78.8,795011,6877,790611,4.43,3.98,0.18406091370558375,0.87,99.45
2022-09-08,Tamil Nadu,1288,17,1286,15870,2876,1774,8.12,0,78.8,796299,6894,791897,3.65,2.25,0.2013959390862944,0.87,99.45
2022-09-09,Tamil Nadu,1067,5,1067,13822,4816,1298,7.72,0,78.8,797366,6899,792964,6.11,1.65,0.17540609137055838,0.87,99.45
2022-09-10,Tamil Nadu,628,7,621,7624,469,180,8.24,0,78.8,797994,6906,793585,0.6,0.23,0.096751269035533,0.87,99.45
2022-09-11,Tamil Nadu,1126,7,1117,13670,4333,1880,8.24,2,78.8,799120,6913,794702,5.5,2.39,0.1734771573604061,0.87,99.45
2022-09-12,Tamil Nadu,1064,14,1062,13220,295,206,8.05,0,78.8,800184,6927,795764,0.37,0.26,0.16776649746192893,0.87,99.45
2022-09-13,Tamil Nadu,404,4,403,5133,2482,2114,7.87,0,78.8,800588,6931,796167,3.15,2.68,0.06513959390862945,0.87,99.45
2022-09-14,Tamil Nadu,1100,9,1093,13328,2545,22,8.25,0,78.8,801688,6940,797260,3.23,0.03,0.16913705583756344,0.87,99.45
2022-09-15,Tamil Nadu,1035,4,1033,13096,2327,1355,7.9,0,78.8,802723,6944,798293,2.95,1.72,0.16619289340101523,0.87,99.45
2022-09-16,Tamil Nadu,1413,13,1405,17304,3601,387,8.17,0,78.8,804136,6957,799698,4.57,0.49,0.21959390862944161,0.87,99.45
2022-09-17,Tamil Nadu,299,4,294,3772,4160,1207,7.93,1,78.8,804435,6961,799992,5.28,1.53,0.04786802030456853,0.87,99.45
2022-09-18,Tamil Nadu,1098,11,1094,13849,4206,495,7.93,0,78.8,805533,6972,801086,5.34,0.63,0.175748730964467,0.87,99.45
2022-09-19,Tamil Nadu,546,4,542,6940,3580,1992,7.87,0,78.8,806079,6976,801628,4.54,2.53,0.08807106598984772,0.87,99.45
2022-09-20,Tamil Nadu,525,5,517,7037,1555,1239,7.46,3,78.8,806604,6981,802145,1.97,1.57,0.0893020304568528,0.87,99.45
2022-09-21,Tamil Nadu,796,11,793,9686,1639,711,8.22,0,78.8,807400,6992,802938,2.08,0.9,0.12291878172588833,0.87,99.45
2022-09-22,Tamil Nadu,1095,14,1092,13510,4425,3056,8.11,0,78.8,808495,7006,804030,5.62,3.88,0.1714467005076142,0.87,99.45
2022-09-23,Tamil Nadu,85,0,82,1108,3083,2752,7.67,3,78.8,808580,7006,804112,3.91,3.49,0.014060913705583756,0.87,99.45
2022-09-24,Tamil Nadu,686,10,683,8464,4763,897,8.1,0,78.8,809266,7016,804795,6.04,1.14,0.10741116751269035,0.87,99.45
2022-09-25,Tamil Nadu,104,0,103,1081,193,13,9.62,1,78.8,809370,7016,804898,0.24,0.02,0.013718274111675127,0.87,99.45
2022-09-26,Tamil Nadu,1033,8,1027,12709,4671,2778,8.13,0,78.8,810403,7024,805925,5.93,3.53,0.16128172588832487,0.87,99.45
2022-09-27,Tamil Nadu,1470,16,1466,18346,1719,1396,8.01,0,78.8,811873,7040,807391,2.18,1.77,0.23281725888324872,0.87,99.45
2022-09-28,Tamil Nadu,490,5,489,5706,2682,2230,8.59,0,78.8,812363,7045,807880,3.4,2.83,0.07241116751269036,0.87,99.45
2022-09-29,Tamil Nadu,828,3,825,10765,3568,3181,7.69,0,78.8,813191,7048,808705,4.53,4.04,0.13661167512690356,0.87,99.45
2022-09-30,Tamil Nadu,1105,9,1097,13685,4439,4245,8.07,0,78.8,814296,7057,809802,5.63,5.39,0.17366751269035532,0.87,99.45
2022-10-01,Tamil Nadu,1277,7,1275,16165,1843,1768,7.9,0,78.8,815573,7064,811077,2.34,2.24,0.20513959390862943,0.87,99.45
2022-10-02,Tamil Nadu,513,5,507,5918,1813,833,8.67,1,78.8,816086,7069,811584,2.3,1.06,0.07510152284263959,0.87,99.45
2022-10-03,Tamil Nadu,70,0,61,1048,1537,423,6.68,9,78.8,816156,7069,811645,1.95,0.54,0.013299492385786801,0.87,99.45
2022-10-04,Tamil Nadu,1240,7,1239,15260,566,62,8.13,0,78.8,817396,7076,812884,0.72,0.08,0.19365482233502537,0.87,99.45
2022-10-05,Tamil Nadu,968,12,961,11940,4535,1283,8.11,0,78.8,818364,7088,813845,5.76,1.63,0.1515228426395939,0.87,99.45
2022-10-06,Tamil Nadu,214,0,209,2436,4478,4025,8.78,5,78.8,818578,7088,814054,5.68,5.11,0.030913705583756345,0.87,99.45
2022-10-07,Tamil Nadu,1189,9,1188,15163,313,108,7.84,0,78.8,819767,7097,815242,0.4,0.14,0.1924238578680203,0.87,99.45
2022-10-08,Tamil Nadu,522,4,522,6579,3642,972,7.93,0,78.8,820289,7101,815764,4.62,1.23,0.08348984771573605,0.87,99.45
2022-10-09,Tamil Nadu,1457,21,1452,18129,1304,1052,8.04,0,78.8,821746,7122,817216,1.65,1.34,0.23006345177664975,0.87,99.45
2022-10-10,Tamil Nadu,107,1,98,1303,3503,2883,8.21,8,78.8,821853,7123,817314,4.45,3.66,0.016535532994923857,0.87,99.45
2022-10-11,Tamil Nadu,553,2,549,7078,4200,2574,7.81,2,78.8,822406,7125,817863,5.33,3.27,0.08982233502538071,0.87,99.45
2022-10-12,Tamil Nadu,752,7,749,9264,3936,3814,8.12,0,78.8,823158,7132,818612,4.99,4.84,0.11756345177664974,0.87,99.45
2022-10-13,Tamil Nadu,104,0,101,1487,4814,2781,6.99,3,78.8,823262,7132,818713,6.11,3.53,0.01887055837563452,0.87,99.45
2022-10-14,Tamil Nadu,1231,10,1225,15293,1231,676,8.05,0,78.8,824493,7142,819938,1.56,0.86,0.1940736040609137,0.87,99.45
2022-10-15,Tamil Nadu,986,9,985,12646,3161,1057,7.8,0,78.8,825479,7151,820923,4.01,1.34,0.16048223350253807,0.87,99.45
2022-10-16,Tamil Nadu,557,7,554,6748,1260,836,8.25,0,78.8,826036,7158,821477,1.6,1.06,0.08563451776649746,0.87,99.45
2022-10-17,Tamil Nadu,435,6,426,5426,394,2,8.02,3,78.8,826471,7164,821903,0.5,0.0,0.06885786802030457,0.87,99.45
2022-10-18,Tamil Nadu,1055,9,1047,13957,4808,2406,7.56,0,78.8,827526,7173,822950,6.1,3.05,0.17711928934010152,0.87,99.45
2022-10-19,Tamil Nadu,1410,9,1410,17680,1136,1079,7.98,0,78.8,828936,7182,824360,1.44,1.37,0.22436548223350253,0.87,99.45
2022-10-20,Tamil Nadu,1354,12,1350,16898,4032,1826,8.01,0,78.8,830290,7194,825710,5.12,2.32,0.21444162436548223,0.87,99.45
2022-10-21,Tamil Nadu,1572,23,1564,19988,2559,219,7.86,0,78.8,831862,7217,827274,3.25,0.28,0.2536548223350254,0.87,99.45
2022-10-22,Tamil Nadu,1406,7,1401,17334,4949,780,8.11,0,78.8,833268,7224,828675,6.28,0.99,0.2199746192893401,0.87,99.45
2022-10-23,Tamil Nadu,249,1,249,2919,24,18,8.53,0,78.8,833517,7225,828924,0.03,0.02,0.03704314720812183,0.87,99.45
2022-10-24,Tamil Nadu,206,1,203,2898,4915,2883,7.11,2,78.8,833723,7226,829127,6.24,3.66,0.036776649746192894,0.87,99.45
2022-10-25,Tamil Nadu,1036,9,1030,12655,4180,3608,8.19,0,78.8,834759,7235,830157,5.3,4.58,0.16059644670050763,0.87,99.45
2022-10-26,Tamil Nadu,1126,14,1124,14515,501,212,7.76,0,78.8,835885,7249,831281,0.64,0.27,0.1842005076142132,0.87,99.45
2022-10-27,Tamil Nadu,1450,10,1447,18094,299,146,8.01,0,78.8,837335,7259,832728,0.38,0.19,0.22961928934010153,0.87,99.45
2022-10-28,Tamil Nadu,821,4,818,10587,2259,995,7.75,0,78.8,838156,7263,833546,2.87,1.26,0.1343527918781726,0.87,99.45
2022-10-29,Tamil Nadu,687,2,682,8714,4477,855,7.88,3,78.8,838843,7265,834228,5.68,1.09,0.11058375634517767,0.87,99.45
2022-10-30,Tamil Nadu,589,3,581,7345,2355,1994,8.02,5,78.8,839432,7268,834809,2.99,2.53,0.09321065989847716,0.87,99.45
2022-10-31,Tamil Nadu,325,4,325,4027,592,217,8.07,0,78.8,839757,7272,835134,0.75,0.28,0.05110406091370558,0.87,99.45
2022-11-01,Tamil Nadu,1514,8,1514,19027,3482,647,7.96,0,78.8,841271,7280,836648,4.42,0.82,0.24145939086294416,0.87,99.45
2022-11-02,Tamil Nadu,504,2,504,6449,208,94,7.82,0,78.8,841775,7282,837152,0.26,0.12,0.08184010152284264,0.87,99.45
2022-11-03,Tamil Nadu,1419,13,1410,17178,1646,733,8.26,0,78.8,843194,7295,838562,2.09,0.93,0.21799492385786803,0.87,99.45
2022-11-04,Tamil Nadu,1504,5,1497,19069,4104,1718,7.89,2,78.8,844698,7300,840059,5.21,2.18,0.24199238578680202,0.86,99.45
2022-11-05,Tamil Nadu,1312,8,1306,16241,1434,1319,8.08,0,78.8,846010,7308,841365,1.82,1.67,0.2061040609137056,0.86,99.45
2022-11-06,Tamil Nadu,462,2,457,5883,4942,2786,7.85,3,78.8,846472,7310,841822,6.27,3.54,0.07465736040609137,0.86,99.45
2022-11-07,Tamil Nadu,1111,8,1103,13945,4657,1660,7.97,0,78.8,847583,7318,842925,5.91,2.11,0.17696700507614213,0.86,99.45
2022-11-08,Tamil Nadu,1176,5,1175,14426,2841,2387,8.15,0,78.8,848759,7323,844100,3.61,3.03,0.1830710659898477,0.86,99.45
2022-11-09,Tamil Nadu,1297,5,1293,16406,4959,2479,7.91,0,78.8,850056,7328,845393,6.29,3.15,0.2081979695431472,0.86,99.45
2022-11-10,Tamil Nadu,1187,16,1184,15048,1064,388,7.89,0,78.8,851243,7344,846577,1.35,0.49,0.19096446700507613,0.86,99.45
2022-11-11,Tamil Nadu,180,2,171,2338,742,504,7.7,7,78.8,851423,7346,846748,0.94,0.64,0.029670050761421318,0.86,99.45
2022-11-12,Tamil Nadu,467,1,467,5638,3084,1584,8.28,0,78.8,851890,7347,847215,3.91,2.01,0.0715482233502538,0.86,99.45
2022-11-13,Tamil Nadu,126,0,120,1623,224,123,7.76,6,78.8,852016,7347,847335,0.28,0.16,0.020596446700507615,0.86,99.45
2022-11-14,Tamil Nadu,436,1,435,5506,3766,2571,7.92,0,78.8,852452,7348,847770,4.78,3.26,0.0698730964467005,0.86,99.45
2022-11-15,Tamil Nadu,987,7,979,12577,1026,266,7.85,1,78.8,853439,7355,848749,1.3,0.34,0.15960659898477159,0.86,99.45
2022-11-16,Tamil Nadu,678,2,670,8418,2391,554,8.05,6,78.8,854117,7357,849419,3.03,0.7,0.1068274111675127,0.86,99.45
2022-11-17,Tamil Nadu,1337,12,1337,16437,1963,998,8.13,0,78.8,855454,7369,850756,2.49,1.27,0.20859137055837562,0.86,99.45
2022-11-18,Tamil Nadu,542,3,536,7076,2266,2070,7.66,3,78.8,855996,7372,851292,2.88,2.63,0.08979695431472082,0.86,99.45
2022-11-19,Tamil Nadu,826,7,817,10378,221,61,7.96,2,78.8,856822,7379,852109,0.28,0.08,0.1317005076142132,0.86,99.45
2022-11-20,Tamil Nadu,1255,6,1255,15491,2649,1496,8.1,0,78.8,858077,7385,853364,3.36,1.9,0.19658629441624365,0.86,99.45
2022-11-21,Tamil Nadu,1399,14,1394,17596,1309,934,7.95,0,78.8,859476,7399,854758,1.66,1.19,0.2232994923857868,0.86,99.45
2022-11-22,Tamil Nadu,1397,17,1392,17357,218,206,8.05,0,78.8,860873,7416,856150,0.28,0.26,0.22026649746192895,0.86,99.45
2022-11-23,Tamil Nadu,810,6,809,10114,1667,1444,8.01,0,78.8,861683,7422,856959,2.12,1.83,0.1283502538071066,0.86,99.45
2022-11-24,Tamil Nadu,378,3,374,4710,254,159,8.03,1,78.8,862061,7425,857333,0.32,0.2,0.059771573604060914,0.86,99.45
2022-11-25,Tamil Nadu,234,1,233,3283,3675,1110,7.13,0,78.8,862295,7426,857566,4.66,1.41,0.04166243654822335,0.86,99.45
2022-11-26,Tamil Nadu,798,9,789,9601,3772,1307,8.31,0,78.8,863093,7435,858355,4.79,1.66,0.12184010152284264,0.86,99.45
2022-11-27,Tamil Nadu,139,1,134,2085,1562,1106,6.67,4,78.8,863232,7436,858489,1.98,1.4,0.026459390862944163,0.86,99.45
2022-11-28,Tamil Nadu,1118,7,1110,14424,1249,94,7.75,1,78.8,864350,7443,859599,1.59,0.12,0.18304568527918783,0.86,99.45
2022-11-29,Tamil Nadu,1120,9,1120,14201,3964,753,7.89,0,78.8,865470,7452,860719,5.03,0.96,0.18021573604060914,0.86,99.45
2022-11-30,Tamil Nadu,184,1,178,2154,4858,2531,8.54,5,78.8,865654,7453,860897,6.16,3.21,0.02733502538071066,0.86,99.45
2022-12-01,Tamil Nadu,431,3,423,5572,4557,2597,7.74,5,78.8,866085,7456,861320,5.78,3.3,0.07071065989847716,0.86,99.45
2022-12-02,Tamil Nadu,1471,4,1467,18190,4176,3455,8.09,0,78.8,867556,7460,862787,5.3,4.38,0.23083756345177664,0.86,99.45
2022-12-03,Tamil Nadu,747,10,740,9451,799,615,7.9,0,78.8,868303,7470,863527,1.01,0.78,0.11993654822335026,0.86,99.45
2022-12-04,Tamil Nadu,1259,15,1253,15520,2198,522,8.11,0,78.8,869562,7485,864780,2.79,0.66,0.19695431472081218,0.86,99.45
2022-12-05,Tamil Nadu,558,2,558,6841,2866,290,8.16,0,78.8,870120,7487,865338,3.64,0.37,0.08681472081218274,0.86,99.45
2022-12-06,Tamil Nadu,799,11,792,9983,1109,1042,8.0,0,78.8,870919,7498,866130,1.41,1.32,0.12668781725888326,0.86,99.45
2022-12-07,Tamil Nadu,628,9,622,8388,3235,790,7.49,0,78.8,871547,7507,866752,4.11,1.0,0.10644670050761422,0.86,99.45
2022-12-08,Tamil Nadu,1149,6,1143,14217,4284,2003,8.08,0,78.8,872696,7513,867895,5.44,2.54,0.18041878172588832,0.86,99.45
2022-12-09,Tamil Nadu,1351,19,1350,16739,4019,116,8.07,0,78.8,874047,7532,869245,5.1,0.15,0.21242385786802032,0.86,99.45
2022-12-10,Tamil Nadu,1413,14,1412,17502,3349,1628,8.07,0,78.8,875460,7546,870657,4.25,2.07,0.22210659898477159,0.86,99.45
2022-12-11,Tamil Nadu,1355,13,1350,17371,1251,102,7.8,0,78.8,876815,7559,872007,1.59,0.13,0.2204441624365482,0.86,99.45
2022-12-12,Tamil Nadu,1149,6,1143,14639,805,484,7.85,0,78.8,877964,7565,873150,1.02,0.61,0.1857741116751269,0.86,99.45
2022-12-13,Tamil Nadu,1291,9,1288,16526,88,59,7.81,0,78.8,879255,7574,874438,0.11,0.07,0.2097208121827411,0.86,99.45
2022-12-14,Tamil Nadu,1399,8,1397,17625,3161,2381,7.94,0,78.8,880654,7582,875835,4.01,3.02,0.22366751269035534,0.86,99.45
2022-12-15,Tamil Nadu,1424,14,1420,17625,2220,705,8.08,0,78.8,882078,7596,877255,2.82,0.89,0.22366751269035534,0.86,99.45
2022-12-16,Tamil Nadu,212,2,204,2637,1526,1476,8.04,6,78.8,882290,7598,877459,1.94,1.87,0.033464467005076146,0.86,99.45
2022-12-17,Tamil Nadu,73,0,73,915,4988,2356,7.98,0,78.8,882363,7598,877532,6.33,2.99,0.011611675126903554,0.86,99.45
2022-12-18,Tamil Nadu,570,4,566,7301,75,72,7.81,0,78.8,882933,7602,878098,0.1,0.09,0.0926522842639594,0.86,99.45
2022-12-19,Tamil Nadu,750,2,750,9482,3130,402,7.91,0,78.8,883683,7604,878848,3.97,0.51,0.12032994923857868,0.86,99.45
2022-12-20,Tamil Nadu,565,3,557,6739,395,175,8.38,5,78.8,884248,7607,879405,0.5,0.22,0.08552030456852792,0.86,99.45
2022-12-21,Tamil Nadu,842,4,838,10235,4385,3470,8.23,0,78.8,885090,7611,880243,5.56,4.4,0.12988578680203045,0.86,99.45
2022-12-22,Tamil Nadu,1594,16,1585,19720,1948,1073,8.08,0,78.8,886684,7627,881828,2.47,1.36,0.250253807106599,0.86,99.45
2022-12-23,Tamil Nadu,468,3,464,6160,819,367,7.6,1,78.8,887152,7630,882292,1.04,0.47,0.07817258883248732,0.86,99.45
2022-12-24,Tamil Nadu,1436,13,1435,17610,4188,2595,8.15,0,78.8,888588,7643,883727,5.31,3.29,0.2234771573604061,0.86,99.45
2022-12-25,Tamil Nadu,876,9,871,10678,594,450,8.2,0,78.8,889464,7652,884598,0.75,0.57,0.13550761421319796,0.86,99.45
2022-12-26,Tamil Nadu,1364,7,1355,17593,2733,2379,7.75,2,78.8,890828,7659,885953,3.47,3.02,0.22326142131979695,0.86,99.45
2022-12-27,Tamil Nadu,922,12,913,10888,2227,233,8.47,0,78.8,891750,7671,886866,2.83,0.3,0.13817258883248731,0.86,99.45
2022-12-28,Tamil Nadu,1033,4,1031,13305,1844,426,7.76,0,78.8,892783,7675,887897,2.34,0.54,0.16884517766497462,0.86,99.45
2022-12-29,Tamil Nadu,1531,13,1523,19510,2033,48,7.85,0,78.8,894314,7688,889420,2.58,0.06,0.24758883248730965,0.86,99.45
2022-12-30,Tamil Nadu,149,0,146,2090,4642,382,7.13,3,78.8,894463,7688,889566,5.89,0.48,0.026522842639593907,0.86,99.45
2022-12-31,Tamil Nadu,1485,21,1483,18714,2368,1382,7.94,0,78.8,895948,7709,891049,3.01,1.75,0.23748730964467005,0.86,99.45
2020-01-01,Telangana,777,3,769,9580,1931,839,8.11,5,40.8,777,3,769,4.73,2.06,0.23480392156862745,0.39,98.97
2020-01-02,Telangana,1145,3,1145,14086,408,316,8.13,0,40.8,1922,6,1914,1.0,0.77,0.34524509803921566,0.31,99.58
2020-01-03,Telangana,1265,11,1261,15955,3063,1516,7.93,0,40.8,3187,17,3175,7.51,3.72,0.39105392156862745,0.53,99.62
2020-01-04,Telangana,283,1,274,3495,1651,329,8.1,8,40.8,3470,18,3449,4.05,0.81,0.08566176470588235,0.52,99.39
2020-01-05,Telangana,815,5,807,10020,4091,3523,8.13,3,40.8,4285,23,4256,10.03,8.63,0.24558823529411763,0.54,99.32
2020-01-06,Telangana,652,3,650,8288,702,619,7.87,0,40.8,4937,26,4906,1.72,1.52,0.20313725490196077,0.53,99.37
2020-01-07,Telangana,1127,16,1121,14220,410,361,7.93,0,40.8,6064,42,6027,1.0,0.88,0.34852941176470587,0.69,99.39
2020-01-08,Telangana,1582,16,1582,19879,4895,1129,7.96,0,40.8,7646,58,7609,12.0,2.77,0.48723039215686276,0.76,99.52
2020-01-09,Telangana,278,1,272,3584,1212,132,7.76,5,40.8,7924,59,7881,2.97,0.32,0.08784313725490196,0.74,99.46
2020-01-10,Telangana,758,9,757,9392,3581,1791,8.07,0,40.8,8682,68,8638,8.78,4.39,0.23019607843137255,0.78,99.49
2020-01-11,Telangana,862,12,856,11099,1135,704,7.77,0,40.8,9544,80,9494,2.78,1.73,0.2720343137254902,0.84,99.48
2020-01-12,Telangana,1226,9,1226,15458,4891,3672,7.93,0,40.8,10770,89,10720,11.99,9.0,0.3788725490196078,0.83,99.54
2020-01-13,Telangana,274,2,267,3037,2773,2204,9.02,5,40.8,11044,91,10987,6.8,5.4,0.07443627450980392,0.82,99.48
2020-01-14,Telangana,327,4,327,4107,3170,1847,7.96,0,40.8,11371,95,11314,7.77,4.53,0.10066176470588235,0.84,99.5
2020-01-15,Telangana,1447,20,1443,17938,1860,1211,8.07,0,40.8,12818,115,12757,4.56,2.97,0.439656862745098,0.9,99.52
2020-01-16,Telangana,1452,9,1451,18295,1260,749,7.94,0,40.8,14270,124,14208,3.09,1.84,0.44840686274509806,0.87,99.57
2020-01-17,Telangana,1480,20,1473,18346,1294,737,8.07,0,40.8,15750,144,15681,3.17,1.81,0.44965686274509803,0.91,99.56
2020-01-18,Telangana,1050,4,1050,13333,3908,1690,7.88,0,40.8,16800,148,16731,9.58,4.14,0.3267892156862745,0.88,99.59
2020-01-19,Telangana,137,1,137,1415,4612,4222,9.68,0,40.8,16937,149,16868,11.3,10.35,0.03468137254901961,0.88,99.59
2020-01-20,Telangana,1187,6,1185,14595,1870,68,8.13,0,40.8,18124,155,18053,4.58,0.17,0.3577205882352941,0.86,99.61
2020-01-21,Telangana,452,5,446,5191,1138,527,8.71,1,40.8,18576,160,18499,2.79,1.29,0.12723039215686274,0.86,99.59
2020-01-22,Telangana,1248,10,1247,15820,2656,2609,7.89,0,40.8,19824,170,19746,6.51,6.39,0.3877450980392157,0.86,99.61
2020-01-23,Telangana,1572,21,1569,19448,3262,1920,8.08,0,40.8,21396,191,21315,8.0,4.71,0.4766666666666667,0.89,99.62
2020-01-24,Telangana,849,9,842,10440,3342,1585,8.13,0,40.8,22245,200,22157,8.19,3.88,0.25588235294117645,0.9,99.6
2020-01-25,Telangana,78,0,70,1143,1542,529,6.82,8,40.8,22323,200,22227,3.78,1.3,0.02801470588235294,0.9,99.57
2020-01-26,Telangana,238,0,229,2781,3210,2776,8.56,9,40.8,22561,200,22456,7.87,6.8,0.06816176470588235,0.89,99.53
2020-01-27,Telangana,1021,13,1013,12899,3782,2742,7.92,0,40.8,23582,213,23469,9.27,6.72,0.31615196078431373,0.9,99.52
2020-01-28,Telangana,1561,14,1558,19064,182,134,8.19,0,40.8,25143,227,25027,0.45,0.33,0.46725490196078434,0.9,99.54
2020-01-29,Telangana,165,0,159,2080,1885,359,7.93,6,40.8,25308,227,25186,4.62,0.88,0.050980392156862744,0.9,99.52
2020-01-30,Telangana,163,1,158,1923,3971,3698,8.48,4,40.8,25471,228,25344,9.73,9.06,0.04713235294117647,0.9,99.5
2020-01-31,Telangana,684,4,678,8433,952,329,8.11,2,40.8,26155,232,26022,2.33,0.81,0.20669117647058824,0.89,99.49
2020-02-01,Telangana,919,8,918,11445,1742,1632,8.03,0,40.8,27074,240,26940,4.27,4.0,0.28051470588235294,0.89,99.51
2020-02-02,Telangana,642,7,635,7948,2781,2255,8.08,0,40.8,27716,247,27575,6.82,5.53,0.19480392156862744,0.89,99.49
2020-02-03,Telangana,1230,9,1224,15393,1925,1845,7.99,0,40.8,28946,256,28799,4.72,4.52,0.37727941176470586,0.88,99.49
2020-02-04,Telangana,1435,15,1435,18055,1437,183,7.95,0,40.8,30381,271,30234,3.52,0.45,0.44252450980392155,0.89,99.52
2020-02-05,Telangana,410,3,409,4992,4622,1656,8.21,0,40.8,30791,274,30643,11.33,4.06,0.1223529411764706,0.89,99.52
2020-02-06,Telangana,245,2,244,2825,3561,2505,8.67,0,40.8,31036,276,30887,8.73,6.14,0.06924019607843138,0.89,99.52
2020-02-07,Telangana,1132,16,1132,13626,1689,699,8.31,0,40.8,32168,292,32019,4.14,1.71,0.33397058823529413,0.91,99.54
2020-02-08,Telangana,859,11,858,10663,1293,988,8.06,0,40.8,33027,303,32877,3.17,2.42,0.2613480392156863,0.92,99.55
2020-02-09,Telangana,1340,14,1334,17086,1820,1528,7.84,0,40.8,34367,317,34211,4.46,3.75,0.41877450980392156,0.92,99.55
2020-02-10,Telangana,961,5,956,11919,1319,268,8.06,0,40.8,35328,322,35167,3.23,0.66,0.29213235294117645,0.91,99.54
2020-02-11,Telangana,478,3,469,5899,4070,1809,8.1,6,40.8,35806,325,35636,9.98,4.43,0.14458333333333334,0.91,99.53
2020-02-12,Telangana,652,5,647,8457,2193,1378,7.71,0,40.8,36458,330,36283,5.38,3.38,0.20727941176470588,0.91,99.52
2020-02-13,Telangana,190,2,190,2171,476,97,8.75,0,40.8,36648,332,36473,1.17,0.24,0.05321078431372549,0.91,99.52
2020-02-14,Telangana,1052,3,1052,13469,1972,84,7.81,0,40.8,37700,335,37525,4.83,0.21,0.33012254901960786,0.89,99.54
2020-02-15,Telangana,474,5,467,5636,3649,3336,8.41,2,40.8,38174,340,37992,8.94,8.18,0.13813725490196077,0.89,99.52
2020-02-16,Telangana,1127,16,1124,14372,199,18,7.84,0,40.8,39301,356,39116,0.49,0.04,0.3522549019607843,0.91,99.53
2020-02-17,Telangana,74,0,67,1003,3922,1928,7.38,7,40.8,39375,356,39183,9.61,4.73,0.024583333333333332,0.9,99.51
2020-02-18,Telangana,838,8,829,10839,459,118,7.73,1,40.8,40213,364,40012,1.12,0.29,0.2656617647058824,0.91,99.5
2020-02-19,Telangana,781,7,776,9766,1221,882,8.0,0,40.8,40994,371,40788,2.99,2.16,0.2393627450980392,0.91,99.5
2020-02-20,Telangana,1174,14,1168,14904,3436,605,7.88,0,40.8,42168,385,41956,8.42,1.48,0.3652941176470588,0.91,99.5
2020-02-21,Telangana,1072,6,1066,13545,327,272,7.91,0,40.8,43240,391,43022,0.8,0.67,0.33198529411764705,0.9,99.5
2020-02-22,Telangana,861,9,853,11034,1328,1208,7.8,0,40.8,44101,400,43875,3.25,2.96,0.27044117647058824,0.91,99.49
2020-02-23,Telangana,1105,9,1104,13742,586,450,8.04,0,40.8,45206,409,44979,1.44,1.1,0.33681372549019606,0.9,99.5
2020-02-24,Telangana,713,5,707,8528,376,276,8.36,1,40.8,45919,414,45686,0.92,0.68,0.20901960784313725,0.9,99.49
2020-02-25,Telangana,343,3,339,4472,4101,2434,7.67,1,40.8,46262,417,46025,10.05,5.97,0.1096078431372549,0.9,99.49
2020-02-26,Telangana,1516,22,1509,18719,734,620,8.1,0,40.8,47778,439,47534,1.8,1.52,0.45879901960784314,0.92,99.49
2020-02-27,Telangana,385,1,377,4670,3880,595,8.24,7,40.8,48163,440,47911,9.51,1.46,0.11446078431372549,0.91,99.48
2020-02-28,Telangana,854,2,847,10720,3927,685,7.97,5,40.8,49017,442,48758,9.62,1.68,0.2627450980392157,0.9,99.47
2020-02-29,Telangana,1492,15,1491,18586,4911,3331,8.03,0,40.8,50509,457,50249,12.04,8.16,0.45553921568627453,0.9,99.49
2020-03-01,Telangana,1544,14,1537,18669,1095,508,8.27,0,40.8,52053,471,51786,2.68,1.25,0.4575735294117647,0.9,99.49
2020-03-02,Telangana,1024,7,1016,12828,4002,3282,7.98,1,40.8,53077,478,52802,9.81,8.04,0.31441176470588234,0.9,99.48
2020-03-03,Telangana,1536,10,1536,19082,3830,3795,8.05,0,40.8,54613,488,54338,9.39,9.3,0.46769607843137256,0.89,99.5
2020-03-04,Telangana,472,3,466,5665,750,328,8.33,3,40.8,55085,491,54804,1.84,0.8,0.13884803921568628,0.89,99.49
2020-03-05,Telangana,1358,19,1356,17347,1822,1332,7.83,0,40.8,56443,510,56160,4.47,3.26,0.425171568627451,0.9,99.5
2020-03-06,Telangana,985,4,978,12320,1094,840,8.0,3,40.8,57428,514,57138,2.68,2.06,0.30196078431372547,0.9,99.5
2020-03-07,Telangana,643,2,635,7748,3072,2236,8.3,6,40.8,58071,516,57773,7.53,5.48,0.18990196078431373,0.89,99.49
2020-03-08,Telangana,293,4,288,3601,3283,1967,8.14,1,40.8,58364,520,58061,8.05,4.82,0.08825980392156862,0.89,99.48
2020-03-09,Telangana,887,12,879,10972,3673,795,8.08,0,40.8,59251,532,58940,9.0,1.95,0.268921568627451,0.9,99.48
2020-03-10,Telangana,479,5,470,5788,834,534,8.28,4,40.8,59730,537,59410,2.04,1.31,0.14186274509803923,0.9,99.46
2020-03-11,Telangana,777,10,770,9670,245,202,8.04,0,40.8,60507,547,60180,0.6,0.5,0.23700980392156862,0.9,99.46
2020-03-12,Telangana,1053,13,1049,13041,2722,1698,8.07,0,40.8,61560,560,61229,6.67,4.16,0.3196323529411765,0.91,99.46
2020-03-13,Telangana,1279,14,1271,15889,3864,1588,8.05,0,40.8,62839,574,62500,9.47,3.89,0.38943627450980395,0.91,99.46
2020-03-14,Telangana,550,5,542,6555,802,75,8.39,3,40.8,63389,579,63042,1.97,0.18,0.16066176470588237,0.91,99.45
2020-03-15,Telangana,1407,18,1400,17638,4783,1539,7.98,0,40.8,64796,597,64442,11.72,3.77,0.43230392156862746,0.92,99.45
2020-03-16,Telangana,290,1,284,3513,3137,1240,8.26,5,40.8,65086,598,64726,7.69,3.04,0.08610294117647059,0.92,99.45
2020-03-17,Telangana,216,2,214,2940,3842,2570,7.35,0,40.8,65302,600,64940,9.42,6.3,0.07205882352941176,0.92,99.45
2020-03-18,Telangana,1219,9,1214,14972,1037,653,8.14,0,40.8,66521,609,66154,2.54,1.6,0.3669607843137255,0.92,99.45
2020-03-19,Telangana,201,2,197,2646,4695,407,7.6,2,40.8,66722,611,66351,11.51,1.0,0.06485294117647059,0.92,99.44
2020-03-20,Telangana,1314,9,1309,16395,1147,859,8.01,0,40.8,68036,620,67660,2.81,2.11,0.40183823529411766,0.91,99.45
2020-03-21,Telangana,1386,15,1378,17248,1169,763,8.04,0,40.8,69422,635,69038,2.87,1.87,0.42274509803921567,0.91,99.45
2020-03-22,Telangana,126,0,120,1994,2692,1663,6.32,6,40.8,69548,635,69158,6.6,4.08,0.048872549019607844,0.91,99.44
2020-03-23,Telangana,281,2,274,3401,4777,2546,8.26,5,40.8,69829,637,69432,11.71,6.24,0.0833578431372549,0.91,99.43
2020-03-24,Telangana,466,5,463,5821,568,60,8.01,0,40.8,70295,642,69895,1.39,0.15,0.14267156862745098,0.91,99.43
2020-03-25,Telangana,1258,4,1252,15914,1727,1418,7.9,2,40.8,71553,646,71147,4.23,3.48,0.39004901960784316,0.9,99.43
2020-03-26,Telangana,910,4,909,11686,4125,2250,7.79,0,40.8,72463,650,72056,10.11,5.51,0.286421568627451,0.9,99.44
2020-03-27,Telangana,577,3,572,7047,4068,347,8.19,2,40.8,73040,653,72628,9.97,0.85,0.17272058823529413,0.89,99.44
2020-03-28,Telangana,735,6,733,8642,1359,1161,8.5,0,40.8,73775,659,73361,3.33,2.85,0.2118137254901961,0.89,99.44
2020-03-29,Telangana,122,1,118,1520,699,341,8.03,3,40.8,73897,660,73479,1.71,0.84,0.03725490196078431,0.89,99.43
2020-03-30,Telangana,810,4,808,10705,3836,2286,7.57,0,40.8,74707,664,74287,9.4,5.6,0.26237745098039217,0.89,99.44
2020-03-31,Telangana,59,0,54,690,797,224,8.55,5,40.8,74766,664,74341,1.95,0.55,0.016911764705882352,0.89,99.43
2020-04-01,Telangana,314,4,311,3623,1333,374,8.67,0,40.8,75080,668,74652,3.27,0.92,0.08879901960784314,0.89,99.43
2020-04-02,Telangana,921,12,917,11468,3834,411,8.03,0,40.8,76001,680,75569,9.4,1.01,0.281078431372549,0.89,99.43
2020-04-03,Telangana,611,6,602,7290,2005,58,8.38,3,40.8,76612,686,76171,4.91,0.14,0.1786764705882353,0.9,99.42
2020-04-04,Telangana,164,0,158,2074,1651,938,7.91,6,40.8,76776,686,76329,4.05,2.3,0.050833333333333335,0.89,99.42
2020-04-05,Telangana,792,11,783,9363,3128,1818,8.46,0,40.8,77568,697,77112,7.67,4.46,0.22948529411764707,0.9,99.41
2020-04-06,Telangana,959,5,954,11886,860,93,8.07,0,40.8,78527,702,78066,2.11,0.23,0.2913235294117647,0.89,99.41
2020-04-07,Telangana,110,1,106,1567,1668,657,7.02,3,40.8,78637,703,78172,4.09,1.61,0.03840686274509804,0.89,99.41
2020-04-08,Telangana,393,5,384,5303,4265,3607,7.41,4,40.8,79030,708,78556,10.45,8.84,0.12997549019607843,0.9,99.4
2020-04-09,Telangana,423,2,421,5105,2223,1251,8.29,0,40.8,79453,710,78977,5.45,3.07,0.12512254901960784,0.89,99.4
2020-04-10,Telangana,779,11,772,9493,1941,1625,8.21,0,40.8,80232,721,79749,4.76,3.98,0.23267156862745098,0.9,99.4
2020-04-11,Telangana,1274,9,1274,16388,248,102,7.77,0,40.8,81506,730,81023,0.61,0.25,0.40166666666666667,0.9,99.41
2020-04-12,Telangana,1366,15,1362,17025,2987,1862,8.02,0,40.8,82872,745,82385,7.32,4.56,0.4172794117647059,0.9,99.41
2020-04-13,Telangana,433,1,432,5166,2648,827,8.38,0,40.8,83305,746,82817,6.49,2.03,0.12661764705882353,0.9,99.41
2020-04-14,Telangana,526,5,517,6674,1448,454,7.88,4,40.8,83831,751,83334,3.55,1.11,0.16357843137254902,0.9,99.41
2020-04-15,Telangana,204,2,201,2438,3793,3548,8.37,1,40.8,84035,753,83535,9.3,8.7,0.05975490196078431,0.9,99.41
2020-04-16,Telangana,465,4,461,5343,2994,2152,8.7,0,40.8,84500,757,83996,7.34,5.27,0.13095588235294117,0.9,99.4
2020-04-17,Telangana,1344,17,1335,16868,1869,1089,7.97,0,40.8,85844,774,85331,4.58,2.67,0.4134313725490196,0.9,99.4
2020-04-18,Telangana,510,5,507,6564,3940,2982,7.77,0,40.8,86354,779,85838,9.66,7.31,0.16088235294117648,0.9,99.4
2020-04-19,Telangana,1444,7,1436,17675,3602,1969,8.17,1,40.8,87798,786,87274,8.83,4.83,0.4332107843137255,0.9,99.4
2020-04-20,Telangana,929,5,923,11467,1121,902,8.1,1,40.8,88727,791,88197,2.75,2.21,0.28105392156862746,0.89,99.4
2020-04-21,Telangana,244,2,236,3490,4934,3190,6.99,6,40.8,88971,793,88433,12.09,7.82,0.08553921568627451,0.89,99.4
2020-04-22,Telangana,233,1,229,2821,1360,17,8.26,3,40.8,89204,794,88662,3.33,0.04,0.0691421568627451,0.89,99.39
2020-04-23,Telangana,1122,12,1119,13869,1604,137,8.09,0,40.8,90326,806,89781,3.93,0.34,0.3399264705882353,0.89,99.4
2020-04-24,Telangana,813,9,807,10483,555,44,7.76,0,40.8,91139,815,90588,1.36,0.11,0.25693627450980394,0.89,99.4
2020-04-25,Telangana,814,4,806,10605,3718,3395,7.68,4,40.8,91953,819,91394,9.11,8.32,0.2599264705882353,0.89,99.39
2020-04-26,Telangana,200,2,192,2375,2704,249,8.42,6,40.8,92153,821,91586,6.63,0.61,0.05821078431372549,0.89,99.38
2020-04-27,Telangana,857,5,849,10390,922,385,8.25,3,40.8,93010,826,92435,2.26,0.94,0.254656862745098,0.89,99.38
2020-04-28,Telangana,1042,11,1033,13337,1245,981,7.81,0,40.8,94052,837,93468,3.05,2.4,0.3268872549019608,0.89,99.38
2020-04-29,Telangana,740,7,732,9737,3543,2683,7.6,1,40.8,94792,844,94200,8.68,6.58,0.23865196078431372,0.89,99.38
2020-04-30,Telangana,1316,15,1308,16869,1455,1053,7.8,0,40.8,96108,859,95508,3.57,2.58,0.4134558823529412,0.89,99.38
2020-05-01,Telangana,557,2,555,7426,4636,3495,7.5,0,40.8,96665,861,96063,11.36,8.57,0.18200980392156862,0.89,99.38
2020-05-02,Telangana,1140,8,1132,14335,2200,1573,7.95,0,40.8,97805,869,97195,5.39,3.86,0.35134803921568625,0.89,99.38
2020-05-03,Telangana,733,5,728,9110,1438,731,8.05,0,40.8,98538,874,97923,3.52,1.79,0.2232843137254902,0.89,99.38
2020-05-04,Telangana,53,0,45,1066,1136,853,4.97,8,40.8,98591,874,97968,2.78,2.09,0.026127450980392156,0.89,99.37
2020-05-05,Telangana,1144,7,1140,14818,1326,847,7.72,0,40.8,99735,881,99108,3.25,2.08,0.3631862745098039,0.88,99.37
2020-05-06,Telangana,596,2,595,7466,147,10,7.98,0,40.8,100331,883,99703,0.36,0.02,0.18299019607843137,0.88,99.37
2020-05-07,Telangana,1401,18,1395,17609,2231,1331,7.96,0,40.8,101732,901,101098,5.47,3.26,0.43159313725490195,0.89,99.38
2020-05-08,Telangana,618,2,612,7794,675,386,7.93,4,40.8,102350,903,101710,1.65,0.95,0.1910294117647059,0.88,99.37
2020-05-09,Telangana,804,8,803,10066,2320,412,7.99,0,40.8,103154,911,102513,5.69,1.01,0.2467156862745098,0.88,99.38
2020-05-10,Telangana,1297,15,1296,16220,4917,2661,8.0,0,40.8,104451,926,103809,12.05,6.52,0.3975490196078431,0.89,99.39
2020-05-11,Telangana,937,6,933,11493,3184,20,8.15,0,40.8,105388,932,104742,7.8,0.05,0.2816911764705882,0.88,99.39
2020-05-12,Telangana,1561,22,1553,19740,4403,3720,7.91,0,40.8,106949,954,106295,10.79,9.12,0.4838235294117647,0.89,99.39
2020-05-13,Telangana,384,1,375,4194,2411,1160,9.16,8,40.8,107333,955,106670,5.91,2.84,0.10279411764705883,0.89,99.38
2020-05-14,Telangana,1305,11,1297,16020,3270,800,8.15,0,40.8,108638,966,107967,8.01,1.96,0.3926470588235294,0.89,99.38
2020-05-15,Telangana,567,5,558,6871,1110,897,8.25,4,40.8,109205,971,108525,2.72,2.2,0.16840686274509803,0.89,99.38
2020-05-16,Telangana,642,2,634,8125,1601,968,7.9,6,40.8,109847,973,109159,3.92,2.37,0.19914215686274508,0.89,99.37
2020-05-17,Telangana,1585,14,1581,19869,480,381,7.98,0,40.8,111432,987,110740,1.18,0.93,0.48698529411764707,0.89,99.38
2020-05-18,Telangana,1366,4,1365,16786,4542,188,8.14,0,40.8,112798,991,112105,11.13,0.46,0.411421568627451,0.88,99.39
2020-05-19,Telangana,797,9,797,9581,3650,943,8.32,0,40.8,113595,1000,112902,8.95,2.31,0.23482843137254902,0.88,99.39
2020-05-20,Telangana,1264,12,1255,15495,1170,858,8.16,0,40.8,114859,1012,114157,2.87,2.1,0.37977941176470587,0.88,99.39
2020-05-21,Telangana,772,9,769,9547,4706,643,8.09,0,40.8,115631,1021,114926,11.53,1.58,0.2339950980392157,0.88,99.39
2020-05-22,Telangana,360,4,359,4954,4447,3542,7.27,0,40.8,115991,1025,115285,10.9,8.68,0.12142156862745097,0.88,99.39
2020-05-23,Telangana,699,4,694,8858,2155,1079,7.89,1,40.8,116690,1029,115979,5.28,2.64,0.2171078431372549,0.88,99.39
2020-05-24,Telangana,1497,7,1490,19250,4423,2138,7.78,0,40.8,118187,1036,117469,10.84,5.24,0.47181372549019607,0.88,99.39
2020-05-25,Telangana,1521,21,1518,18818,1301,1117,8.08,0,40.8,119708,1057,118987,3.19,2.74,0.46122549019607845,0.88,99.4
2020-05-26,Telangana,1238,4,1236,15622,769,398,7.92,0,40.8,120946,1061,120223,1.88,0.98,0.3828921568627451,0.88,99.4
2020-05-27,Telangana,786,7,783,9411,4474,433,8.35,0,40.8,121732,1068,121006,10.97,1.06,0.23066176470588234,0.88,99.4
2020-05-28,Telangana,1211,11,1203,15185,891,803,7.97,0,40.8,122943,1079,122209,2.18,1.97,0.3721813725490196,0.88,99.4
2020-05-29,Telangana,1317,17,1311,16973,1353,1220,7.76,0,40.8,124260,1096,123520,3.32,2.99,0.4160049019607843,0.88,99.4
2020-05-30,Telangana,229,1,225,3094,4681,2068,7.4,3,40.8,124489,1097,123745,11.47,5.07,0.07583333333333334,0.88,99.4
2020-05-31,Telangana,1179,4,1171,14813,2859,1649,7.96,4,40.8,125668,1101,124916,7.01,4.04,0.36306372549019605,0.88,99.4
2020-06-01,Telangana,1047,13,1038,13248,1814,1654,7.9,0,40.8,126715,1114,125954,4.45,4.05,0.3247058823529412,0.88,99.4
2020-06-02,Telangana,492,2,488,6203,3808,2302,7.93,2,40.8,127207,1116,126442,9.33,5.64,0.1520343137254902,0.88,99.4
2020-06-03,Telangana,934,3,934,11799,2589,2145,7.92,0,40.8,128141,1119,127376,6.35,5.26,0.28919117647058823,0.87,99.4
2020-06-04,Telangana,1426,7,1419,17860,4023,1928,7.98,0,40.8,129567,1126,128795,9.86,4.73,0.4377450980392157,0.87,99.4
2020-06-05,Telangana,1185,6,1176,14637,2886,1512,8.1,3,40.8,130752,1132,129971,7.07,3.71,0.35875,0.87,99.4
2020-06-06,Telangana,1445,16,1437,17846,1817,389,8.1,0,40.8,132197,1148,131408,4.45,0.95,0.4374019607843137,0.87,99.4
2020-06-07,Telangana,1447,17,1438,18222,1511,138,7.94,0,40.8,133644,1165,132846,3.7,0.34,0.4466176470588235,0.87,99.4
2020-06-08,Telangana,1173,11,1171,14963,2632,242,7.84,0,40.8,134817,1176,134017,6.45,0.59,0.3667401960784314,0.87,99.41
2020-06-09,Telangana,674,9,671,8007,2968,7,8.42,0,40.8,135491,1185,134688,7.27,0.02,0.19625,0.87,99.41
2020-06-10,Telangana,270,1,264,3589,3133,1381,7.52,5,40.8,135761,1186,134952,7.68,3.38,0.0879656862745098,0.87,99.4
2020-06-11,Telangana,1323,18,1321,17085,3865,2386,7.74,0,40.8,137084,1204,136273,9.47,5.85,0.41875,0.88,99.41
2020-06-12,Telangana,295,2,294,3719,3708,2992,7.93,0,40.8,137379,1206,136567,9.09,7.33,0.09115196078431373,0.88,99.41
2020-06-13,Telangana,226,2,225,2883,4924,1297,7.84,0,40.8,137605,1208,136792,12.07,3.18,0.07066176470588235,0.88,99.41
2020-06-14,Telangana,465,1,461,5432,2647,1559,8.56,3,40.8,138070,1209,137253,6.49,3.82,0.1331372549019608,0.88,99.41
2020-06-15,Telangana,184,2,179,2294,4774,619,8.02,3,40.8,138254,1211,137432,11.7,1.52,0.056225490196078434,0.88,99.41
2020-06-16,Telangana,76,0,67,1217,2598,1736,6.24,9,40.8,138330,1211,137499,6.37,4.25,0.02982843137254902,0.88,99.4
2020-06-17,Telangana,166,1,158,2153,3162,991,7.71,7,40.8,138496,1212,137657,7.75,2.43,0.05276960784313726,0.88,99.39
2020-06-18,Telangana,952,3,944,12055,2769,420,7.9,5,40.8,139448,1215,138601,6.79,1.03,0.2954656862745098,0.87,99.39
2020-06-19,Telangana,914,8,913,11391,2469,1049,8.02,0,40.8,140362,1223,139514,6.05,2.57,0.2791911764705882,0.87,99.4
2020-06-20,Telangana,54,0,50,753,1721,728,7.17,4,40.8,140416,1223,139564,4.22,1.78,0.018455882352941176,0.87,99.39
2020-06-21,Telangana,1545,8,1538,19197,3024,1817,8.05,0,40.8,141961,1231,141102,7.41,4.45,0.47051470588235295,0.87,99.39
2020-06-22,Telangana,1449,12,1445,17960,349,268,8.07,0,40.8,143410,1243,142547,0.86,0.66,0.44019607843137254,0.87,99.4
2020-06-23,Telangana,459,6,452,6005,3263,932,7.64,1,40.8,143869,1249,142999,8.0,2.28,0.1471813725490196,0.87,99.4
2020-06-24,Telangana,369,4,363,4493,97,47,8.21,2,40.8,144238,1253,143362,0.24,0.12,0.11012254901960784,0.87,99.39
2020-06-25,Telangana,176,2,170,2529,2269,1101,6.96,4,40.8,144414,1255,143532,5.56,2.7,0.06198529411764706,0.87,99.39
2020-06-26,Telangana,1487,19,1484,19007,1573,449,7.82,0,40.8,145901,1274,145016,3.86,1.1,0.4658578431372549,0.87,99.39
2020-06-27,Telangana,458,4,449,5917,1735,849,7.74,5,40.8,146359,1278,145465,4.25,2.08,0.14502450980392156,0.87,99.39
2020-06-28,Telangana,788,7,786,10431,1156,991,7.55,0,40.8,147147,1285,146251,2.83,2.43,0.25566176470588237,0.87,99.39
2020-06-29,Telangana,95,0,94,1676,1018,487,5.67,1,40.8,147242,1285,146345,2.5,1.19,0.04107843137254902,0.87,99.39
2020-06-30,Telangana,1490,18,1483,18607,803,675,8.01,0,40.8,148732,1303,147828,1.97,1.65,0.45605392156862745,0.88,99.39
2020-07-01,Telangana,1321,8,1321,17007,3924,799,7.77,0,40.8,150053,1311,149149,9.62,1.96,0.4168382352941176,0.87,99.4
2020-07-02,Telangana,533,7,531,6617,2145,1521,8.06,0,40.8,150586,1318,149680,5.26,3.73,0.1621813725490196,0.88,99.4
2020-07-03,Telangana,1548,20,1548,19294,892,118,8.02,0,40.8,152134,1338,151228,2.19,0.29,0.4728921568627451,0.88,99.4
2020-07-04,Telangana,1586,23,1580,19949,2601,675,7.95,0,40.8,153720,1361,152808,6.38,1.65,0.48894607843137255,0.89,99.41
2020-07-05,Telangana,966,7,958,12599,1806,1620,7.67,1,40.8,154686,1368,153766,4.43,3.97,0.3087990196078431,0.88,99.41
2020-07-06,Telangana,801,10,798,10032,3996,2756,7.98,0,40.8,155487,1378,154564,9.79,6.75,0.24588235294117647,0.89,99.41
2020-07-07,Telangana,1164,11,1156,14369,3162,566,8.1,0,40.8,156651,1389,155720,7.75,1.39,0.3521813725490196,0.89,99.41
2020-07-08,Telangana,348,1,342,5040,2013,1112,6.9,5,40.8,156999,1390,156062,4.93,2.73,0.12352941176470589,0.89,99.4
2020-07-09,Telangana,1533,6,1527,19027,3336,336,8.06,0,40.8,158532,1396,157589,8.18,0.82,0.4663480392156863,0.88,99.41
2020-07-10,Telangana,934,5,929,11862,1150,244,7.87,0,40.8,159466,1401,158518,2.82,0.6,0.29073529411764704,0.88,99.41
2020-07-11,Telangana,1466,16,1465,18253,273,112,8.03,0,40.8,160932,1417,159983,0.67,0.27,0.44737745098039217,0.88,99.41
2020-07-12,Telangana,385,4,377,4948,834,824,7.78,4,40.8,161317,1421,160360,2.04,2.02,0.12127450980392157,0.88,99.41
2020-07-13,Telangana,793,7,784,10129,942,455,7.83,2,40.8,162110,1428,161144,2.31,1.12,0.24825980392156863,0.88,99.4
2020-07-14,Telangana,875,10,869,10684,2143,1031,8.19,0,40.8,162985,1438,162013,5.25,2.53,0.2618627450980392,0.88,99.4
2020-07-15,Telangana,1136,6,1131,14305,3384,3239,7.94,0,40.8,164121,1444,163144,8.29,7.94,0.3506127450980392,0.88,99.4
2020-07-16,Telangana,399,1,391,5074,4377,1120,7.86,7,40.8,164520,1445,163535,10.73,2.75,0.12436274509803921,0.88,99.4
2020-07-17,Telangana,1008,9,1002,12891,360,290,7.82,0,40.8,165528,1454,164537,0.88,0.71,0.3159558823529412,0.88,99.4
2020-07-18,Telangana,1093,8,1085,13519,1351,982,8.08,0,40.8,166621,1462,165622,3.31,2.41,0.3313480392156863,0.88,99.4
2020-07-19,Telangana,451,2,449,5822,4304,2416,7.75,0,40.8,167072,1464,166071,10.55,5.92,0.14269607843137255,0.88,99.4
2020-07-20,Telangana,1198,6,1192,15356,1878,941,7.8,0,40.8,168270,1470,167263,4.6,2.31,0.3763725490196078,0.87,99.4
2020-07-21,Telangana,576,3,573,7218,455,264,7.98,0,40.8,168846,1473,167836,1.12,0.65,0.17691176470588235,0.87,99.4
2020-07-22,Telangana,1509,10,1505,18993,1073,247,7.95,0,40.8,170355,1483,169341,2.63,0.61,0.46551470588235294,0.87,99.4
2020-07-23,Telangana,305,3,296,3625,2882,365,8.41,6,40.8,170660,1486,169637,7.06,0.89,0.08884803921568628,0.87,99.4
2020-07-24,Telangana,683,5,676,8415,1760,1659,8.12,2,40.8,171343,1491,170313,4.31,4.07,0.20625,0.87,99.4
2020-07-25,Telangana,388,2,379,4754,3777,1893,8.16,7,40.8,171731,1493,170692,9.26,4.64,0.11651960784313725,0.87,99.39
2020-07-26,Telangana,520,7,519,6597,830,297,7.88,0,40.8,172251,1500,171211,2.03,0.73,0.16169117647058823,0.87,99.4
2020-07-27,Telangana,363,2,358,3794,4766,2139,9.57,3,40.8,172614,1502,171569,11.68,5.24,0.09299019607843137,0.87,99.39
2020-07-28,Telangana,1534,21,1531,19206,1084,604,7.99,0,40.8,174148,1523,173100,2.66,1.48,0.4707352941176471,0.87,99.4
2020-07-29,Telangana,138,0,134,1711,3677,481,8.07,4,40.8,174286,1523,173234,9.01,1.18,0.041936274509803924,0.87,99.4
2020-07-30,Telangana,1204,14,1199,14774,1885,1412,8.15,0,40.8,175490,1537,174433,4.62,3.46,0.3621078431372549,0.88,99.4
2020-07-31,Telangana,726,4,723,9312,147,114,7.8,0,40.8,176216,1541,175156,0.36,0.28,0.22823529411764706,0.87,99.4
2020-08-01,Telangana,704,2,695,8578,3976,2027,8.21,7,40.8,176920,1543,175851,9.75,4.97,0.21024509803921568,0.87,99.4
2020-08-02,Telangana,185,0,184,2193,2232,1207,8.44,1,40.8,177105,1543,176035,5.47,2.96,0.05375,0.87,99.4
2020-08-03,Telangana,225,1,221,2919,2525,607,7.71,3,40.8,177330,1544,176256,6.19,1.49,0.07154411764705883,0.87,99.39
2020-08-04,Telangana,1077,13,1076,13340,2482,1376,8.07,0,40.8,178407,1557,177332,6.08,3.37,0.3269607843137255,0.87,99.4
2020-08-05,Telangana,1447,7,1438,18155,119,56,7.97,2,40.8,179854,1564,178770,0.29,0.14,0.4449754901960784,0.87,99.4
2020-08-06,Telangana,1384,16,1383,16985,3430,882,8.15,0,40.8,181238,1580,180153,8.41,2.16,0.41629901960784316,0.87,99.4
2020-08-07,Telangana,101,1,100,1653,3699,3084,6.11,0,40.8,181339,1581,180253,9.07,7.56,0.04051470588235294,0.87,99.4
2020-08-08,Telangana,1082,13,1082,13595,482,319,7.96,0,40.8,182421,1594,181335,1.18,0.78,0.33321078431372547,0.87,99.4
2020-08-09,Telangana,796,10,795,10210,3175,2334,7.8,0,40.8,183217,1604,182130,7.78,5.72,0.2502450980392157,0.88,99.41
2020-08-10,Telangana,1282,7,1278,16111,3427,2016,7.96,0,40.8,184499,1611,183408,8.4,4.94,0.3948774509803922,0.87,99.41
2020-08-11,Telangana,1493,11,1486,18374,2774,2754,8.13,0,40.8,185992,1622,184894,6.8,6.75,0.45034313725490194,0.87,99.41
2020-08-12,Telangana,182,2,178,2972,3509,3403,6.12,2,40.8,186174,1624,185072,8.6,8.34,0.07284313725490196,0.87,99.41
2020-08-13,Telangana,1062,15,1057,12995,2271,913,8.17,0,40.8,187236,1639,186129,5.57,2.24,0.3185049019607843,0.88,99.41
2020-08-14,Telangana,328,3,322,3645,2607,2266,9.0,3,40.8,187564,1642,186451,6.39,5.55,0.08933823529411765,0.88,99.41
2020-08-15,Telangana,1571,5,1566,19590,3752,917,8.02,0,40.8,189135,1647,188017,9.2,2.25,0.4801470588235294,0.87,99.41
2020-08-16,Telangana,1282,17,1279,16087,4479,3578,7.97,0,40.8,190417,1664,189296,10.98,8.77,0.3942892156862745,0.87,99.41
2020-08-17,Telangana,382,1,375,5170,409,93,7.39,6,40.8,190799,1665,189671,1.0,0.23,0.1267156862745098,0.87,99.41
2020-08-18,Telangana,545,2,537,6573,4208,3130,8.29,6,40.8,191344,1667,190208,10.31,7.67,0.1611029411764706,0.87,99.41
2020-08-19,Telangana,410,2,402,5337,4221,3147,7.68,6,40.8,191754,1669,190610,10.35,7.71,0.13080882352941176,0.87,99.4
2020-08-20,Telangana,1093,4,1084,13614,3564,3326,8.03,5,40.8,192847,1673,191694,8.74,8.15,0.3336764705882353,0.87,99.4
2020-08-21,Telangana,1223,11,1216,15281,1851,1580,8.0,0,40.8,194070,1684,192910,4.54,3.87,0.3745343137254902,0.87,99.4
2020-08-22,Telangana,871,5,870,10948,4811,410,7.96,0,40.8,194941,1689,193780,11.79,1.0,0.2683333333333333,0.87,99.4
2020-08-23,Telangana,1067,6,1065,13464,1263,1100,7.92,0,40.8,196008,1695,194845,3.1,2.7,0.33,0.86,99.41
2020-08-24,Telangana,470,2,464,6081,2747,760,7.73,4,40.8,196478,1697,195309,6.73,1.86,0.14904411764705883,0.86,99.41
2020-08-25,Telangana,687,9,680,8385,4893,245,8.19,0,40.8,197165,1706,195989,11.99,0.6,0.20551470588235293,0.87,99.4
2020-08-26,Telangana,1562,14,1560,19957,4753,411,7.83,0,40.8,198727,1720,197549,11.65,1.01,0.4891421568627451,0.87,99.41
2020-08-27,Telangana,828,7,823,10565,703,364,7.84,0,40.8,199555,1727,198372,1.72,0.89,0.2589460784313726,0.87,99.41
2020-08-28,Telangana,1501,12,1492,19221,122,82,7.81,0,40.8,201056,1739,199864,0.3,0.2,0.4711029411764706,0.86,99.41
2020-08-29,Telangana,1526,8,1522,19649,4981,1068,7.77,0,40.8,202582,1747,201386,12.21,2.62,0.48159313725490194,0.86,99.41
2020-08-30,Telangana,892,6,886,11269,1724,1518,7.92,0,40.8,203474,1753,202272,4.23,3.72,0.27620098039215685,0.86,99.41
2020-08-31,Telangana,1030,14,1021,12438,1849,1412,8.28,0,40.8,204504,1767,203293,4.53,3.46,0.3048529411764706,0.86,99.41
2020-09-01,Telangana,1001,8,1001,12719,4430,286,7.87,0,40.8,205505,1775,204294,10.86,0.7,0.3117401960784314,0.86,99.41
2020-09-02,Telangana,661,3,653,8309,33,29,7.96,5,40.8,206166,1778,204947,0.08,0.07,0.20365196078431372,0.86,99.41
2020-09-03,Telangana,1535,21,1535,19612,4365,487,7.83,0,40.8,207701,1799,206482,10.7,1.19,0.48068627450980395,0.87,99.41
2020-09-04,Telangana,815,6,812,10184,4986,2018,8.0,0,40.8,208516,1805,207294,12.22,4.95,0.2496078431372549,0.87,99.41
2020-09-05,Telangana,1299,5,1299,16368,1532,1217,7.94,0,40.8,209815,1810,208593,3.75,2.98,0.4011764705882353,0.86,99.42
2020-09-06,Telangana,1517,16,1509,19322,2889,976,7.85,0,40.8,211332,1826,210102,7.08,2.39,0.473578431372549,0.86,99.42
2020-09-07,Telangana,117,1,113,1424,1152,216,8.22,3,40.8,211449,1827,210215,2.82,0.53,0.03490196078431373,0.86,99.42
2020-09-08,Telangana,921,5,914,11574,500,88,7.96,2,40.8,212370,1832,211129,1.23,0.22,0.2836764705882353,0.86,99.42
2020-09-09,Telangana,1460,16,1451,18423,810,431,7.92,0,40.8,213830,1848,212580,1.99,1.06,0.4515441176470588,0.86,99.42
2020-09-10,Telangana,327,3,322,4443,63,14,7.36,2,40.8,214157,1851,212902,0.15,0.03,0.10889705882352942,0.86,99.41
2020-09-11,Telangana,1394,12,1390,17650,3618,2462,7.9,0,40.8,215551,1863,214292,8.87,6.03,0.4325980392156863,0.86,99.42
2020-09-12,Telangana,851,6,849,10710,1171,689,7.95,0,40.8,216402,1869,215141,2.87,1.69,0.2625,0.86,99.42
2020-09-13,Telangana,1055,11,1047,13150,259,72,8.02,0,40.8,217457,1880,216188,0.63,0.18,0.32230392156862747,0.86,99.42
2020-09-14,Telangana,1282,11,1276,16195,457,31,7.92,0,40.8,218739,1891,217464,1.12,0.08,0.3969362745098039,0.86,99.42
2020-09-15,Telangana,327,1,326,3826,4642,4336,8.55,0,40.8,219066,1892,217790,11.38,10.63,0.09377450980392157,0.86,99.42
2020-09-16,Telangana,1144,12,1144,13997,4726,5,8.17,0,40.8,220210,1904,218934,11.58,0.01,0.3430637254901961,0.86,99.42
2020-09-17,Telangana,1416,20,1416,17408,3357,2239,8.13,0,40.8,221626,1924,220350,8.23,5.49,0.4266666666666667,0.87,99.42
2020-09-18,Telangana,1150,10,1148,14610,4807,1190,7.87,0,40.8,222776,1934,221498,11.78,2.92,0.35808823529411765,0.87,99.43
2020-09-19,Telangana,1177,8,1170,14957,2343,361,7.87,0,40.8,223953,1942,222668,5.74,0.88,0.36659313725490195,0.87,99.43
2020-09-20,Telangana,1122,9,1119,13872,471,80,8.09,0,40.8,225075,1951,223787,1.15,0.2,0.34,0.87,99.43
2020-09-21,Telangana,1391,4,1391,17320,154,43,8.03,0,40.8,226466,1955,225178,0.38,0.11,0.4245098039215686,0.86,99.43
2020-09-22,Telangana,967,3,961,11871,2434,1307,8.15,3,40.8,227433,1958,226139,5.97,3.2,0.2909558823529412,0.86,99.43
2020-09-23,Telangana,632,7,626,7775,222,63,8.13,0,40.8,228065,1965,226765,0.54,0.15,0.19056372549019607,0.86,99.43
2020-09-24,Telangana,31,0,26,550,530,336,5.64,5,40.8,228096,1965,226791,1.3,0.82,0.013480392156862746,0.86,99.43
2020-09-25,Telangana,955,3,952,12125,1521,1122,7.88,0,40.8,229051,1968,227743,3.73,2.75,0.2971813725490196,0.86,99.43
2020-09-26,Telangana,853,6,851,10792,4810,1012,7.9,0,40.8,229904,1974,228594,11.79,2.48,0.26450980392156864,0.86,99.43
2020-09-27,Telangana,1232,4,1226,15387,872,757,8.01,2,40.8,231136,1978,229820,2.14,1.86,0.3771323529411765,0.86,99.43
2020-09-28,Telangana,1528,22,1527,18960,1587,481,8.06,0,40.8,232664,2000,231347,3.89,1.18,0.4647058823529412,0.86,99.43
2020-09-29,Telangana,56,0,56,711,4092,139,7.88,0,40.8,232720,2000,231403,10.03,0.34,0.017426470588235293,0.86,99.43
2020-09-30,Telangana,1208,16,1206,15281,4742,770,7.91,0,40.8,233928,2016,232609,11.62,1.89,0.3745343137254902,0.86,99.44
2020-10-01,Telangana,676,9,667,8134,3558,2343,8.31,0,40.8,234604,2025,233276,8.72,5.74,0.19936274509803922,0.86,99.43
2020-10-02,Telangana,324,2,315,4131,4403,3189,7.84,7,40.8,234928,2027,233591,10.79,7.82,0.10125,0.86,99.43
2020-10-03,Telangana,633,8,628,7983,1107,911,7.93,0,40.8,235561,2035,234219,2.71,2.23,0.19566176470588234,0.86,99.43
2020-10-04,Telangana,1453,6,1453,17887,4284,1946,8.12,0,40.8,237014,2041,235672,10.5,4.77,0.43840686274509805,0.86,99.43
2020-10-05,Telangana,997,8,996,12134,2562,1001,8.22,0,40.8,238011,2049,236668,6.28,2.45,0.29740196078431375,0.86,99.44
2020-10-06,Telangana,860,3,857,10542,3693,2257,8.16,0,40.8,238871,2052,237525,9.05,5.53,0.25838235294117645,0.86,99.44
2020-10-07,Telangana,739,2,735,9362,827,819,7.89,2,40.8,239610,2054,238260,2.03,2.01,0.2294607843137255,0.86,99.44
2020-10-08,Telangana,1513,17,1509,18673,3177,625,8.1,0,40.8,241123,2071,239769,7.79,1.53,0.45767156862745095,0.86,99.44
2020-10-09,Telangana,604,4,599,7326,4223,3492,8.24,1,40.8,241727,2075,240368,10.35,8.56,0.17955882352941177,0.86,99.44
2020-10-10,Telangana,1117,7,1115,14495,4925,4340,7.71,0,40.8,242844,2082,241483,12.07,10.64,0.35526960784313727,0.86,99.44
2020-10-11,Telangana,1107,7,1098,13912,4149,2697,7.96,2,40.8,243951,2089,242581,10.17,6.61,0.34098039215686277,0.86,99.44
2020-10-12,Telangana,451,2,443,5602,652,500,8.05,6,40.8,244402,2091,243024,1.6,1.23,0.13730392156862745,0.86,99.44
2020-10-13,Telangana,461,1,453,5401,4333,4156,8.54,7,40.8,244863,2092,243477,10.62,10.19,0.13237745098039216,0.85,99.43
2020-10-14,Telangana,294,3,287,3769,2473,2108,7.8,4,40.8,245157,2095,243764,6.06,5.17,0.09237745098039216,0.85,99.43
2020-10-15,Telangana,1494,16,1487,18586,4530,4364,8.04,0,40.8,246651,2111,245251,11.1,10.7,0.45553921568627453,0.86,99.43
2020-10-16,Telangana,1106,11,1104,13692,4844,170,8.08,0,40.8,247757,2122,246355,11.87,0.42,0.33558823529411763,0.86,99.43
2020-10-17,Telangana,1441,16,1438,17950,2180,1104,8.03,0,40.8,249198,2138,247793,5.34,2.71,0.43995098039215685,0.86,99.44
2020-10-18,Telangana,1202,11,1202,15059,1894,618,7.98,0,40.8,250400,2149,248995,4.64,1.51,0.36909313725490195,0.86,99.44
2020-10-19,Telangana,385,4,384,4932,2720,1082,7.81,0,40.8,250785,2153,249379,6.67,2.65,0.12088235294117647,0.86,99.44
2020-10-20,Telangana,1133,9,1124,14383,2411,1076,7.88,0,40.8,251918,2162,250503,5.91,2.64,0.3525245098039216,0.86,99.44
2020-10-21,Telangana,908,10,907,11379,3758,1776,7.98,0,40.8,252826,2172,251410,9.21,4.35,0.2788970588235294,0.86,99.44
2020-10-22,Telangana,1432,12,1430,18402,3224,2062,7.78,0,40.8,254258,2184,252840,7.9,5.05,0.4510294117647059,0.86,99.44
2020-10-23,Telangana,795,10,789,9882,4536,4233,8.04,0,40.8,255053,2194,253629,11.12,10.38,0.2422058823529412,0.86,99.44
2020-10-24,Telangana,1041,13,1039,13667,1466,462,7.62,0,40.8,256094,2207,254668,3.59,1.13,0.3349754901960784,0.86,99.44
2020-10-25,Telangana,835,12,832,10568,939,231,7.9,0,40.8,256929,2219,255500,2.3,0.57,0.25901960784313727,0.86,99.44
2020-10-26,Telangana,1063,3,1057,13669,3740,386,7.78,3,40.8,257992,2222,256557,9.17,0.95,0.33502450980392157,0.86,99.44
2020-10-27,Telangana,1024,15,1016,12676,3518,119,8.08,0,40.8,259016,2237,257573,8.62,0.29,0.3106862745098039,0.86,99.44
2020-10-28,Telangana,342,2,336,4471,3275,2072,7.65,4,40.8,259358,2239,257909,8.03,5.08,0.10958333333333334,0.86,99.44
2020-10-29,Telangana,1114,12,1109,14147,1668,1142,7.87,0,40.8,260472,2251,259018,4.09,2.8,0.3467401960784314,0.86,99.44
2020-10-30,Telangana,521,5,515,6612,3045,1773,7.88,1,40.8,260993,2256,259533,7.46,4.35,0.16205882352941176,0.86,99.44
2020-10-31,Telangana,986,13,980,12106,3653,3444,8.14,0,40.8,261979,2269,260513,8.95,8.44,0.2967156862745098,0.87,99.44
2020-11-01,Telangana,195,0,192,2451,4398,3627,7.96,3,40.8,262174,2269,260705,10.78,8.89,0.060073529411764706,0.87,99.44
2020-11-02,Telangana,1131,11,1127,14045,2267,1310,8.05,0,40.8,263305,2280,261832,5.56,3.21,0.34424019607843137,0.87,99.44
2020-11-03,Telangana,787,4,784,9613,1298,415,8.19,0,40.8,264092,2284,262616,3.18,1.02,0.23561274509803923,0.86,99.44
2020-11-04,Telangana,1482,17,1481,18288,3609,2616,8.1,0,40.8,265574,2301,264097,8.85,6.41,0.44823529411764707,0.87,99.44
2020-11-05,Telangana,1307,17,1307,16252,4372,4156,8.04,0,40.8,266881,2318,265404,10.72,10.19,0.3983333333333333,0.87,99.45
2020-11-06,Telangana,1359,6,1351,17220,1343,1248,7.89,2,40.8,268240,2324,266755,3.29,3.06,0.42205882352941176,0.87,99.45
2020-11-07,Telangana,683,4,677,7998,2412,402,8.54,2,40.8,268923,2328,267432,5.91,0.99,0.19602941176470587,0.87,99.45
2020-11-08,Telangana,278,2,276,3323,3402,3152,8.37,0,40.8,269201,2330,267708,8.34,7.73,0.08144607843137255,0.87,99.45
2020-11-09,Telangana,1480,21,1478,18072,2730,32,8.19,0,40.8,270681,2351,269186,6.69,0.08,0.4429411764705882,0.87,99.45
2020-11-10,Telangana,1412,20,1404,17458,3447,1004,8.09,0,40.8,272093,2371,270590,8.45,2.46,0.4278921568627451,0.87,99.45
2020-11-11,Telangana,1005,6,996,12633,3359,2962,7.96,3,40.8,273098,2377,271586,8.23,7.26,0.30963235294117647,0.87,99.45
2020-11-12,Telangana,1323,12,1322,17120,4141,769,7.73,0,40.8,274421,2389,272908,10.15,1.88,0.4196078431372549,0.87,99.45
2020-11-13,Telangana,1412,13,1409,17750,3018,270,7.95,0,40.8,275833,2402,274317,7.4,0.66,0.43504901960784315,0.87,99.45
2020-11-14,Telangana,312,1,306,4042,3511,1342,7.72,5,40.8,276145,2403,274623,8.61,3.29,0.0990686274509804,0.87,99.45
2020-11-15,Telangana,1057,15,1054,12980,1889,422,8.14,0,40.8,277202,2418,275677,4.63,1.03,0.31813725490196076,0.87,99.45
2020-11-16,Telangana,918,3,913,11166,4052,699,8.22,2,40.8,278120,2421,276590,9.93,1.71,0.2736764705882353,0.87,99.45
2020-11-17,Telangana,570,7,569,6845,1305,99,8.33,0,40.8,278690,2428,277159,3.2,0.24,0.16776960784313724,0.87,99.45
2020-11-18,Telangana,104,1,101,1045,3050,2784,9.95,2,40.8,278794,2429,277260,7.48,6.82,0.025612745098039215,0.87,99.45
2020-11-19,Telangana,1046,6,1039,13378,1814,567,7.82,1,40.8,279840,2435,278299,4.45,1.39,0.3278921568627451,0.87,99.45
2020-11-20,Telangana,322,1,321,4580,1953,1437,7.03,0,40.8,280162,2436,278620,4.79,3.52,0.11225490196078432,0.87,99.45
2020-11-21,Telangana,1506,14,1498,18125,1487,863,8.31,0,40.8,281668,2450,280118,3.64,2.12,0.44424019607843135,0.87,99.45
2020-11-22,Telangana,76,0,72,634,2708,651,11.99,4,40.8,281744,2450,280190,6.64,1.6,0.01553921568627451,0.87,99.45
2020-11-23,Telangana,1566,6,1563,19509,1722,1478,8.03,0,40.8,283310,2456,281753,4.22,3.62,0.47816176470588234,0.87,99.45
2020-11-24,Telangana,922,9,915,11610,2451,696,7.94,0,40.8,284232,2465,282668,6.01,1.71,0.28455882352941175,0.87,99.45
2020-11-25,Telangana,682,3,676,8376,3817,646,8.14,3,40.8,284914,2468,283344,9.36,1.58,0.20529411764705882,0.87,99.45
2020-11-26,Telangana,349,1,344,4387,310,199,7.96,4,40.8,285263,2469,283688,0.76,0.49,0.10752450980392157,0.87,99.45
2020-11-27,Telangana,234,2,231,3010,606,565,7.77,1,40.8,285497,2471,283919,1.49,1.38,0.07377450980392157,0.87,99.45
2020-11-28,Telangana,1226,9,1217,15669,1403,1173,7.82,0,40.8,286723,2480,285136,3.44,2.88,0.3840441176470588,0.86,99.45
2020-11-29,Telangana,966,9,965,12166,493,278,7.94,0,40.8,287689,2489,286101,1.21,0.68,0.2981862745098039,0.87,99.45
2020-11-30,Telangana,599,7,595,7506,4874,2475,7.98,0,40.8,288288,2496,286696,11.95,6.07,0.1839705882352941,0.87,99.45
2020-12-01,Telangana,49,0,47,926,1683,888,5.29,2,40.8,288337,2496,286743,4.12,2.18,0.02269607843137255,0.87,99.45
2020-12-02,Telangana,535,6,534,6909,4055,234,7.74,0,40.8,288872,2502,287277,9.94,0.57,0.16933823529411765,0.87,99.45
2020-12-03,Telangana,368,5,365,4786,2008,389,7.69,0,40.8,289240,2507,287642,4.92,0.95,0.11730392156862746,0.87,99.45
2020-12-04,Telangana,525,2,524,6332,4276,3202,8.29,0,40.8,289765,2509,288166,10.48,7.85,0.15519607843137254,0.87,99.45
2020-12-05,Telangana,49,0,40,653,3997,3649,7.5,9,40.8,289814,2509,288206,9.8,8.94,0.016004901960784315,0.87,99.45
2020-12-06,Telangana,728,9,728,9062,1048,711,8.03,0,40.8,290542,2518,288934,2.57,1.74,0.2221078431372549,0.87,99.45
2020-12-07,Telangana,1333,6,1327,16650,2556,1971,8.01,0,40.8,291875,2524,290261,6.26,4.83,0.40808823529411764,0.86,99.45
2020-12-08,Telangana,916,4,912,11627,3560,764,7.88,0,40.8,292791,2528,291173,8.73,1.87,0.28497549019607843,0.86,99.45
2020-12-09,Telangana,278,2,274,3381,4847,964,8.22,2,40.8,293069,2530,291447,11.88,2.36,0.08286764705882353,0.86,99.45
2020-12-10,Telangana,936,13,927,11993,4068,3827,7.8,0,40.8,294005,2543,292374,9.97,9.38,0.29394607843137255,0.86,99.45
2020-12-11,Telangana,552,2,549,6531,4846,3929,8.45,1,40.8,294557,2545,292923,11.88,9.63,0.1600735294117647,0.86,99.45
2020-12-12,Telangana,761,6,753,9498,534,10,8.01,2,40.8,295318,2551,293676,1.31,0.02,0.23279411764705882,0.86,99.44
2020-12-13,Telangana,177,0,170,2420,2600,1628,7.31,7,40.8,295495,2551,293846,6.37,3.99,0.059313725490196076,0.86,99.44
2020-12-14,Telangana,748,8,748,9677,3292,2280,7.73,0,40.8,296243,2559,294594,8.07,5.59,0.2371813725490196,0.86,99.44
2020-12-15,Telangana,1036,11,1036,13614,3127,232,7.61,0,40.8,297279,2570,295630,7.66,0.57,0.3336764705882353,0.86,99.45
2020-12-16,Telangana,264,3,257,3573,4948,1808,7.39,4,40.8,297543,2573,295887,12.13,4.43,0.0875735294117647,0.86,99.44
2020-12-17,Telangana,983,10,977,12810,4242,1331,7.67,0,40.8,298526,2583,296864,10.4,3.26,0.3139705882352941,0.87,99.44
2020-12-18,Telangana,543,2,541,6501,3086,962,8.35,0,40.8,299069,2585,297405,7.56,2.36,0.15933823529411764,0.86,99.44
2020-12-19,Telangana,824,11,823,9859,1433,680,8.36,0,40.8,299893,2596,298228,3.51,1.67,0.2416421568627451,0.87,99.44
2020-12-20,Telangana,222,2,219,2655,1315,199,8.36,1,40.8,300115,2598,298447,3.22,0.49,0.06507352941176471,0.87,99.44
2020-12-21,Telangana,1056,14,1048,13166,4302,3237,8.02,0,40.8,301171,2612,299495,10.54,7.93,0.32269607843137255,0.87,99.44
2020-12-22,Telangana,1492,6,1492,19213,3048,2319,7.77,0,40.8,302663,2618,300987,7.47,5.68,0.470906862745098,0.86,99.45
2020-12-23,Telangana,1160,4,1159,14761,1016,293,7.86,0,40.8,303823,2622,302146,2.49,0.72,0.36178921568627453,0.86,99.45
2020-12-24,Telangana,770,6,770,9427,3348,836,8.17,0,40.8,304593,2628,302916,8.21,2.05,0.23105392156862745,0.86,99.45
2020-12-25,Telangana,516,1,515,6538,619,39,7.89,0,40.8,305109,2629,303431,1.52,0.1,0.1602450980392157,0.86,99.45
2020-12-26,Telangana,938,3,937,11588,3835,355,8.09,0,40.8,306047,2632,304368,9.4,0.87,0.28401960784313723,0.86,99.45
2020-12-27,Telangana,214,0,212,2828,2058,11,7.57,2,40.8,306261,2632,304580,5.04,0.03,0.06931372549019608,0.86,99.45
2020-12-28,Telangana,1064,12,1056,13391,4741,2390,7.95,0,40.8,307325,2644,305636,11.62,5.86,0.32821078431372547,0.86,99.45
2020-12-29,Telangana,755,9,755,9572,4337,3005,7.89,0,40.8,308080,2653,306391,10.63,7.37,0.2346078431372549,0.86,99.45
2020-12-30,Telangana,589,3,586,7453,4594,4228,7.9,0,40.8,308669,2656,306977,11.26,10.36,0.182671568627451,0.86,99.45
2020-12-31,Telangana,696,7,696,8979,4591,1921,7.75,0,40.8,309365,2663,307673,11.25,4.71,0.2200735294117647,0.86,99.45
2021-01-01,Telangana,1052,4,1047,12701,2400,297,8.28,1,40.8,310417,2667,308720,5.88,0.73,0.3112990196078431,0.86,99.45
2021-01-02,Telangana,895,8,887,11517,1149,1132,7.77,0,40.8,311312,2675,309607,2.82,2.77,0.2822794117647059,0.86,99.45
2021-01-03,Telangana,1338,6,1335,16869,57,26,7.93,0,40.8,312650,2681,310942,0.14,0.06,0.4134558823529412,0.86,99.45
2021-01-04,Telangana,1123,16,1123,13675,1907,280,8.21,0,40.8,313773,2697,312065,4.67,0.69,0.33517156862745096,0.86,99.46
2021-01-05,Telangana,1030,11,1025,12983,1585,493,7.93,0,40.8,314803,2708,313090,3.88,1.21,0.3182107843137255,0.86,99.46
2021-01-06,Telangana,1231,17,1226,15854,4834,3892,7.76,0,40.8,316034,2725,314316,11.85,9.54,0.388578431372549,0.86,99.46
2021-01-07,Telangana,292,4,286,3826,2228,1828,7.63,2,40.8,316326,2729,314602,5.46,4.48,0.09377450980392157,0.86,99.45
2021-01-08,Telangana,215,3,211,2556,2475,1917,8.41,1,40.8,316541,2732,314813,6.07,4.7,0.06264705882352942,0.86,99.45
2021-01-09,Telangana,109,1,103,1252,1581,1287,8.71,5,40.8,316650,2733,314916,3.88,3.15,0.03068627450980392,0.86,99.45
2021-01-10,Telangana,549,6,545,6830,3484,1252,8.04,0,40.8,317199,2739,315461,8.54,3.07,0.1674019607843137,0.86,99.45
2021-01-11,Telangana,692,7,691,9066,1303,585,7.63,0,40.8,317891,2746,316152,3.19,1.43,0.22220588235294117,0.86,99.45
2021-01-12,Telangana,409,2,400,5109,1588,1417,8.01,7,40.8,318300,2748,316552,3.89,3.47,0.1252205882352941,0.86,99.45
2021-01-13,Telangana,913,11,913,11186,3629,80,8.16,0,40.8,319213,2759,317465,8.89,0.2,0.27416666666666667,0.86,99.45
2021-01-14,Telangana,610,2,608,7719,3621,1621,7.9,0,40.8,319823,2761,318073,8.88,3.97,0.18919117647058822,0.86,99.45
2021-01-15,Telangana,1008,10,1003,12901,4301,3422,7.81,0,40.8,320831,2771,319076,10.54,8.39,0.3162009803921569,0.86,99.45
2021-01-16,Telangana,1366,12,1365,17225,1210,961,7.93,0,40.8,322197,2783,320441,2.97,2.36,0.4221813725490196,0.86,99.45
2021-01-17,Telangana,285,3,282,3661,613,571,7.78,0,40.8,322482,2786,320723,1.5,1.4,0.08973039215686275,0.86,99.45
2021-01-18,Telangana,1542,22,1535,19615,3500,1246,7.86,0,40.8,324024,2808,322258,8.58,3.05,0.48075980392156864,0.87,99.45
2021-01-19,Telangana,1385,20,1381,16898,1152,1107,8.2,0,40.8,325409,2828,323639,2.82,2.71,0.4141666666666667,0.87,99.46
2021-01-20,Telangana,1014,12,1010,12812,1933,1305,7.91,0,40.8,326423,2840,324649,4.74,3.2,0.31401960784313726,0.87,99.46
2021-01-21,Telangana,186,0,183,2397,4178,2869,7.76,3,40.8,326609,2840,324832,10.24,7.03,0.05875,0.87,99.46
2021-01-22,Telangana,879,9,873,10668,3438,523,8.24,0,40.8,327488,2849,325705,8.43,1.28,0.2614705882352941,0.87,99.46
2021-01-23,Telangana,569,2,560,7446,2614,594,7.64,7,40.8,328057,2851,326265,6.41,1.46,0.1825,0.87,99.45
2021-01-24,Telangana,1481,19,1477,18471,4293,1303,8.02,0,40.8,329538,2870,327742,10.52,3.19,0.4527205882352941,0.87,99.45
2021-01-25,Telangana,909,5,906,11425,554,278,7.96,0,40.8,330447,2875,328648,1.36,0.68,0.2800245098039216,0.87,99.46
2021-01-26,Telangana,855,3,853,10605,808,247,8.06,0,40.8,331302,2878,329501,1.98,0.61,0.2599264705882353,0.87,99.46
2021-01-27,Telangana,358,4,354,4624,2454,2001,7.74,0,40.8,331660,2882,329855,6.01,4.9,0.11333333333333333,0.87,99.46
2021-01-28,Telangana,302,3,302,3715,3183,1151,8.13,0,40.8,331962,2885,330157,7.8,2.82,0.09105392156862745,0.87,99.46
2021-01-29,Telangana,264,3,264,3056,3074,215,8.64,0,40.8,332226,2888,330421,7.53,0.53,0.07490196078431373,0.87,99.46
2021-01-30,Telangana,1232,9,1231,15582,4088,2857,7.91,0,40.8,333458,2897,331652,10.02,7.0,0.38191176470588234,0.87,99.46
2021-01-31,Telangana,751,9,750,9345,2827,817,8.04,0,40.8,334209,2906,332402,6.93,2.0,0.22904411764705881,0.87,99.46
2021-02-01,Telangana,81,0,74,881,4924,780,9.19,7,40.8,334290,2906,332476,12.07,1.91,0.021593137254901962,0.87,99.46
2021-02-02,Telangana,982,11,980,12288,2308,1072,7.99,0,40.8,335272,2917,333456,5.66,2.63,0.30117647058823527,0.87,99.46
2021-02-03,Telangana,952,7,949,12297,3808,1127,7.74,0,40.8,336224,2924,334405,9.33,2.76,0.3013970588235294,0.87,99.46
2021-02-04,Telangana,917,2,910,10791,2885,2274,8.5,5,40.8,337141,2926,335315,7.07,5.57,0.26448529411764704,0.87,99.46
2021-02-05,Telangana,1196,10,1189,15108,3933,687,7.92,0,40.8,338337,2936,336504,9.64,1.68,0.37029411764705883,0.87,99.46
2021-02-06,Telangana,1395,16,1390,17504,3387,715,7.97,0,40.8,339732,2952,337894,8.3,1.75,0.42901960784313725,0.87,99.46
2021-02-07,Telangana,840,6,834,10479,4928,2874,8.02,0,40.8,340572,2958,338728,12.08,7.04,0.25683823529411764,0.87,99.46
2021-02-08,Telangana,1357,16,1357,16858,4197,3215,8.05,0,40.8,341929,2974,340085,10.29,7.88,0.41318627450980394,0.87,99.46
2021-02-09,Telangana,91,0,91,1674,4245,2442,5.44,0,40.8,342020,2974,340176,10.4,5.99,0.041029411764705884,0.87,99.46
2021-02-10,Telangana,713,3,713,8322,4634,1452,8.57,0,40.8,342733,2977,340889,11.36,3.56,0.20397058823529413,0.87,99.46
2021-02-11,Telangana,1108,10,1106,14539,4768,3473,7.62,0,40.8,343841,2987,341995,11.69,8.51,0.35634803921568625,0.87,99.46
2021-02-12,Telangana,1499,20,1494,18659,93,92,8.03,0,40.8,345340,3007,343489,0.23,0.23,0.457328431372549,0.87,99.46
2021-02-13,Telangana,302,4,299,3188,128,8,9.47,0,40.8,345642,3011,343788,0.31,0.02,0.07813725490196079,0.87,99.46
2021-02-14,Telangana,1216,14,1215,14779,509,248,8.23,0,40.8,346858,3025,345003,1.25,0.61,0.36223039215686276,0.87,99.47
2021-02-15,Telangana,110,1,104,1152,3796,3082,9.55,5,40.8,346968,3026,345107,9.3,7.55,0.02823529411764706,0.87,99.46
2021-02-16,Telangana,1387,10,1378,17125,3233,1897,8.1,0,40.8,348355,3036,346485,7.92,4.65,0.41973039215686275,0.87,99.46
2021-02-17,Telangana,659,4,652,8517,4323,4066,7.74,3,40.8,349014,3040,347137,10.6,9.97,0.20875,0.87,99.46
2021-02-18,Telangana,110,0,104,819,1556,1228,13.43,6,40.8,349124,3040,347241,3.81,3.01,0.020073529411764705,0.87,99.46
2021-02-19,Telangana,110,0,110,1606,1327,8,6.85,0,40.8,349234,3040,347351,3.25,0.02,0.03936274509803921,0.87,99.46
2021-02-20,Telangana,1315,17,1311,16932,3204,2601,7.77,0,40.8,350549,3057,348662,7.85,6.38,0.415,0.87,99.46
2021-02-21,Telangana,801,4,799,10221,312,216,7.84,0,40.8,351350,3061,349461,0.76,0.53,0.2505147058823529,0.87,99.46
2021-02-22,Telangana,397,2,392,4843,951,641,8.2,3,40.8,351747,3063,349853,2.33,1.57,0.11870098039215686,0.87,99.46
2021-02-23,Telangana,63,0,58,855,3700,2284,7.37,5,40.8,351810,3063,349911,9.07,5.6,0.020955882352941175,0.87,99.46
2021-02-24,Telangana,1283,12,1276,16115,4371,3793,7.96,0,40.8,353093,3075,351187,10.71,9.3,0.3949754901960784,0.87,99.46
2021-02-25,Telangana,639,6,635,8425,3914,673,7.58,0,40.8,353732,3081,351822,9.59,1.65,0.20649509803921567,0.87,99.46
2021-02-26,Telangana,1552,21,1551,19475,3479,3450,7.97,0,40.8,355284,3102,353373,8.53,8.46,0.47732843137254904,0.87,99.46
2021-02-27,Telangana,906,9,902,11292,449,332,8.02,0,40.8,356190,3111,354275,1.1,0.81,0.27676470588235297,0.87,99.46
2021-02-28,Telangana,989,10,985,12475,1518,1224,7.93,0,40.8,357179,3121,355260,3.72,3.0,0.30575980392156865,0.87,99.46
2021-03-01,Telangana,474,6,472,5833,1715,966,8.13,0,40.8,357653,3127,355732,4.2,2.37,0.1429656862745098,0.87,99.46
2021-03-02,Telangana,529,2,523,6200,2420,985,8.53,4,40.8,358182,3129,356255,5.93,2.41,0.15196078431372548,0.87,99.46
2021-03-03,Telangana,635,7,630,7941,2757,160,8.0,0,40.8,358817,3136,356885,6.76,0.39,0.19463235294117648,0.87,99.46
2021-03-04,Telangana,104,0,104,1510,2830,1566,6.89,0,40.8,358921,3136,356989,6.94,3.84,0.03700980392156863,0.87,99.46
2021-03-05,Telangana,1372,12,1370,17095,843,271,8.03,0,40.8,360293,3148,358359,2.07,0.66,0.4189950980392157,0.87,99.46
2021-03-06,Telangana,722,3,716,8691,4797,2699,8.31,3,40.8,361015,3151,359075,11.76,6.62,0.21301470588235294,0.87,99.46
2021-03-07,Telangana,1490,19,1490,18516,2523,1817,8.05,0,40.8,362505,3170,360565,6.18,4.45,0.4538235294117647,0.87,99.46
2021-03-08,Telangana,668,6,661,8735,3917,1689,7.65,1,40.8,363173,3176,361226,9.6,4.14,0.21409313725490195,0.87,99.46
2021-03-09,Telangana,484,4,483,6132,1966,1542,7.89,0,40.8,363657,3180,361709,4.82,3.78,0.15029411764705883,0.87,99.46
2021-03-10,Telangana,1236,13,1228,15263,1958,602,8.1,0,40.8,364893,3193,362937,4.8,1.48,0.37409313725490195,0.88,99.46
2021-03-11,Telangana,75,1,74,1347,2980,2832,5.57,0,40.8,364968,3194,363011,7.3,6.94,0.03301470588235294,0.88,99.46
2021-03-12,Telangana,756,9,752,9482,4989,624,7.97,0,40.8,365724,3203,363763,12.23,1.53,0.23240196078431372,0.88,99.46
2021-03-13,Telangana,1365,4,1358,17344,4457,3137,7.87,3,40.8,367089,3207,365121,10.92,7.69,0.4250980392156863,0.87,99.46
2021-03-14,Telangana,1190,9,1183,15156,3432,2854,7.85,0,40.8,368279,3216,366304,8.41,7.0,0.3714705882352941,0.87,99.46
2021-03-15,Telangana,1198,13,1189,14813,3206,1172,8.09,0,40.8,369477,3229,367493,7.86,2.87,0.36306372549019605,0.87,99.46
2021-03-16,Telangana,217,2,215,2590,2410,321,8.38,0,40.8,369694,3231,367708,5.91,0.79,0.06348039215686274,0.87,99.46
2021-03-17,Telangana,1288,16,1287,15975,631,389,8.06,0,40.8,370982,3247,368995,1.55,0.95,0.3915441176470588,0.88,99.46
2021-03-18,Telangana,1354,18,1353,16537,4396,3751,8.19,0,40.8,372336,3265,370348,10.77,9.19,0.4053186274509804,0.88,99.47
2021-03-19,Telangana,795,10,787,10169,3948,2548,7.82,0,40.8,373131,3275,371135,9.68,6.25,0.24924019607843137,0.88,99.47
2021-03-20,Telangana,163,2,162,1881,481,233,8.67,0,40.8,373294,3277,371297,1.18,0.57,0.04610294117647059,0.88,99.47
2021-03-21,Telangana,1064,10,1062,12966,2384,167,8.21,0,40.8,374358,3287,372359,5.84,0.41,0.31779411764705884,0.88,99.47
2021-03-22,Telangana,1451,17,1450,17941,3459,117,8.09,0,40.8,375809,3304,373809,8.48,0.29,0.43973039215686277,0.88,99.47
2021-03-23,Telangana,1493,18,1491,18423,2304,1335,8.1,0,40.8,377302,3322,375300,5.65,3.27,0.4515441176470588,0.88,99.47
2021-03-24,Telangana,146,0,145,1714,1417,599,8.52,1,40.8,377448,3322,375445,3.47,1.47,0.042009803921568625,0.88,99.47
2021-03-25,Telangana,857,11,851,10992,1129,213,7.8,0,40.8,378305,3333,376296,2.77,0.52,0.26941176470588235,0.88,99.47
2021-03-26,Telangana,673,5,667,7790,3825,2304,8.64,1,40.8,378978,3338,376963,9.38,5.65,0.1909313725490196,0.88,99.47
2021-03-27,Telangana,1394,20,1387,17602,1771,484,7.92,0,40.8,380372,3358,378350,4.34,1.19,0.43142156862745096,0.88,99.47
2021-03-28,Telangana,529,4,528,6358,4157,2989,8.32,0,40.8,380901,3362,378878,10.19,7.33,0.15583333333333332,0.88,99.47
2021-03-29,Telangana,746,4,742,9237,3462,2471,8.08,0,40.8,381647,3366,379620,8.49,6.06,0.22639705882352942,0.88,99.47
2021-03-30,Telangana,226,1,219,2660,3078,442,8.5,6,40.8,381873,3367,379839,7.54,1.08,0.06519607843137255,0.88,99.47
2021-03-31,Telangana,707,3,699,8552,1207,654,8.27,5,40.8,382580,3370,380538,2.96,1.6,0.2096078431372549,0.88,99.47
2021-04-01,Telangana,463,5,460,6067,3971,3876,7.63,0,40.8,383043,3375,380998,9.73,9.5,0.14870098039215687,0.88,99.47
2021-04-02,Telangana,895,7,887,10863,2589,165,8.24,1,40.8,383938,3382,381885,6.35,0.4,0.26625,0.88,99.47
2021-04-03,Telangana,941,9,934,11814,261,163,7.97,0,40.8,384879,3391,382819,0.64,0.4,0.28955882352941176,0.88,99.46
2021-04-04,Telangana,1120,9,1114,13988,1724,1638,8.01,0,40.8,385999,3400,383933,4.23,4.01,0.34284313725490195,0.88,99.46
2021-04-05,Telangana,1003,13,997,12513,541,40,8.02,0,40.8,387002,3413,384930,1.33,0.1,0.30669117647058824,0.88,99.46
2021-04-06,Telangana,1093,5,1085,13706,3623,3127,7.97,3,40.8,388095,3418,386015,8.88,7.66,0.3359313725490196,0.88,99.46
2021-04-07,Telangana,963,10,958,11820,4400,4101,8.15,0,40.8,389058,3428,386973,10.78,10.05,0.2897058823529412,0.88,99.46
2021-04-08,Telangana,711,4,709,9261,1923,1213,7.68,0,40.8,389769,3432,387682,4.71,2.97,0.22698529411764706,0.88,99.46
2021-04-09,Telangana,1542,14,1538,19733,1921,71,7.81,0,40.8,391311,3446,389220,4.71,0.17,0.4836519607843137,0.88,99.47
2021-04-10,Telangana,234,1,227,2864,3486,1258,8.17,6,40.8,391545,3447,389447,8.54,3.08,0.07019607843137254,0.88,99.46
2021-04-11,Telangana,1000,6,998,12120,2912,997,8.25,0,40.8,392545,3453,390445,7.14,2.44,0.29705882352941176,0.88,99.47
2021-04-12,Telangana,896,6,893,11219,4583,3296,7.99,0,40.8,393441,3459,391338,11.23,8.08,0.2749754901960784,0.88,99.47
2021-04-13,Telangana,1525,17,1524,18884,1987,1134,8.08,0,40.8,394966,3476,392862,4.87,2.78,0.46284313725490195,0.88,99.47
2021-04-14,Telangana,191,2,183,2552,4602,4194,7.48,6,40.8,395157,3478,393045,11.28,10.28,0.06254901960784313,0.88,99.47
2021-04-15,Telangana,141,1,141,1857,4753,441,7.59,0,40.8,395298,3479,393186,11.65,1.08,0.04551470588235294,0.88,99.47
2021-04-16,Telangana,276,2,271,3147,2794,1722,8.77,3,40.8,395574,3481,393457,6.85,4.22,0.07713235294117647,0.88,99.46
2021-04-17,Telangana,1228,10,1228,14860,300,273,8.26,0,40.8,396802,3491,394685,0.74,0.67,0.3642156862745098,0.88,99.47
2021-04-18,Telangana,1345,13,1344,16852,2445,420,7.98,0,40.8,398147,3504,396029,5.99,1.03,0.4130392156862745,0.88,99.47
2021-04-19,Telangana,726,7,720,9194,1985,1626,7.9,0,40.8,398873,3511,396749,4.87,3.99,0.22534313725490196,0.88,99.47
2021-04-20,Telangana,1103,3,1101,13543,1490,1312,8.14,0,40.8,399976,3514,397850,3.65,3.22,0.3319362745098039,0.88,99.47
2021-04-21,Telangana,1117,11,1116,13839,3477,3279,8.07,0,40.8,401093,3525,398966,8.52,8.04,0.3391911764705882,0.88,99.47
2021-04-22,Telangana,1354,19,1348,16698,211,17,8.11,0,40.8,402447,3544,400314,0.52,0.04,0.4092647058823529,0.88,99.47
2021-04-23,Telangana,1582,10,1579,19901,3766,2753,7.95,0,40.8,404029,3554,401893,9.23,6.75,0.4877696078431373,0.88,99.47
2021-04-24,Telangana,1196,8,1188,14907,4412,3680,8.02,0,40.8,405225,3562,403081,10.81,9.02,0.3653676470588235,0.88,99.47
2021-04-25,Telangana,1464,11,1456,18255,4146,3997,8.02,0,40.8,406689,3573,404537,10.16,9.8,0.4474264705882353,0.88,99.47
2021-04-26,Telangana,695,4,692,8260,2856,2573,8.41,0,40.8,407384,3577,405229,7.0,6.31,0.20245098039215687,0.88,99.47
2021-04-27,Telangana,439,1,433,5756,621,219,7.63,5,40.8,407823,3578,405662,1.52,0.54,0.14107843137254902,0.88,99.47
2021-04-28,Telangana,1278,14,1271,16092,238,204,7.94,0,40.8,409101,3592,406933,0.58,0.5,0.39441176470588235,0.88,99.47
2021-04-29,Telangana,1298,4,1296,16331,338,171,7.95,0,40.8,410399,3596,408229,0.83,0.42,0.40026960784313725,0.88,99.47
2021-04-30,Telangana,406,5,404,4853,1795,184,8.37,0,40.8,410805,3601,408633,4.4,0.45,0.11894607843137255,0.88,99.47
2021-05-01,Telangana,970,4,968,12370,1619,1264,7.84,0,40.8,411775,3605,409601,3.97,3.1,0.3031862745098039,0.88,99.47
2021-05-02,Telangana,959,3,959,12181,2659,103,7.87,0,40.8,412734,3608,410560,6.52,0.25,0.2985539215686275,0.87,99.47
2021-05-03,Telangana,583,7,576,7201,4123,528,8.1,0,40.8,413317,3615,411136,10.11,1.29,0.17649509803921568,0.87,99.47
2021-05-04,Telangana,503,6,503,6250,2860,1284,8.05,0,40.8,413820,3621,411639,7.01,3.15,0.15318627450980393,0.88,99.47
2021-05-05,Telangana,683,5,683,8510,1522,1023,8.03,0,40.8,414503,3626,412322,3.73,2.51,0.20857843137254903,0.87,99.47
2021-05-06,Telangana,759,2,750,9597,4410,1390,7.91,7,40.8,415262,3628,413072,10.81,3.41,0.23522058823529413,0.87,99.47
2021-05-07,Telangana,841,2,837,10058,1132,458,8.36,2,40.8,416103,3630,413909,2.77,1.12,0.24651960784313726,0.87,99.47
2021-05-08,Telangana,1247,4,1241,15536,3598,2923,8.03,2,40.8,417350,3634,415150,8.82,7.16,0.3807843137254902,0.87,99.47
2021-05-09,Telangana,314,1,309,4158,1272,305,7.55,4,40.8,417664,3635,415459,3.12,0.75,0.10191176470588235,0.87,99.47
2021-05-10,Telangana,1555,22,1552,19275,2935,179,8.07,0,40.8,419219,3657,417011,7.19,0.44,0.4724264705882353,0.87,99.47
2021-05-11,Telangana,386,1,377,4391,4999,1197,8.79,8,40.8,419605,3658,417388,12.25,2.93,0.10762254901960784,0.87,99.47
2021-05-12,Telangana,971,10,965,12164,1027,861,7.98,0,40.8,420576,3668,418353,2.52,2.11,0.2981372549019608,0.87,99.47
2021-05-13,Telangana,656,7,648,7873,1039,684,8.33,1,40.8,421232,3675,419001,2.55,1.68,0.1929656862745098,0.87,99.47
2021-05-14,Telangana,1083,5,1077,13484,1633,225,8.03,1,40.8,422315,3680,420078,4.0,0.55,0.3304901960784314,0.87,99.47
2021-05-15,Telangana,1579,10,1570,19199,2831,1778,8.22,0,40.8,423894,3690,421648,6.94,4.36,0.4705637254901961,0.87,99.47
2021-05-16,Telangana,303,3,302,4019,1681,433,7.54,0,40.8,424197,3693,421950,4.12,1.06,0.09850490196078432,0.87,99.47
2021-05-17,Telangana,1139,10,1138,14152,3484,2350,8.05,0,40.8,425336,3703,423088,8.54,5.76,0.3468627450980392,0.87,99.47
2021-05-18,Telangana,218,1,209,2686,1439,1227,8.12,8,40.8,425554,3704,423297,3.53,3.01,0.06583333333333333,0.87,99.47
2021-05-19,Telangana,738,10,737,9373,2613,302,7.87,0,40.8,426292,3714,424034,6.4,0.74,0.22973039215686275,0.87,99.47
2021-05-20,Telangana,1207,4,1206,15166,2527,226,7.96,0,40.8,427499,3718,425240,6.19,0.55,0.3717156862745098,0.87,99.47
2021-05-21,Telangana,146,1,143,1940,1434,610,7.53,2,40.8,427645,3719,425383,3.51,1.5,0.047549019607843135,0.87,99.47
2021-05-22,Telangana,161,2,156,2138,4500,3303,7.53,3,40.8,427806,3721,425539,11.03,8.1,0.05240196078431372,0.87,99.47
2021-05-23,Telangana,1207,4,1200,14760,676,49,8.18,3,40.8,429013,3725,426739,1.66,0.12,0.36176470588235293,0.87,99.47
2021-05-24,Telangana,921,3,914,11205,1002,756,8.22,4,40.8,429934,3728,427653,2.46,1.85,0.2746323529411765,0.87,99.47
2021-05-25,Telangana,964,6,964,11730,3012,1739,8.22,0,40.8,430898,3734,428617,7.38,4.26,0.2875,0.87,99.47
2021-05-26,Telangana,1065,14,1056,13748,3940,351,7.75,0,40.8,431963,3748,429673,9.66,0.86,0.3369607843137255,0.87,99.47
2021-05-27,Telangana,765,6,763,9896,86,4,7.73,0,40.8,432728,3754,430436,0.21,0.01,0.24254901960784314,0.87,99.47
2021-05-28,Telangana,375,2,373,4509,78,48,8.32,0,40.8,433103,3756,430809,0.19,0.12,0.11051470588235295,0.87,99.47
2021-05-29,Telangana,717,8,713,8920,3806,2722,8.04,0,40.8,433820,3764,431522,9.33,6.67,0.21862745098039216,0.87,99.47
2021-05-30,Telangana,527,5,526,6320,1867,208,8.34,0,40.8,434347,3769,432048,4.58,0.51,0.15490196078431373,0.87,99.47
2021-05-31,Telangana,660,6,651,8707,4711,4397,7.58,3,40.8,435007,3775,432699,11.55,10.78,0.21340686274509804,0.87,99.47
2021-06-01,Telangana,621,3,619,7816,1717,97,7.95,0,40.8,435628,3778,433318,4.21,0.24,0.19156862745098038,0.87,99.47
2021-06-02,Telangana,554,6,547,6288,1435,445,8.81,1,40.8,436182,3784,433865,3.52,1.09,0.15411764705882353,0.87,99.47
2021-06-03,Telangana,888,10,888,11765,2507,2126,7.55,0,40.8,437070,3794,434753,6.14,5.21,0.2883578431372549,0.87,99.47
2021-06-04,Telangana,717,3,708,9107,2550,1464,7.87,6,40.8,437787,3797,435461,6.25,3.59,0.22321078431372549,0.87,99.47
2021-06-05,Telangana,201,2,196,2560,3391,1938,7.85,3,40.8,437988,3799,435657,8.31,4.75,0.06274509803921569,0.87,99.47
2021-06-06,Telangana,1435,7,1433,17734,1036,463,8.09,0,40.8,439423,3806,437090,2.54,1.13,0.434656862745098,0.87,99.47
2021-06-07,Telangana,1180,12,1173,14876,792,754,7.93,0,40.8,440603,3818,438263,1.94,1.85,0.3646078431372549,0.87,99.47
2021-06-08,Telangana,815,10,815,10324,552,543,7.89,0,40.8,441418,3828,439078,1.35,1.33,0.2530392156862745,0.87,99.47
2021-06-09,Telangana,284,1,280,3742,4942,4540,7.59,3,40.8,441702,3829,439358,12.11,11.13,0.09171568627450981,0.87,99.47
2021-06-10,Telangana,364,3,357,4611,680,172,7.89,4,40.8,442066,3832,439715,1.67,0.42,0.11301470588235295,0.87,99.47
2021-06-11,Telangana,267,2,261,3333,1581,916,8.01,4,40.8,442333,3834,439976,3.88,2.25,0.08169117647058824,0.87,99.47
2021-06-12,Telangana,1226,4,1221,15438,3935,242,7.94,1,40.8,443559,3838,441197,9.64,0.59,0.37838235294117645,0.87,99.47
2021-06-13,Telangana,1304,9,1298,16352,4273,1518,7.97,0,40.8,444863,3847,442495,10.47,3.72,0.40078431372549017,0.86,99.47
2021-06-14,Telangana,1276,5,1273,15835,2325,1987,8.06,0,40.8,446139,3852,443768,5.7,4.87,0.3881127450980392,0.86,99.47
2021-06-15,Telangana,633,4,632,7899,3388,1731,8.01,0,40.8,446772,3856,444400,8.3,4.24,0.1936029411764706,0.86,99.47
2021-06-16,Telangana,763,11,755,9897,2693,538,7.71,0,40.8,447535,3867,445155,6.6,1.32,0.24257352941176472,0.86,99.47
2021-06-17,Telangana,1116,9,1114,14072,3361,1324,7.93,0,40.8,448651,3876,446269,8.24,3.25,0.34490196078431373,0.86,99.47
2021-06-18,Telangana,842,12,838,10925,795,119,7.71,0,40.8,449493,3888,447107,1.95,0.29,0.26776960784313725,0.86,99.47
2021-06-19,Telangana,516,5,514,6281,1829,1345,8.22,0,40.8,450009,3893,447621,4.48,3.3,0.15394607843137256,0.87,99.47
2021-06-20,Telangana,136,0,129,1679,1811,225,8.1,7,40.8,450145,3893,447750,4.44,0.55,0.041151960784313726,0.86,99.47
2021-06-21,Telangana,439,6,434,6005,114,81,7.31,0,40.8,450584,3899,448184,0.28,0.2,0.1471813725490196,0.87,99.47
2021-06-22,Telangana,1019,6,1012,12756,1652,500,7.99,1,40.8,451603,3905,449196,4.05,1.23,0.3126470588235294,0.86,99.47
2021-06-23,Telangana,1179,5,1170,14431,2999,1139,8.17,4,40.8,452782,3910,450366,7.35,2.79,0.35370098039215686,0.86,99.47
2021-06-24,Telangana,581,4,581,7497,4687,2052,7.75,0,40.8,453363,3914,450947,11.49,5.03,0.18375,0.86,99.47
2021-06-25,Telangana,665,9,657,8013,2532,548,8.3,0,40.8,454028,3923,451604,6.21,1.34,0.19639705882352942,0.86,99.47
2021-06-26,Telangana,511,3,508,6243,2702,1682,8.19,0,40.8,454539,3926,452112,6.62,4.12,0.15301470588235294,0.86,99.47
2021-06-27,Telangana,1070,7,1062,13877,3865,2682,7.71,1,40.8,455609,3933,453174,9.47,6.57,0.34012254901960787,0.86,99.47
2021-06-28,Telangana,1370,13,1364,16803,1446,1377,8.15,0,40.8,456979,3946,454538,3.54,3.38,0.41183823529411767,0.86,99.47
2021-06-29,Telangana,89,0,89,874,4250,1790,10.18,0,40.8,457068,3946,454627,10.42,4.39,0.021421568627450982,0.86,99.47
2021-06-30,Telangana,1119,12,1115,13588,1874,487,8.24,0,40.8,458187,3958,455742,4.59,1.19,0.33303921568627454,0.86,99.47
2021-07-01,Telangana,1170,3,1167,14656,2990,1065,7.98,0,40.8,459357,3961,456909,7.33,2.61,0.3592156862745098,0.86,99.47
2021-07-02,Telangana,877,9,869,10647,2884,307,8.24,0,40.8,460234,3970,457778,7.07,0.75,0.2609558823529412,0.86,99.47
2021-07-03,Telangana,1124,6,1124,14020,3290,1628,8.02,0,40.8,461358,3976,458902,8.06,3.99,0.34362745098039216,0.86,99.47
2021-07-04,Telangana,389,3,384,4907,4869,4175,7.93,2,40.8,461747,3979,459286,11.93,10.23,0.12026960784313726,0.86,99.47
2021-07-05,Telangana,933,7,933,12335,4032,369,7.56,0,40.8,462680,3986,460219,9.88,0.9,0.302328431372549,0.86,99.47
2021-07-06,Telangana,1218,13,1218,15240,2949,2291,7.99,0,40.8,463898,3999,461437,7.23,5.62,0.3735294117647059,0.86,99.47
2021-07-07,Telangana,200,2,193,2541,4187,1612,7.87,5,40.8,464098,4001,461630,10.26,3.95,0.06227941176470588,0.86,99.47
2021-07-08,Telangana,285,3,284,2957,1299,816,9.64,0,40.8,464383,4004,461914,3.18,2.0,0.07247549019607843,0.86,99.47
2021-07-09,Telangana,1155,10,1152,14775,2126,1705,7.82,0,40.8,465538,4014,463066,5.21,4.18,0.36213235294117646,0.86,99.47
2021-07-10,Telangana,1363,15,1355,17274,2169,1398,7.89,0,40.8,466901,4029,464421,5.32,3.43,0.4233823529411765,0.86,99.47
2021-07-11,Telangana,1472,9,1463,18410,2799,2729,8.0,0,40.8,468373,4038,465884,6.86,6.69,0.45122549019607844,0.86,99.47
2021-07-12,Telangana,1467,12,1459,18753,917,41,7.82,0,40.8,469840,4050,467343,2.25,0.1,0.4596323529411765,0.86,99.47
2021-07-13,Telangana,224,0,220,2859,3193,115,7.83,4,40.8,470064,4050,467563,7.83,0.28,0.0700735294117647,0.86,99.47
2021-07-14,Telangana,1516,10,1514,18722,4407,300,8.1,0,40.8,471580,4060,469077,10.8,0.74,0.45887254901960783,0.86,99.47
2021-07-15,Telangana,1566,6,1566,19392,1440,558,8.08,0,40.8,473146,4066,470643,3.53,1.37,0.4752941176470588,0.86,99.47
2021-07-16,Telangana,1401,10,1394,17138,2115,505,8.17,0,40.8,474547,4076,472037,5.18,1.24,0.42004901960784313,0.86,99.47
2021-07-17,Telangana,1567,20,1562,19344,3301,2649,8.1,0,40.8,476114,4096,473599,8.09,6.49,0.47411764705882353,0.86,99.47
2021-07-18,Telangana,1598,10,1594,19702,2856,864,8.11,0,40.8,477712,4106,475193,7.0,2.12,0.4828921568627451,0.86,99.47
2021-07-19,Telangana,665,4,656,8493,2416,729,7.83,5,40.8,478377,4110,475849,5.92,1.79,0.20816176470588235,0.86,99.47
2021-07-20,Telangana,1377,14,1370,17075,2184,1034,8.06,0,40.8,479754,4124,477219,5.35,2.53,0.4185049019607843,0.86,99.47
2021-07-21,Telangana,73,1,64,501,3627,2607,14.57,8,40.8,479827,4125,477283,8.89,6.39,0.012279411764705882,0.86,99.47
2021-07-22,Telangana,1018,6,1016,12927,3770,327,7.87,0,40.8,480845,4131,478299,9.24,0.8,0.31683823529411764,0.86,99.47
2021-07-23,Telangana,543,2,543,6834,4987,447,7.95,0,40.8,481388,4133,478842,12.22,1.1,0.1675,0.86,99.47
2021-07-24,Telangana,643,2,636,8202,3365,1264,7.84,5,40.8,482031,4135,479478,8.25,3.1,0.20102941176470587,0.86,99.47
2021-07-25,Telangana,1240,15,1235,15175,3163,115,8.17,0,40.8,483271,4150,480713,7.75,0.28,0.37193627450980393,0.86,99.47
2021-07-26,Telangana,1296,13,1293,16241,3313,1166,7.98,0,40.8,484567,4163,482006,8.12,2.86,0.3980637254901961,0.86,99.47
2021-07-27,Telangana,325,4,320,3971,3640,791,8.18,1,40.8,484892,4167,482326,8.92,1.94,0.09732843137254903,0.86,99.47
2021-07-28,Telangana,270,2,261,3658,3313,903,7.38,7,40.8,485162,4169,482587,8.12,2.21,0.08965686274509804,0.86,99.47
2021-07-29,Telangana,1271,9,1271,15991,1940,1354,7.95,0,40.8,486433,4178,483858,4.75,3.32,0.3919362745098039,0.86,99.47
2021-07-30,Telangana,1191,12,1191,14811,2049,1702,8.04,0,40.8,487624,4190,485049,5.02,4.17,0.36301470588235296,0.86,99.47
2021-07-31,Telangana,658,3,653,7901,4079,3293,8.33,2,40.8,488282,4193,485702,10.0,8.07,0.19365196078431374,0.86,99.47
2021-08-01,Telangana,1090,7,1084,13661,457,198,7.98,0,40.8,489372,4200,486786,1.12,0.49,0.33482843137254903,0.86,99.47
2021-08-02,Telangana,630,4,629,7733,4615,289,8.15,0,40.8,490002,4204,487415,11.31,0.71,0.1895343137254902,0.86,99.47
2021-08-03,Telangana,298,3,289,3692,1181,606,8.07,6,40.8,490300,4207,487704,2.89,1.49,0.09049019607843137,0.86,99.47
2021-08-04,Telangana,331,4,326,3858,749,318,8.58,1,40.8,490631,4211,488030,1.84,0.78,0.09455882352941176,0.86,99.47
2021-08-05,Telangana,768,6,761,9368,3075,1239,8.2,1,40.8,491399,4217,488791,7.54,3.04,0.2296078431372549,0.86,99.47
2021-08-06,Telangana,1323,17,1319,16628,4957,2480,7.96,0,40.8,492722,4234,490110,12.15,6.08,0.4075490196078431,0.86,99.47
2021-08-07,Telangana,99,1,97,1069,788,88,9.26,1,40.8,492821,4235,490207,1.93,0.22,0.02620098039215686,0.86,99.47
2021-08-08,Telangana,1534,8,1526,19257,1332,553,7.97,0,40.8,494355,4243,491733,3.26,1.36,0.47198529411764706,0.86,99.47
2021-08-09,Telangana,398,2,390,5155,2865,684,7.72,6,40.8,494753,4245,492123,7.02,1.68,0.12634803921568627,0.86,99.47
2021-08-10,Telangana,1197,17,1197,15336,2204,1013,7.81,0,40.8,495950,4262,493320,5.4,2.48,0.37588235294117645,0.86,99.47
2021-08-11,Telangana,881,5,872,10602,3440,2481,8.31,4,40.8,496831,4267,494192,8.43,6.08,0.25985294117647056,0.86,99.47
2021-08-12,Telangana,616,4,609,7882,3713,538,7.82,3,40.8,497447,4271,494801,9.1,1.32,0.1931862745098039,0.86,99.47
2021-08-13,Telangana,1247,11,1241,15053,2491,1773,8.28,0,40.8,498694,4282,496042,6.11,4.35,0.36894607843137256,0.86,99.47
2021-08-14,Telangana,1066,7,1066,13222,473,291,8.06,0,40.8,499760,4289,497108,1.16,0.71,0.3240686274509804,0.86,99.47
2021-08-15,Telangana,431,4,428,5156,2689,486,8.36,0,40.8,500191,4293,497536,6.59,1.19,0.12637254901960784,0.86,99.47
2021-08-16,Telangana,1284,10,1279,16314,1971,410,7.87,0,40.8,501475,4303,498815,4.83,1.0,0.3998529411764706,0.86,99.47
2021-08-17,Telangana,1225,6,1220,15286,2705,1467,8.01,0,40.8,502700,4309,500035,6.63,3.6,0.374656862745098,0.86,99.47
2021-08-18,Telangana,690,2,690,8334,812,197,8.28,0,40.8,503390,4311,500725,1.99,0.48,0.20426470588235293,0.86,99.47
2021-08-19,Telangana,719,7,715,9102,3470,2397,7.9,0,40.8,504109,4318,501440,8.5,5.88,0.22308823529411764,0.86,99.47
2021-08-20,Telangana,51,0,44,577,4222,2785,8.84,7,40.8,504160,4318,501484,10.35,6.83,0.014142156862745099,0.86,99.47
2021-08-21,Telangana,1517,11,1508,19029,4638,150,7.97,0,40.8,505677,4329,502992,11.37,0.37,0.4663970588235294,0.86,99.47
2021-08-22,Telangana,1434,15,1428,17713,2091,1679,8.1,0,40.8,507111,4344,504420,5.12,4.12,0.4341421568627451,0.86,99.47
2021-08-23,Telangana,1202,4,1196,15000,2954,1816,8.01,2,40.8,508313,4348,505616,7.24,4.45,0.36764705882352944,0.86,99.47
2021-08-24,Telangana,1073,7,1066,13385,3516,322,8.02,0,40.8,509386,4355,506682,8.62,0.79,0.3280637254901961,0.85,99.47
2021-08-25,Telangana,1426,15,1425,17851,3821,1411,7.99,0,40.8,510812,4370,508107,9.37,3.46,0.43752450980392155,0.86,99.47
2021-08-26,Telangana,970,13,966,12180,3749,2774,7.96,0,40.8,511782,4383,509073,9.19,6.8,0.2985294117647059,0.86,99.47
2021-08-27,Telangana,684,6,684,8445,23,7,8.1,0,40.8,512466,4389,509757,0.06,0.02,0.20698529411764705,0.86,99.47
2021-08-28,Telangana,231,0,228,2796,92,10,8.26,3,40.8,512697,4389,509985,0.23,0.02,0.06852941176470588,0.86,99.47
2021-08-29,Telangana,184,1,176,2405,715,483,7.65,7,40.8,512881,4390,510161,1.75,1.18,0.05894607843137255,0.86,99.47
2021-08-30,Telangana,368,5,365,4367,4567,1820,8.43,0,40.8,513249,4395,510526,11.19,4.46,0.1070343137254902,0.86,99.47
2021-08-31,Telangana,415,3,410,4841,1531,50,8.57,2,40.8,513664,4398,510936,3.75,0.12,0.11865196078431373,0.86,99.47
2021-09-01,Telangana,1076,13,1069,13836,519,281,7.78,0,40.8,514740,4411,512005,1.27,0.69,0.3391176470588235,0.86,99.47
2021-09-02,Telangana,117,1,109,1807,3605,2119,6.47,7,40.8,514857,4412,512114,8.84,5.19,0.04428921568627451,0.86,99.47
2021-09-03,Telangana,1267,10,1260,15770,825,734,8.03,0,40.8,516124,4422,513374,2.02,1.8,0.38651960784313727,0.86,99.47
2021-09-04,Telangana,692,3,692,8924,3062,2320,7.75,0,40.8,516816,4425,514066,7.5,5.69,0.21872549019607843,0.86,99.47
2021-09-05,Telangana,1018,7,1017,12924,2141,1972,7.88,0,40.8,517834,4432,515083,5.25,4.83,0.31676470588235295,0.86,99.47
2021-09-06,Telangana,640,6,638,8116,3528,1724,7.89,0,40.8,518474,4438,515721,8.65,4.23,0.19892156862745097,0.86,99.47
2021-09-07,Telangana,899,5,897,11243,3245,2554,8.0,0,40.8,519373,4443,516618,7.95,6.26,0.2755637254901961,0.86,99.47
2021-09-08,Telangana,532,2,528,6396,2296,755,8.32,2,40.8,519905,4445,517146,5.63,1.85,0.15676470588235294,0.85,99.47
2021-09-09,Telangana,935,13,926,11336,4118,1333,8.25,0,40.8,520840,4458,518072,10.09,3.27,0.27784313725490195,0.86,99.47
2021-09-10,Telangana,879,7,878,11047,4136,675,7.96,0,40.8,521719,4465,518950,10.14,1.65,0.2707598039215686,0.86,99.47
2021-09-11,Telangana,1405,12,1403,17601,1114,1081,7.98,0,40.8,523124,4477,520353,2.73,2.65,0.4313970588235294,0.86,99.47
2021-09-12,Telangana,1208,6,1206,15058,3124,2450,8.02,0,40.8,524332,4483,521559,7.66,6.0,0.3690686274509804,0.85,99.47
2021-09-13,Telangana,274,0,274,3497,4890,431,7.84,0,40.8,524606,4483,521833,11.99,1.06,0.08571078431372549,0.85,99.47
2021-09-14,Telangana,698,2,692,8940,2691,808,7.81,4,40.8,525304,4485,522525,6.6,1.98,0.21911764705882353,0.85,99.47
2021-09-15,Telangana,925,11,922,11987,3614,287,7.72,0,40.8,526229,4496,523447,8.86,0.7,0.29379901960784316,0.85,99.47
2021-09-16,Telangana,940,3,938,11987,3647,1797,7.84,0,40.8,527169,4499,524385,8.94,4.4,0.29379901960784316,0.85,99.47
2021-09-17,Telangana,349,4,347,4321,3436,1029,8.08,0,40.8,527518,4503,524732,8.42,2.52,0.10590686274509804,0.85,99.47
2021-09-18,Telangana,378,3,378,5104,2095,1416,7.41,0,40.8,527896,4506,525110,5.13,3.47,0.12509803921568627,0.85,99.47
2021-09-19,Telangana,300,2,299,3450,3983,2350,8.7,0,40.8,528196,4508,525409,9.76,5.76,0.08455882352941177,0.85,99.47
2021-09-20,Telangana,586,6,582,7385,159,47,7.94,0,40.8,528782,4514,525991,0.39,0.12,0.1810049019607843,0.85,99.47
2021-09-21,Telangana,1045,9,1040,12971,2676,1055,8.06,0,40.8,529827,4523,527031,6.56,2.59,0.3179166666666667,0.85,99.47
2021-09-22,Telangana,1073,10,1073,13307,32,8,8.06,0,40.8,530900,4533,528104,0.08,0.02,0.32615196078431374,0.85,99.47
2021-09-23,Telangana,423,6,423,5440,4911,1619,7.78,0,40.8,531323,4539,528527,12.04,3.97,0.13333333333333333,0.85,99.47
2021-09-24,Telangana,405,3,396,5475,53,46,7.4,6,40.8,531728,4542,528923,0.13,0.11,0.13419117647058823,0.85,99.47
2021-09-25,Telangana,1330,15,1326,16845,150,29,7.9,0,40.8,533058,4557,530249,0.37,0.07,0.4128676470588235,0.85,99.47
2021-09-26,Telangana,157,1,157,2096,2747,825,7.49,0,40.8,533215,4558,530406,6.73,2.02,0.05137254901960785,0.85,99.47
2021-09-27,Telangana,1241,17,1233,15399,50,48,8.06,0,40.8,534456,4575,531639,0.12,0.12,0.3774264705882353,0.86,99.47
2021-09-28,Telangana,104,0,100,1252,2685,2610,8.31,4,40.8,534560,4575,531739,6.58,6.4,0.03068627450980392,0.86,99.47
2021-09-29,Telangana,552,4,552,6744,1859,168,8.19,0,40.8,535112,4579,532291,4.56,0.41,0.1652941176470588,0.86,99.47
2021-09-30,Telangana,1423,6,1415,18199,2953,784,7.82,2,40.8,536535,4585,533706,7.24,1.92,0.44605392156862744,0.85,99.47
2021-10-01,Telangana,1361,8,1354,17231,1690,1352,7.9,0,40.8,537896,4593,535060,4.14,3.31,0.422328431372549,0.85,99.47
2021-10-02,Telangana,1101,5,1099,13474,638,401,8.17,0,40.8,538997,4598,536159,1.56,0.98,0.3302450980392157,0.85,99.47
2021-10-03,Telangana,547,4,545,6645,1915,1682,8.23,0,40.8,539544,4602,536704,4.69,4.12,0.16286764705882353,0.85,99.47
2021-10-04,Telangana,517,2,514,7040,2540,1274,7.34,1,40.8,540061,4604,537218,6.23,3.12,0.17254901960784313,0.85,99.47
2021-10-05,Telangana,1351,7,1342,16736,4797,258,8.07,2,40.8,541412,4611,538560,11.76,0.63,0.41019607843137257,0.85,99.47
2021-10-06,Telangana,919,9,912,11408,2345,322,8.06,0,40.8,542331,4620,539472,5.75,0.79,0.2796078431372549,0.85,99.47
2021-10-07,Telangana,616,7,612,8362,4570,2562,7.37,0,40.8,542947,4627,540084,11.2,6.28,0.20495098039215687,0.85,99.47
2021-10-08,Telangana,77,0,71,965,3380,261,7.98,6,40.8,543024,4627,540155,8.28,0.64,0.023651960784313725,0.85,99.47
2021-10-09,Telangana,770,8,763,9346,4990,3458,8.24,0,40.8,543794,4635,540918,12.23,8.48,0.2290686274509804,0.85,99.47
2021-10-10,Telangana,936,5,933,11736,953,397,7.98,0,40.8,544730,4640,541851,2.34,0.97,0.2876470588235294,0.85,99.47
2021-10-11,Telangana,624,6,620,7722,1819,254,8.08,0,40.8,545354,4646,542471,4.46,0.62,0.18926470588235295,0.85,99.47
2021-10-12,Telangana,1378,15,1376,17010,3866,1150,8.1,0,40.8,546732,4661,543847,9.48,2.82,0.41691176470588237,0.85,99.47
2021-10-13,Telangana,1023,15,1021,12804,3798,611,7.99,0,40.8,547755,4676,544868,9.31,1.5,0.3138235294117647,0.85,99.47
2021-10-14,Telangana,708,5,700,8958,3415,1230,7.9,3,40.8,548463,4681,545568,8.37,3.01,0.21955882352941178,0.85,99.47
2021-10-15,Telangana,310,4,304,3916,1903,1155,7.92,2,40.8,548773,4685,545872,4.66,2.83,0.09598039215686274,0.85,99.47
2021-10-16,Telangana,1326,13,1319,16838,796,22,7.88,0,40.8,550099,4698,547191,1.95,0.05,0.41269607843137257,0.85,99.47
2021-10-17,Telangana,483,5,482,5522,1779,1478,8.75,0,40.8,550582,4703,547673,4.36,3.62,0.13534313725490196,0.85,99.47
2021-10-18,Telangana,440,3,435,5631,2648,1028,7.81,2,40.8,551022,4706,548108,6.49,2.52,0.13801470588235293,0.85,99.47
2021-10-19,Telangana,287,3,287,4202,2184,495,6.83,0,40.8,551309,4709,548395,5.35,1.21,0.10299019607843138,0.85,99.47
2021-10-20,Telangana,1426,11,1418,17565,4408,1830,8.12,0,40.8,552735,4720,549813,10.8,4.49,0.43051470588235297,0.85,99.47
2021-10-21,Telangana,510,3,504,6845,166,53,7.45,3,40.8,553245,4723,550317,0.41,0.13,0.16776960784313724,0.85,99.47
2021-10-22,Telangana,667,4,665,8773,3672,213,7.6,0,40.8,553912,4727,550982,9.0,0.52,0.21502450980392157,0.85,99.47
2021-10-23,Telangana,1251,8,1244,15825,3502,3292,7.91,0,40.8,555163,4735,552226,8.58,8.07,0.38786764705882354,0.85,99.47
2021-10-24,Telangana,972,10,967,12110,3225,998,8.03,0,40.8,556135,4745,553193,7.9,2.45,0.2968137254901961,0.85,99.47
2021-10-25,Telangana,571,7,571,7302,4429,2974,7.82,0,40.8,556706,4752,553764,10.86,7.29,0.17897058823529413,0.85,99.47
2021-10-26,Telangana,978,2,972,12242,2280,1588,7.99,4,40.8,557684,4754,554736,5.59,3.89,0.30004901960784314,0.85,99.47
2021-10-27,Telangana,125,1,121,2044,464,220,6.12,3,40.8,557809,4755,554857,1.14,0.54,0.05009803921568627,0.85,99.47
2021-10-28,Telangana,1210,11,1207,15111,813,627,8.01,0,40.8,559019,4766,556064,1.99,1.54,0.3703676470588235,0.85,99.47
2021-10-29,Telangana,1322,12,1322,16611,3617,1926,7.96,0,40.8,560341,4778,557386,8.87,4.72,0.40713235294117645,0.85,99.47
2021-10-30,Telangana,703,4,697,8729,2224,1204,8.05,2,40.8,561044,4782,558083,5.45,2.95,0.21394607843137256,0.85,99.47
2021-10-31,Telangana,554,6,553,6794,1527,1081,8.15,0,40.8,561598,4788,558636,3.74,2.65,0.16651960784313727,0.85,99.47
2021-11-01,Telangana,190,0,183,2165,1475,1063,8.78,7,40.8,561788,4788,558819,3.62,2.61,0.05306372549019608,0.85,99.47
2021-11-02,Telangana,1541,18,1539,19331,2873,2425,7.97,0,40.8,563329,4806,560358,7.04,5.94,0.47379901960784315,0.85,99.47
2021-11-03,Telangana,76,0,75,763,3512,3235,9.96,1,40.8,563405,4806,560433,8.61,7.93,0.01870098039215686,0.85,99.47
2021-11-04,Telangana,565,7,564,6964,1851,737,8.11,0,40.8,563970,4813,560997,4.54,1.81,0.17068627450980392,0.85,99.47
2021-11-05,Telangana,476,3,470,6134,3753,3674,7.76,3,40.8,564446,4816,561467,9.2,9.0,0.15034313725490195,0.85,99.47
2021-11-06,Telangana,1592,23,1586,19920,2404,1316,7.99,0,40.8,566038,4839,563053,5.89,3.23,0.48823529411764705,0.85,99.47
2021-11-07,Telangana,1454,4,1448,18381,86,2,7.91,2,40.8,567492,4843,564501,0.21,0.0,0.45051470588235293,0.85,99.47
2021-11-08,Telangana,1027,13,1023,12573,251,86,8.17,0,40.8,568519,4856,565524,0.62,0.21,0.30816176470588236,0.85,99.47
2021-11-09,Telangana,1242,10,1233,15412,2460,141,8.06,0,40.8,569761,4866,566757,6.03,0.35,0.3777450980392157,0.85,99.47
2021-11-10,Telangana,603,8,598,7764,4568,531,7.77,0,40.8,570364,4874,567355,11.2,1.3,0.19029411764705884,0.85,99.47
2021-11-11,Telangana,180,2,171,2099,1456,488,8.58,7,40.8,570544,4876,567526,3.57,1.2,0.05144607843137255,0.85,99.47
2021-11-12,Telangana,30,0,26,795,4906,2586,3.77,4,40.8,570574,4876,567552,12.02,6.34,0.01948529411764706,0.85,99.47
2021-11-13,Telangana,45,0,36,654,1788,610,6.88,9,40.8,570619,4876,567588,4.38,1.5,0.016029411764705882,0.85,99.47
2021-11-14,Telangana,1127,13,1123,13695,3698,1758,8.23,0,40.8,571746,4889,568711,9.06,4.31,0.3356617647058823,0.86,99.47
2021-11-15,Telangana,1035,14,1028,13160,4939,4419,7.86,0,40.8,572781,4903,569739,12.11,10.83,0.32254901960784316,0.86,99.47
2021-11-16,Telangana,1065,14,1064,13212,1428,354,8.06,0,40.8,573846,4917,570803,3.5,0.87,0.32382352941176473,0.86,99.47
2021-11-17,Telangana,871,10,864,10297,4770,90,8.46,0,40.8,574717,4927,571667,11.69,0.22,0.25237745098039216,0.86,99.47
2021-11-18,Telangana,1409,13,1400,17540,200,186,8.03,0,40.8,576126,4940,573067,0.49,0.46,0.42990196078431375,0.86,99.47
2021-11-19,Telangana,673,9,669,8018,1465,235,8.39,0,40.8,576799,4949,573736,3.59,0.58,0.19651960784313727,0.86,99.47
2021-11-20,Telangana,1314,6,1314,16464,809,618,7.98,0,40.8,578113,4955,575050,1.98,1.51,0.40352941176470586,0.86,99.47
2021-11-21,Telangana,167,1,162,1895,4724,3777,8.81,4,40.8,578280,4956,575212,11.58,9.26,0.04644607843137255,0.86,99.47
2021-11-22,Telangana,1093,13,1087,13794,1284,332,7.92,0,40.8,579373,4969,576299,3.15,0.81,0.33808823529411763,0.86,99.47
2021-11-23,Telangana,437,2,428,5146,1225,211,8.49,7,40.8,579810,4971,576727,3.0,0.52,0.12612745098039216,0.86,99.47
2021-11-24,Telangana,1154,14,1145,14454,4007,3214,7.98,0,40.8,580964,4985,577872,9.82,7.88,0.3542647058823529,0.86,99.47
2021-11-25,Telangana,1315,11,1307,16270,965,126,8.08,0,40.8,582279,4996,579179,2.37,0.31,0.3987745098039216,0.86,99.47
2021-11-26,Telangana,184,0,176,2278,3198,1433,8.08,8,40.8,582463,4996,579355,7.84,3.51,0.05583333333333333,0.86,99.47
2021-11-27,Telangana,760,7,754,9248,151,48,8.22,0,40.8,583223,5003,580109,0.37,0.12,0.22666666666666666,0.86,99.47
2021-11-28,Telangana,99,1,90,1331,1740,1035,7.44,8,40.8,583322,5004,580199,4.26,2.54,0.032622549019607844,0.86,99.46
2021-11-29,Telangana,1587,8,1585,19732,211,88,8.04,0,40.8,584909,5012,581784,0.52,0.22,0.48362745098039217,0.86,99.47
2021-11-30,Telangana,1022,10,1015,13438,3320,135,7.61,0,40.8,585931,5022,582799,8.14,0.33,0.3293627450980392,0.86,99.47
2021-12-01,Telangana,624,5,622,8001,4292,2724,7.8,0,40.8,586555,5027,583421,10.52,6.68,0.1961029411764706,0.86,99.47
2021-12-02,Telangana,1363,18,1357,17083,882,709,7.98,0,40.8,587918,5045,584778,2.16,1.74,0.41870098039215686,0.86,99.47
2021-12-03,Telangana,589,3,586,7950,2605,2398,7.41,0,40.8,588507,5048,585364,6.38,5.88,0.1948529411764706,0.86,99.47
2021-12-04,Telangana,935,11,927,11833,1259,807,7.9,0,40.8,589442,5059,586291,3.09,1.98,0.2900245098039216,0.86,99.47
2021-12-05,Telangana,630,5,628,8316,2935,223,7.58,0,40.8,590072,5064,586919,7.19,0.55,0.2038235294117647,0.86,99.47
2021-12-06,Telangana,1393,18,1388,17483,578,317,7.97,0,40.8,591465,5082,588307,1.42,0.78,0.42850490196078433,0.86,99.47
2021-12-07,Telangana,410,4,408,4668,4522,4110,8.78,0,40.8,591875,5086,588715,11.08,10.07,0.11441176470588235,0.86,99.47
2021-12-08,Telangana,508,6,501,6475,3598,1149,7.85,1,40.8,592383,5092,589216,8.82,2.82,0.15870098039215685,0.86,99.47
2021-12-09,Telangana,659,2,657,7499,1427,144,8.79,0,40.8,593042,5094,589873,3.5,0.35,0.18379901960784314,0.86,99.47
2021-12-10,Telangana,190,2,187,2586,3718,2893,7.35,1,40.8,593232,5096,590060,9.11,7.09,0.06338235294117647,0.86,99.47
2021-12-11,Telangana,925,4,922,11226,48,14,8.24,0,40.8,594157,5100,590982,0.12,0.03,0.2751470588235294,0.86,99.47
2021-12-12,Telangana,1449,9,1446,18350,3945,1948,7.9,0,40.8,595606,5109,592428,9.67,4.77,0.4497549019607843,0.86,99.47
2021-12-13,Telangana,981,5,977,12028,2878,2100,8.16,0,40.8,596587,5114,593405,7.05,5.15,0.29480392156862745,0.86,99.47
2021-12-14,Telangana,425,5,423,5320,1623,53,7.99,0,40.8,597012,5119,593828,3.98,0.13,0.1303921568627451,0.86,99.47
2021-12-15,Telangana,1312,9,1305,16163,3061,2457,8.12,0,40.8,598324,5128,595133,7.5,6.02,0.39615196078431375,0.86,99.47
2021-12-16,Telangana,188,1,181,2309,1369,576,8.14,6,40.8,598512,5129,595314,3.36,1.41,0.05659313725490196,0.86,99.47
2021-12-17,Telangana,326,4,323,4062,4109,3953,8.03,0,40.8,598838,5133,595637,10.07,9.69,0.09955882352941177,0.86,99.47
2021-12-18,Telangana,1416,11,1408,17597,1639,709,8.05,0,40.8,600254,5144,597045,4.02,1.74,0.4312990196078431,0.86,99.47
2021-12-19,Telangana,980,10,975,12471,1476,564,7.86,0,40.8,601234,5154,598020,3.62,1.38,0.30566176470588236,0.86,99.47
2021-12-20,Telangana,969,7,963,12238,3119,693,7.92,0,40.8,602203,5161,598983,7.64,1.7,0.29995098039215684,0.86,99.47
2021-12-21,Telangana,1455,11,1449,18307,1327,311,7.95,0,40.8,603658,5172,600432,3.25,0.76,0.4487009803921569,0.86,99.47
2021-12-22,Telangana,1161,15,1153,14678,1821,94,7.91,0,40.8,604819,5187,601585,4.46,0.23,0.3597549019607843,0.86,99.47
2021-12-23,Telangana,521,7,520,6460,4361,2491,8.07,0,40.8,605340,5194,602105,10.69,6.11,0.15833333333333333,0.86,99.47
2021-12-24,Telangana,374,5,371,4924,2810,711,7.6,0,40.8,605714,5199,602476,6.89,1.74,0.12068627450980392,0.86,99.47
2021-12-25,Telangana,1026,5,1017,13380,1035,371,7.67,4,40.8,606740,5204,603493,2.54,0.91,0.32794117647058824,0.86,99.46
2021-12-26,Telangana,1244,16,1238,15178,807,451,8.2,0,40.8,607984,5220,604731,1.98,1.11,0.3720098039215686,0.86,99.46
2021-12-27,Telangana,1002,4,1002,12393,4585,2965,8.09,0,40.8,608986,5224,605733,11.24,7.27,0.30375,0.86,99.47
2021-12-28,Telangana,564,3,555,7235,2705,1934,7.8,6,40.8,609550,5227,606288,6.63,4.74,0.17732843137254903,0.86,99.46
2021-12-29,Telangana,655,9,654,8362,3695,3510,7.83,0,40.8,610205,5236,606942,9.06,8.6,0.20495098039215687,0.86,99.47
2021-12-30,Telangana,691,7,690,8572,792,691,8.06,0,40.8,610896,5243,607632,1.94,1.69,0.21009803921568626,0.86,99.47
2021-12-31,Telangana,409,3,402,5075,3601,519,8.06,4,40.8,611305,5246,608034,8.83,1.27,0.12438725490196079,0.86,99.46
2022-01-01,Telangana,901,5,892,11370,4479,3361,7.92,4,40.8,612206,5251,608926,10.98,8.24,0.2786764705882353,0.86,99.46
2022-01-02,Telangana,399,1,390,4841,891,860,8.24,8,40.8,612605,5252,609316,2.18,2.11,0.11865196078431373,0.86,99.46
2022-01-03,Telangana,729,5,728,8975,3299,2470,8.12,0,40.8,613334,5257,610044,8.09,6.05,0.21997549019607843,0.86,99.46
2022-01-04,Telangana,1233,13,1224,15141,2292,897,8.14,0,40.8,614567,5270,611268,5.62,2.2,0.3711029411764706,0.86,99.46
2022-01-05,Telangana,683,2,679,8977,1132,831,7.61,2,40.8,615250,5272,611947,2.77,2.04,0.22002450980392158,0.86,99.46
2022-01-06,Telangana,372,4,371,4643,4367,4164,8.01,0,40.8,615622,5276,612318,10.7,10.21,0.11379901960784314,0.86,99.46
2022-01-07,Telangana,74,0,74,951,103,87,7.78,0,40.8,615696,5276,612392,0.25,0.21,0.023308823529411764,0.86,99.46
2022-01-08,Telangana,496,6,495,6195,2753,821,8.01,0,40.8,616192,5282,612887,6.75,2.01,0.15183823529411763,0.86,99.46
2022-01-09,Telangana,510,1,503,6562,4595,3946,7.77,6,40.8,616702,5283,613390,11.26,9.67,0.16083333333333333,0.86,99.46
2022-01-10,Telangana,611,1,609,7464,1577,529,8.19,1,40.8,617313,5284,613999,3.87,1.3,0.18294117647058825,0.86,99.46
2022-01-11,Telangana,82,0,76,1389,1834,185,5.9,6,40.8,617395,5284,614075,4.5,0.45,0.03404411764705882,0.86,99.46
2022-01-12,Telangana,624,7,623,7850,2318,178,7.95,0,40.8,618019,5291,614698,5.68,0.44,0.19240196078431374,0.86,99.46
2022-01-13,Telangana,1039,7,1039,12504,1623,1436,8.31,0,40.8,619058,5298,615737,3.98,3.52,0.3064705882352941,0.86,99.46
2022-01-14,Telangana,433,6,428,5705,409,56,7.59,0,40.8,619491,5304,616165,1.0,0.14,0.13982843137254902,0.86,99.46
2022-01-15,Telangana,815,3,806,9835,3138,1732,8.29,6,40.8,620306,5307,616971,7.69,4.25,0.24105392156862746,0.86,99.46
2022-01-16,Telangana,494,6,493,6246,4971,1150,7.91,0,40.8,620800,5313,617464,12.18,2.82,0.15308823529411764,0.86,99.46
2022-01-17,Telangana,622,6,621,7881,3050,1580,7.89,0,40.8,621422,5319,618085,7.48,3.87,0.19316176470588237,0.86,99.46
2022-01-18,Telangana,292,4,288,3500,1353,772,8.34,0,40.8,621714,5323,618373,3.32,1.89,0.0857843137254902,0.86,99.46
2022-01-19,Telangana,1591,15,1587,19442,2553,1307,8.18,0,40.8,623305,5338,619960,6.26,3.2,0.47651960784313724,0.86,99.46
2022-01-20,Telangana,176,2,167,2032,2390,747,8.66,7,40.8,623481,5340,620127,5.86,1.83,0.04980392156862745,0.86,99.46
2022-01-21,Telangana,569,7,561,7155,4482,3058,7.95,1,40.8,624050,5347,620688,10.99,7.5,0.17536764705882352,0.86,99.46
2022-01-22,Telangana,721,9,713,8894,2051,67,8.11,0,40.8,624771,5356,621401,5.03,0.16,0.21799019607843137,0.86,99.46
2022-01-23,Telangana,863,3,857,10775,1552,1487,8.01,3,40.8,625634,5359,622258,3.8,3.64,0.26409313725490197,0.86,99.46
2022-01-24,Telangana,678,9,669,8744,2505,1569,7.75,0,40.8,626312,5368,622927,6.14,3.85,0.2143137254901961,0.86,99.46
2022-01-25,Telangana,1114,13,1114,13657,1615,1504,8.16,0,40.8,627426,5381,624041,3.96,3.69,0.33473039215686273,0.86,99.46
2022-01-26,Telangana,857,2,848,10786,2962,2381,7.95,7,40.8,628283,5383,624889,7.26,5.84,0.2643627450980392,0.86,99.46
2022-01-27,Telangana,1038,13,1036,13068,96,33,7.94,0,40.8,629321,5396,625925,0.24,0.08,0.32029411764705884,0.86,99.46
2022-01-28,Telangana,943,9,941,11734,4091,833,8.04,0,40.8,630264,5405,626866,10.03,2.04,0.2875980392156863,0.86,99.46
2022-01-29,Telangana,652,4,643,8761,4527,2982,7.44,5,40.8,630916,5409,627509,11.1,7.31,0.21473039215686274,0.86,99.46
2022-01-30,Telangana,1369,10,1367,17022,1751,1638,8.04,0,40.8,632285,5419,628876,4.29,4.01,0.4172058823529412,0.86,99.46
2022-01-31,Telangana,462,6,460,5791,2307,2306,7.98,0,40.8,632747,5425,629336,5.65,5.65,0.14193627450980392,0.86,99.46
2022-02-01,Telangana,857,5,853,10807,2583,1271,7.93,0,40.8,633604,5430,630189,6.33,3.12,0.26487745098039217,0.86,99.46
2022-02-02,Telangana,76,0,68,1018,3227,725,7.47,8,40.8,633680,5430,630257,7.91,1.78,0.024950980392156864,0.86,99.46
2022-02-03,Telangana,945,6,936,12230,4611,3722,7.73,3,40.8,634625,5436,631193,11.3,9.12,0.2997549019607843,0.86,99.46
2022-02-04,Telangana,699,3,693,8509,1541,445,8.21,3,40.8,635324,5439,631886,3.78,1.09,0.20855392156862745,0.86,99.46
2022-02-05,Telangana,1473,15,1473,18092,657,124,8.14,0,40.8,636797,5454,633359,1.61,0.3,0.4434313725490196,0.86,99.46
2022-02-06,Telangana,303,1,295,3451,4471,3802,8.78,7,40.8,637100,5455,633654,10.96,9.32,0.08458333333333333,0.86,99.46
2022-02-07,Telangana,668,6,660,8235,1610,322,8.11,2,40.8,637768,5461,634314,3.95,0.79,0.20183823529411765,0.86,99.46
2022-02-08,Telangana,598,3,591,7592,3416,688,7.88,4,40.8,638366,5464,634905,8.37,1.69,0.186078431372549,0.86,99.46
2022-02-09,Telangana,1126,7,1120,13819,2751,1165,8.15,0,40.8,639492,5471,636025,6.74,2.86,0.33870098039215685,0.86,99.46
2022-02-10,Telangana,1601,22,1598,19866,1859,948,8.06,0,40.8,641093,5493,637623,4.56,2.32,0.4869117647058824,0.86,99.46
2022-02-11,Telangana,1202,5,1199,14959,1293,57,8.04,0,40.8,642295,5498,638822,3.17,0.14,0.3666421568627451,0.86,99.46
2022-02-12,Telangana,942,7,936,11491,2648,663,8.2,0,40.8,643237,5505,639758,6.49,1.62,0.2816421568627451,0.86,99.46
2022-02-13,Telangana,598,8,595,7486,332,317,7.99,0,40.8,643835,5513,640353,0.81,0.78,0.18348039215686274,0.86,99.46
2022-02-14,Telangana,1130,8,1130,14052,4959,4726,8.04,0,40.8,644965,5521,641483,12.15,11.58,0.34441176470588236,0.86,99.46
2022-02-15,Telangana,256,2,255,3050,2229,1718,8.39,0,40.8,645221,5523,641738,5.46,4.21,0.07475490196078431,0.86,99.46
2022-02-16,Telangana,511,4,503,6468,1306,1121,7.9,4,40.8,645732,5527,642241,3.2,2.75,0.1585294117647059,0.86,99.46
2022-02-17,Telangana,1392,14,1391,17194,3317,2846,8.1,0,40.8,647124,5541,643632,8.13,6.98,0.421421568627451,0.86,99.46
2022-02-18,Telangana,307,2,298,3765,3576,874,8.15,7,40.8,647431,5543,643930,8.76,2.14,0.09227941176470589,0.86,99.46
2022-02-19,Telangana,1332,18,1331,16370,4541,1373,8.14,0,40.8,648763,5561,645261,11.13,3.37,0.40122549019607845,0.86,99.46
2022-02-20,Telangana,1523,15,1515,19230,1883,876,7.92,0,40.8,650286,5576,646776,4.62,2.15,0.4713235294117647,0.86,99.46
2022-02-21,Telangana,1126,10,1124,14100,1106,136,7.99,0,40.8,651412,5586,647900,2.71,0.33,0.34558823529411764,0.86,99.46
2022-02-22,Telangana,107,0,100,1664,553,343,6.43,7,40.8,651519,5586,648000,1.36,0.84,0.0407843137254902,0.86,99.46
2022-02-23,Telangana,1430,16,1425,18085,2908,2424,7.91,0,40.8,652949,5602,649425,7.13,5.94,0.4432598039215686,0.86,99.46
2022-02-24,Telangana,474,1,466,5551,3787,1678,8.54,7,40.8,653423,5603,649891,9.28,4.11,0.13605392156862745,0.86,99.46
2022-02-25,Telangana,545,6,537,7189,12,2,7.58,2,40.8,653968,5609,650428,0.03,0.0,0.17620098039215687,0.86,99.46
2022-02-26,Telangana,176,0,175,2292,1377,3,7.68,1,40.8,654144,5609,650603,3.38,0.01,0.05617647058823529,0.86,99.46
2022-02-27,Telangana,465,2,462,5521,3293,2253,8.42,1,40.8,654609,5611,651065,8.07,5.52,0.1353186274509804,0.86,99.46
2022-02-28,Telangana,1252,9,1251,15832,2151,1232,7.91,0,40.8,655861,5620,652316,5.27,3.02,0.38803921568627453,0.86,99.46
2022-03-01,Telangana,952,9,943,12509,4061,3214,7.61,0,40.8,656813,5629,653259,9.95,7.88,0.30659313725490195,0.86,99.46
2022-03-02,Telangana,965,11,960,12416,1966,1098,7.77,0,40.8,657778,5640,654219,4.82,2.69,0.3043137254901961,0.86,99.46
2022-03-03,Telangana,725,8,723,9336,4176,1398,7.77,0,40.8,658503,5648,654942,10.24,3.43,0.2288235294117647,0.86,99.46
2022-03-04,Telangana,718,6,716,8940,3650,3344,8.03,0,40.8,659221,5654,655658,8.95,8.2,0.21911764705882353,0.86,99.46
2022-03-05,Telangana,1045,3,1041,13477,2615,1740,7.75,1,40.8,660266,5657,656699,6.41,4.26,0.3303186274509804,0.86,99.46
2022-03-06,Telangana,534,7,534,6676,3160,671,8.0,0,40.8,660800,5664,657233,7.75,1.64,0.16362745098039216,0.86,99.46
2022-03-07,Telangana,1357,6,1352,17099,1505,204,7.94,0,40.8,662157,5670,658585,3.69,0.5,0.41909313725490194,0.86,99.46
2022-03-08,Telangana,443,4,435,5303,2327,1763,8.35,4,40.8,662600,5674,659020,5.7,4.32,0.12997549019607843,0.86,99.46
2022-03-09,Telangana,1507,16,1500,19201,4587,3511,7.85,0,40.8,664107,5690,660520,11.24,8.61,0.47061274509803924,0.86,99.46
2022-03-10,Telangana,628,5,627,8157,4601,228,7.7,0,40.8,664735,5695,661147,11.28,0.56,0.1999264705882353,0.86,99.46
2022-03-11,Telangana,681,2,678,8219,3606,1485,8.29,1,40.8,665416,5697,661825,8.84,3.64,0.20144607843137255,0.86,99.46
2022-03-12,Telangana,257,2,249,3342,3629,2305,7.69,6,40.8,665673,5699,662074,8.89,5.65,0.08191176470588235,0.86,99.46
2022-03-13,Telangana,925,13,923,11324,3924,3206,8.17,0,40.8,666598,5712,662997,9.62,7.86,0.2775490196078431,0.86,99.46
2022-03-14,Telangana,1506,15,1503,18875,3387,834,7.98,0,40.8,668104,5727,664500,8.3,2.04,0.46262254901960786,0.86,99.46
2022-03-15,Telangana,1081,8,1078,13072,872,433,8.27,0,40.8,669185,5735,665578,2.14,1.06,0.3203921568627451,0.86,99.46
2022-03-16,Telangana,141,1,132,2166,1831,1674,6.51,8,40.8,669326,5736,665710,4.49,4.1,0.053088235294117644,0.86,99.46
2022-03-17,Telangana,696,10,688,8530,4760,3778,8.16,0,40.8,670022,5746,666398,11.67,9.26,0.2090686274509804,0.86,99.46
2022-03-18,Telangana,1505,10,1500,18541,3716,2301,8.12,0,40.8,671527,5756,667898,9.11,5.64,0.4544362745098039,0.86,99.46
2022-03-19,Telangana,399,3,396,4998,226,67,7.98,0,40.8,671926,5759,668294,0.55,0.16,0.1225,0.86,99.46
2022-03-20,Telangana,1299,5,1297,15988,1446,256,8.12,0,40.8,673225,5764,669591,3.54,0.63,0.3918627450980392,0.86,99.46
2022-03-21,Telangana,1535,13,1526,19349,1602,99,7.93,0,40.8,674760,5777,671117,3.93,0.24,0.4742401960784314,0.86,99.46
2022-03-22,Telangana,1493,20,1488,18630,979,515,8.01,0,40.8,676253,5797,672605,2.4,1.26,0.4566176470588235,0.86,99.46
2022-03-23,Telangana,1207,9,1200,14878,29,12,8.11,0,40.8,677460,5806,673805,0.07,0.03,0.36465686274509806,0.86,99.46
2022-03-24,Telangana,282,4,277,3589,416,302,7.86,1,40.8,677742,5810,674082,1.02,0.74,0.0879656862745098,0.86,99.46
2022-03-25,Telangana,540,4,534,6866,4170,1238,7.86,2,40.8,678282,5814,674616,10.22,3.03,0.1682843137254902,0.86,99.46
2022-03-26,Telangana,801,6,798,10067,3657,794,7.96,0,40.8,679083,5820,675414,8.96,1.95,0.24674019607843137,0.86,99.46
2022-03-27,Telangana,1229,6,1227,15344,3290,212,8.01,0,40.8,680312,5826,676641,8.06,0.52,0.37607843137254904,0.86,99.46
2022-03-28,Telangana,1449,17,1447,18548,3423,2317,7.81,0,40.8,681761,5843,678088,8.39,5.68,0.4546078431372549,0.86,99.46
2022-03-29,Telangana,912,10,910,11320,2884,1576,8.06,0,40.8,682673,5853,678998,7.07,3.86,0.2774509803921569,0.86,99.46
2022-03-30,Telangana,1047,14,1038,12796,3197,2283,8.18,0,40.8,683720,5867,680036,7.84,5.6,0.31362745098039213,0.86,99.46
2022-03-31,Telangana,1056,9,1055,13502,3052,1107,7.82,0,40.8,684776,5876,681091,7.48,2.71,0.3309313725490196,0.86,99.46
2022-04-01,Telangana,825,6,817,10005,435,13,8.25,2,40.8,685601,5882,681908,1.07,0.03,0.2452205882352941,0.86,99.46
2022-04-02,Telangana,1387,14,1386,17431,2589,337,7.96,0,40.8,686988,5896,683294,6.35,0.83,0.42723039215686276,0.86,99.46
2022-04-03,Telangana,551,3,543,7115,4623,4116,7.74,5,40.8,687539,5899,683837,11.33,10.09,0.17438725490196078,0.86,99.46
2022-04-04,Telangana,377,2,370,5137,2546,1151,7.34,5,40.8,687916,5901,684207,6.24,2.82,0.12590686274509805,0.86,99.46
2022-04-05,Telangana,840,6,839,10582,533,504,7.94,0,40.8,688756,5907,685046,1.31,1.24,0.2593627450980392,0.86,99.46
2022-04-06,Telangana,1246,8,1245,15268,1136,234,8.16,0,40.8,690002,5915,686291,2.78,0.57,0.3742156862745098,0.86,99.46
2022-04-07,Telangana,147,1,139,1756,2946,531,8.37,7,40.8,690149,5916,686430,7.22,1.3,0.04303921568627451,0.86,99.46
2022-04-08,Telangana,949,5,943,11731,1887,1053,8.09,1,40.8,691098,5921,687373,4.62,2.58,0.2875245098039216,0.86,99.46
2022-04-09,Telangana,157,0,148,1862,3585,1993,8.43,9,40.8,691255,5921,687521,8.79,4.88,0.045637254901960786,0.86,99.46
2022-04-10,Telangana,1129,7,1121,13678,3017,1328,8.25,1,40.8,692384,5928,688642,7.39,3.25,0.3352450980392157,0.86,99.46
2022-04-11,Telangana,424,2,423,5402,4301,644,7.85,0,40.8,692808,5930,689065,10.54,1.58,0.13240196078431374,0.86,99.46
2022-04-12,Telangana,1610,14,1605,19428,2864,2831,8.29,0,40.8,694418,5944,690670,7.02,6.94,0.4761764705882353,0.86,99.46
2022-04-13,Telangana,916,9,907,11456,904,201,8.0,0,40.8,695334,5953,691577,2.22,0.49,0.2807843137254902,0.86,99.46
2022-04-14,Telangana,1256,18,1252,15659,2500,28,8.02,0,40.8,696590,5971,692829,6.13,0.07,0.38379901960784313,0.86,99.46
2022-04-15,Telangana,744,10,740,9391,872,266,7.92,0,40.8,697334,5981,693569,2.14,0.65,0.23017156862745097,0.86,99.46
2022-04-16,Telangana,605,5,603,7666,2597,29,7.89,0,40.8,697939,5986,694172,6.37,0.07,0.1878921568627451,0.86,99.46
2022-04-17,Telangana,926,9,924,11883,3653,2556,7.79,0,40.8,698865,5995,695096,8.95,6.26,0.29125,0.86,99.46
2022-04-18,Telangana,111,1,105,1666,2298,1296,6.66,5,40.8,698976,5996,695201,5.63,3.18,0.04083333333333333,0.86,99.46
2022-04-19,Telangana,1335,5,1327,16918,2354,1413,7.89,3,40.8,700311,6001,696528,5.77,3.46,0.41465686274509805,0.86,99.46
2022-04-20,Telangana,296,4,292,3749,2855,141,7.9,0,40.8,700607,6005,696820,7.0,0.35,0.09188725490196079,0.86,99.46
2022-04-21,Telangana,1465,9,1464,18656,1205,198,7.85,0,40.8,702072,6014,698284,2.95,0.49,0.45725490196078433,0.86,99.46
2022-04-22,Telangana,1231,8,1222,15873,4497,3162,7.76,1,40.8,703303,6022,699506,11.02,7.75,0.3890441176470588,0.86,99.46
2022-04-23,Telangana,929,8,928,11833,1079,404,7.85,0,40.8,704232,6030,700434,2.64,0.99,0.2900245098039216,0.86,99.46
2022-04-24,Telangana,543,6,536,6828,2147,274,7.95,1,40.8,704775,6036,700970,5.26,0.67,0.1673529411764706,0.86,99.46
2022-04-25,Telangana,317,3,316,3713,1529,1037,8.54,0,40.8,705092,6039,701286,3.75,2.54,0.09100490196078431,0.86,99.46
2022-04-26,Telangana,1078,8,1076,13269,3861,906,8.12,0,40.8,706170,6047,702362,9.46,2.22,0.3252205882352941,0.86,99.46
2022-04-27,Telangana,775,7,770,9622,334,196,8.05,0,40.8,706945,6054,703132,0.82,0.48,0.23583333333333334,0.86,99.46
2022-04-28,Telangana,1063,11,1062,13216,1802,830,8.04,0,40.8,708008,6065,704194,4.42,2.03,0.323921568627451,0.86,99.46
2022-04-29,Telangana,148,0,145,2079,809,70,7.12,3,40.8,708156,6065,704339,1.98,0.17,0.05095588235294118,0.86,99.46
2022-04-30,Telangana,987,4,978,13054,2968,548,7.56,5,40.8,709143,6069,705317,7.27,1.34,0.31995098039215686,0.86,99.46
2022-05-01,Telangana,1352,9,1350,16601,1802,359,8.14,0,40.8,710495,6078,706667,4.42,0.88,0.40688725490196076,0.86,99.46
2022-05-02,Telangana,1174,15,1173,14966,632,366,7.84,0,40.8,711669,6093,707840,1.55,0.9,0.3668137254901961,0.86,99.46
2022-05-03,Telangana,605,5,597,7550,340,281,8.01,3,40.8,712274,6098,708437,0.83,0.69,0.18504901960784315,0.86,99.46
2022-05-04,Telangana,1155,11,1150,14727,3820,1180,7.84,0,40.8,713429,6109,709587,9.36,2.89,0.3609558823529412,0.86,99.46
2022-05-05,Telangana,1336,7,1335,16578,4196,4040,8.06,0,40.8,714765,6116,710922,10.28,9.9,0.4063235294117647,0.86,99.46
2022-05-06,Telangana,831,3,830,10224,3558,2004,8.13,0,40.8,715596,6119,711752,8.72,4.91,0.25058823529411767,0.86,99.46
2022-05-07,Telangana,1343,7,1334,17042,3837,1528,7.88,2,40.8,716939,6126,713086,9.4,3.75,0.4176960784313726,0.85,99.46
2022-05-08,Telangana,1066,7,1065,13183,231,73,8.09,0,40.8,718005,6133,714151,0.57,0.18,0.3231127450980392,0.85,99.46
2022-05-09,Telangana,1074,5,1068,13438,3451,317,7.99,1,40.8,719079,6138,715219,8.46,0.78,0.3293627450980392,0.85,99.46
2022-05-10,Telangana,1079,11,1074,13324,860,667,8.1,0,40.8,720158,6149,716293,2.11,1.63,0.3265686274509804,0.85,99.46
2022-05-11,Telangana,1408,8,1401,17359,3948,295,8.11,0,40.8,721566,6157,717694,9.68,0.72,0.4254656862745098,0.85,99.46
2022-05-12,Telangana,1353,6,1352,16837,62,39,8.04,0,40.8,722919,6163,719046,0.15,0.1,0.41267156862745097,0.85,99.46
2022-05-13,Telangana,221,2,215,2835,4316,3173,7.8,4,40.8,723140,6165,719261,10.58,7.78,0.06948529411764706,0.85,99.46
2022-05-14,Telangana,212,3,209,2422,978,137,8.75,0,40.8,723352,6168,719470,2.4,0.34,0.05936274509803922,0.85,99.46
2022-05-15,Telangana,1346,5,1342,16867,2577,789,7.98,0,40.8,724698,6173,720812,6.32,1.93,0.413406862745098,0.85,99.46
2022-05-16,Telangana,1302,5,1296,15813,2529,2081,8.23,1,40.8,726000,6178,722108,6.2,5.1,0.3875735294117647,0.85,99.46
2022-05-17,Telangana,1424,13,1423,17677,3201,1729,8.06,0,40.8,727424,6191,723531,7.85,4.24,0.43325980392156865,0.85,99.46
2022-05-18,Telangana,925,8,924,11109,4114,759,8.33,0,40.8,728349,6199,724455,10.08,1.86,0.2722794117647059,0.85,99.47
2022-05-19,Telangana,1463,16,1461,18551,4585,2568,7.89,0,40.8,729812,6215,725916,11.24,6.29,0.4546813725490196,0.85,99.47
2022-05-20,Telangana,1455,13,1447,17785,3084,2174,8.18,0,40.8,731267,6228,727363,7.56,5.33,0.43590686274509804,0.85,99.47
2022-05-21,Telangana,1464,15,1458,18172,1769,447,8.06,0,40.8,732731,6243,728821,4.34,1.1,0.4453921568627451,0.85,99.47
2022-05-22,Telangana,1270,13,1264,16016,2486,1687,7.93,0,40.8,734001,6256,730085,6.09,4.13,0.39254901960784316,0.85,99.47
2022-05-23,Telangana,1511,19,1509,19124,2804,2739,7.9,0,40.8,735512,6275,731594,6.87,6.71,0.46872549019607845,0.85,99.47
2022-05-24,Telangana,1485,20,1484,18992,359,72,7.82,0,40.8,736997,6295,733078,0.88,0.18,0.4654901960784314,0.85,99.47
2022-05-25,Telangana,731,9,730,8660,4786,4350,8.44,0,40.8,737728,6304,733808,11.73,10.66,0.2122549019607843,0.85,99.47
2022-05-26,Telangana,1248,13,1247,15392,388,283,8.11,0,40.8,738976,6317,735055,0.95,0.69,0.3772549019607843,0.85,99.47
2022-05-27,Telangana,326,1,317,4066,3858,2459,8.02,8,40.8,739302,6318,735372,9.46,6.03,0.09965686274509804,0.85,99.47
2022-05-28,Telangana,183,2,178,2415,4473,688,7.58,3,40.8,739485,6320,735550,10.96,1.69,0.05919117647058823,0.85,99.47
2022-05-29,Telangana,1381,14,1378,17075,2200,1929,8.09,0,40.8,740866,6334,736928,5.39,4.73,0.4185049019607843,0.85,99.47
2022-05-30,Telangana,1285,19,1279,16249,556,526,7.91,0,40.8,742151,6353,738207,1.36,1.29,0.3982598039215686,0.86,99.47
2022-05-31,Telangana,525,5,525,6777,4231,2866,7.75,0,40.8,742676,6358,738732,10.37,7.02,0.1661029411764706,0.86,99.47
2022-06-01,Telangana,70,0,62,1039,1886,356,6.74,8,40.8,742746,6358,738794,4.62,0.87,0.025465686274509805,0.86,99.47
2022-06-02,Telangana,1272,18,1271,15781,2303,493,8.06,0,40.8,744018,6376,740065,5.64,1.21,0.3867892156862745,0.86,99.47
2022-06-03,Telangana,914,4,914,11390,3074,91,8.02,0,40.8,744932,6380,740979,7.53,0.22,0.2791666666666667,0.86,99.47
2022-06-04,Telangana,1520,6,1512,18999,2622,2472,8.0,2,40.8,746452,6386,742491,6.43,6.06,0.46566176470588233,0.86,99.47
2022-06-05,Telangana,1078,7,1071,13710,4332,1770,7.86,0,40.8,747530,6393,743562,10.62,4.34,0.3360294117647059,0.86,99.47
2022-06-06,Telangana,1487,14,1482,18428,3729,3430,8.07,0,40.8,749017,6407,745044,9.14,8.41,0.45166666666666666,0.86,99.47
2022-06-07,Telangana,358,3,357,4241,3524,2519,8.44,0,40.8,749375,6410,745401,8.64,6.17,0.10394607843137255,0.86,99.47
2022-06-08,Telangana,490,3,488,6185,1857,326,7.92,0,40.8,749865,6413,745889,4.55,0.8,0.15159313725490195,0.86,99.47
2022-06-09,Telangana,884,13,878,11018,1020,941,8.02,0,40.8,750749,6426,746767,2.5,2.31,0.2700490196078431,0.86,99.47
2022-06-10,Telangana,682,7,682,8321,2054,1763,8.2,0,40.8,751431,6433,747449,5.03,4.32,0.20394607843137255,0.86,99.47
2022-06-11,Telangana,1045,8,1045,12908,2592,1127,8.1,0,40.8,752476,6441,748494,6.35,2.76,0.3163725490196078,0.86,99.47
2022-06-12,Telangana,499,6,499,5952,4223,599,8.38,0,40.8,752975,6447,748993,10.35,1.47,0.14588235294117646,0.86,99.47
2022-06-13,Telangana,1529,14,1529,19196,4775,4165,7.97,0,40.8,754504,6461,750522,11.7,10.21,0.4704901960784314,0.86,99.47
2022-06-14,Telangana,372,5,372,4936,4784,492,7.54,0,40.8,754876,6466,750894,11.73,1.21,0.12098039215686275,0.86,99.47
2022-06-15,Telangana,1057,15,1048,13302,3077,2290,7.95,0,40.8,755933,6481,751942,7.54,5.61,0.3260294117647059,0.86,99.47
2022-06-16,Telangana,1057,6,1053,12980,4080,827,8.14,0,40.8,756990,6487,752995,10.0,2.03,0.31813725490196076,0.86,99.47
2022-06-17,Telangana,827,5,825,10090,3532,1399,8.2,0,40.8,757817,6492,753820,8.66,3.43,0.24730392156862746,0.86,99.47
2022-06-18,Telangana,544,6,536,6574,4932,3789,8.28,2,40.8,758361,6498,754356,12.09,9.29,0.16112745098039216,0.86,99.47
2022-06-19,Telangana,884,3,876,11356,2202,2182,7.78,5,40.8,759245,6501,755232,5.4,5.35,0.2783333333333333,0.86,99.47
2022-06-20,Telangana,598,4,591,7726,290,53,7.74,3,40.8,759843,6505,755823,0.71,0.13,0.18936274509803921,0.86,99.47
2022-06-21,Telangana,1440,8,1437,17844,913,609,8.07,0,40.8,761283,6513,757260,2.24,1.49,0.4373529411764706,0.86,99.47
2022-06-22,Telangana,1443,12,1443,18471,2767,2676,7.81,0,40.8,762726,6525,758703,6.78,6.56,0.4527205882352941,0.86,99.47
2022-06-23,Telangana,1367,5,1367,17684,3635,3557,7.73,0,40.8,764093,6530,760070,8.91,8.72,0.4334313725490196,0.85,99.47
2022-06-24,Telangana,657,5,648,8068,4269,1904,8.14,4,40.8,764750,6535,760718,10.46,4.67,0.1977450980392157,0.85,99.47
2022-06-25,Telangana,250,3,249,3285,3363,1032,7.61,0,40.8,765000,6538,760967,8.24,2.53,0.08051470588235295,0.85,99.47
2022-06-26,Telangana,880,4,875,10504,748,683,8.38,1,40.8,765880,6542,761842,1.83,1.67,0.25745098039215686,0.85,99.47
2022-06-27,Telangana,1376,16,1374,16965,2397,2337,8.11,0,40.8,767256,6558,763216,5.88,5.73,0.4158088235294118,0.85,99.47
2022-06-28,Telangana,1543,9,1541,19132,4039,626,8.07,0,40.8,768799,6567,764757,9.9,1.53,0.468921568627451,0.85,99.47
2022-06-29,Telangana,755,10,748,9279,1493,865,8.14,0,40.8,769554,6577,765505,3.66,2.12,0.22742647058823529,0.85,99.47
2022-06-30,Telangana,621,5,612,7524,591,401,8.25,4,40.8,770175,6582,766117,1.45,0.98,0.18441176470588236,0.85,99.47
2022-07-01,Telangana,380,3,378,4740,3173,110,8.02,0,40.8,770555,6585,766495,7.78,0.27,0.1161764705882353,0.85,99.47
2022-07-02,Telangana,550,2,543,7313,291,48,7.52,5,40.8,771105,6587,767038,0.71,0.12,0.17924019607843136,0.85,99.47
2022-07-03,Telangana,558,3,555,6467,1385,701,8.63,0,40.8,771663,6590,767593,3.39,1.72,0.15850490196078432,0.85,99.47
2022-07-04,Telangana,736,7,729,9299,1864,1622,7.91,0,40.8,772399,6597,768322,4.57,3.98,0.22791666666666666,0.85,99.47
2022-07-05,Telangana,950,4,944,12165,3022,2688,7.81,2,40.8,773349,6601,769266,7.41,6.59,0.29816176470588235,0.85,99.47
2022-07-06,Telangana,1367,17,1361,17848,520,427,7.66,0,40.8,774716,6618,770627,1.27,1.05,0.43745098039215685,0.85,99.47
2022-07-07,Telangana,1566,8,1564,19220,1274,469,8.15,0,40.8,776282,6626,772191,3.12,1.15,0.471078431372549,0.85,99.47
2022-07-08,Telangana,698,3,697,8816,605,163,7.92,0,40.8,776980,6629,772888,1.48,0.4,0.216078431372549,0.85,99.47
2022-07-09,Telangana,732,7,723,9397,4896,4343,7.79,2,40.8,777712,6636,773611,12.0,10.64,0.2303186274509804,0.85,99.47
2022-07-10,Telangana,702,6,700,8520,4494,1362,8.24,0,40.8,778414,6642,774311,11.01,3.34,0.2088235294117647,0.85,99.47
2022-07-11,Telangana,107,0,103,1690,2740,2356,6.33,4,40.8,778521,6642,774414,6.72,5.77,0.04142156862745098,0.85,99.47
2022-07-12,Telangana,410,2,401,5474,2832,1676,7.49,7,40.8,778931,6644,774815,6.94,4.11,0.13416666666666666,0.85,99.47
2022-07-13,Telangana,1381,15,1377,17215,3284,2931,8.02,0,40.8,780312,6659,776192,8.05,7.18,0.4219362745098039,0.85,99.47
2022-07-14,Telangana,344,1,341,4352,3459,1715,7.9,2,40.8,780656,6660,776533,8.48,4.2,0.10666666666666667,0.85,99.47
2022-07-15,Telangana,720,9,719,8571,3182,1708,8.4,0,40.8,781376,6669,777252,7.8,4.19,0.21007352941176471,0.85,99.47
2022-07-16,Telangana,1161,5,1160,14669,2692,2171,7.91,0,40.8,782537,6674,778412,6.6,5.32,0.3595343137254902,0.85,99.47
2022-07-17,Telangana,298,2,298,4014,2505,1363,7.42,0,40.8,782835,6676,778710,6.14,3.34,0.09838235294117648,0.85,99.47
2022-07-18,Telangana,264,3,264,3600,1745,1268,7.33,0,40.8,783099,6679,778974,4.28,3.11,0.08823529411764706,0.85,99.47
2022-07-19,Telangana,529,5,522,6791,1761,1528,7.79,2,40.8,783628,6684,779496,4.32,3.75,0.16644607843137255,0.85,99.47
2022-07-20,Telangana,235,1,234,3166,4270,2531,7.42,0,40.8,783863,6685,779730,10.47,6.2,0.07759803921568627,0.85,99.47
2022-07-21,Telangana,345,2,340,4231,3644,876,8.15,3,40.8,784208,6687,780070,8.93,2.15,0.10370098039215686,0.85,99.47
2022-07-22,Telangana,279,2,276,3332,2675,616,8.37,1,40.8,784487,6689,780346,6.56,1.51,0.08166666666666667,0.85,99.47
2022-07-23,Telangana,84,0,84,1087,478,374,7.73,0,40.8,784571,6689,780430,1.17,0.92,0.026642156862745098,0.85,99.47
2022-07-24,Telangana,859,3,850,10750,4953,2186,7.99,6,40.8,785430,6692,781280,12.14,5.36,0.26348039215686275,0.85,99.47
2022-07-25,Telangana,1421,21,1421,17289,384,216,8.22,0,40.8,786851,6713,782701,0.94,0.53,0.42375,0.85,99.47
2022-07-26,Telangana,805,3,802,9731,3058,574,8.27,0,40.8,787656,6716,783503,7.5,1.41,0.2385049019607843,0.85,99.47
2022-07-27,Telangana,1562,8,1559,19459,4537,1401,8.03,0,40.8,789218,6724,785062,11.12,3.43,0.4769362745098039,0.85,99.47
2022-07-28,Telangana,840,4,835,10023,4650,2260,8.38,1,40.8,790058,6728,785897,11.4,5.54,0.24566176470588236,0.85,99.47
2022-07-29,Telangana,1473,6,1473,18494,4892,1169,7.96,0,40.8,791531,6734,787370,11.99,2.87,0.4532843137254902,0.85,99.47
2022-07-30,Telangana,670,3,670,8154,2426,2070,8.22,0,40.8,792201,6737,788040,5.95,5.07,0.1998529411764706,0.85,99.47
2022-07-31,Telangana,165,2,156,2273,3763,1214,7.26,7,40.8,792366,6739,788196,9.22,2.98,0.05571078431372549,0.85,99.47
2022-08-01,Telangana,1270,9,1269,15775,3833,2897,8.05,0,40.8,793636,6748,789465,9.39,7.1,0.3866421568627451,0.85,99.47
2022-08-02,Telangana,784,4,775,9664,1860,279,8.11,5,40.8,794420,6752,790240,4.56,0.68,0.23686274509803923,0.85,99.47
2022-08-03,Telangana,134,1,134,1538,2429,85,8.71,0,40.8,794554,6753,790374,5.95,0.21,0.03769607843137255,0.85,99.47
2022-08-04,Telangana,1341,17,1339,16546,1375,791,8.1,0,40.8,795895,6770,791713,3.37,1.94,0.4055392156862745,0.85,99.47
2022-08-05,Telangana,1579,6,1572,19720,2612,2122,8.01,1,40.8,797474,6776,793285,6.4,5.2,0.48333333333333334,0.85,99.47
2022-08-06,Telangana,1346,11,1342,16688,2894,1332,8.07,0,40.8,798820,6787,794627,7.09,3.26,0.40901960784313723,0.85,99.48
2022-08-07,Telangana,379,5,372,5054,1269,523,7.5,2,40.8,799199,6792,794999,3.11,1.28,0.12387254901960784,0.85,99.47
2022-08-08,Telangana,1025,9,1025,13319,4225,2835,7.7,0,40.8,800224,6801,796024,10.36,6.95,0.3264460784313725,0.85,99.48
2022-08-09,Telangana,1122,6,1120,14192,920,862,7.91,0,40.8,801346,6807,797144,2.25,2.11,0.34784313725490196,0.85,99.48
2022-08-10,Telangana,690,5,685,8752,4772,2084,7.88,0,40.8,802036,6812,797829,11.7,5.11,0.21450980392156863,0.85,99.48
2022-08-11,Telangana,144,0,144,2084,1563,1137,6.91,0,40.8,802180,6812,797973,3.83,2.79,0.05107843137254902,0.85,99.48
2022-08-12,Telangana,601,5,596,7311,1106,1092,8.22,0,40.8,802781,6817,798569,2.71,2.68,0.17919117647058824,0.85,99.48
2022-08-13,Telangana,852,5,845,10437,1608,1078,8.16,2,40.8,803633,6822,799414,3.94,2.64,0.25580882352941176,0.85,99.48
2022-08-14,Telangana,1041,8,1033,12865,558,486,8.09,0,40.8,804674,6830,800447,1.37,1.19,0.3153186274509804,0.85,99.47
2022-08-15,Telangana,1488,17,1485,18536,3719,3043,8.03,0,40.8,806162,6847,801932,9.12,7.46,0.45431372549019605,0.85,99.48
2022-08-16,Telangana,1564,8,1560,19639,3613,2619,7.96,0,40.8,807726,6855,803492,8.86,6.42,0.48134803921568625,0.85,99.48
2022-08-17,Telangana,175,2,167,2022,3791,651,8.65,6,40.8,807901,6857,803659,9.29,1.6,0.049558823529411766,0.85,99.47
2022-08-18,Telangana,742,9,741,9215,610,72,8.05,0,40.8,808643,6866,804400,1.5,0.18,0.2258578431372549,0.85,99.48
2022-08-19,Telangana,824,11,819,10451,3970,3310,7.88,0,40.8,809467,6877,805219,9.73,8.11,0.25615196078431374,0.85,99.48
2022-08-20,Telangana,737,5,736,9695,1924,185,7.6,0,40.8,810204,6882,805955,4.72,0.45,0.23762254901960783,0.85,99.48
2022-08-21,Telangana,389,3,380,4526,1995,1581,8.59,6,40.8,810593,6885,806335,4.89,3.88,0.11093137254901961,0.85,99.47
2022-08-22,Telangana,702,2,700,8931,2535,819,7.86,0,40.8,811295,6887,807035,6.21,2.01,0.21889705882352942,0.85,99.47
2022-08-23,Telangana,216,0,210,2697,1782,905,8.01,6,40.8,811511,6887,807245,4.37,2.22,0.06610294117647059,0.85,99.47
2022-08-24,Telangana,74,0,68,640,3924,571,11.56,6,40.8,811585,6887,807313,9.62,1.4,0.01568627450980392,0.85,99.47
2022-08-25,Telangana,834,9,827,10589,3736,174,7.88,0,40.8,812419,6896,808140,9.16,0.43,0.2595343137254902,0.85,99.47
2022-08-26,Telangana,1357,6,1348,16872,2831,119,8.04,3,40.8,813776,6902,809488,6.94,0.29,0.41352941176470587,0.85,99.47
2022-08-27,Telangana,934,3,930,11704,255,105,7.98,1,40.8,814710,6905,810418,0.62,0.26,0.2868627450980392,0.85,99.47
2022-08-28,Telangana,560,4,554,6959,3378,972,8.05,2,40.8,815270,6909,810972,8.28,2.38,0.17056372549019608,0.85,99.47
2022-08-29,Telangana,308,1,300,3594,366,193,8.57,7,40.8,815578,6910,811272,0.9,0.47,0.08808823529411765,0.85,99.47
2022-08-30,Telangana,1458,15,1451,17864,1889,1135,8.16,0,40.8,817036,6925,812723,4.63,2.78,0.437843137254902,0.85,99.47
2022-08-31,Telangana,364,3,356,4970,205,103,7.32,5,40.8,817400,6928,813079,0.5,0.25,0.12181372549019608,0.85,99.47
2022-09-01,Telangana,823,10,817,10222,2788,83,8.05,0,40.8,818223,6938,813896,6.83,0.2,0.2505392156862745,0.85,99.47
2022-09-02,Telangana,1113,9,1111,14089,979,972,7.9,0,40.8,819336,6947,815007,2.4,2.38,0.3453186274509804,0.85,99.47
2022-09-03,Telangana,622,8,621,7972,2564,1567,7.8,0,40.8,819958,6955,815628,6.28,3.84,0.1953921568627451,0.85,99.47
2022-09-04,Telangana,546,1,540,6731,2907,247,8.11,5,40.8,820504,6956,816168,7.12,0.61,0.16497549019607843,0.85,99.47
2022-09-05,Telangana,704,6,702,9129,2125,2,7.71,0,40.8,821208,6962,816870,5.21,0.0,0.22375,0.85,99.47
2022-09-06,Telangana,1405,15,1401,17584,461,83,7.99,0,40.8,822613,6977,818271,1.13,0.2,0.43098039215686273,0.85,99.47
2022-09-07,Telangana,485,1,479,6074,3756,3042,7.98,5,40.8,823098,6978,818750,9.21,7.46,0.14887254901960784,0.85,99.47
2022-09-08,Telangana,453,1,445,5497,1800,1733,8.24,7,40.8,823551,6979,819195,4.41,4.25,0.13473039215686275,0.85,99.47
2022-09-09,Telangana,1256,13,1255,15614,962,413,8.04,0,40.8,824807,6992,820450,2.36,1.01,0.38269607843137254,0.85,99.47
2022-09-10,Telangana,510,7,509,6822,2743,371,7.48,0,40.8,825317,6999,820959,6.72,0.91,0.16720588235294118,0.85,99.47
2022-09-11,Telangana,127,0,118,1561,1943,1579,8.14,9,40.8,825444,6999,821077,4.76,3.87,0.03825980392156863,0.85,99.47
2022-09-12,Telangana,1312,7,1304,16668,2419,356,7.87,1,40.8,826756,7006,822381,5.93,0.87,0.40852941176470586,0.85,99.47
2022-09-13,Telangana,1459,17,1451,18221,4028,1197,8.01,0,40.8,828215,7023,823832,9.87,2.93,0.44659313725490196,0.85,99.47
2022-09-14,Telangana,424,4,418,5592,4638,793,7.58,2,40.8,828639,7027,824250,11.37,1.94,0.13705882352941176,0.85,99.47
2022-09-15,Telangana,1420,15,1413,17401,3082,2944,8.16,0,40.8,830059,7042,825663,7.55,7.22,0.4264950980392157,0.85,99.47
2022-09-16,Telangana,1200,10,1199,14914,1290,1200,8.05,0,40.8,831259,7052,826862,3.16,2.94,0.3655392156862745,0.85,99.47
2022-09-17,Telangana,694,9,689,8425,3563,664,8.24,0,40.8,831953,7061,827551,8.73,1.63,0.20649509803921567,0.85,99.47
2022-09-18,Telangana,1226,15,1223,15006,3920,28,8.17,0,40.8,833179,7076,828774,9.61,0.07,0.3677941176470588,0.85,99.47
2022-09-19,Telangana,1075,11,1075,13720,1565,481,7.84,0,40.8,834254,7087,829849,3.84,1.18,0.3362745098039216,0.85,99.47
2022-09-20,Telangana,927,6,924,11593,2162,798,8.0,0,40.8,835181,7093,830773,5.3,1.96,0.2841421568627451,0.85,99.47
2022-09-21,Telangana,1229,4,1224,15587,1697,329,7.88,1,40.8,836410,7097,831997,4.16,0.81,0.3820343137254902,0.85,99.47
2022-09-22,Telangana,299,3,292,3374,3310,3241,8.86,4,40.8,836709,7100,832289,8.11,7.94,0.08269607843137255,0.85,99.47
2022-09-23,Telangana,1180,7,1180,14643,4820,3997,8.06,0,40.8,837889,7107,833469,11.81,9.8,0.3588970588235294,0.85,99.47
2022-09-24,Telangana,89,1,85,1173,1007,233,7.59,3,40.8,837978,7108,833554,2.47,0.57,0.02875,0.85,99.47
2022-09-25,Telangana,411,3,411,5159,2285,1412,7.97,0,40.8,838389,7111,833965,5.6,3.46,0.12644607843137254,0.85,99.47
2022-09-26,Telangana,1352,18,1345,17060,3351,2017,7.92,0,40.8,839741,7129,835310,8.21,4.94,0.4181372549019608,0.85,99.47
2022-09-27,Telangana,185,1,185,2424,1839,1394,7.63,0,40.8,839926,7130,835495,4.51,3.42,0.05941176470588235,0.85,99.47
2022-09-28,Telangana,935,7,927,11738,2504,923,7.97,1,40.8,840861,7137,836422,6.14,2.26,0.28769607843137257,0.85,99.47
2022-09-29,Telangana,704,10,701,8665,1993,1366,8.12,0,40.8,841565,7147,837123,4.88,3.35,0.21237745098039215,0.85,99.47
2022-09-30,Telangana,1427,7,1421,17904,3853,2970,7.97,0,40.8,842992,7154,838544,9.44,7.28,0.4388235294117647,0.85,99.47
2022-10-01,Telangana,1418,15,1418,17833,4351,131,7.95,0,40.8,844410,7169,839962,10.66,0.32,0.4370833333333333,0.85,99.47
2022-10-02,Telangana,971,6,970,11869,3884,2962,8.18,0,40.8,845381,7175,840932,9.52,7.26,0.290906862745098,0.85,99.47
2022-10-03,Telangana,603,4,598,7145,2571,1403,8.44,1,40.8,845984,7179,841530,6.3,3.44,0.17512254901960783,0.85,99.47
2022-10-04,Telangana,1021,14,1016,12527,269,190,8.15,0,40.8,847005,7193,842546,0.66,0.47,0.30703431372549017,0.85,99.47
2022-10-05,Telangana,268,2,262,3174,2918,1352,8.44,4,40.8,847273,7195,842808,7.15,3.31,0.07779411764705882,0.85,99.47
2022-10-06,Telangana,499,3,490,6233,2410,1870,8.01,6,40.8,847772,7198,843298,5.91,4.58,0.15276960784313726,0.85,99.47
2022-10-07,Telangana,730,8,722,9186,1012,615,7.95,0,40.8,848502,7206,844020,2.48,1.51,0.22514705882352942,0.85,99.47
2022-10-08,Telangana,1521,19,1514,19095,1162,1,7.97,0,40.8,850023,7225,845534,2.85,0.0,0.46801470588235294,0.85,99.47
2022-10-09,Telangana,683,9,679,8455,4812,3494,8.08,0,40.8,850706,7234,846213,11.79,8.56,0.20723039215686276,0.85,99.47
2022-10-10,Telangana,608,3,608,7472,3425,229,8.14,0,40.8,851314,7237,846821,8.39,0.56,0.18313725490196078,0.85,99.47
2022-10-11,Telangana,473,2,466,6025,2003,958,7.85,5,40.8,851787,7239,847287,4.91,2.35,0.14767156862745098,0.85,99.47
2022-10-12,Telangana,1036,5,1032,13037,2784,486,7.95,0,40.8,852823,7244,848319,6.82,1.19,0.3195343137254902,0.85,99.47
2022-10-13,Telangana,1391,15,1389,17525,744,246,7.94,0,40.8,854214,7259,849708,1.82,0.6,0.42953431372549017,0.85,99.47
2022-10-14,Telangana,1194,14,1186,15310,753,504,7.8,0,40.8,855408,7273,850894,1.85,1.24,0.3752450980392157,0.85,99.47
2022-10-15,Telangana,107,0,99,1462,2114,822,7.32,8,40.8,855515,7273,850993,5.18,2.01,0.035833333333333335,0.85,99.47
2022-10-16,Telangana,88,0,81,1288,4979,4577,6.83,7,40.8,855603,7273,851074,12.2,11.22,0.031568627450980394,0.85,99.47
2022-10-17,Telangana,436,1,431,5456,3849,2909,7.99,4,40.8,856039,7274,851505,9.43,7.13,0.13372549019607843,0.85,99.47
2022-10-18,Telangana,845,3,838,10578,731,160,7.99,4,40.8,856884,7277,852343,1.79,0.39,0.25926470588235295,0.85,99.47
2022-10-19,Telangana,1277,8,1275,16079,2059,1918,7.94,0,40.8,858161,7285,853618,5.05,4.7,0.39409313725490197,0.85,99.47
2022-10-20,Telangana,526,6,518,6586,4564,2780,7.99,2,40.8,858687,7291,854136,11.19,6.81,0.16142156862745097,0.85,99.47
2022-10-21,Telangana,725,8,725,9357,1238,1189,7.75,0,40.8,859412,7299,854861,3.03,2.91,0.22933823529411765,0.85,99.47
2022-10-22,Telangana,1337,15,1333,16560,1586,44,8.07,0,40.8,860749,7314,856194,3.89,0.11,0.40588235294117647,0.85,99.47
2022-10-23,Telangana,64,0,61,1278,3769,616,5.01,3,40.8,860813,7314,856255,9.24,1.51,0.03132352941176471,0.85,99.47
2022-10-24,Telangana,371,3,367,5314,4240,3980,6.98,1,40.8,861184,7317,856622,10.39,9.75,0.1302450980392157,0.85,99.47
2022-10-25,Telangana,876,12,875,10977,1194,491,7.98,0,40.8,862060,7329,857497,2.93,1.2,0.2690441176470588,0.85,99.47
2022-10-26,Telangana,39,0,31,684,4457,2842,5.7,8,40.8,862099,7329,857528,10.92,6.97,0.016764705882352942,0.85,99.47
2022-10-27,Telangana,557,3,555,6536,3659,2958,8.52,0,40.8,862656,7332,858083,8.97,7.25,0.16019607843137254,0.85,99.47
2022-10-28,Telangana,955,12,946,11973,4202,2362,7.98,0,40.8,863611,7344,859029,10.3,5.79,0.2934558823529412,0.85,99.47
2022-10-29,Telangana,1353,18,1352,16721,4679,4570,8.09,0,40.8,864964,7362,860381,11.47,11.2,0.40982843137254904,0.85,99.47
2022-10-30,Telangana,70,0,68,825,3126,2773,8.48,2,40.8,865034,7362,860449,7.66,6.8,0.02022058823529412,0.85,99.47
2022-10-31,Telangana,765,3,765,9887,3358,1429,7.74,0,40.8,865799,7365,861214,8.23,3.5,0.24232843137254903,0.85,99.47
2022-11-01,Telangana,67,0,58,1253,4353,184,5.35,9,40.8,865866,7365,861272,10.67,0.45,0.03071078431372549,0.85,99.47
2022-11-02,Telangana,1000,7,993,12074,279,7,8.28,0,40.8,866866,7372,862265,0.68,0.02,0.29593137254901963,0.85,99.47
2022-11-03,Telangana,1168,14,1166,14568,745,582,8.02,0,40.8,868034,7386,863431,1.83,1.43,0.35705882352941176,0.85,99.47
2022-11-04,Telangana,281,4,277,3263,3769,3755,8.61,0,40.8,868315,7390,863708,9.24,9.2,0.07997549019607843,0.85,99.47
2022-11-05,Telangana,851,6,851,10699,2928,2909,7.95,0,40.8,869166,7396,864559,7.18,7.13,0.2622303921568627,0.85,99.47
2022-11-06,Telangana,798,9,792,9932,422,373,8.03,0,40.8,869964,7405,865351,1.03,0.91,0.24343137254901961,0.85,99.47
2022-11-07,Telangana,141,0,137,1705,4713,38,8.27,4,40.8,870105,7405,865488,11.55,0.09,0.04178921568627451,0.85,99.47
2022-11-08,Telangana,705,5,696,8819,3566,3271,7.99,4,40.8,870810,7410,866184,8.74,8.02,0.21615196078431373,0.85,99.47
2022-11-09,Telangana,853,12,847,10556,4101,1300,8.08,0,40.8,871663,7422,867031,10.05,3.19,0.25872549019607843,0.85,99.47
2022-11-10,Telangana,588,6,584,7450,4631,3298,7.89,0,40.8,872251,7428,867615,11.35,8.08,0.18259803921568626,0.85,99.47
2022-11-11,Telangana,248,2,239,2609,1825,1595,9.51,7,40.8,872499,7430,867854,4.47,3.91,0.06394607843137255,0.85,99.47
2022-11-12,Telangana,1571,4,1563,19753,4807,4355,7.95,4,40.8,874070,7434,869417,11.78,10.67,0.4841421568627451,0.85,99.47
2022-11-13,Telangana,1269,9,1260,16336,1887,75,7.77,0,40.8,875339,7443,870677,4.62,0.18,0.4003921568627451,0.85,99.47
2022-11-14,Telangana,1587,13,1584,19607,3109,2543,8.09,0,40.8,876926,7456,872261,7.62,6.23,0.4805637254901961,0.85,99.47
2022-11-15,Telangana,1065,6,1061,13095,2801,697,8.13,0,40.8,877991,7462,873322,6.87,1.71,0.3209558823529412,0.85,99.47
2022-11-16,Telangana,1291,13,1287,16049,1627,1417,8.04,0,40.8,879282,7475,874609,3.99,3.47,0.3933578431372549,0.85,99.47
2022-11-17,Telangana,1407,21,1407,17336,2658,1193,8.12,0,40.8,880689,7496,876016,6.51,2.92,0.42490196078431375,0.85,99.47
2022-11-18,Telangana,575,5,570,7567,2772,2743,7.6,0,40.8,881264,7501,876586,6.79,6.72,0.1854656862745098,0.85,99.47
2022-11-19,Telangana,367,3,361,5024,2246,1498,7.3,3,40.8,881631,7504,876947,5.5,3.67,0.12313725490196079,0.85,99.47
2022-11-20,Telangana,1419,8,1419,17703,2977,126,8.02,0,40.8,883050,7512,878366,7.3,0.31,0.4338970588235294,0.85,99.47
2022-11-21,Telangana,1293,17,1286,15651,4127,2163,8.26,0,40.8,884343,7529,879652,10.12,5.3,0.3836029411764706,0.85,99.47
2022-11-22,Telangana,608,4,600,7449,479,342,8.16,4,40.8,884951,7533,880252,1.17,0.84,0.18257352941176472,0.85,99.47
2022-11-23,Telangana,127,1,120,1670,1776,555,7.6,6,40.8,885078,7534,880372,4.35,1.36,0.04093137254901961,0.85,99.47
2022-11-24,Telangana,766,6,765,9379,901,828,8.17,0,40.8,885844,7540,881137,2.21,2.03,0.22987745098039217,0.85,99.47
2022-11-25,Telangana,896,4,889,11111,4012,2758,8.06,3,40.8,886740,7544,882026,9.83,6.76,0.27232843137254903,0.85,99.47
2022-11-26,Telangana,522,5,518,6944,4123,2175,7.52,0,40.8,887262,7549,882544,10.11,5.33,0.17019607843137255,0.85,99.47
2022-11-27,Telangana,417,3,415,5921,2623,585,7.04,0,40.8,887679,7552,882959,6.43,1.43,0.14512254901960783,0.85,99.47
2022-11-28,Telangana,539,7,535,6907,1065,922,7.8,0,40.8,888218,7559,883494,2.61,2.26,0.1692892156862745,0.85,99.47
2022-11-29,Telangana,1503,7,1494,19164,2277,753,7.84,2,40.8,889721,7566,884988,5.58,1.85,0.4697058823529412,0.85,99.47
2022-11-30,Telangana,1578,22,1576,19407,1289,243,8.13,0,40.8,891299,7588,886564,3.16,0.6,0.47566176470588234,0.85,99.47
2022-12-01,Telangana,305,3,296,3630,663,432,8.4,6,40.8,891604,7591,886860,1.62,1.06,0.08897058823529412,0.85,99.47
2022-12-02,Telangana,1408,8,1404,17727,4381,3903,7.94,0,40.8,893012,7599,888264,10.74,9.57,0.4344852941176471,0.85,99.47
2022-12-03,Telangana,522,1,516,6251,339,98,8.35,5,40.8,893534,7600,888780,0.83,0.24,0.15321078431372548,0.85,99.47
2022-12-04,Telangana,100,1,99,1092,1161,626,9.16,0,40.8,893634,7601,888879,2.85,1.53,0.02676470588235294,0.85,99.47
2022-12-05,Telangana,307,1,306,4073,1901,884,7.54,0,40.8,893941,7602,889185,4.66,2.17,0.09982843137254901,0.85,99.47
2022-12-06,Telangana,984,12,975,12181,2201,446,8.08,0,40.8,894925,7614,890160,5.39,1.09,0.2985539215686275,0.85,99.47
2022-12-07,Telangana,1557,20,1554,19243,1761,166,8.09,0,40.8,896482,7634,891714,4.32,0.41,0.4716421568627451,0.85,99.47
2022-12-08,Telangana,1304,14,1303,16340,4504,2906,7.98,0,40.8,897786,7648,893017,11.04,7.12,0.4004901960784314,0.85,99.47
2022-12-09,Telangana,785,6,782,9640,486,2,8.14,0,40.8,898571,7654,893799,1.19,0.0,0.23627450980392156,0.85,99.47
2022-12-10,Telangana,149,2,146,2164,3147,2224,6.89,1,40.8,898720,7656,893945,7.71,5.45,0.05303921568627451,0.85,99.47
2022-12-11,Telangana,1570,20,1563,19770,3382,1564,7.94,0,40.8,900290,7676,895508,8.29,3.83,0.48455882352941176,0.85,99.47
2022-12-12,Telangana,933,9,924,11874,1637,382,7.86,0,40.8,901223,7685,896432,4.01,0.94,0.29102941176470587,0.85,99.47
2022-12-13,Telangana,93,0,85,1089,3415,765,8.54,8,40.8,901316,7685,896517,8.37,1.88,0.026691176470588236,0.85,99.47
2022-12-14,Telangana,254,2,246,3021,2388,1966,8.41,6,40.8,901570,7687,896763,5.85,4.82,0.07404411764705883,0.85,99.47
2022-12-15,Telangana,1012,3,1010,12648,1440,723,8.0,0,40.8,902582,7690,897773,3.53,1.77,0.31,0.85,99.47
2022-12-16,Telangana,516,6,508,6425,2322,1433,8.03,2,40.8,903098,7696,898281,5.69,3.51,0.15747549019607843,0.85,99.47
2022-12-17,Telangana,1455,20,1454,17973,592,381,8.1,0,40.8,904553,7716,899735,1.45,0.93,0.4405147058823529,0.85,99.47
2022-12-18,Telangana,341,4,337,4222,355,105,8.08,0,40.8,904894,7720,900072,0.87,0.26,0.10348039215686275,0.85,99.47
2022-12-19,Telangana,1542,11,1540,19349,3822,424,7.97,0,40.8,906436,7731,901612,9.37,1.04,0.4742401960784314,0.85,99.47
2022-12-20,Telangana,279,3,277,3166,198,48,8.81,0,40.8,906715,7734,901889,0.49,0.12,0.07759803921568627,0.85,99.47
2022-12-21,Telangana,442,3,440,5263,2092,1281,8.4,0,40.8,907157,7737,902329,5.13,3.14,0.1289950980392157,0.85,99.47
2022-12-22,Telangana,764,5,758,9424,532,481,8.11,1,40.8,907921,7742,903087,1.3,1.18,0.23098039215686275,0.85,99.47
2022-12-23,Telangana,1161,15,1155,14469,937,341,8.02,0,40.8,909082,7757,904242,2.3,0.84,0.35463235294117645,0.85,99.47
2022-12-24,Telangana,637,5,634,7996,1351,284,7.97,0,40.8,909719,7762,904876,3.31,0.7,0.19598039215686275,0.85,99.47
2022-12-25,Telangana,395,4,386,5214,2275,1250,7.58,5,40.8,910114,7766,905262,5.58,3.06,0.12779411764705884,0.85,99.47
2022-12-26,Telangana,407,5,399,4833,3706,3543,8.42,3,40.8,910521,7771,905661,9.08,8.68,0.11845588235294117,0.85,99.47
2022-12-27,Telangana,664,3,664,8628,1219,10,7.7,0,40.8,911185,7774,906325,2.99,0.02,0.2114705882352941,0.85,99.47
2022-12-28,Telangana,415,5,414,5198,1943,1571,7.98,0,40.8,911600,7779,906739,4.76,3.85,0.12740196078431373,0.85,99.47
2022-12-29,Telangana,1367,7,1363,16740,4226,1304,8.17,0,40.8,912967,7786,908102,10.36,3.2,0.4102941176470588,0.85,99.47
2022-12-30,Telangana,375,2,374,4632,4703,1650,8.1,0,40.8,913342,7788,908476,11.53,4.04,0.11352941176470588,0.85,99.47
2022-12-31,Telangana,1491,12,1489,18565,1783,1398,8.03,0,40.8,914833,7800,909965,4.37,3.43,0.45502450980392156,0.85,99.47
2020-01-01,Tripura,425,4,424,5100,801,86,8.33,0,4.1,425,4,424,19.54,2.1,1.2439024390243905,0.94,99.76
2020-01-02,Tripura,1130,11,1125,13898,2792,802,8.13,0,4.1,1555,15,1549,68.1,19.56,3.389756097560976,0.96,99.61
2020-01-03,Tripura,989,11,983,12310,4171,1395,8.03,0,4.1,2544,26,2532,101.73,34.02,3.0024390243902443,1.02,99.53
2020-01-04,Tripura,530,7,521,6363,1978,197,8.33,2,4.1,3074,33,3053,48.24,4.8,1.5519512195121954,1.07,99.32
2020-01-05,Tripura,1482,20,1476,18681,628,559,7.93,0,4.1,4556,53,4529,15.32,13.63,4.556341463414634,1.16,99.41
2020-01-06,Tripura,977,9,972,12133,2444,987,8.05,0,4.1,5533,62,5501,59.61,24.07,2.959268292682927,1.12,99.42
2020-01-07,Tripura,195,1,188,1992,3875,1068,9.79,6,4.1,5728,63,5689,94.51,26.05,0.4858536585365854,1.1,99.32
2020-01-08,Tripura,509,6,503,6336,3561,2266,8.03,0,4.1,6237,69,6192,86.85,55.27,1.5453658536585368,1.11,99.28
2020-01-09,Tripura,613,8,605,7475,4718,4386,8.2,0,4.1,6850,77,6797,115.07,106.98,1.8231707317073174,1.12,99.23
2020-01-10,Tripura,1253,18,1251,16328,1464,691,7.67,0,4.1,8103,95,8048,35.71,16.85,3.9824390243902443,1.17,99.32
2020-01-11,Tripura,240,0,239,3144,4483,3165,7.63,1,4.1,8343,95,8287,109.34,77.2,0.766829268292683,1.14,99.33
2020-01-12,Tripura,771,10,767,9953,5,4,7.75,0,4.1,9114,105,9054,0.12,0.1,2.4275609756097563,1.15,99.34
2020-01-13,Tripura,1429,9,1423,18188,1770,1163,7.86,0,4.1,10543,114,10477,43.17,28.37,4.43609756097561,1.08,99.37
2020-01-14,Tripura,1348,9,1348,16683,2870,782,8.08,0,4.1,11891,123,11825,70.0,19.07,4.069024390243903,1.03,99.44
2020-01-15,Tripura,319,1,311,3735,3215,882,8.54,7,4.1,12210,124,12136,78.41,21.51,0.9109756097560977,1.02,99.39
2020-01-16,Tripura,1560,5,1555,19465,4423,3411,8.01,0,4.1,13770,129,13691,107.88,83.2,4.7475609756097565,0.94,99.43
2020-01-17,Tripura,167,1,158,2540,4961,4323,6.57,8,4.1,13937,130,13849,121.0,105.44,0.6195121951219513,0.93,99.37
2020-01-18,Tripura,472,4,466,5767,1406,586,8.18,2,4.1,14409,134,14315,34.29,14.29,1.4065853658536587,0.93,99.35
2020-01-19,Tripura,1166,6,1160,14576,4753,2283,8.0,0,4.1,15575,140,15475,115.93,55.68,3.5551219512195127,0.9,99.36
2020-01-20,Tripura,964,4,959,11482,2356,3,8.4,1,4.1,16539,144,16434,57.46,0.07,2.800487804878049,0.87,99.37
2020-01-21,Tripura,404,4,400,5383,2906,1111,7.51,0,4.1,16943,148,16834,70.88,27.1,1.3129268292682927,0.87,99.36
2020-01-22,Tripura,1428,21,1425,17677,3885,2980,8.08,0,4.1,18371,169,18259,94.76,72.68,4.311463414634146,0.92,99.39
2020-01-23,Tripura,1428,20,1424,18171,384,219,7.86,0,4.1,19799,189,19683,9.37,5.34,4.431951219512196,0.95,99.41
2020-01-24,Tripura,267,2,267,3126,4024,3094,8.54,0,4.1,20066,191,19950,98.15,75.46,0.762439024390244,0.95,99.42
2020-01-25,Tripura,294,1,285,3288,1356,258,8.94,8,4.1,20360,192,20235,33.07,6.29,0.8019512195121952,0.94,99.39
2020-01-26,Tripura,776,8,774,9696,923,656,8.0,0,4.1,21136,200,21009,22.51,16.0,2.364878048780488,0.95,99.4
2020-01-27,Tripura,534,4,532,6768,2095,1731,7.89,0,4.1,21670,204,21541,51.1,42.22,1.6507317073170733,0.94,99.4
2020-01-28,Tripura,87,0,86,1605,3956,2081,5.42,1,4.1,21757,204,21627,96.49,50.76,0.3914634146341464,0.94,99.4
2020-01-29,Tripura,451,3,447,5707,1788,1304,7.9,1,4.1,22208,207,22074,43.61,31.8,1.3919512195121952,0.93,99.4
2020-01-30,Tripura,856,11,856,10745,1112,779,7.97,0,4.1,23064,218,22930,27.12,19.0,2.6207317073170735,0.95,99.42
2020-01-31,Tripura,156,1,149,2232,3440,1975,6.99,6,4.1,23220,219,23079,83.9,48.17,0.5443902439024391,0.94,99.39
2020-02-01,Tripura,856,5,850,10801,3932,3570,7.93,1,4.1,24076,224,23929,95.9,87.07,2.6343902439024394,0.93,99.39
2020-02-02,Tripura,299,2,299,4144,2065,1233,7.22,0,4.1,24375,226,24228,50.37,30.07,1.0107317073170732,0.93,99.4
2020-02-03,Tripura,1127,14,1125,14045,2895,2080,8.02,0,4.1,25502,240,25353,70.61,50.73,3.4256097560975616,0.94,99.42
2020-02-04,Tripura,243,3,236,2783,1296,595,8.73,4,4.1,25745,243,25589,31.61,14.51,0.6787804878048781,0.94,99.39
2020-02-05,Tripura,288,3,284,3837,3006,204,7.51,1,4.1,26033,246,25873,73.32,4.98,0.9358536585365854,0.94,99.39
2020-02-06,Tripura,384,1,376,4857,4113,150,7.91,7,4.1,26417,247,26249,100.32,3.66,1.1846341463414636,0.94,99.36
2020-02-07,Tripura,245,2,236,3214,297,158,7.62,7,4.1,26662,249,26485,7.24,3.85,0.7839024390243904,0.93,99.34
2020-02-08,Tripura,599,8,597,7563,91,61,7.92,0,4.1,27261,257,27082,2.22,1.49,1.8446341463414637,0.94,99.34
2020-02-09,Tripura,487,6,478,6233,4243,2139,7.81,3,4.1,27748,263,27560,103.49,52.17,1.5202439024390246,0.95,99.32
2020-02-10,Tripura,573,7,566,7238,680,347,7.92,0,4.1,28321,270,28126,16.59,8.46,1.7653658536585368,0.95,99.31
2020-02-11,Tripura,215,1,206,3051,2839,30,7.05,8,4.1,28536,271,28332,69.24,0.73,0.7441463414634147,0.95,99.29
2020-02-12,Tripura,1306,9,1300,16656,1928,1728,7.84,0,4.1,29842,280,29632,47.02,42.15,4.062439024390244,0.94,99.3
2020-02-13,Tripura,70,0,70,716,4486,45,9.78,0,4.1,29912,280,29702,109.41,1.1,0.17463414634146343,0.94,99.3
2020-02-14,Tripura,320,3,317,4035,1280,1212,7.93,0,4.1,30232,283,30019,31.22,29.56,0.9841463414634147,0.94,99.3
2020-02-15,Tripura,1236,11,1236,15556,2682,1225,7.95,0,4.1,31468,294,31255,65.41,29.88,3.794146341463415,0.93,99.32
2020-02-16,Tripura,184,2,180,2268,2154,893,8.11,2,4.1,31652,296,31435,52.54,21.78,0.5531707317073171,0.94,99.31
2020-02-17,Tripura,1326,14,1319,16274,3556,630,8.15,0,4.1,32978,310,32754,86.73,15.37,3.9692682926829272,0.94,99.32
2020-02-18,Tripura,1104,8,1097,13734,291,241,8.04,0,4.1,34082,318,33851,7.1,5.88,3.349756097560976,0.93,99.32
2020-02-19,Tripura,450,5,447,6230,1355,1178,7.22,0,4.1,34532,323,34298,33.05,28.73,1.5195121951219515,0.94,99.32
2020-02-20,Tripura,648,2,647,8155,4002,1963,7.95,0,4.1,35180,325,34945,97.61,47.88,1.9890243902439027,0.92,99.33
2020-02-21,Tripura,1222,6,1218,15523,1049,389,7.87,0,4.1,36402,331,36163,25.59,9.49,3.7860975609756102,0.91,99.34
2020-02-22,Tripura,1520,16,1517,19433,4899,3743,7.82,0,4.1,37922,347,37680,119.49,91.29,4.739756097560976,0.92,99.36
2020-02-23,Tripura,1494,17,1493,18966,24,0,7.88,0,4.1,39416,364,39173,0.59,0.0,4.6258536585365855,0.92,99.38
2020-02-24,Tripura,412,6,404,4660,955,43,8.84,2,4.1,39828,370,39577,23.29,1.05,1.1365853658536587,0.93,99.37
2020-02-25,Tripura,118,0,110,1062,312,9,11.11,8,4.1,39946,370,39687,7.61,0.22,0.25902439024390245,0.93,99.35
2020-02-26,Tripura,424,5,423,5595,4074,1766,7.58,0,4.1,40370,375,40110,99.37,43.07,1.3646341463414635,0.93,99.36
2020-02-27,Tripura,1246,5,1237,15590,3272,1901,7.99,4,4.1,41616,380,41347,79.8,46.37,3.802439024390244,0.91,99.35
2020-02-28,Tripura,1418,12,1416,17681,3726,1577,8.02,0,4.1,43034,392,42763,90.88,38.46,4.312439024390244,0.91,99.37
2020-02-29,Tripura,1162,8,1161,14019,2456,196,8.29,0,4.1,44196,400,43924,59.9,4.78,3.4192682926829274,0.91,99.38
2020-03-01,Tripura,316,3,310,4212,3157,1544,7.5,3,4.1,44512,403,44234,77.0,37.66,1.0273170731707317,0.91,99.38
2020-03-02,Tripura,1010,13,1006,12462,4144,55,8.1,0,4.1,45522,416,45240,101.07,1.34,3.0395121951219517,0.91,99.38
2020-03-03,Tripura,537,6,530,6403,3292,1896,8.39,1,4.1,46059,422,45770,80.29,46.24,1.561707317073171,0.92,99.37
2020-03-04,Tripura,378,5,371,5030,1108,357,7.51,2,4.1,46437,427,46141,27.02,8.71,1.2268292682926831,0.92,99.36
2020-03-05,Tripura,604,3,604,7403,4405,586,8.16,0,4.1,47041,430,46745,107.44,14.29,1.8056097560975612,0.91,99.37
2020-03-06,Tripura,337,2,333,4242,2951,1819,7.94,2,4.1,47378,432,47078,71.98,44.37,1.0346341463414634,0.91,99.37
2020-03-07,Tripura,550,2,542,7109,2416,1267,7.74,6,4.1,47928,434,47620,58.93,30.9,1.7339024390243905,0.91,99.36
2020-03-08,Tripura,164,1,164,2055,2961,1047,7.98,0,4.1,48092,435,47784,72.22,25.54,0.5012195121951221,0.9,99.36
2020-03-09,Tripura,222,0,215,2949,12,4,7.53,7,4.1,48314,435,47999,0.29,0.1,0.7192682926829269,0.9,99.35
2020-03-10,Tripura,1557,18,1550,19603,4407,3770,7.94,0,4.1,49871,453,49549,107.49,91.95,4.781219512195123,0.91,99.35
2020-03-11,Tripura,1210,3,1201,15078,2763,1862,8.02,6,4.1,51081,456,50750,67.39,45.41,3.6775609756097567,0.89,99.35
2020-03-12,Tripura,1003,13,1000,12548,4158,3916,7.99,0,4.1,52084,469,51750,101.41,95.51,3.0604878048780493,0.9,99.36
2020-03-13,Tripura,1359,12,1354,16632,209,61,8.17,0,4.1,53443,481,53104,5.1,1.49,4.056585365853659,0.9,99.37
2020-03-14,Tripura,1163,5,1160,14572,3987,3434,7.98,0,4.1,54606,486,54264,97.24,83.76,3.554146341463415,0.89,99.37
2020-03-15,Tripura,1164,7,1161,14433,484,185,8.06,0,4.1,55770,493,55425,11.8,4.51,3.5202439024390246,0.88,99.38
2020-03-16,Tripura,452,6,449,5619,4247,3756,8.04,0,4.1,56222,499,55874,103.59,91.61,1.3704878048780489,0.89,99.38
2020-03-17,Tripura,1186,7,1185,15172,3470,1659,7.82,0,4.1,57408,506,57059,84.63,40.46,3.7004878048780494,0.88,99.39
2020-03-18,Tripura,190,2,187,2234,791,312,8.5,1,4.1,57598,508,57246,19.29,7.61,0.5448780487804878,0.88,99.39
2020-03-19,Tripura,557,3,554,7010,3541,2478,7.95,0,4.1,58155,511,57800,86.37,60.44,1.7097560975609758,0.88,99.39
2020-03-20,Tripura,322,4,319,3789,2426,1184,8.5,0,4.1,58477,515,58119,59.17,28.88,0.9241463414634148,0.88,99.39
2020-03-21,Tripura,1273,10,1265,16093,852,570,7.91,0,4.1,59750,525,59384,20.78,13.9,3.925121951219513,0.88,99.39
2020-03-22,Tripura,718,2,717,9070,3327,2876,7.92,0,4.1,60468,527,60101,81.15,70.15,2.2121951219512197,0.87,99.39
2020-03-23,Tripura,1397,14,1389,17468,2462,992,8.0,0,4.1,61865,541,61490,60.05,24.2,4.260487804878049,0.87,99.39
2020-03-24,Tripura,159,2,159,1739,746,427,9.14,0,4.1,62024,543,61649,18.2,10.41,0.4241463414634147,0.88,99.4
2020-03-25,Tripura,1515,17,1515,18546,1607,832,8.17,0,4.1,63539,560,63164,39.2,20.29,4.523414634146342,0.88,99.41
2020-03-26,Tripura,303,1,301,3484,373,5,8.7,1,4.1,63842,561,63465,9.1,0.12,0.8497560975609757,0.88,99.41
2020-03-27,Tripura,857,12,849,10548,1856,1721,8.12,0,4.1,64699,573,64314,45.27,41.98,2.572682926829269,0.89,99.4
2020-03-28,Tripura,781,2,772,9738,548,317,8.02,7,4.1,65480,575,65086,13.37,7.73,2.3751219512195125,0.88,99.4
2020-03-29,Tripura,148,0,143,1977,2277,1055,7.49,5,4.1,65628,575,65229,55.54,25.73,0.48219512195121955,0.88,99.39
2020-03-30,Tripura,1000,6,1000,12479,136,122,8.01,0,4.1,66628,581,66229,3.32,2.98,3.043658536585366,0.87,99.4
2020-03-31,Tripura,385,2,378,4608,2364,139,8.36,5,4.1,67013,583,66607,57.66,3.39,1.1239024390243904,0.87,99.39
2020-04-01,Tripura,583,5,576,7275,2245,126,8.01,2,4.1,67596,588,67183,54.76,3.07,1.7743902439024393,0.87,99.39
2020-04-02,Tripura,1468,13,1462,18758,4209,1324,7.83,0,4.1,69064,601,68645,102.66,32.29,4.575121951219513,0.87,99.39
2020-04-03,Tripura,989,7,983,12534,4262,1437,7.89,0,4.1,70053,608,69628,103.95,35.05,3.057073170731708,0.87,99.39
2020-04-04,Tripura,1150,13,1147,14356,2114,1208,8.01,0,4.1,71203,621,70775,51.56,29.46,3.501463414634147,0.87,99.4
2020-04-05,Tripura,795,11,792,9730,1422,1411,8.17,0,4.1,71998,632,71567,34.68,34.41,2.3731707317073174,0.88,99.4
2020-04-06,Tripura,1129,13,1128,14467,276,142,7.8,0,4.1,73127,645,72695,6.73,3.46,3.528536585365854,0.88,99.41
2020-04-07,Tripura,662,3,653,7866,647,407,8.42,6,4.1,73789,648,73348,15.78,9.93,1.9185365853658538,0.88,99.4
2020-04-08,Tripura,266,3,262,3390,1034,544,7.85,1,4.1,74055,651,73610,25.22,13.27,0.826829268292683,0.88,99.4
2020-04-09,Tripura,1055,5,1047,13420,2809,44,7.86,3,4.1,75110,656,74657,68.51,1.07,3.2731707317073173,0.87,99.4
2020-04-10,Tripura,698,5,691,8985,3706,2971,7.77,2,4.1,75808,661,75348,90.39,72.46,2.1914634146341467,0.87,99.39
2020-04-11,Tripura,828,5,827,10311,4490,3243,8.03,0,4.1,76636,666,76175,109.51,79.1,2.514878048780488,0.87,99.4
2020-04-12,Tripura,1147,12,1145,14041,1504,1407,8.17,0,4.1,77783,678,77320,36.68,34.32,3.424634146341464,0.87,99.4
2020-04-13,Tripura,976,5,976,11369,2707,1441,8.58,0,4.1,78759,683,78296,66.02,35.15,2.772926829268293,0.87,99.41
2020-04-14,Tripura,678,4,674,8141,4247,1401,8.33,0,4.1,79437,687,78970,103.59,34.17,1.9856097560975612,0.86,99.41
2020-04-15,Tripura,1408,5,1402,17733,1316,1194,7.94,1,4.1,80845,692,80372,32.1,29.12,4.325121951219512,0.86,99.41
2020-04-16,Tripura,858,9,851,10533,606,39,8.15,0,4.1,81703,701,81223,14.78,0.95,2.5690243902439027,0.86,99.41
2020-04-17,Tripura,865,6,861,10920,4600,784,7.92,0,4.1,82568,707,82084,112.2,19.12,2.6634146341463416,0.86,99.41
2020-04-18,Tripura,880,4,880,11135,295,150,7.9,0,4.1,83448,711,82964,7.2,3.66,2.715853658536586,0.85,99.42
2020-04-19,Tripura,252,3,252,2964,617,183,8.5,0,4.1,83700,714,83216,15.05,4.46,0.7229268292682928,0.85,99.42
2020-04-20,Tripura,1459,15,1459,18629,1580,1506,7.83,0,4.1,85159,729,84675,38.54,36.73,4.543658536585366,0.86,99.43
2020-04-21,Tripura,103,0,95,1475,2436,1277,6.98,8,4.1,85262,729,84770,59.41,31.15,0.35975609756097565,0.86,99.42
2020-04-22,Tripura,672,8,666,8596,3730,757,7.82,0,4.1,85934,737,85436,90.98,18.46,2.0965853658536586,0.86,99.42
2020-04-23,Tripura,962,10,954,12236,2442,2312,7.86,0,4.1,86896,747,86390,59.56,56.39,2.9843902439024395,0.86,99.42
2020-04-24,Tripura,272,2,272,3116,2394,1624,8.73,0,4.1,87168,749,86662,58.39,39.61,0.7600000000000001,0.86,99.42
2020-04-25,Tripura,39,0,32,509,752,558,7.66,7,4.1,87207,749,86694,18.34,13.61,0.12414634146341465,0.86,99.41
2020-04-26,Tripura,287,2,285,3572,806,62,8.03,0,4.1,87494,751,86979,19.66,1.51,0.8712195121951221,0.86,99.41
2020-04-27,Tripura,496,2,494,6222,1039,386,7.97,0,4.1,87990,753,87473,25.34,9.41,1.5175609756097563,0.86,99.41
2020-04-28,Tripura,1262,12,1256,15783,2631,98,8.0,0,4.1,89252,765,88729,64.17,2.39,3.8495121951219518,0.86,99.41
2020-04-29,Tripura,830,4,824,9761,2189,2004,8.5,2,4.1,90082,769,89553,53.39,48.88,2.3807317073170733,0.85,99.41
2020-04-30,Tripura,1392,17,1385,17370,4707,3683,8.01,0,4.1,91474,786,90938,114.8,89.83,4.236585365853659,0.86,99.41
2020-05-01,Tripura,1440,16,1433,17899,2301,579,8.05,0,4.1,92914,802,92371,56.12,14.12,4.3656097560975615,0.86,99.42
2020-05-02,Tripura,1561,8,1560,19530,3785,1966,7.99,0,4.1,94475,810,93931,92.32,47.95,4.763414634146342,0.86,99.42
2020-05-03,Tripura,205,0,205,2500,1183,594,8.2,0,4.1,94680,810,94136,28.85,14.49,0.6097560975609757,0.86,99.43
2020-05-04,Tripura,1124,8,1119,14125,3506,1101,7.96,0,4.1,95804,818,95255,85.51,26.85,3.4451219512195124,0.85,99.43
2020-05-05,Tripura,1482,9,1481,18402,3523,3164,8.05,0,4.1,97286,827,96736,85.93,77.17,4.48829268292683,0.85,99.43
2020-05-06,Tripura,1181,3,1179,14846,1791,39,7.96,0,4.1,98467,830,97915,43.68,0.95,3.620975609756098,0.84,99.44
2020-05-07,Tripura,964,6,955,12044,4984,2151,8.0,3,4.1,99431,836,98870,121.56,52.46,2.9375609756097565,0.84,99.44
2020-05-08,Tripura,294,3,285,3722,3059,690,7.9,6,4.1,99725,839,99155,74.61,16.83,0.9078048780487806,0.84,99.43
2020-05-09,Tripura,1127,12,1118,14211,1965,518,7.93,0,4.1,100852,851,100273,47.93,12.63,3.46609756097561,0.84,99.43
2020-05-10,Tripura,1561,11,1560,19491,1314,73,8.01,0,4.1,102413,862,101833,32.05,1.78,4.753902439024391,0.84,99.43
2020-05-11,Tripura,849,7,849,10069,4407,209,8.43,0,4.1,103262,869,102682,107.49,5.1,2.4558536585365855,0.84,99.44
2020-05-12,Tripura,1448,5,1448,18077,4307,993,8.01,0,4.1,104710,874,104130,105.05,24.22,4.409024390243903,0.83,99.45
2020-05-13,Tripura,1274,15,1265,15501,128,64,8.22,0,4.1,105984,889,105395,3.12,1.56,3.7807317073170736,0.84,99.44
2020-05-14,Tripura,1520,20,1518,18583,4457,2102,8.18,0,4.1,107504,909,106913,108.71,51.27,4.532439024390245,0.85,99.45
2020-05-15,Tripura,566,4,559,6819,2710,1878,8.3,3,4.1,108070,913,107472,66.1,45.8,1.6631707317073172,0.84,99.45
2020-05-16,Tripura,1562,5,1553,19323,3740,2994,8.08,4,4.1,109632,918,109025,91.22,73.02,4.7129268292682935,0.84,99.45
2020-05-17,Tripura,1474,17,1474,18596,4690,1895,7.93,0,4.1,111106,935,110499,114.39,46.22,4.5356097560975615,0.84,99.45
2020-05-18,Tripura,602,7,602,7666,2718,1998,7.85,0,4.1,111708,942,111101,66.29,48.73,1.8697560975609757,0.84,99.46
2020-05-19,Tripura,304,1,301,3751,467,366,8.1,2,4.1,112012,943,111402,11.39,8.93,0.914878048780488,0.84,99.46
2020-05-20,Tripura,1425,18,1419,17780,2037,815,8.01,0,4.1,113437,961,112821,49.68,19.88,4.336585365853659,0.85,99.46
2020-05-21,Tripura,70,0,70,994,1942,1020,7.04,0,4.1,113507,961,112891,47.37,24.88,0.24243902439024392,0.85,99.46
2020-05-22,Tripura,1272,16,1266,15531,4716,4051,8.19,0,4.1,114779,977,114157,115.02,98.8,3.7880487804878054,0.85,99.46
2020-05-23,Tripura,1369,4,1363,17428,2268,1084,7.86,2,4.1,116148,981,115520,55.32,26.44,4.250731707317073,0.84,99.46
2020-05-24,Tripura,738,2,736,8940,4315,2748,8.26,0,4.1,116886,983,116256,105.24,67.02,2.180487804878049,0.84,99.46
2020-05-25,Tripura,1582,21,1578,19692,2076,803,8.03,0,4.1,118468,1004,117834,50.63,19.59,4.802926829268293,0.85,99.46
2020-05-26,Tripura,130,1,130,1392,3931,1385,9.34,0,4.1,118598,1005,117964,95.88,33.78,0.33951219512195124,0.85,99.47
2020-05-27,Tripura,1020,9,1020,13021,3554,3439,7.83,0,4.1,119618,1014,118984,86.68,83.88,3.1758536585365857,0.85,99.47
2020-05-28,Tripura,1409,10,1403,17855,2331,711,7.89,0,4.1,121027,1024,120387,56.85,17.34,4.354878048780488,0.85,99.47
2020-05-29,Tripura,611,7,610,7541,2319,392,8.1,0,4.1,121638,1031,120997,56.56,9.56,1.8392682926829271,0.85,99.47
2020-05-30,Tripura,1243,7,1242,15445,4834,1793,8.05,0,4.1,122881,1038,122239,117.9,43.73,3.7670731707317078,0.84,99.48
2020-05-31,Tripura,497,5,489,5906,292,86,8.42,3,4.1,123378,1043,122728,7.12,2.1,1.440487804878049,0.85,99.47
2020-06-01,Tripura,873,9,864,11066,4971,1931,7.89,0,4.1,124251,1052,123592,121.24,47.1,2.6990243902439026,0.85,99.47
2020-06-02,Tripura,1399,12,1392,17631,2477,2172,7.93,0,4.1,125650,1064,124984,60.41,52.98,4.300243902439025,0.85,99.47
2020-06-03,Tripura,282,3,277,3157,2054,1609,8.93,2,4.1,125932,1067,125261,50.1,39.24,0.7700000000000001,0.85,99.47
2020-06-04,Tripura,1261,6,1261,16155,552,455,7.81,0,4.1,127193,1073,126522,13.46,11.1,3.940243902439025,0.84,99.47
2020-06-05,Tripura,1372,12,1364,17514,4661,685,7.83,0,4.1,128565,1085,127886,113.68,16.71,4.271707317073171,0.84,99.47
2020-06-06,Tripura,923,4,919,11599,4187,681,7.96,0,4.1,129488,1089,128805,102.12,16.61,2.829024390243903,0.84,99.47
2020-06-07,Tripura,738,10,730,9356,3100,1009,7.89,0,4.1,130226,1099,129535,75.61,24.61,2.2819512195121954,0.84,99.47
2020-06-08,Tripura,1022,13,1022,13178,1576,558,7.76,0,4.1,131248,1112,130557,38.44,13.61,3.214146341463415,0.85,99.47
2020-06-09,Tripura,791,6,787,9798,525,223,8.07,0,4.1,132039,1118,131344,12.8,5.44,2.389756097560976,0.85,99.47
2020-06-10,Tripura,1587,15,1584,19911,1331,25,7.97,0,4.1,133626,1133,132928,32.46,0.61,4.856341463414635,0.85,99.48
2020-06-11,Tripura,274,3,266,3417,1426,1096,8.02,5,4.1,133900,1136,133194,34.78,26.73,0.8334146341463415,0.85,99.47
2020-06-12,Tripura,425,4,423,5682,2470,649,7.48,0,4.1,134325,1140,133617,60.24,15.83,1.3858536585365855,0.85,99.47
2020-06-13,Tripura,1261,8,1260,16016,593,443,7.87,0,4.1,135586,1148,134877,14.46,10.8,3.9063414634146345,0.85,99.48
2020-06-14,Tripura,806,8,803,10132,4529,3928,7.95,0,4.1,136392,1156,135680,110.46,95.8,2.4712195121951224,0.85,99.48
2020-06-15,Tripura,1366,13,1357,17652,3250,1099,7.74,0,4.1,137758,1169,137037,79.27,26.8,4.305365853658537,0.85,99.48
2020-06-16,Tripura,317,1,310,3623,991,339,8.75,6,4.1,138075,1170,137347,24.17,8.27,0.883658536585366,0.85,99.47
2020-06-17,Tripura,1137,9,1133,13973,2866,1052,8.14,0,4.1,139212,1179,138480,69.9,25.66,3.4080487804878055,0.85,99.47
2020-06-18,Tripura,47,0,44,601,1660,1318,7.82,3,4.1,139259,1179,138524,40.49,32.15,0.14658536585365856,0.85,99.47
2020-06-19,Tripura,1243,11,1235,15491,1762,437,8.02,0,4.1,140502,1190,139759,42.98,10.66,3.7782926829268297,0.85,99.47
2020-06-20,Tripura,753,9,753,9549,4411,4198,7.89,0,4.1,141255,1199,140512,107.59,102.39,2.3290243902439025,0.85,99.47
2020-06-21,Tripura,65,0,64,943,3044,2316,6.89,1,4.1,141320,1199,140576,74.24,56.49,0.23000000000000004,0.85,99.47
2020-06-22,Tripura,1032,6,1029,12881,4632,2082,8.01,0,4.1,142352,1205,141605,112.98,50.78,3.141707317073171,0.85,99.48
2020-06-23,Tripura,322,4,319,3945,591,318,8.16,0,4.1,142674,1209,141924,14.41,7.76,0.9621951219512196,0.85,99.47
2020-06-24,Tripura,1035,12,1032,12518,3943,2666,8.27,0,4.1,143709,1221,142956,96.17,65.02,3.0531707317073176,0.85,99.48
2020-06-25,Tripura,1101,5,1095,13452,4891,2800,8.18,1,4.1,144810,1226,144051,119.29,68.29,3.280975609756098,0.85,99.48
2020-06-26,Tripura,1354,7,1351,17060,3561,3249,7.94,0,4.1,146164,1233,145402,86.85,79.24,4.160975609756098,0.84,99.48
2020-06-27,Tripura,287,1,281,3766,507,49,7.62,5,4.1,146451,1234,145683,12.37,1.2,0.9185365853658538,0.84,99.48
2020-06-28,Tripura,1013,12,1008,12500,482,452,8.1,0,4.1,147464,1246,146691,11.76,11.02,3.0487804878048785,0.84,99.48
2020-06-29,Tripura,46,0,41,735,3430,2342,6.26,5,4.1,147510,1246,146732,83.66,57.12,0.17926829268292685,0.84,99.47
2020-06-30,Tripura,1369,19,1365,17321,644,143,7.9,0,4.1,148879,1265,148097,15.71,3.49,4.224634146341464,0.85,99.47
2020-07-01,Tripura,556,4,549,6884,4177,1271,8.08,3,4.1,149435,1269,148646,101.88,31.0,1.6790243902439026,0.85,99.47
2020-07-02,Tripura,743,7,743,9742,2425,2138,7.63,0,4.1,150178,1276,149389,59.15,52.15,2.37609756097561,0.85,99.47
2020-07-03,Tripura,251,2,250,2931,3524,351,8.56,0,4.1,150429,1278,149639,85.95,8.56,0.7148780487804879,0.85,99.47
2020-07-04,Tripura,1564,7,1555,19656,1375,1216,7.96,2,4.1,151993,1285,151194,33.54,29.66,4.794146341463415,0.85,99.47
2020-07-05,Tripura,1297,11,1288,16212,1045,685,8.0,0,4.1,153290,1296,152482,25.49,16.71,3.954146341463415,0.85,99.47
2020-07-06,Tripura,318,1,309,3963,2382,2255,8.02,8,4.1,153608,1297,152791,58.1,55.0,0.9665853658536586,0.84,99.47
2020-07-07,Tripura,794,5,792,10164,3003,586,7.81,0,4.1,154402,1302,153583,73.24,14.29,2.479024390243903,0.84,99.47
2020-07-08,Tripura,1255,16,1249,15520,4376,2697,8.09,0,4.1,155657,1318,154832,106.73,65.78,3.785365853658537,0.85,99.47
2020-07-09,Tripura,1535,16,1534,19011,982,298,8.07,0,4.1,157192,1334,156366,23.95,7.27,4.636829268292684,0.85,99.47
2020-07-10,Tripura,1291,16,1283,16245,4868,518,7.95,0,4.1,158483,1350,157649,118.73,12.63,3.96219512195122,0.85,99.47
2020-07-11,Tripura,574,3,574,7080,2771,1271,8.11,0,4.1,159057,1353,158223,67.59,31.0,1.7268292682926831,0.85,99.48
2020-07-12,Tripura,1511,21,1509,18894,4198,2006,8.0,0,4.1,160568,1374,159732,102.39,48.93,4.608292682926829,0.86,99.48
2020-07-13,Tripura,909,5,907,11350,779,779,8.01,0,4.1,161477,1379,160639,19.0,19.0,2.7682926829268295,0.85,99.48
2020-07-14,Tripura,778,5,778,9914,671,27,7.85,0,4.1,162255,1384,161417,16.37,0.66,2.4180487804878052,0.85,99.48
2020-07-15,Tripura,40,0,39,637,1534,1437,6.28,1,4.1,162295,1384,161456,37.41,35.05,0.1553658536585366,0.85,99.48
2020-07-16,Tripura,237,1,237,2934,4211,137,8.08,0,4.1,162532,1385,161693,102.71,3.34,0.7156097560975611,0.85,99.48
2020-07-17,Tripura,1087,12,1087,13472,1404,1175,8.07,0,4.1,163619,1397,162780,34.24,28.66,3.2858536585365856,0.85,99.49
2020-07-18,Tripura,1334,15,1326,16654,2077,1858,8.01,0,4.1,164953,1412,164106,50.66,45.32,4.061951219512196,0.86,99.49
2020-07-19,Tripura,715,8,714,8714,1944,541,8.21,0,4.1,165668,1420,164820,47.41,13.2,2.1253658536585367,0.86,99.49
2020-07-20,Tripura,449,6,440,5392,3315,2822,8.33,3,4.1,166117,1426,165260,80.85,68.83,1.3151219512195123,0.86,99.48
2020-07-21,Tripura,362,3,354,4513,26,16,8.02,5,4.1,166479,1429,165614,0.63,0.39,1.1007317073170733,0.86,99.48
2020-07-22,Tripura,424,3,424,5272,1012,316,8.04,0,4.1,166903,1432,166038,24.68,7.71,1.2858536585365856,0.86,99.48
2020-07-23,Tripura,1008,3,1001,12564,3548,3291,8.02,4,4.1,167911,1435,167039,86.54,80.27,3.0643902439024395,0.85,99.48
2020-07-24,Tripura,658,9,656,8537,3440,3196,7.71,0,4.1,168569,1444,167695,83.9,77.95,2.08219512195122,0.86,99.48
2020-07-25,Tripura,1258,15,1257,16053,2813,375,7.84,0,4.1,169827,1459,168952,68.61,9.15,3.915365853658537,0.86,99.48
2020-07-26,Tripura,912,10,903,11467,2677,208,7.95,0,4.1,170739,1469,169855,65.29,5.07,2.7968292682926834,0.86,99.48
2020-07-27,Tripura,141,0,132,1625,4017,422,8.68,9,4.1,170880,1469,169987,97.98,10.29,0.39634146341463417,0.86,99.48
2020-07-28,Tripura,759,9,758,9125,4168,1518,8.32,0,4.1,171639,1478,170745,101.66,37.02,2.2256097560975614,0.86,99.48
2020-07-29,Tripura,1161,14,1153,14659,2144,209,7.92,0,4.1,172800,1492,171898,52.29,5.1,3.575365853658537,0.86,99.48
2020-07-30,Tripura,284,2,281,3307,404,259,8.59,1,4.1,173084,1494,172179,9.85,6.32,0.8065853658536586,0.86,99.48
2020-07-31,Tripura,1222,5,1213,15020,4209,1342,8.14,4,4.1,174306,1499,173392,102.66,32.73,3.663414634146342,0.86,99.48
2020-08-01,Tripura,133,0,127,1623,3022,2412,8.19,6,4.1,174439,1499,173519,73.71,58.83,0.3958536585365854,0.86,99.47
2020-08-02,Tripura,1381,13,1376,17446,4224,2756,7.92,0,4.1,175820,1512,174895,103.02,67.22,4.255121951219513,0.86,99.47
2020-08-03,Tripura,925,9,918,11268,2853,38,8.21,0,4.1,176745,1521,175813,69.59,0.93,2.7482926829268295,0.86,99.47
2020-08-04,Tripura,565,8,557,7128,2625,2575,7.93,0,4.1,177310,1529,176370,64.02,62.8,1.7385365853658539,0.86,99.47
2020-08-05,Tripura,1529,5,1528,19310,1748,1323,7.92,0,4.1,178839,1534,177898,42.63,32.27,4.709756097560976,0.86,99.47
2020-08-06,Tripura,47,0,39,612,4294,2892,7.68,8,4.1,178886,1534,177937,104.73,70.54,0.14926829268292685,0.86,99.47
2020-08-07,Tripura,334,3,328,3958,2754,1364,8.44,3,4.1,179220,1537,178265,67.17,33.27,0.9653658536585367,0.86,99.47
2020-08-08,Tripura,890,7,881,11126,1860,760,8.0,2,4.1,180110,1544,179146,45.37,18.54,2.713658536585366,0.86,99.46
2020-08-09,Tripura,187,1,182,2477,173,62,7.55,4,4.1,180297,1545,179328,4.22,1.51,0.6041463414634147,0.86,99.46
2020-08-10,Tripura,641,4,638,8318,4576,1346,7.71,0,4.1,180938,1549,179966,111.61,32.83,2.028780487804878,0.86,99.46
2020-08-11,Tripura,1575,19,1569,19949,1756,1580,7.9,0,4.1,182513,1568,181535,42.83,38.54,4.8656097560975615,0.86,99.46
2020-08-12,Tripura,1201,9,1199,15053,3173,2640,7.98,0,4.1,183714,1577,182734,77.39,64.39,3.6714634146341467,0.86,99.47
2020-08-13,Tripura,189,1,189,2356,4712,1125,8.02,0,4.1,183903,1578,182923,114.93,27.44,0.5746341463414635,0.86,99.47
2020-08-14,Tripura,870,11,869,11127,4489,1226,7.82,0,4.1,184773,1589,183792,109.49,29.9,2.7139024390243907,0.86,99.47
2020-08-15,Tripura,1458,10,1451,18138,2922,2142,8.04,0,4.1,186231,1599,185243,71.27,52.24,4.423902439024391,0.86,99.47
2020-08-16,Tripura,324,2,315,4069,1322,213,7.96,7,4.1,186555,1601,185558,32.24,5.2,0.992439024390244,0.86,99.47
2020-08-17,Tripura,898,6,895,11494,1955,38,7.81,0,4.1,187453,1607,186453,47.68,0.93,2.8034146341463417,0.86,99.47
2020-08-18,Tripura,670,7,666,8258,2658,2464,8.11,0,4.1,188123,1614,187119,64.83,60.1,2.0141463414634146,0.86,99.47
2020-08-19,Tripura,345,2,341,4141,4251,3096,8.33,2,4.1,188468,1616,187460,103.68,75.51,1.01,0.86,99.47
2020-08-20,Tripura,1609,13,1608,19809,3917,2814,8.12,0,4.1,190077,1629,189068,95.54,68.63,4.831463414634147,0.86,99.47
2020-08-21,Tripura,507,5,507,6332,4505,2667,8.01,0,4.1,190584,1634,189575,109.88,65.05,1.5443902439024393,0.86,99.47
2020-08-22,Tripura,906,9,900,11058,3782,3661,8.19,0,4.1,191490,1643,190475,92.24,89.29,2.6970731707317075,0.86,99.47
2020-08-23,Tripura,1533,22,1533,19007,1650,555,8.07,0,4.1,193023,1665,192008,40.24,13.54,4.635853658536586,0.86,99.47
2020-08-24,Tripura,912,6,909,11516,3578,3562,7.92,0,4.1,193935,1671,192917,87.27,86.88,2.8087804878048783,0.86,99.48
2020-08-25,Tripura,1219,11,1217,14884,1578,724,8.19,0,4.1,195154,1682,194134,38.49,17.66,3.630243902439025,0.86,99.48
2020-08-26,Tripura,236,1,234,2613,1245,635,9.03,1,4.1,195390,1683,194368,30.37,15.49,0.6373170731707318,0.86,99.48
2020-08-27,Tripura,775,4,768,9814,1145,912,7.9,3,4.1,196165,1687,195136,27.93,22.24,2.393658536585366,0.86,99.48
2020-08-28,Tripura,1410,16,1408,17573,4833,2067,8.02,0,4.1,197575,1703,196544,117.88,50.41,4.286097560975611,0.86,99.48
2020-08-29,Tripura,1240,10,1238,15321,2363,1864,8.09,0,4.1,198815,1713,197782,57.63,45.46,3.7368292682926834,0.86,99.48
2020-08-30,Tripura,210,2,202,2387,1335,946,8.8,6,4.1,199025,1715,197984,32.56,23.07,0.5821951219512196,0.86,99.48
2020-08-31,Tripura,1405,9,1399,17572,4935,2884,8.0,0,4.1,200430,1724,199383,120.37,70.34,4.285853658536586,0.86,99.48
2020-09-01,Tripura,795,4,795,9694,2484,2402,8.2,0,4.1,201225,1728,200178,60.59,58.59,2.3643902439024393,0.86,99.48
2020-09-02,Tripura,1133,16,1126,14155,3144,683,8.0,0,4.1,202358,1744,201304,76.68,16.66,3.452439024390244,0.86,99.48
2020-09-03,Tripura,83,0,78,637,2500,1825,13.03,5,4.1,202441,1744,201382,60.98,44.51,0.1553658536585366,0.86,99.48
2020-09-04,Tripura,538,7,533,6692,197,9,8.04,0,4.1,202979,1751,201915,4.8,0.22,1.6321951219512196,0.86,99.48
2020-09-05,Tripura,896,7,895,11333,584,11,7.91,0,4.1,203875,1758,202810,14.24,0.27,2.764146341463415,0.86,99.48
2020-09-06,Tripura,416,2,414,5203,3648,3483,8.0,0,4.1,204291,1760,203224,88.98,84.95,1.2690243902439027,0.86,99.48
2020-09-07,Tripura,1527,22,1519,19255,2419,222,7.93,0,4.1,205818,1782,204743,59.0,5.41,4.696341463414635,0.87,99.48
2020-09-08,Tripura,309,3,307,4232,995,967,7.3,0,4.1,206127,1785,205050,24.27,23.59,1.0321951219512195,0.87,99.48
2020-09-09,Tripura,889,12,881,11040,2302,298,8.05,0,4.1,207016,1797,205931,56.15,7.27,2.6926829268292685,0.87,99.48
2020-09-10,Tripura,1429,12,1420,17517,1996,1721,8.16,0,4.1,208445,1809,207351,48.68,41.98,4.272439024390245,0.87,99.48
2020-09-11,Tripura,1406,4,1405,17485,2351,2218,8.04,0,4.1,209851,1813,208756,57.34,54.1,4.264634146341464,0.86,99.48
2020-09-12,Tripura,1067,15,1065,13429,1043,105,7.95,0,4.1,210918,1828,209821,25.44,2.56,3.275365853658537,0.87,99.48
2020-09-13,Tripura,631,7,627,8200,4644,3513,7.7,0,4.1,211549,1835,210448,113.27,85.68,2.0000000000000004,0.87,99.48
2020-09-14,Tripura,1532,15,1528,19066,374,97,8.04,0,4.1,213081,1850,211976,9.12,2.37,4.6502439024390245,0.87,99.48
2020-09-15,Tripura,516,6,516,5977,3576,2048,8.63,0,4.1,213597,1856,212492,87.22,49.95,1.4578048780487807,0.87,99.48
2020-09-16,Tripura,1515,22,1506,18980,2229,2130,7.98,0,4.1,215112,1878,213998,54.37,51.95,4.629268292682927,0.87,99.48
2020-09-17,Tripura,455,5,455,5444,3017,780,8.36,0,4.1,215567,1883,214453,73.59,19.02,1.3278048780487806,0.87,99.48
2020-09-18,Tripura,1473,19,1470,18886,1514,963,7.8,0,4.1,217040,1902,215923,36.93,23.49,4.606341463414634,0.88,99.49
2020-09-19,Tripura,1024,12,1016,12577,2993,601,8.14,0,4.1,218064,1914,216939,73.0,14.66,3.0675609756097564,0.88,99.48
2020-09-20,Tripura,61,0,55,889,3475,3013,6.86,6,4.1,218125,1914,216994,84.76,73.49,0.21682926829268295,0.88,99.48
2020-09-21,Tripura,77,1,77,820,535,416,9.39,0,4.1,218202,1915,217071,13.05,10.15,0.2,0.88,99.48
2020-09-22,Tripura,1237,8,1232,15803,1640,1024,7.83,0,4.1,219439,1923,218303,40.0,24.98,3.8543902439024396,0.88,99.48
2020-09-23,Tripura,1193,13,1189,14801,661,164,8.06,0,4.1,220632,1936,219492,16.12,4.0,3.6100000000000003,0.88,99.48
2020-09-24,Tripura,1386,8,1378,17252,4599,492,8.03,0,4.1,222018,1944,220870,112.17,12.0,4.207804878048781,0.88,99.48
2020-09-25,Tripura,783,9,779,9961,498,386,7.86,0,4.1,222801,1953,221649,12.15,9.41,2.4295121951219514,0.88,99.48
2020-09-26,Tripura,118,0,115,1362,3875,536,8.66,3,4.1,222919,1953,221764,94.51,13.07,0.33219512195121953,0.88,99.48
2020-09-27,Tripura,1078,13,1073,13468,1664,369,8.0,0,4.1,223997,1966,222837,40.59,9.0,3.284878048780488,0.88,99.48
2020-09-28,Tripura,1370,14,1370,17051,3801,842,8.03,0,4.1,225367,1980,224207,92.71,20.54,4.158780487804878,0.88,99.49
2020-09-29,Tripura,272,2,266,2945,4313,2257,9.24,4,4.1,225639,1982,224473,105.2,55.05,0.7182926829268294,0.88,99.48
2020-09-30,Tripura,931,13,930,11897,2206,432,7.83,0,4.1,226570,1995,225403,53.8,10.54,2.901707317073171,0.88,99.48
2020-10-01,Tripura,966,4,963,11739,424,421,8.23,0,4.1,227536,1999,226366,10.34,10.27,2.8631707317073176,0.88,99.49
2020-10-02,Tripura,71,0,66,1040,3948,2580,6.83,5,4.1,227607,1999,226432,96.29,62.93,0.25365853658536586,0.88,99.48
2020-10-03,Tripura,198,2,197,3016,799,128,6.56,0,4.1,227805,2001,226629,19.49,3.12,0.7356097560975611,0.88,99.48
2020-10-04,Tripura,916,10,912,11516,4302,1240,7.95,0,4.1,228721,2011,227541,104.93,30.24,2.8087804878048783,0.88,99.48
2020-10-05,Tripura,729,5,721,8985,2213,1223,8.11,3,4.1,229450,2016,228262,53.98,29.83,2.1914634146341467,0.88,99.48
2020-10-06,Tripura,376,1,369,5276,1597,638,7.13,6,4.1,229826,2017,228631,38.95,15.56,1.2868292682926832,0.88,99.48
2020-10-07,Tripura,694,6,694,8550,4290,3687,8.12,0,4.1,230520,2023,229325,104.63,89.93,2.0853658536585367,0.88,99.48
2020-10-08,Tripura,476,2,472,5938,4049,1053,8.02,2,4.1,230996,2025,229797,98.76,25.68,1.4482926829268294,0.88,99.48
2020-10-09,Tripura,282,1,277,3433,287,23,8.21,4,4.1,231278,2026,230074,7.0,0.56,0.8373170731707318,0.88,99.48
2020-10-10,Tripura,730,8,726,8804,3249,2905,8.29,0,4.1,232008,2034,230800,79.24,70.85,2.147317073170732,0.88,99.48
2020-10-11,Tripura,939,7,938,11357,4725,3379,8.27,0,4.1,232947,2041,231738,115.24,82.41,2.7700000000000005,0.88,99.48
2020-10-12,Tripura,948,11,945,11982,3443,846,7.91,0,4.1,233895,2052,232683,83.98,20.63,2.9224390243902443,0.88,99.48
2020-10-13,Tripura,476,4,473,5639,692,453,8.44,0,4.1,234371,2056,233156,16.88,11.05,1.3753658536585367,0.88,99.48
2020-10-14,Tripura,519,3,514,6162,957,803,8.42,2,4.1,234890,2059,233670,23.34,19.59,1.502926829268293,0.88,99.48
2020-10-15,Tripura,505,1,502,6467,4809,4126,7.81,2,4.1,235395,2060,234172,117.29,100.63,1.5773170731707318,0.88,99.48
2020-10-16,Tripura,1358,16,1358,16903,4320,3290,8.03,0,4.1,236753,2076,235530,105.37,80.24,4.122682926829269,0.88,99.48
2020-10-17,Tripura,159,0,158,2367,471,66,6.72,1,4.1,236912,2076,235688,11.49,1.61,0.5773170731707318,0.88,99.48
2020-10-18,Tripura,648,7,642,8058,4383,2271,8.04,0,4.1,237560,2083,236330,106.9,55.39,1.9653658536585368,0.88,99.48
2020-10-19,Tripura,1256,15,1249,15832,1124,698,7.93,0,4.1,238816,2098,237579,27.41,17.02,3.8614634146341467,0.88,99.48
2020-10-20,Tripura,1232,7,1229,15485,4606,4448,7.96,0,4.1,240048,2105,238808,112.34,108.49,3.7768292682926834,0.88,99.48
2020-10-21,Tripura,678,5,675,8512,4189,3296,7.97,0,4.1,240726,2110,239483,102.17,80.39,2.07609756097561,0.88,99.48
2020-10-22,Tripura,1002,6,995,12298,4897,544,8.15,1,4.1,241728,2116,240478,119.44,13.27,2.9995121951219517,0.88,99.48
2020-10-23,Tripura,466,2,466,5980,4086,1086,7.79,0,4.1,242194,2118,240944,99.66,26.49,1.4585365853658538,0.87,99.48
2020-10-24,Tripura,1528,15,1523,19098,1869,1838,8.0,0,4.1,243722,2133,242467,45.59,44.83,4.658048780487805,0.88,99.49
2020-10-25,Tripura,751,10,751,9557,1974,1481,7.86,0,4.1,244473,2143,243218,48.15,36.12,2.3309756097560976,0.88,99.49
2020-10-26,Tripura,988,6,982,12059,2615,1073,8.19,0,4.1,245461,2149,244200,63.78,26.17,2.941219512195122,0.88,99.49
2020-10-27,Tripura,1544,22,1536,19298,932,9,8.0,0,4.1,247005,2171,245736,22.73,0.22,4.706829268292683,0.88,99.49
2020-10-28,Tripura,438,4,437,5573,1169,420,7.86,0,4.1,247443,2175,246173,28.51,10.24,1.359268292682927,0.88,99.49
2020-10-29,Tripura,179,1,174,1939,902,470,9.23,4,4.1,247622,2176,246347,22.0,11.46,0.4729268292682927,0.88,99.49
2020-10-30,Tripura,1303,16,1298,16665,2305,847,7.82,0,4.1,248925,2192,247645,56.22,20.66,4.064634146341464,0.88,99.49
2020-10-31,Tripura,1450,18,1446,18259,1534,1422,7.94,0,4.1,250375,2210,249091,37.41,34.68,4.453414634146342,0.88,99.49
2020-11-01,Tripura,468,4,464,6126,170,126,7.64,0,4.1,250843,2214,249555,4.15,3.07,1.4941463414634149,0.88,99.49
2020-11-02,Tripura,781,9,773,10194,1444,1326,7.66,0,4.1,251624,2223,250328,35.22,32.34,2.4863414634146346,0.88,99.48
2020-11-03,Tripura,944,5,941,11776,3969,2862,8.02,0,4.1,252568,2228,251269,96.8,69.8,2.87219512195122,0.88,99.49
2020-11-04,Tripura,936,11,934,11539,2838,511,8.11,0,4.1,253504,2239,252203,69.22,12.46,2.8143902439024395,0.88,99.49
2020-11-05,Tripura,148,1,145,1651,839,632,8.96,2,4.1,253652,2240,252348,20.46,15.41,0.4026829268292683,0.88,99.49
2020-11-06,Tripura,1469,19,1466,18542,1309,488,7.92,0,4.1,255121,2259,253814,31.93,11.9,4.522439024390245,0.89,99.49
2020-11-07,Tripura,1048,15,1043,13088,4190,1220,8.01,0,4.1,256169,2274,254857,102.2,29.76,3.1921951219512197,0.89,99.49
2020-11-08,Tripura,1408,20,1408,17675,2352,1847,7.97,0,4.1,257577,2294,256265,57.37,45.05,4.310975609756098,0.89,99.49
2020-11-09,Tripura,587,3,584,7276,3871,2973,8.07,0,4.1,258164,2297,256849,94.41,72.51,1.7746341463414637,0.89,99.49
2020-11-10,Tripura,432,4,432,5288,238,128,8.17,0,4.1,258596,2301,257281,5.8,3.12,1.2897560975609759,0.89,99.49
2020-11-11,Tripura,201,2,195,2499,1002,903,8.04,4,4.1,258797,2303,257476,24.44,22.02,0.6095121951219513,0.89,99.49
2020-11-12,Tripura,109,1,102,1653,2961,544,6.59,6,4.1,258906,2304,257578,72.22,13.27,0.4031707317073171,0.89,99.49
2020-11-13,Tripura,641,9,634,7885,2870,1078,8.13,0,4.1,259547,2313,258212,70.0,26.29,1.9231707317073172,0.89,99.49
2020-11-14,Tripura,884,5,876,11203,1694,1495,7.89,3,4.1,260431,2318,259088,41.32,36.46,2.7324390243902443,0.89,99.48
2020-11-15,Tripura,1524,22,1523,18742,4857,1930,8.13,0,4.1,261955,2340,260611,118.46,47.07,4.571219512195123,0.89,99.49
2020-11-16,Tripura,380,4,373,5006,2086,743,7.59,3,4.1,262335,2344,260984,50.88,18.12,1.2209756097560978,0.89,99.49
2020-11-17,Tripura,364,2,360,4168,1019,875,8.73,2,4.1,262699,2346,261344,24.85,21.34,1.0165853658536586,0.89,99.48
2020-11-18,Tripura,1396,19,1396,17085,215,15,8.17,0,4.1,264095,2365,262740,5.24,0.37,4.167073170731708,0.9,99.49
2020-11-19,Tripura,352,2,348,4341,4027,3235,8.11,2,4.1,264447,2367,263088,98.22,78.9,1.058780487804878,0.9,99.49
2020-11-20,Tripura,1410,8,1404,17528,3150,1150,8.04,0,4.1,265857,2375,264492,76.83,28.05,4.275121951219512,0.89,99.49
2020-11-21,Tripura,261,1,260,2810,4783,2262,9.29,0,4.1,266118,2376,264752,116.66,55.17,0.6853658536585366,0.89,99.49
2020-11-22,Tripura,336,3,336,4665,4273,1748,7.2,0,4.1,266454,2379,265088,104.22,42.63,1.1378048780487806,0.89,99.49
2020-11-23,Tripura,1459,17,1458,18185,4633,3107,8.02,0,4.1,267913,2396,266546,113.0,75.78,4.435365853658537,0.89,99.49
2020-11-24,Tripura,677,7,671,8646,2907,2350,7.83,0,4.1,268590,2403,267217,70.9,57.32,2.108780487804878,0.89,99.49
2020-11-25,Tripura,608,4,601,7846,4414,2049,7.75,3,4.1,269198,2407,267818,107.66,49.98,1.913658536585366,0.89,99.49
2020-11-26,Tripura,1343,4,1334,16581,2285,1069,8.1,5,4.1,270541,2411,269152,55.73,26.07,4.044146341463415,0.89,99.49
2020-11-27,Tripura,274,2,270,3448,4474,3243,7.95,2,4.1,270815,2413,269422,109.12,79.1,0.8409756097560976,0.89,99.49
2020-11-28,Tripura,1543,5,1538,19712,2857,2123,7.83,0,4.1,272358,2418,270960,69.68,51.78,4.807804878048781,0.89,99.49
2020-11-29,Tripura,358,2,355,4830,3188,2219,7.41,1,4.1,272716,2420,271315,77.76,54.12,1.178048780487805,0.89,99.49
2020-11-30,Tripura,1210,13,1210,14932,4929,1138,8.1,0,4.1,273926,2433,272525,120.22,27.76,3.6419512195121957,0.89,99.49
2020-12-01,Tripura,87,0,83,962,2189,115,9.04,4,4.1,274013,2433,272608,53.39,2.8,0.23463414634146343,0.89,99.49
2020-12-02,Tripura,1229,15,1220,15285,454,139,8.04,0,4.1,275242,2448,273828,11.07,3.39,3.7280487804878053,0.89,99.49
2020-12-03,Tripura,1480,20,1472,18638,4630,1989,7.94,0,4.1,276722,2468,275300,112.93,48.51,4.545853658536586,0.89,99.49
2020-12-04,Tripura,568,2,567,7203,1987,976,7.89,0,4.1,277290,2470,275867,48.46,23.8,1.7568292682926832,0.89,99.49
2020-12-05,Tripura,968,11,959,12206,1963,912,7.93,0,4.1,278258,2481,276826,47.88,22.24,2.9770731707317077,0.89,99.49
2020-12-06,Tripura,885,11,879,11106,425,279,7.97,0,4.1,279143,2492,277705,10.37,6.8,2.7087804878048782,0.89,99.48
2020-12-07,Tripura,1008,10,1006,12492,3308,840,8.07,0,4.1,280151,2502,278711,80.68,20.49,3.0468292682926834,0.89,99.49
2020-12-08,Tripura,534,6,529,6620,180,64,8.07,0,4.1,280685,2508,279240,4.39,1.56,1.6146341463414635,0.89,99.49
2020-12-09,Tripura,544,6,535,6577,4423,252,8.27,3,4.1,281229,2514,279775,107.88,6.15,1.6041463414634147,0.89,99.48
2020-12-10,Tripura,174,1,171,2117,2623,782,8.22,2,4.1,281403,2515,279946,63.98,19.07,0.5163414634146342,0.89,99.48
2020-12-11,Tripura,1250,14,1247,15517,3988,497,8.06,0,4.1,282653,2529,281193,97.27,12.12,3.784634146341464,0.89,99.48
2020-12-12,Tripura,796,7,792,10210,1692,1366,7.8,0,4.1,283449,2536,281985,41.27,33.32,2.490243902439025,0.89,99.48
2020-12-13,Tripura,367,2,367,4643,3085,1926,7.9,0,4.1,283816,2538,282352,75.24,46.98,1.132439024390244,0.89,99.48
2020-12-14,Tripura,1125,13,1118,13760,4413,2477,8.18,0,4.1,284941,2551,283470,107.63,60.41,3.35609756097561,0.9,99.48
2020-12-15,Tripura,1574,16,1568,19510,400,227,8.07,0,4.1,286515,2567,285038,9.76,5.54,4.758536585365854,0.9,99.48
2020-12-16,Tripura,1202,17,1202,15039,250,234,7.99,0,4.1,287717,2584,286240,6.1,5.71,3.6680487804878052,0.9,99.49
2020-12-17,Tripura,347,1,346,4189,2832,1059,8.28,0,4.1,288064,2585,286586,69.07,25.83,1.0217073170731708,0.9,99.49
2020-12-18,Tripura,1505,10,1501,19033,363,35,7.91,0,4.1,289569,2595,288087,8.85,0.85,4.64219512195122,0.9,99.49
2020-12-19,Tripura,785,4,778,9695,2713,32,8.1,3,4.1,290354,2599,288865,66.17,0.78,2.3646341463414635,0.9,99.49
2020-12-20,Tripura,1294,10,1288,16366,2350,184,7.91,0,4.1,291648,2609,290153,57.32,4.49,3.991707317073171,0.89,99.49
2020-12-21,Tripura,1182,9,1179,14724,1269,412,8.03,0,4.1,292830,2618,291332,30.95,10.05,3.5912195121951225,0.89,99.49
2020-12-22,Tripura,155,2,153,1852,871,711,8.37,0,4.1,292985,2620,291485,21.24,17.34,0.4517073170731708,0.89,99.49
2020-12-23,Tripura,815,3,812,10326,2003,49,7.89,0,4.1,293800,2623,292297,48.85,1.2,2.518536585365854,0.89,99.49
2020-12-24,Tripura,297,3,288,3812,29,6,7.79,6,4.1,294097,2626,292585,0.71,0.15,0.9297560975609758,0.89,99.49
2020-12-25,Tripura,698,8,698,8619,4856,1769,8.1,0,4.1,294795,2634,293283,118.44,43.15,2.10219512195122,0.89,99.49
2020-12-26,Tripura,122,1,121,1249,333,110,9.77,0,4.1,294917,2635,293404,8.12,2.68,0.30463414634146346,0.89,99.49
2020-12-27,Tripura,1187,12,1179,15061,3953,1285,7.88,0,4.1,296104,2647,294583,96.41,31.34,3.673414634146342,0.89,99.49
2020-12-28,Tripura,764,7,762,9533,901,465,8.01,0,4.1,296868,2654,295345,21.98,11.34,2.3251219512195123,0.89,99.49
2020-12-29,Tripura,1474,22,1471,18478,1665,1258,7.98,0,4.1,298342,2676,296816,40.61,30.68,4.506829268292684,0.9,99.49
2020-12-30,Tripura,1132,10,1126,13873,3372,1870,8.16,0,4.1,299474,2686,297942,82.24,45.61,3.3836585365853664,0.9,99.49
2020-12-31,Tripura,1297,9,1290,16010,2578,519,8.1,0,4.1,300771,2695,299232,62.88,12.66,3.904878048780488,0.9,99.49
2021-01-01,Tripura,175,2,167,2203,1467,556,7.94,6,4.1,300946,2697,299399,35.78,13.56,0.5373170731707317,0.9,99.49
2021-01-02,Tripura,452,6,450,5804,4310,4289,7.79,0,4.1,301398,2703,299849,105.12,104.61,1.4156097560975611,0.9,99.49
2021-01-03,Tripura,1209,10,1202,14875,4082,3815,8.13,0,4.1,302607,2713,301051,99.56,93.05,3.628048780487805,0.9,99.49
2021-01-04,Tripura,992,3,986,12309,342,133,8.06,3,4.1,303599,2716,302037,8.34,3.24,3.0021951219512197,0.89,99.49
2021-01-05,Tripura,429,3,420,5198,141,140,8.25,6,4.1,304028,2719,302457,3.44,3.41,1.2678048780487807,0.89,99.48
2021-01-06,Tripura,161,1,155,2155,28,28,7.47,5,4.1,304189,2720,302612,0.68,0.68,0.525609756097561,0.89,99.48
2021-01-07,Tripura,492,3,489,6369,4707,1062,7.72,0,4.1,304681,2723,303101,114.8,25.9,1.5534146341463417,0.89,99.48
2021-01-08,Tripura,1097,3,1096,13990,2684,611,7.84,0,4.1,305778,2726,304197,65.46,14.9,3.41219512195122,0.89,99.48
2021-01-09,Tripura,1460,18,1451,18547,3882,97,7.87,0,4.1,307238,2744,305648,94.68,2.37,4.5236585365853665,0.89,99.48
2021-01-10,Tripura,1565,11,1563,19742,1603,1283,7.93,0,4.1,308803,2755,307211,39.1,31.29,4.8151219512195125,0.89,99.48
2021-01-11,Tripura,1259,14,1250,16020,1217,197,7.86,0,4.1,310062,2769,308461,29.68,4.8,3.907317073170732,0.89,99.48
2021-01-12,Tripura,136,1,132,1297,4478,3760,10.49,3,4.1,310198,2770,308593,109.22,91.71,0.3163414634146342,0.89,99.48
2021-01-13,Tripura,170,0,166,2151,2475,397,7.9,4,4.1,310368,2770,308759,60.37,9.68,0.5246341463414634,0.89,99.48
2021-01-14,Tripura,1358,6,1356,17753,2581,1090,7.65,0,4.1,311726,2776,310115,62.95,26.59,4.33,0.89,99.48
2021-01-15,Tripura,1186,6,1185,15337,2653,1188,7.73,0,4.1,312912,2782,311300,64.71,28.98,3.7407317073170736,0.89,99.48
2021-01-16,Tripura,229,2,220,2880,4985,2322,7.95,7,4.1,313141,2784,311520,121.59,56.63,0.702439024390244,0.89,99.48
2021-01-17,Tripura,593,3,593,7359,3620,602,8.06,0,4.1,313734,2787,312113,88.29,14.68,1.794878048780488,0.89,99.48
2021-01-18,Tripura,910,7,903,11443,2911,1131,7.95,0,4.1,314644,2794,313016,71.0,27.59,2.790975609756098,0.89,99.48
2021-01-19,Tripura,1113,9,1105,13377,4958,3456,8.32,0,4.1,315757,2803,314121,120.93,84.29,3.2626829268292687,0.89,99.48
2021-01-20,Tripura,1398,5,1396,17646,3123,739,7.92,0,4.1,317155,2808,315517,76.17,18.02,4.303902439024391,0.89,99.48
2021-01-21,Tripura,271,3,264,3151,1509,1039,8.6,4,4.1,317426,2811,315781,36.8,25.34,0.7685365853658538,0.89,99.48
2021-01-22,Tripura,1471,9,1470,18480,4342,1593,7.96,0,4.1,318897,2820,317251,105.9,38.85,4.507317073170732,0.88,99.48
2021-01-23,Tripura,647,3,647,8070,4449,487,8.02,0,4.1,319544,2823,317898,108.51,11.88,1.9682926829268295,0.88,99.48
2021-01-24,Tripura,417,3,412,5199,589,478,8.02,2,4.1,319961,2826,318310,14.37,11.66,1.2680487804878051,0.88,99.48
2021-01-25,Tripura,59,0,52,543,3086,1680,10.87,7,4.1,320020,2826,318362,75.27,40.98,0.1324390243902439,0.88,99.48
2021-01-26,Tripura,1184,16,1178,14851,1526,585,7.97,0,4.1,321204,2842,319540,37.22,14.27,3.62219512195122,0.88,99.48
2021-01-27,Tripura,712,3,711,8844,3310,776,8.05,0,4.1,321916,2845,320251,80.73,18.93,2.1570731707317075,0.88,99.48
2021-01-28,Tripura,478,6,478,6070,97,23,7.87,0,4.1,322394,2851,320729,2.37,0.56,1.480487804878049,0.88,99.48
2021-01-29,Tripura,158,0,155,2393,562,76,6.6,3,4.1,322552,2851,320884,13.71,1.85,0.5836585365853659,0.88,99.48
2021-01-30,Tripura,1071,14,1070,13125,4768,3632,8.16,0,4.1,323623,2865,321954,116.29,88.59,3.2012195121951224,0.89,99.48
2021-01-31,Tripura,693,3,689,8501,3632,1281,8.15,1,4.1,324316,2868,322643,88.59,31.24,2.0734146341463418,0.88,99.48
2021-02-01,Tripura,386,5,382,4959,4050,3623,7.78,0,4.1,324702,2873,323025,98.78,88.37,1.2095121951219514,0.88,99.48
2021-02-02,Tripura,41,0,41,951,4748,2618,4.31,0,4.1,324743,2873,323066,115.8,63.85,0.23195121951219516,0.88,99.48
2021-02-03,Tripura,1440,19,1437,17766,2305,873,8.11,0,4.1,326183,2892,324503,56.22,21.29,4.333170731707318,0.89,99.48
2021-02-04,Tripura,287,0,286,3729,3544,1032,7.7,1,4.1,326470,2892,324789,86.44,25.17,0.9095121951219514,0.89,99.49
2021-02-05,Tripura,236,2,232,3161,1140,575,7.47,2,4.1,326706,2894,325021,27.8,14.02,0.7709756097560977,0.89,99.48
2021-02-06,Tripura,1237,15,1230,15374,50,42,8.05,0,4.1,327943,2909,326251,1.22,1.02,3.749756097560976,0.89,99.48
2021-02-07,Tripura,1223,14,1223,15239,2897,2729,8.03,0,4.1,329166,2923,327474,70.66,66.56,3.7168292682926833,0.89,99.49
2021-02-08,Tripura,1497,14,1494,18488,4210,293,8.1,0,4.1,330663,2937,328968,102.68,7.15,4.509268292682927,0.89,99.49
2021-02-09,Tripura,1128,15,1120,14400,4011,3431,7.83,0,4.1,331791,2952,330088,97.83,83.68,3.51219512195122,0.89,99.49
2021-02-10,Tripura,52,0,44,921,2216,1420,5.65,8,4.1,331843,2952,330132,54.05,34.63,0.22463414634146345,0.89,99.48
2021-02-11,Tripura,950,10,944,11829,1832,219,8.03,0,4.1,332793,2962,331076,44.68,5.34,2.8851219512195123,0.89,99.48
2021-02-12,Tripura,446,4,446,5523,384,121,8.08,0,4.1,333239,2966,331522,9.37,2.95,1.3470731707317074,0.89,99.48
2021-02-13,Tripura,829,12,829,10158,3381,1381,8.16,0,4.1,334068,2978,332351,82.46,33.68,2.4775609756097565,0.89,99.49
2021-02-14,Tripura,907,3,901,11278,3500,2287,8.04,3,4.1,334975,2981,333252,85.37,55.78,2.7507317073170734,0.89,99.49
2021-02-15,Tripura,74,0,68,568,2139,860,13.03,6,4.1,335049,2981,333320,52.17,20.98,0.13853658536585367,0.89,99.48
2021-02-16,Tripura,1107,13,1098,13763,2769,297,8.04,0,4.1,336156,2994,334418,67.54,7.24,3.3568292682926835,0.89,99.48
2021-02-17,Tripura,474,1,472,5745,1638,179,8.25,1,4.1,336630,2995,334890,39.95,4.37,1.401219512195122,0.89,99.48
2021-02-18,Tripura,1081,14,1072,13728,4727,4656,7.87,0,4.1,337711,3009,335962,115.29,113.56,3.3482926829268296,0.89,99.48
2021-02-19,Tripura,1166,16,1164,14614,1998,864,7.98,0,4.1,338877,3025,337126,48.73,21.07,3.5643902439024395,0.89,99.48
2021-02-20,Tripura,320,3,316,3657,949,328,8.75,1,4.1,339197,3028,337442,23.15,8.0,0.8919512195121952,0.89,99.48
2021-02-21,Tripura,1500,21,1491,18583,3531,1025,8.07,0,4.1,340697,3049,338933,86.12,25.0,4.532439024390245,0.89,99.48
2021-02-22,Tripura,518,5,514,6309,4783,1784,8.21,0,4.1,341215,3054,339447,116.66,43.51,1.5387804878048783,0.9,99.48
2021-02-23,Tripura,130,1,126,1130,2639,2221,11.5,3,4.1,341345,3055,339573,64.37,54.17,0.275609756097561,0.89,99.48
2021-02-24,Tripura,79,0,74,1011,568,518,7.81,5,4.1,341424,3055,339647,13.85,12.63,0.24658536585365856,0.89,99.48
2021-02-25,Tripura,1613,17,1611,19716,4763,4152,8.18,0,4.1,343037,3072,341258,116.17,101.27,4.808780487804879,0.9,99.48
2021-02-26,Tripura,115,0,106,1578,2682,1617,7.29,9,4.1,343152,3072,341364,65.41,39.44,0.38487804878048787,0.9,99.48
2021-02-27,Tripura,889,6,885,11166,1486,1236,7.96,0,4.1,344041,3078,342249,36.24,30.15,2.7234146341463417,0.89,99.48
2021-02-28,Tripura,826,6,821,10114,4713,3323,8.17,0,4.1,344867,3084,343070,114.95,81.05,2.4668292682926833,0.89,99.48
2021-03-01,Tripura,1393,6,1391,17486,2870,1130,7.97,0,4.1,346260,3090,344461,70.0,27.56,4.2648780487804885,0.89,99.48
2021-03-02,Tripura,126,0,120,1518,4092,3868,8.3,6,4.1,346386,3090,344581,99.8,94.34,0.37024390243902444,0.89,99.48
2021-03-03,Tripura,930,4,921,11815,297,162,7.87,5,4.1,347316,3094,345502,7.24,3.95,2.881707317073171,0.89,99.48
2021-03-04,Tripura,747,10,747,9435,3222,2094,7.92,0,4.1,348063,3104,346249,78.59,51.07,2.301219512195122,0.89,99.48
2021-03-05,Tripura,1580,22,1573,19819,2675,1074,7.97,0,4.1,349643,3126,347822,65.24,26.2,4.833902439024391,0.89,99.48
2021-03-06,Tripura,611,7,605,7960,201,193,7.68,0,4.1,350254,3133,348427,4.9,4.71,1.9414634146341465,0.89,99.48
2021-03-07,Tripura,864,5,856,10892,2987,2920,7.93,3,4.1,351118,3138,349283,72.85,71.22,2.6565853658536587,0.89,99.48
2021-03-08,Tripura,937,6,929,11980,4851,277,7.82,2,4.1,352055,3144,350212,118.32,6.76,2.9219512195121955,0.89,99.48
2021-03-09,Tripura,794,4,786,9830,1654,797,8.08,4,4.1,352849,3148,350998,40.34,19.44,2.3975609756097565,0.89,99.48
2021-03-10,Tripura,1273,9,1268,16203,4127,807,7.86,0,4.1,354122,3157,352266,100.66,19.68,3.9519512195121957,0.89,99.48
2021-03-11,Tripura,1458,6,1453,18381,360,97,7.93,0,4.1,355580,3163,353719,8.78,2.37,4.483170731707317,0.89,99.48
2021-03-12,Tripura,1267,17,1266,16211,189,33,7.82,0,4.1,356847,3180,354985,4.61,0.8,3.953902439024391,0.89,99.48
2021-03-13,Tripura,1284,13,1276,16734,4916,3624,7.67,0,4.1,358131,3193,356261,119.9,88.39,4.081463414634147,0.89,99.48
2021-03-14,Tripura,1481,8,1480,18614,3047,1540,7.96,0,4.1,359612,3201,357741,74.32,37.56,4.540000000000001,0.89,99.48
2021-03-15,Tripura,1424,17,1422,18268,2053,601,7.8,0,4.1,361036,3218,359163,50.07,14.66,4.455609756097561,0.89,99.48
2021-03-16,Tripura,488,2,484,6447,3564,196,7.57,2,4.1,361524,3220,359647,86.93,4.78,1.5724390243902442,0.89,99.48
2021-03-17,Tripura,1110,13,1109,14349,1736,941,7.74,0,4.1,362634,3233,360756,42.34,22.95,3.499756097560976,0.89,99.48
2021-03-18,Tripura,320,4,315,3719,2518,1988,8.6,1,4.1,362954,3237,361071,61.41,48.49,0.9070731707317075,0.89,99.48
2021-03-19,Tripura,885,5,878,10906,1568,1115,8.11,2,4.1,363839,3242,361949,38.24,27.2,2.66,0.89,99.48
2021-03-20,Tripura,1021,13,1018,13051,3958,1681,7.82,0,4.1,364860,3255,362967,96.54,41.0,3.1831707317073175,0.89,99.48
2021-03-21,Tripura,1450,5,1442,18148,1336,316,7.99,3,4.1,366310,3260,364409,32.59,7.71,4.4263414634146345,0.89,99.48
2021-03-22,Tripura,533,7,525,6892,603,544,7.73,1,4.1,366843,3267,364934,14.71,13.27,1.6809756097560977,0.89,99.48
2021-03-23,Tripura,1480,8,1477,18527,1022,1022,7.99,0,4.1,368323,3275,366411,24.93,24.93,4.518780487804879,0.89,99.48
2021-03-24,Tripura,469,4,461,5620,679,337,8.35,4,4.1,368792,3279,366872,16.56,8.22,1.3707317073170733,0.89,99.48
2021-03-25,Tripura,833,5,825,10638,4910,901,7.83,3,4.1,369625,3284,367697,119.76,21.98,2.5946341463414635,0.89,99.48
2021-03-26,Tripura,1239,5,1233,15678,4020,3297,7.9,1,4.1,370864,3289,368930,98.05,80.41,3.8239024390243905,0.89,99.48
2021-03-27,Tripura,1030,7,1023,13024,1481,15,7.91,0,4.1,371894,3296,369953,36.12,0.37,3.1765853658536587,0.89,99.48
2021-03-28,Tripura,857,9,853,11098,4622,3442,7.72,0,4.1,372751,3305,370806,112.73,83.95,2.706829268292683,0.89,99.48
2021-03-29,Tripura,375,4,367,4772,765,755,7.86,4,4.1,373126,3309,371173,18.66,18.41,1.1639024390243904,0.89,99.48
2021-03-30,Tripura,1233,13,1225,15531,987,644,7.94,0,4.1,374359,3322,372398,24.07,15.71,3.7880487804878054,0.89,99.48
2021-03-31,Tripura,1268,5,1262,15890,1706,1054,7.98,1,4.1,375627,3327,373660,41.61,25.71,3.8756097560975613,0.89,99.48
2021-04-01,Tripura,1054,10,1045,13534,4276,3464,7.79,0,4.1,376681,3337,374705,104.29,84.49,3.300975609756098,0.89,99.48
2021-04-02,Tripura,1575,9,1568,19591,3154,2696,8.04,0,4.1,378256,3346,376273,76.93,65.76,4.77829268292683,0.88,99.48
2021-04-03,Tripura,432,4,431,5777,1008,460,7.48,0,4.1,378688,3350,376704,24.59,11.22,1.4090243902439026,0.88,99.48
2021-04-04,Tripura,985,4,977,12493,2475,980,7.88,4,4.1,379673,3354,377681,60.37,23.9,3.0470731707317076,0.88,99.48
2021-04-05,Tripura,883,10,877,11120,4454,2025,7.94,0,4.1,380556,3364,378558,108.63,49.39,2.7121951219512197,0.88,99.47
2021-04-06,Tripura,649,5,648,7881,921,33,8.23,0,4.1,381205,3369,379206,22.46,0.8,1.9221951219512197,0.88,99.48
2021-04-07,Tripura,975,3,967,12409,1587,439,7.86,5,4.1,382180,3372,380173,38.71,10.71,3.026585365853659,0.88,99.47
2021-04-08,Tripura,1473,11,1468,18641,3726,819,7.9,0,4.1,383653,3383,381641,90.88,19.98,4.546585365853659,0.88,99.48
2021-04-09,Tripura,1226,5,1218,15414,4114,914,7.95,3,4.1,384879,3388,382859,100.34,22.29,3.7595121951219515,0.88,99.48
2021-04-10,Tripura,265,3,261,3666,415,99,7.23,1,4.1,385144,3391,383120,10.12,2.41,0.8941463414634148,0.88,99.47
2021-04-11,Tripura,421,3,412,5161,395,283,8.16,6,4.1,385565,3394,383532,9.63,6.9,1.2587804878048783,0.88,99.47
2021-04-12,Tripura,1134,6,1133,14186,1150,599,7.99,0,4.1,386699,3400,384665,28.05,14.61,3.4600000000000004,0.88,99.47
2021-04-13,Tripura,184,0,181,2320,2572,1949,7.93,3,4.1,386883,3400,384846,62.73,47.54,0.5658536585365854,0.88,99.47
2021-04-14,Tripura,146,1,142,2104,704,595,6.94,3,4.1,387029,3401,384988,17.17,14.51,0.5131707317073171,0.88,99.47
2021-04-15,Tripura,174,0,171,1932,1724,1090,9.01,3,4.1,387203,3401,385159,42.05,26.59,0.471219512195122,0.88,99.47
2021-04-16,Tripura,958,9,954,12448,4473,2006,7.7,0,4.1,388161,3410,386113,109.1,48.93,3.0360975609756102,0.88,99.47
2021-04-17,Tripura,428,2,423,5301,3257,872,8.07,3,4.1,388589,3412,386536,79.44,21.27,1.2929268292682927,0.88,99.47
2021-04-18,Tripura,590,3,587,7163,3460,1019,8.24,0,4.1,389179,3415,387123,84.39,24.85,1.7470731707317075,0.88,99.47
2021-04-19,Tripura,1395,9,1386,17670,1653,1050,7.89,0,4.1,390574,3424,388509,40.32,25.61,4.309756097560976,0.88,99.47
2021-04-20,Tripura,705,8,699,8705,3747,3472,8.1,0,4.1,391279,3432,389208,91.39,84.68,2.1231707317073174,0.88,99.47
2021-04-21,Tripura,157,2,153,1974,151,130,7.95,2,4.1,391436,3434,389361,3.68,3.17,0.4814634146341464,0.88,99.47
2021-04-22,Tripura,804,5,796,10220,2063,183,7.87,3,4.1,392240,3439,390157,50.32,4.46,2.4926829268292687,0.88,99.47
2021-04-23,Tripura,1174,8,1166,14363,612,38,8.17,0,4.1,393414,3447,391323,14.93,0.93,3.5031707317073173,0.88,99.47
2021-04-24,Tripura,1161,13,1156,14767,2908,1920,7.86,0,4.1,394575,3460,392479,70.93,46.83,3.601707317073171,0.88,99.47
2021-04-25,Tripura,280,1,271,3373,3810,1078,8.3,8,4.1,394855,3461,392750,92.93,26.29,0.8226829268292684,0.88,99.47
2021-04-26,Tripura,1532,22,1532,19455,4871,4322,7.87,0,4.1,396387,3483,394282,118.8,105.41,4.745121951219513,0.88,99.47
2021-04-27,Tripura,1345,14,1338,16818,2598,1491,8.0,0,4.1,397732,3497,395620,63.37,36.37,4.101951219512196,0.88,99.47
2021-04-28,Tripura,125,1,122,1593,2818,1058,7.85,2,4.1,397857,3498,395742,68.73,25.8,0.3885365853658537,0.88,99.47
2021-04-29,Tripura,894,8,887,11146,952,568,8.02,0,4.1,398751,3506,396629,23.22,13.85,2.718536585365854,0.88,99.47
2021-04-30,Tripura,886,8,877,10813,693,308,8.19,1,4.1,399637,3514,397506,16.9,7.51,2.637317073170732,0.88,99.47
2021-05-01,Tripura,288,1,282,3797,3824,267,7.58,5,4.1,399925,3515,397788,93.27,6.51,0.9260975609756099,0.88,99.47
2021-05-02,Tripura,834,6,826,10130,4451,3738,8.23,2,4.1,400759,3521,398614,108.56,91.17,2.4707317073170736,0.88,99.46
2021-05-03,Tripura,725,7,719,9067,525,405,8.0,0,4.1,401484,3528,399333,12.8,9.88,2.2114634146341468,0.88,99.46
2021-05-04,Tripura,597,7,594,7301,312,14,8.18,0,4.1,402081,3535,399927,7.61,0.34,1.7807317073170734,0.88,99.46
2021-05-05,Tripura,1062,10,1056,13109,3706,3324,8.1,0,4.1,403143,3545,400983,90.39,81.07,3.197317073170732,0.88,99.46
2021-05-06,Tripura,830,4,827,10478,1034,916,7.92,0,4.1,403973,3549,401810,25.22,22.34,2.5556097560975615,0.88,99.46
2021-05-07,Tripura,1303,7,1298,16327,2833,1222,7.98,0,4.1,405276,3556,403108,69.1,29.8,3.98219512195122,0.88,99.47
2021-05-08,Tripura,1078,12,1078,13569,1554,641,7.94,0,4.1,406354,3568,404186,37.9,15.63,3.3095121951219517,0.88,99.47
2021-05-09,Tripura,385,4,382,4574,250,79,8.42,0,4.1,406739,3572,404568,6.1,1.93,1.115609756097561,0.88,99.47
2021-05-10,Tripura,1341,5,1332,16479,2918,2082,8.14,4,4.1,408080,3577,405900,71.17,50.78,4.019268292682927,0.88,99.47
2021-05-11,Tripura,1312,10,1309,16217,4968,4683,8.09,0,4.1,409392,3587,407209,121.17,114.22,3.955365853658537,0.88,99.47
2021-05-12,Tripura,985,4,980,12043,1617,1602,8.18,1,4.1,410377,3591,408189,39.44,39.07,2.937317073170732,0.88,99.47
2021-05-13,Tripura,881,4,872,10539,4817,4781,8.36,5,4.1,411258,3595,409061,117.49,116.61,2.570487804878049,0.87,99.47
2021-05-14,Tripura,725,4,723,8871,2350,1852,8.17,0,4.1,411983,3599,409784,57.32,45.17,2.163658536585366,0.87,99.47
2021-05-15,Tripura,727,10,720,9058,1759,721,8.03,0,4.1,412710,3609,410504,42.9,17.59,2.209268292682927,0.87,99.47
2021-05-16,Tripura,960,7,959,11719,3118,2631,8.19,0,4.1,413670,3616,411463,76.05,64.17,2.85829268292683,0.87,99.47
2021-05-17,Tripura,514,3,509,6450,1749,1119,7.97,2,4.1,414184,3619,411972,42.66,27.29,1.5731707317073174,0.87,99.47
2021-05-18,Tripura,1606,22,1603,19319,872,466,8.31,0,4.1,415790,3641,413575,21.27,11.37,4.711951219512196,0.88,99.47
2021-05-19,Tripura,724,5,717,9625,4919,834,7.52,2,4.1,416514,3646,414292,119.98,20.34,2.347560975609756,0.88,99.47
2021-05-20,Tripura,194,1,190,2431,1090,862,7.98,3,4.1,416708,3647,414482,26.59,21.02,0.5929268292682928,0.88,99.47
2021-05-21,Tripura,718,10,715,9510,4783,1705,7.55,0,4.1,417426,3657,415197,116.66,41.59,2.3195121951219515,0.88,99.47
2021-05-22,Tripura,1185,10,1177,14807,943,828,8.0,0,4.1,418611,3667,416374,23.0,20.2,3.6114634146341467,0.88,99.47
2021-05-23,Tripura,1024,4,1024,12684,3552,176,8.07,0,4.1,419635,3671,417398,86.63,4.29,3.0936585365853664,0.87,99.47
2021-05-24,Tripura,329,4,322,4151,2045,1740,7.93,3,4.1,419964,3675,417720,49.88,42.44,1.012439024390244,0.88,99.47
2021-05-25,Tripura,837,3,828,10253,2784,276,8.16,6,4.1,420801,3678,418548,67.9,6.73,2.5007317073170734,0.87,99.46
2021-05-26,Tripura,1224,6,1220,15466,3066,309,7.91,0,4.1,422025,3684,419768,74.78,7.54,3.7721951219512198,0.87,99.47
2021-05-27,Tripura,236,1,230,2847,2953,498,8.29,5,4.1,422261,3685,419998,72.02,12.15,0.6943902439024391,0.87,99.46
2021-05-28,Tripura,431,5,427,5425,3441,3404,7.94,0,4.1,422692,3690,420425,83.93,83.02,1.3231707317073171,0.87,99.46
2021-05-29,Tripura,632,8,631,7920,1138,496,7.98,0,4.1,423324,3698,421056,27.76,12.1,1.931707317073171,0.87,99.46
2021-05-30,Tripura,617,7,609,8094,4976,649,7.62,1,4.1,423941,3705,421665,121.37,15.83,1.9741463414634148,0.87,99.46
2021-05-31,Tripura,352,2,343,4108,3725,1146,8.57,7,4.1,424293,3707,422008,90.85,27.95,1.0019512195121953,0.87,99.46
2021-06-01,Tripura,1154,16,1154,14424,2250,1953,8.0,0,4.1,425447,3723,423162,54.88,47.63,3.5180487804878053,0.88,99.46
2021-06-02,Tripura,1518,10,1513,18566,343,197,8.18,0,4.1,426965,3733,424675,8.37,4.8,4.52829268292683,0.87,99.46
2021-06-03,Tripura,844,5,838,10651,3326,2566,7.92,1,4.1,427809,3738,425513,81.12,62.59,2.597804878048781,0.87,99.46
2021-06-04,Tripura,991,8,985,12006,2258,2103,8.25,0,4.1,428800,3746,426498,55.07,51.29,2.9282926829268296,0.87,99.46
2021-06-05,Tripura,870,3,862,11014,1631,117,7.9,5,4.1,429670,3749,427360,39.78,2.85,2.6863414634146343,0.87,99.46
2021-06-06,Tripura,1563,9,1562,19408,4219,3733,8.05,0,4.1,431233,3758,428922,102.9,91.05,4.7336585365853665,0.87,99.46
2021-06-07,Tripura,989,4,988,11975,4573,3053,8.26,0,4.1,432222,3762,429910,111.54,74.46,2.9207317073170733,0.87,99.47
2021-06-08,Tripura,806,5,805,10227,3137,1948,7.88,0,4.1,433028,3767,430715,76.51,47.51,2.4943902439024392,0.87,99.47
2021-06-09,Tripura,303,1,301,3979,161,105,7.61,1,4.1,433331,3768,431016,3.93,2.56,0.9704878048780489,0.87,99.47
2021-06-10,Tripura,754,10,747,9221,1165,200,8.18,0,4.1,434085,3778,431763,28.41,4.88,2.249024390243903,0.87,99.47
2021-06-11,Tripura,419,5,410,5247,3246,2232,7.99,4,4.1,434504,3783,432173,79.17,54.44,1.2797560975609759,0.87,99.46
2021-06-12,Tripura,1348,4,1346,16837,385,364,8.01,0,4.1,435852,3787,433519,9.39,8.88,4.106585365853659,0.87,99.46
2021-06-13,Tripura,912,6,910,11284,2971,289,8.08,0,4.1,436764,3793,434429,72.46,7.05,2.7521951219512197,0.87,99.47
2021-06-14,Tripura,583,3,575,7451,4104,1840,7.82,5,4.1,437347,3796,435004,100.1,44.88,1.817317073170732,0.87,99.46
2021-06-15,Tripura,242,3,239,3275,3228,1191,7.39,0,4.1,437589,3799,435243,78.73,29.05,0.7987804878048781,0.87,99.46
2021-06-16,Tripura,702,4,697,8525,4596,4200,8.23,1,4.1,438291,3803,435940,112.1,102.44,2.079268292682927,0.87,99.46
2021-06-17,Tripura,105,0,103,1942,4086,2827,5.41,2,4.1,438396,3803,436043,99.66,68.95,0.4736585365853659,0.87,99.46
2021-06-18,Tripura,373,2,369,4464,4808,2950,8.36,2,4.1,438769,3805,436412,117.27,71.95,1.0887804878048781,0.87,99.46
2021-06-19,Tripura,1416,11,1415,17563,3782,3572,8.06,0,4.1,440185,3816,437827,92.24,87.12,4.283658536585366,0.87,99.46
2021-06-20,Tripura,72,0,69,1159,3314,1190,6.21,3,4.1,440257,3816,437896,80.83,29.02,0.2826829268292683,0.87,99.46
2021-06-21,Tripura,1522,14,1520,18820,304,85,8.09,0,4.1,441779,3830,439416,7.41,2.07,4.590243902439025,0.87,99.47
2021-06-22,Tripura,337,3,330,4387,3287,2053,7.68,4,4.1,442116,3833,439746,80.17,50.07,1.07,0.87,99.46
2021-06-23,Tripura,255,2,251,3187,4589,1337,8.0,2,4.1,442371,3835,439997,111.93,32.61,0.7773170731707318,0.87,99.46
2021-06-24,Tripura,734,10,731,8873,3498,2926,8.27,0,4.1,443105,3845,440728,85.32,71.37,2.164146341463415,0.87,99.46
2021-06-25,Tripura,317,2,308,3697,3251,2148,8.57,7,4.1,443422,3847,441036,79.29,52.39,0.9017073170731709,0.87,99.46
2021-06-26,Tripura,1529,5,1527,19047,2353,647,8.03,0,4.1,444951,3852,442563,57.39,15.78,4.645609756097562,0.87,99.46
2021-06-27,Tripura,611,3,603,7199,303,1,8.49,5,4.1,445562,3855,443166,7.39,0.02,1.7558536585365856,0.87,99.46
2021-06-28,Tripura,412,5,411,5487,816,282,7.51,0,4.1,445974,3860,443577,19.9,6.88,1.3382926829268293,0.87,99.46
2021-06-29,Tripura,742,5,737,9734,4407,3510,7.62,0,4.1,446716,3865,444314,107.49,85.61,2.374146341463415,0.87,99.46
2021-06-30,Tripura,378,3,375,4904,2099,663,7.71,0,4.1,447094,3868,444689,51.2,16.17,1.19609756097561,0.87,99.46
2021-07-01,Tripura,985,2,981,12515,247,88,7.87,2,4.1,448079,3870,445670,6.02,2.15,3.052439024390244,0.86,99.46
2021-07-02,Tripura,1369,5,1365,17180,4744,2002,7.97,0,4.1,449448,3875,447035,115.71,48.83,4.190243902439025,0.86,99.46
2021-07-03,Tripura,868,5,864,10892,3429,3132,7.97,0,4.1,450316,3880,447899,83.63,76.39,2.6565853658536587,0.86,99.46
2021-07-04,Tripura,779,6,771,9689,13,3,8.04,2,4.1,451095,3886,448670,0.32,0.07,2.363170731707317,0.86,99.46
2021-07-05,Tripura,253,2,244,3407,2998,1422,7.43,7,4.1,451348,3888,448914,73.12,34.68,0.8309756097560976,0.86,99.46
2021-07-06,Tripura,118,0,111,1290,4624,2983,9.15,7,4.1,451466,3888,449025,112.78,72.76,0.31463414634146347,0.86,99.46
2021-07-07,Tripura,1400,19,1399,17162,1382,594,8.16,0,4.1,452866,3907,450424,33.71,14.49,4.185853658536586,0.86,99.46
2021-07-08,Tripura,137,1,131,2043,184,101,6.71,5,4.1,453003,3908,450555,4.49,2.46,0.4982926829268293,0.86,99.46
2021-07-09,Tripura,1019,13,1014,12657,4392,311,8.05,0,4.1,454022,3921,451569,107.12,7.59,3.0870731707317076,0.86,99.46
2021-07-10,Tripura,968,5,966,12008,4962,3553,8.06,0,4.1,454990,3926,452535,121.02,86.66,2.9287804878048784,0.86,99.46
2021-07-11,Tripura,1602,23,1602,19995,466,451,8.01,0,4.1,456592,3949,454137,11.37,11.0,4.876829268292683,0.86,99.46
2021-07-12,Tripura,1146,13,1137,14329,385,247,8.0,0,4.1,457738,3962,455274,9.39,6.02,3.494878048780488,0.87,99.46
2021-07-13,Tripura,1303,12,1295,16063,3388,757,8.11,0,4.1,459041,3974,456569,82.63,18.46,3.917804878048781,0.87,99.46
2021-07-14,Tripura,692,10,685,8571,2944,2900,8.07,0,4.1,459733,3984,457254,71.8,70.73,2.090487804878049,0.87,99.46
2021-07-15,Tripura,379,2,373,4582,1362,1278,8.27,4,4.1,460112,3986,457627,33.22,31.17,1.1175609756097562,0.87,99.46
2021-07-16,Tripura,954,11,950,11830,4903,2390,8.06,0,4.1,461066,3997,458577,119.59,58.29,2.885365853658537,0.87,99.46
2021-07-17,Tripura,1378,16,1370,17568,4947,378,7.84,0,4.1,462444,4013,459947,120.66,9.22,4.284878048780488,0.87,99.46
2021-07-18,Tripura,760,3,757,9162,1986,1574,8.3,0,4.1,463204,4016,460704,48.44,38.39,2.2346341463414636,0.87,99.46
2021-07-19,Tripura,285,3,285,3526,1245,1170,8.08,0,4.1,463489,4019,460989,30.37,28.54,0.8600000000000001,0.87,99.46
2021-07-20,Tripura,891,5,886,11162,2316,602,7.98,0,4.1,464380,4024,461875,56.49,14.68,2.722439024390244,0.87,99.46
2021-07-21,Tripura,111,0,102,948,1535,1153,11.71,9,4.1,464491,4024,461977,37.44,28.12,0.231219512195122,0.87,99.46
2021-07-22,Tripura,440,4,436,5101,3433,1335,8.63,0,4.1,464931,4028,462413,83.73,32.56,1.2441463414634149,0.87,99.46
2021-07-23,Tripura,532,1,531,6656,2448,2066,7.99,0,4.1,465463,4029,462944,59.71,50.39,1.6234146341463416,0.87,99.46
2021-07-24,Tripura,1271,8,1262,15578,3976,3557,8.16,1,4.1,466734,4037,464206,96.98,86.76,3.7995121951219515,0.86,99.46
2021-07-25,Tripura,1301,14,1296,15985,2649,538,8.14,0,4.1,468035,4051,465502,64.61,13.12,3.8987804878048786,0.87,99.46
2021-07-26,Tripura,1562,7,1555,19727,1435,669,7.92,0,4.1,469597,4058,467057,35.0,16.32,4.811463414634147,0.86,99.46
2021-07-27,Tripura,1140,13,1132,14649,3421,1363,7.78,0,4.1,470737,4071,468189,83.44,33.24,3.572926829268293,0.86,99.46
2021-07-28,Tripura,193,1,186,2979,4009,3755,6.48,6,4.1,470930,4072,468375,97.78,91.59,0.7265853658536586,0.86,99.46
2021-07-29,Tripura,435,4,429,5345,1716,210,8.14,2,4.1,471365,4076,468804,41.85,5.12,1.303658536585366,0.86,99.46
2021-07-30,Tripura,1125,10,1120,14042,1891,1601,8.01,0,4.1,472490,4086,469924,46.12,39.05,3.424878048780488,0.86,99.46
2021-07-31,Tripura,1551,7,1546,19115,2430,998,8.11,0,4.1,474041,4093,471470,59.27,24.34,4.66219512195122,0.86,99.46
2021-08-01,Tripura,963,9,954,11932,1875,1474,8.07,0,4.1,475004,4102,472424,45.73,35.95,2.9102439024390248,0.86,99.46
2021-08-02,Tripura,209,2,200,2753,3878,1272,7.59,7,4.1,475213,4104,472624,94.59,31.02,0.6714634146341464,0.86,99.46
2021-08-03,Tripura,1355,6,1349,17132,873,320,7.91,0,4.1,476568,4110,473973,21.29,7.8,4.178536585365854,0.86,99.46
2021-08-04,Tripura,301,0,292,4005,3248,1622,7.52,9,4.1,476869,4110,474265,79.22,39.56,0.976829268292683,0.86,99.45
2021-08-05,Tripura,138,1,138,1500,4528,1824,9.2,0,4.1,477007,4111,474403,110.44,44.49,0.3658536585365854,0.86,99.45
2021-08-06,Tripura,459,3,450,5840,4195,4191,7.86,6,4.1,477466,4114,474853,102.32,102.22,1.4243902439024392,0.86,99.45
2021-08-07,Tripura,1341,16,1334,16804,4559,1615,7.98,0,4.1,478807,4130,476187,111.2,39.39,4.098536585365854,0.86,99.45
2021-08-08,Tripura,565,3,559,6676,711,32,8.46,3,4.1,479372,4133,476746,17.34,0.78,1.6282926829268294,0.86,99.45
2021-08-09,Tripura,764,7,756,9645,1120,1025,7.92,1,4.1,480136,4140,477502,27.32,25.0,2.352439024390244,0.86,99.45
2021-08-10,Tripura,1307,11,1307,16510,4031,1609,7.92,0,4.1,481443,4151,478809,98.32,39.24,4.026829268292683,0.86,99.45
2021-08-11,Tripura,1425,17,1425,18043,3245,1146,7.9,0,4.1,482868,4168,480234,79.15,27.95,4.400731707317074,0.86,99.45
2021-08-12,Tripura,1373,11,1371,17498,2212,143,7.85,0,4.1,484241,4179,481605,53.95,3.49,4.267804878048781,0.86,99.46
2021-08-13,Tripura,1541,21,1540,19155,2796,1497,8.04,0,4.1,485782,4200,483145,68.2,36.51,4.671951219512196,0.86,99.46
2021-08-14,Tripura,1214,11,1210,15246,4584,3303,7.96,0,4.1,486996,4211,484355,111.8,80.56,3.7185365853658543,0.86,99.46
2021-08-15,Tripura,111,0,102,1842,3618,3359,6.03,9,4.1,487107,4211,484457,88.24,81.93,0.4492682926829269,0.86,99.46
2021-08-16,Tripura,678,8,673,8722,595,225,7.77,0,4.1,487785,4219,485130,14.51,5.49,2.127317073170732,0.86,99.46
2021-08-17,Tripura,1085,4,1080,13694,3042,999,7.92,1,4.1,488870,4223,486210,74.2,24.37,3.3400000000000003,0.86,99.46
2021-08-18,Tripura,670,4,670,8144,4670,907,8.23,0,4.1,489540,4227,486880,113.9,22.12,1.9863414634146344,0.86,99.46
2021-08-19,Tripura,1500,7,1497,18842,1442,1078,7.96,0,4.1,491040,4234,488377,35.17,26.29,4.595609756097561,0.86,99.46
2021-08-20,Tripura,961,10,960,12153,4853,577,7.91,0,4.1,492001,4244,489337,118.37,14.07,2.964146341463415,0.86,99.46
2021-08-21,Tripura,1467,16,1463,18399,2285,1294,7.97,0,4.1,493468,4260,490800,55.73,31.56,4.487560975609757,0.86,99.46
2021-08-22,Tripura,160,1,155,1880,2646,20,8.51,4,4.1,493628,4261,490955,64.54,0.49,0.45853658536585373,0.86,99.46
2021-08-23,Tripura,545,4,545,6783,1562,918,8.03,0,4.1,494173,4265,491500,38.1,22.39,1.6543902439024392,0.86,99.46
2021-08-24,Tripura,485,2,480,6325,2000,2,7.67,3,4.1,494658,4267,491980,48.78,0.05,1.5426829268292686,0.86,99.46
2021-08-25,Tripura,1511,9,1511,19011,1402,1043,7.95,0,4.1,496169,4276,493491,34.2,25.44,4.636829268292684,0.86,99.46
2021-08-26,Tripura,200,0,197,3007,63,48,6.65,3,4.1,496369,4276,493688,1.54,1.17,0.7334146341463416,0.86,99.46
2021-08-27,Tripura,952,14,952,11866,485,380,8.02,0,4.1,497321,4290,494640,11.83,9.27,2.894146341463415,0.86,99.46
2021-08-28,Tripura,949,8,946,11897,4653,3829,7.98,0,4.1,498270,4298,495586,113.49,93.39,2.901707317073171,0.86,99.46
2021-08-29,Tripura,804,9,798,10127,263,83,7.94,0,4.1,499074,4307,496384,6.41,2.02,2.47,0.86,99.46
2021-08-30,Tripura,253,2,248,3193,4323,3069,7.92,3,4.1,499327,4309,496632,105.44,74.85,0.7787804878048782,0.86,99.46
2021-08-31,Tripura,648,2,644,8291,3154,709,7.82,2,4.1,499975,4311,497276,76.93,17.29,2.0221951219512198,0.86,99.46
2021-09-01,Tripura,1515,9,1513,18948,355,14,8.0,0,4.1,501490,4320,498789,8.66,0.34,4.621463414634147,0.86,99.46
2021-09-02,Tripura,1164,11,1162,14393,2891,2457,8.09,0,4.1,502654,4331,499951,70.51,59.93,3.510487804878049,0.86,99.46
2021-09-03,Tripura,601,2,598,7563,764,474,7.95,1,4.1,503255,4333,500549,18.63,11.56,1.8446341463414637,0.86,99.46
2021-09-04,Tripura,587,8,584,7243,4098,43,8.1,0,4.1,503842,4341,501133,99.95,1.05,1.7665853658536588,0.86,99.46
2021-09-05,Tripura,105,0,102,1275,1176,960,8.24,3,4.1,503947,4341,501235,28.68,23.41,0.3109756097560976,0.86,99.46
2021-09-06,Tripura,504,5,495,6451,4500,2411,7.81,4,4.1,504451,4346,501730,109.76,58.8,1.5734146341463418,0.86,99.46
2021-09-07,Tripura,461,2,460,5060,1289,813,9.11,0,4.1,504912,4348,502190,31.44,19.83,1.2341463414634148,0.86,99.46
2021-09-08,Tripura,388,3,385,4937,2655,1278,7.86,0,4.1,505300,4351,502575,64.76,31.17,1.2041463414634148,0.86,99.46
2021-09-09,Tripura,688,9,688,8445,4804,3046,8.15,0,4.1,505988,4360,503263,117.17,74.29,2.059756097560976,0.86,99.46
2021-09-10,Tripura,110,1,104,1403,1453,1447,7.84,5,4.1,506098,4361,503367,35.44,35.29,0.34219512195121954,0.86,99.46
2021-09-11,Tripura,1408,12,1402,17462,48,33,8.06,0,4.1,507506,4373,504769,1.17,0.8,4.259024390243903,0.86,99.46
2021-09-12,Tripura,1572,9,1563,19643,134,1,8.0,0,4.1,509078,4382,506332,3.27,0.02,4.7909756097560985,0.86,99.46
2021-09-13,Tripura,1296,5,1296,15946,4415,3086,8.13,0,4.1,510374,4387,507628,107.68,75.27,3.889268292682927,0.86,99.46
2021-09-14,Tripura,1400,14,1397,17575,4371,3178,7.97,0,4.1,511774,4401,509025,106.61,77.51,4.286585365853659,0.86,99.46
2021-09-15,Tripura,1343,11,1337,17159,2195,31,7.83,0,4.1,513117,4412,510362,53.54,0.76,4.185121951219513,0.86,99.46
2021-09-16,Tripura,255,0,249,3152,4598,4448,8.09,6,4.1,513372,4412,510611,112.15,108.49,0.7687804878048782,0.86,99.46
2021-09-17,Tripura,510,3,507,6307,4651,2676,8.09,0,4.1,513882,4415,511118,113.44,65.27,1.5382926829268295,0.86,99.46
2021-09-18,Tripura,250,3,249,3544,4240,93,7.05,0,4.1,514132,4418,511367,103.41,2.27,0.8643902439024391,0.86,99.46
2021-09-19,Tripura,768,10,768,9258,1901,1758,8.3,0,4.1,514900,4428,512135,46.37,42.88,2.258048780487805,0.86,99.46
2021-09-20,Tripura,1213,13,1204,15424,763,422,7.86,0,4.1,516113,4441,513339,18.61,10.29,3.7619512195121954,0.86,99.46
2021-09-21,Tripura,331,3,322,4168,1032,5,7.94,6,4.1,516444,4444,513661,25.17,0.12,1.0165853658536586,0.86,99.46
2021-09-22,Tripura,262,3,260,2915,104,70,8.99,0,4.1,516706,4447,513921,2.54,1.71,0.7109756097560976,0.86,99.46
2021-09-23,Tripura,886,5,886,10858,348,161,8.16,0,4.1,517592,4452,514807,8.49,3.93,2.6482926829268294,0.86,99.46
2021-09-24,Tripura,1325,13,1318,16536,1969,1354,8.01,0,4.1,518917,4465,516125,48.02,33.02,4.033170731707317,0.86,99.46
2021-09-25,Tripura,553,6,550,7359,4726,58,7.51,0,4.1,519470,4471,516675,115.27,1.41,1.794878048780488,0.86,99.46
2021-09-26,Tripura,1477,16,1477,18396,632,2,8.03,0,4.1,520947,4487,518152,15.41,0.05,4.486829268292683,0.86,99.46
2021-09-27,Tripura,766,9,761,9329,2319,1459,8.21,0,4.1,521713,4496,518913,56.56,35.59,2.275365853658537,0.86,99.46
2021-09-28,Tripura,540,3,536,7027,598,214,7.68,1,4.1,522253,4499,519449,14.59,5.22,1.7139024390243904,0.86,99.46
2021-09-29,Tripura,1349,14,1344,16710,3897,2324,8.07,0,4.1,523602,4513,520793,95.05,56.68,4.0756097560975615,0.86,99.46
2021-09-30,Tripura,1589,18,1589,19755,3722,1456,8.04,0,4.1,525191,4531,522382,90.78,35.51,4.81829268292683,0.86,99.47
2021-10-01,Tripura,727,9,727,9298,879,160,7.82,0,4.1,525918,4540,523109,21.44,3.9,2.2678048780487807,0.86,99.47
2021-10-02,Tripura,920,8,917,11562,552,339,7.96,0,4.1,526838,4548,524026,13.46,8.27,2.8200000000000003,0.86,99.47
2021-10-03,Tripura,1353,10,1346,16729,1536,333,8.09,0,4.1,528191,4558,525372,37.46,8.12,4.080243902439025,0.86,99.47
2021-10-04,Tripura,1253,8,1246,15404,836,571,8.13,0,4.1,529444,4566,526618,20.39,13.93,3.7570731707317075,0.86,99.47
2021-10-05,Tripura,633,3,629,7760,2772,2308,8.16,1,4.1,530077,4569,527247,67.61,56.29,1.8926829268292684,0.86,99.47
2021-10-06,Tripura,923,12,921,11799,2795,2082,7.82,0,4.1,531000,4581,528168,68.17,50.78,2.8778048780487806,0.86,99.47
2021-10-07,Tripura,1303,7,1297,15939,3606,810,8.17,0,4.1,532303,4588,529465,87.95,19.76,3.8875609756097567,0.86,99.47
2021-10-08,Tripura,1469,9,1468,18196,528,464,8.07,0,4.1,533772,4597,530933,12.88,11.32,4.438048780487805,0.86,99.47
2021-10-09,Tripura,1386,19,1378,17221,4206,501,8.05,0,4.1,535158,4616,532311,102.59,12.22,4.200243902439025,0.86,99.47
2021-10-10,Tripura,580,4,576,7066,1026,1021,8.21,0,4.1,535738,4620,532887,25.02,24.9,1.7234146341463417,0.86,99.47
2021-10-11,Tripura,1589,18,1581,19726,3630,1833,8.06,0,4.1,537327,4638,534468,88.54,44.71,4.811219512195122,0.86,99.47
2021-10-12,Tripura,62,0,62,947,1393,296,6.55,0,4.1,537389,4638,534530,33.98,7.22,0.2309756097560976,0.86,99.47
2021-10-13,Tripura,1214,7,1211,15069,2325,432,8.06,0,4.1,538603,4645,535741,56.71,10.54,3.675365853658537,0.86,99.47
2021-10-14,Tripura,374,3,369,5324,4312,4126,7.02,2,4.1,538977,4648,536110,105.17,100.63,1.2985365853658537,0.86,99.47
2021-10-15,Tripura,967,5,962,12077,1632,40,8.01,0,4.1,539944,4653,537072,39.8,0.98,2.945609756097561,0.86,99.47
2021-10-16,Tripura,365,4,361,4692,4325,852,7.78,0,4.1,540309,4657,537433,105.49,20.78,1.1443902439024392,0.86,99.47
2021-10-17,Tripura,243,1,243,3006,72,24,8.08,0,4.1,540552,4658,537676,1.76,0.59,0.7331707317073172,0.86,99.47
2021-10-18,Tripura,1486,4,1485,18305,774,390,8.12,0,4.1,542038,4662,539161,18.88,9.51,4.464634146341464,0.86,99.47
2021-10-19,Tripura,1384,15,1379,17246,4207,699,8.03,0,4.1,543422,4677,540540,102.61,17.05,4.206341463414635,0.86,99.47
2021-10-20,Tripura,549,4,545,6858,1729,1148,8.01,0,4.1,543971,4681,541085,42.17,28.0,1.6726829268292684,0.86,99.47
2021-10-21,Tripura,1548,19,1546,19365,2043,1708,7.99,0,4.1,545519,4700,542631,49.83,41.66,4.7231707317073175,0.86,99.47
2021-10-22,Tripura,354,2,352,4321,434,386,8.19,0,4.1,545873,4702,542983,10.59,9.41,1.0539024390243903,0.86,99.47
2021-10-23,Tripura,363,5,359,3890,775,292,9.33,0,4.1,546236,4707,543342,18.9,7.12,0.9487804878048781,0.86,99.47
2021-10-24,Tripura,1526,17,1519,19428,876,269,7.85,0,4.1,547762,4724,544861,21.37,6.56,4.738536585365854,0.86,99.47
2021-10-25,Tripura,295,1,286,3549,988,470,8.31,8,4.1,548057,4725,545147,24.1,11.46,0.8656097560975611,0.86,99.47
2021-10-26,Tripura,1511,17,1504,19089,2974,2534,7.92,0,4.1,549568,4742,546651,72.54,61.8,4.655853658536586,0.86,99.47
2021-10-27,Tripura,424,1,424,5489,4142,1198,7.72,0,4.1,549992,4743,547075,101.02,29.22,1.3387804878048781,0.86,99.47
2021-10-28,Tripura,836,10,831,10600,4314,1258,7.89,0,4.1,550828,4753,547906,105.22,30.68,2.5853658536585367,0.86,99.47
2021-10-29,Tripura,334,4,331,4341,412,133,7.69,0,4.1,551162,4757,548237,10.05,3.24,1.058780487804878,0.86,99.47
2021-10-30,Tripura,818,3,817,10231,1302,217,8.0,0,4.1,551980,4760,549054,31.76,5.29,2.495365853658537,0.86,99.47
2021-10-31,Tripura,1242,9,1237,15258,508,384,8.14,0,4.1,553222,4769,550291,12.39,9.37,3.721463414634147,0.86,99.47
2021-11-01,Tripura,300,1,299,3831,4144,4081,7.83,0,4.1,553522,4770,550590,101.07,99.54,0.9343902439024391,0.86,99.47
2021-11-02,Tripura,1085,14,1080,13253,743,327,8.19,0,4.1,554607,4784,551670,18.12,7.98,3.2324390243902443,0.86,99.47
2021-11-03,Tripura,1380,18,1377,17354,44,21,7.95,0,4.1,555987,4802,553047,1.07,0.51,4.232682926829269,0.86,99.47
2021-11-04,Tripura,573,2,566,7226,1146,1114,7.93,5,4.1,556560,4804,553613,27.95,27.17,1.7624390243902441,0.86,99.47
2021-11-05,Tripura,902,6,893,11581,2952,2293,7.79,3,4.1,557462,4810,554506,72.0,55.93,2.824634146341464,0.86,99.47
2021-11-06,Tripura,1500,15,1492,18408,363,307,8.15,0,4.1,558962,4825,555998,8.85,7.49,4.489756097560976,0.86,99.47
2021-11-07,Tripura,225,0,221,2781,4793,4286,8.09,4,4.1,559187,4825,556219,116.9,104.54,0.6782926829268293,0.86,99.47
2021-11-08,Tripura,1212,5,1210,15466,1216,97,7.84,0,4.1,560399,4830,557429,29.66,2.37,3.7721951219512198,0.86,99.47
2021-11-09,Tripura,1597,16,1597,19861,4080,508,8.04,0,4.1,561996,4846,559026,99.51,12.39,4.844146341463415,0.86,99.47
2021-11-10,Tripura,739,8,737,8934,1639,262,8.27,0,4.1,562735,4854,559763,39.98,6.39,2.1790243902439026,0.86,99.47
2021-11-11,Tripura,729,10,723,9080,2746,1689,8.03,0,4.1,563464,4864,560486,66.98,41.2,2.2146341463414636,0.86,99.47
2021-11-12,Tripura,76,1,72,895,2095,1859,8.49,3,4.1,563540,4865,560558,51.1,45.34,0.2182926829268293,0.86,99.47
2021-11-13,Tripura,400,1,399,4996,3341,9,8.01,0,4.1,563940,4866,560957,81.49,0.22,1.2185365853658539,0.86,99.47
2021-11-14,Tripura,524,7,516,6814,2916,1597,7.69,1,4.1,564464,4873,561473,71.12,38.95,1.6619512195121953,0.86,99.47
2021-11-15,Tripura,1532,16,1532,19662,4314,92,7.79,0,4.1,565996,4889,563005,105.22,2.24,4.795609756097561,0.86,99.47
2021-11-16,Tripura,139,0,137,2036,1625,196,6.83,2,4.1,566135,4889,563142,39.63,4.78,0.4965853658536586,0.86,99.47
2021-11-17,Tripura,151,0,146,2361,671,633,6.4,5,4.1,566286,4889,563288,16.37,15.44,0.5758536585365854,0.86,99.47
2021-11-18,Tripura,548,7,546,6926,2771,2113,7.91,0,4.1,566834,4896,563834,67.59,51.54,1.689268292682927,0.86,99.47
2021-11-19,Tripura,1473,4,1470,18530,4255,941,7.95,0,4.1,568307,4900,565304,103.78,22.95,4.519512195121952,0.86,99.47
2021-11-20,Tripura,761,7,754,9535,3301,2724,7.98,0,4.1,569068,4907,566058,80.51,66.44,2.325609756097561,0.86,99.47
2021-11-21,Tripura,906,3,904,11368,3118,2904,7.97,0,4.1,569974,4910,566962,76.05,70.83,2.7726829268292685,0.86,99.47
2021-11-22,Tripura,726,2,726,9009,4244,3733,8.06,0,4.1,570700,4912,567688,103.51,91.05,2.197317073170732,0.86,99.47
2021-11-23,Tripura,109,0,109,1476,4422,3609,7.38,0,4.1,570809,4912,567797,107.85,88.02,0.36000000000000004,0.86,99.47
2021-11-24,Tripura,474,5,469,6361,2093,668,7.45,0,4.1,571283,4917,568266,51.05,16.29,1.5514634146341466,0.86,99.47
2021-11-25,Tripura,857,9,852,10873,1804,936,7.88,0,4.1,572140,4926,569118,44.0,22.83,2.6519512195121955,0.86,99.47
2021-11-26,Tripura,387,5,379,4925,3734,605,7.86,3,4.1,572527,4931,569497,91.07,14.76,1.2012195121951221,0.86,99.47
2021-11-27,Tripura,1046,6,1040,13126,4123,706,7.97,0,4.1,573573,4937,570537,100.56,17.22,3.2014634146341465,0.86,99.47
2021-11-28,Tripura,246,2,237,3171,4467,3538,7.76,7,4.1,573819,4939,570774,108.95,86.29,0.7734146341463416,0.86,99.47
2021-11-29,Tripura,638,6,636,8122,3619,2792,7.86,0,4.1,574457,4945,571410,88.27,68.1,1.9809756097560978,0.86,99.47
2021-11-30,Tripura,453,2,448,5945,3235,184,7.62,3,4.1,574910,4947,571858,78.9,4.49,1.4500000000000002,0.86,99.47
2021-12-01,Tripura,1130,14,1124,13991,2414,226,8.08,0,4.1,576040,4961,572982,58.88,5.51,3.4124390243902445,0.86,99.47
2021-12-02,Tripura,445,2,436,5519,1995,1702,8.06,7,4.1,576485,4963,573418,48.66,41.51,1.3460975609756098,0.86,99.47
2021-12-03,Tripura,144,0,139,2009,19,3,7.17,5,4.1,576629,4963,573557,0.46,0.07,0.49000000000000005,0.86,99.47
2021-12-04,Tripura,856,3,847,10369,4922,1526,8.26,6,4.1,577485,4966,574404,120.05,37.22,2.5290243902439027,0.86,99.47
2021-12-05,Tripura,1308,6,1301,16693,2544,142,7.84,1,4.1,578793,4972,575705,62.05,3.46,4.071463414634147,0.86,99.47
2021-12-06,Tripura,1455,17,1449,17655,3888,3879,8.24,0,4.1,580248,4989,577154,94.83,94.61,4.30609756097561,0.86,99.47
2021-12-07,Tripura,118,0,113,1227,1918,937,9.62,5,4.1,580366,4989,577267,46.78,22.85,0.2992682926829269,0.86,99.47
2021-12-08,Tripura,1619,13,1612,19853,2813,325,8.15,0,4.1,581985,5002,578879,68.61,7.93,4.84219512195122,0.86,99.47
2021-12-09,Tripura,471,4,464,6175,48,15,7.63,3,4.1,582456,5006,579343,1.17,0.37,1.50609756097561,0.86,99.47
2021-12-10,Tripura,875,12,874,10566,1185,610,8.28,0,4.1,583331,5018,580217,28.9,14.88,2.577073170731708,0.86,99.47
2021-12-11,Tripura,1207,12,1204,15253,3692,3173,7.91,0,4.1,584538,5030,581421,90.05,77.39,3.720243902439025,0.86,99.47
2021-12-12,Tripura,37,0,31,830,4864,1829,4.46,6,4.1,584575,5030,581452,118.63,44.61,0.20243902439024392,0.86,99.47
2021-12-13,Tripura,800,2,795,9675,4722,1040,8.27,3,4.1,585375,5032,582247,115.17,25.37,2.3597560975609757,0.86,99.47
2021-12-14,Tripura,653,6,651,8482,72,69,7.7,0,4.1,586028,5038,582898,1.76,1.68,2.068780487804878,0.86,99.47
2021-12-15,Tripura,32,0,23,530,3310,1733,6.04,9,4.1,586060,5038,582921,80.73,42.27,0.12926829268292683,0.86,99.46
2021-12-16,Tripura,303,2,300,3885,4224,223,7.8,1,4.1,586363,5040,583221,103.02,5.44,0.9475609756097562,0.86,99.46
2021-12-17,Tripura,151,1,147,1965,2069,188,7.68,3,4.1,586514,5041,583368,50.46,4.59,0.47926829268292687,0.86,99.46
2021-12-18,Tripura,411,2,406,5187,2666,429,7.92,3,4.1,586925,5043,583774,65.02,10.46,1.2651219512195124,0.86,99.46
2021-12-19,Tripura,1424,14,1415,17848,2550,1195,7.98,0,4.1,588349,5057,585189,62.2,29.15,4.353170731707317,0.86,99.46
2021-12-20,Tripura,1292,17,1290,16145,4557,1224,8.0,0,4.1,589641,5074,586479,111.15,29.85,3.937804878048781,0.86,99.46
2021-12-21,Tripura,1191,4,1183,14825,3183,575,8.03,4,4.1,590832,5078,587662,77.63,14.02,3.6158536585365857,0.86,99.46
2021-12-22,Tripura,971,9,967,12257,3302,2098,7.92,0,4.1,591803,5087,588629,80.54,51.17,2.9895121951219514,0.86,99.46
2021-12-23,Tripura,809,9,806,9846,793,349,8.22,0,4.1,592612,5096,589435,19.34,8.51,2.4014634146341467,0.86,99.46
2021-12-24,Tripura,760,7,758,9400,2823,1464,8.09,0,4.1,593372,5103,590193,68.85,35.71,2.2926829268292686,0.86,99.46
2021-12-25,Tripura,1373,8,1369,17283,4554,2304,7.94,0,4.1,594745,5111,591562,111.07,56.2,4.215365853658537,0.86,99.46
2021-12-26,Tripura,433,6,424,5486,2470,1112,7.89,3,4.1,595178,5117,591986,60.24,27.12,1.338048780487805,0.86,99.46
2021-12-27,Tripura,236,2,234,2443,4067,2136,9.66,0,4.1,595414,5119,592220,99.2,52.1,0.5958536585365855,0.86,99.46
2021-12-28,Tripura,787,5,783,9619,988,275,8.18,0,4.1,596201,5124,593003,24.1,6.71,2.34609756097561,0.86,99.46
2021-12-29,Tripura,664,9,659,8724,1883,1547,7.61,0,4.1,596865,5133,593662,45.93,37.73,2.1278048780487806,0.86,99.46
2021-12-30,Tripura,214,1,211,2532,4788,1773,8.45,2,4.1,597079,5134,593873,116.78,43.24,0.6175609756097562,0.86,99.46
2021-12-31,Tripura,544,5,539,6866,2374,895,7.92,0,4.1,597623,5139,594412,57.9,21.83,1.6746341463414636,0.86,99.46
2022-01-01,Tripura,1569,14,1566,19536,139,0,8.03,0,4.1,599192,5153,595978,3.39,0.0,4.7648780487804885,0.86,99.46
2022-01-02,Tripura,273,4,270,3356,1851,1389,8.13,0,4.1,599465,5157,596248,45.15,33.88,0.8185365853658537,0.86,99.46
2022-01-03,Tripura,143,1,140,1314,4543,3572,10.88,2,4.1,599608,5158,596388,110.8,87.12,0.32048780487804884,0.86,99.46
2022-01-04,Tripura,726,4,717,8865,298,155,8.19,5,4.1,600334,5162,597105,7.27,3.78,2.16219512195122,0.86,99.46
2022-01-05,Tripura,494,6,489,6072,608,82,8.14,0,4.1,600828,5168,597594,14.83,2.0,1.4809756097560978,0.86,99.46
2022-01-06,Tripura,786,7,786,9835,4759,720,7.99,0,4.1,601614,5175,598380,116.07,17.56,2.398780487804878,0.86,99.46
2022-01-07,Tripura,652,7,644,8103,3310,2211,8.05,1,4.1,602266,5182,599024,80.73,53.93,1.9763414634146343,0.86,99.46
2022-01-08,Tripura,662,3,655,8323,3401,3203,7.95,4,4.1,602928,5185,599679,82.95,78.12,2.0300000000000002,0.86,99.46
2022-01-09,Tripura,1238,16,1237,15794,1917,1330,7.84,0,4.1,604166,5201,600916,46.76,32.44,3.85219512195122,0.86,99.46
2022-01-10,Tripura,1386,15,1382,17083,858,822,8.11,0,4.1,605552,5216,602298,20.93,20.05,4.166585365853659,0.86,99.46
2022-01-11,Tripura,493,6,493,5939,4255,2026,8.3,0,4.1,606045,5222,602791,103.78,49.41,1.4485365853658538,0.86,99.46
2022-01-12,Tripura,1281,14,1276,15915,470,450,8.05,0,4.1,607326,5236,604067,11.46,10.98,3.8817073170731713,0.86,99.46
2022-01-13,Tripura,1609,5,1605,19996,2145,473,8.05,0,4.1,608935,5241,605672,52.32,11.54,4.877073170731708,0.86,99.46
2022-01-14,Tripura,1325,19,1319,16654,4451,242,7.96,0,4.1,610260,5260,606991,108.56,5.9,4.061951219512196,0.86,99.46
2022-01-15,Tripura,820,3,814,10436,3248,900,7.86,3,4.1,611080,5263,607805,79.22,21.95,2.545365853658537,0.86,99.46
2022-01-16,Tripura,1545,8,1545,19408,2607,2274,7.96,0,4.1,612625,5271,609350,63.59,55.46,4.7336585365853665,0.86,99.47
2022-01-17,Tripura,854,5,851,10710,164,120,7.97,0,4.1,613479,5276,610201,4.0,2.93,2.6121951219512196,0.86,99.47
2022-01-18,Tripura,347,1,341,3943,2471,1845,8.8,5,4.1,613826,5277,610542,60.27,45.0,0.9617073170731708,0.86,99.46
2022-01-19,Tripura,125,1,118,1463,4694,3865,8.54,6,4.1,613951,5278,610660,114.49,94.27,0.35682926829268297,0.86,99.46
2022-01-20,Tripura,1304,13,1297,16181,4512,3235,8.06,0,4.1,615255,5291,611957,110.05,78.9,3.946585365853659,0.86,99.46
2022-01-21,Tripura,517,5,517,6486,4827,4199,7.97,0,4.1,615772,5296,612474,117.73,102.41,1.5819512195121952,0.86,99.46
2022-01-22,Tripura,1535,9,1535,19130,3461,2113,8.02,0,4.1,617307,5305,614009,84.41,51.54,4.6658536585365855,0.86,99.47
2022-01-23,Tripura,524,7,522,6604,998,979,7.93,0,4.1,617831,5312,614531,24.34,23.88,1.6107317073170733,0.86,99.47
2022-01-24,Tripura,167,1,165,2275,4326,1950,7.34,1,4.1,617998,5313,614696,105.51,47.56,0.5548780487804879,0.86,99.47
2022-01-25,Tripura,1217,17,1216,15288,2861,1708,7.96,0,4.1,619215,5330,615912,69.78,41.66,3.7287804878048783,0.86,99.47
2022-01-26,Tripura,1157,4,1149,14990,704,191,7.72,4,4.1,620372,5334,617061,17.17,4.66,3.6560975609756103,0.86,99.47
2022-01-27,Tripura,811,9,804,10114,3531,1259,8.02,0,4.1,621183,5343,617865,86.12,30.71,2.4668292682926833,0.86,99.47
2022-01-28,Tripura,1094,10,1090,13872,330,214,7.89,0,4.1,622277,5353,618955,8.05,5.22,3.383414634146342,0.86,99.47
2022-01-29,Tripura,809,5,808,10219,841,145,7.92,0,4.1,623086,5358,619763,20.51,3.54,2.492439024390244,0.86,99.47
2022-01-30,Tripura,114,1,112,1088,1586,1178,10.48,1,4.1,623200,5359,619875,38.68,28.73,0.2653658536585366,0.86,99.47
2022-01-31,Tripura,1417,15,1413,17716,4207,3058,8.0,0,4.1,624617,5374,621288,102.61,74.59,4.320975609756098,0.86,99.47
2022-02-01,Tripura,811,9,811,10251,754,451,7.91,0,4.1,625428,5383,622099,18.39,11.0,2.5002439024390246,0.86,99.47
2022-02-02,Tripura,141,1,141,2071,1275,240,6.81,0,4.1,625569,5384,622240,31.1,5.85,0.5051219512195122,0.86,99.47
2022-02-03,Tripura,234,1,233,3067,4123,3483,7.63,0,4.1,625803,5385,622473,100.56,84.95,0.748048780487805,0.86,99.47
2022-02-04,Tripura,820,5,817,10398,549,149,7.89,0,4.1,626623,5390,623290,13.39,3.63,2.5360975609756102,0.86,99.47
2022-02-05,Tripura,982,7,981,11694,694,275,8.4,0,4.1,627605,5397,624271,16.93,6.71,2.85219512195122,0.86,99.47
2022-02-06,Tripura,159,2,152,2479,606,423,6.41,5,4.1,627764,5399,624423,14.78,10.32,0.6046341463414635,0.86,99.47
2022-02-07,Tripura,869,10,868,10689,1667,305,8.13,0,4.1,628633,5409,625291,40.66,7.44,2.6070731707317076,0.86,99.47
2022-02-08,Tripura,1527,19,1526,19206,4255,2182,7.95,0,4.1,630160,5428,626817,103.78,53.22,4.684390243902439,0.86,99.47
2022-02-09,Tripura,1572,8,1569,19558,2719,1906,8.04,0,4.1,631732,5436,628386,66.32,46.49,4.770243902439025,0.86,99.47
2022-02-10,Tripura,1122,4,1113,13888,1142,89,8.08,5,4.1,632854,5440,629499,27.85,2.17,3.387317073170732,0.86,99.47
2022-02-11,Tripura,1210,12,1204,15137,1505,456,7.99,0,4.1,634064,5452,630703,36.71,11.12,3.6919512195121955,0.86,99.47
2022-02-12,Tripura,1284,10,1281,16229,1821,859,7.91,0,4.1,635348,5462,631984,44.41,20.95,3.95829268292683,0.86,99.47
2022-02-13,Tripura,1593,14,1586,19970,2895,226,7.98,0,4.1,636941,5476,633570,70.61,5.51,4.8707317073170735,0.86,99.47
2022-02-14,Tripura,549,5,547,6868,2566,754,7.99,0,4.1,637490,5481,634117,62.59,18.39,1.6751219512195124,0.86,99.47
2022-02-15,Tripura,1609,7,1605,19680,2701,206,8.18,0,4.1,639099,5488,635722,65.88,5.02,4.800000000000001,0.86,99.47
2022-02-16,Tripura,1254,16,1251,15647,14,1,8.01,0,4.1,640353,5504,636973,0.34,0.02,3.8163414634146346,0.86,99.47
2022-02-17,Tripura,794,9,791,10123,4929,1714,7.84,0,4.1,641147,5513,637764,120.22,41.8,2.4690243902439026,0.86,99.47
2022-02-18,Tripura,202,2,200,2148,4252,1785,9.4,0,4.1,641349,5515,637964,103.71,43.54,0.5239024390243903,0.86,99.47
2022-02-19,Tripura,683,3,681,8693,624,124,7.86,0,4.1,642032,5518,638645,15.22,3.02,2.1202439024390247,0.86,99.47
2022-02-20,Tripura,1269,6,1264,15802,4478,3035,8.03,0,4.1,643301,5524,639909,109.22,74.02,3.854146341463415,0.86,99.47
2022-02-21,Tripura,166,0,166,1883,4782,840,8.82,0,4.1,643467,5524,640075,116.63,20.49,0.4592682926829269,0.86,99.47
2022-02-22,Tripura,1555,6,1553,19347,840,325,8.04,0,4.1,645022,5530,641628,20.49,7.93,4.718780487804879,0.86,99.47
2022-02-23,Tripura,1553,10,1550,19644,3489,960,7.91,0,4.1,646575,5540,643178,85.1,23.41,4.791219512195123,0.86,99.47
2022-02-24,Tripura,1028,7,1027,13259,2579,876,7.75,0,4.1,647603,5547,644205,62.9,21.37,3.2339024390243907,0.86,99.48
2022-02-25,Tripura,768,5,768,10106,3463,1530,7.6,0,4.1,648371,5552,644973,84.46,37.32,2.464878048780488,0.86,99.48
2022-02-26,Tripura,1478,22,1470,18452,4574,360,8.01,0,4.1,649849,5574,646443,111.56,8.78,4.500487804878049,0.86,99.48
2022-02-27,Tripura,1303,5,1296,16548,4910,1134,7.87,2,4.1,651152,5579,647739,119.76,27.66,4.03609756097561,0.86,99.48
2022-02-28,Tripura,1525,10,1518,18980,231,10,8.03,0,4.1,652677,5589,649257,5.63,0.24,4.629268292682927,0.86,99.48
2022-03-01,Tripura,746,8,737,9552,2182,1734,7.81,1,4.1,653423,5597,649994,53.22,42.29,2.329756097560976,0.86,99.48
2022-03-02,Tripura,819,9,814,9684,3230,1470,8.46,0,4.1,654242,5606,650808,78.78,35.85,2.3619512195121954,0.86,99.48
2022-03-03,Tripura,1237,4,1232,15314,358,89,8.08,1,4.1,655479,5610,652040,8.73,2.17,3.7351219512195124,0.86,99.48
2022-03-04,Tripura,987,7,987,12280,2779,800,8.04,0,4.1,656466,5617,653027,67.78,19.51,2.9951219512195126,0.86,99.48
2022-03-05,Tripura,463,5,455,5751,3574,1265,8.05,3,4.1,656929,5622,653482,87.17,30.85,1.4026829268292684,0.86,99.48
2022-03-06,Tripura,560,4,560,7019,3282,571,7.98,0,4.1,657489,5626,654042,80.05,13.93,1.7119512195121953,0.86,99.48
2022-03-07,Tripura,284,1,279,3538,3330,1113,8.03,4,4.1,657773,5627,654321,81.22,27.15,0.8629268292682928,0.86,99.48
2022-03-08,Tripura,1449,14,1440,17929,404,186,8.08,0,4.1,659222,5641,655761,9.85,4.54,4.372926829268293,0.86,99.47
2022-03-09,Tripura,508,7,501,6170,219,201,8.23,0,4.1,659730,5648,656262,5.34,4.9,1.504878048780488,0.86,99.47
2022-03-10,Tripura,1546,9,1544,19253,4793,3298,8.03,0,4.1,661276,5657,657806,116.9,80.44,4.695853658536586,0.86,99.48
2022-03-11,Tripura,1070,3,1064,13822,2742,1005,7.74,3,4.1,662346,5660,658870,66.88,24.51,3.3712195121951223,0.85,99.48
2022-03-12,Tripura,507,5,499,6167,4620,1252,8.22,3,4.1,662853,5665,659369,112.68,30.54,1.5041463414634149,0.85,99.47
2022-03-13,Tripura,1514,15,1508,18950,460,222,7.99,0,4.1,664367,5680,660877,11.22,5.41,4.621951219512195,0.85,99.47
2022-03-14,Tripura,104,1,98,1148,1875,244,9.06,5,4.1,664471,5681,660975,45.73,5.95,0.28,0.85,99.47
2022-03-15,Tripura,1063,3,1060,13409,2504,693,7.93,0,4.1,665534,5684,662035,61.07,16.9,3.2704878048780492,0.85,99.47
2022-03-16,Tripura,267,1,265,3398,4879,1068,7.86,1,4.1,665801,5685,662300,119.0,26.05,0.8287804878048781,0.85,99.47
2022-03-17,Tripura,461,5,460,5653,4146,3035,8.15,0,4.1,666262,5690,662760,101.12,74.02,1.3787804878048782,0.85,99.47
2022-03-18,Tripura,1052,3,1048,13713,3676,3065,7.67,1,4.1,667314,5693,663808,89.66,74.76,3.344634146341464,0.85,99.47
2022-03-19,Tripura,1001,4,998,12995,884,314,7.7,0,4.1,668315,5697,664806,21.56,7.66,3.1695121951219516,0.85,99.47
2022-03-20,Tripura,971,14,967,12169,2351,1279,7.98,0,4.1,669286,5711,665773,57.34,31.2,2.968048780487805,0.85,99.48
2022-03-21,Tripura,1253,16,1252,15847,4726,1224,7.91,0,4.1,670539,5727,667025,115.27,29.85,3.8651219512195127,0.85,99.48
2022-03-22,Tripura,1020,10,1016,12669,3062,2580,8.05,0,4.1,671559,5737,668041,74.68,62.93,3.0900000000000003,0.85,99.48
2022-03-23,Tripura,160,0,152,2102,1369,845,7.61,8,4.1,671719,5737,668193,33.39,20.61,0.5126829268292683,0.85,99.48
2022-03-24,Tripura,654,4,646,7913,900,811,8.26,4,4.1,672373,5741,668839,21.95,19.78,1.9300000000000002,0.85,99.47
2022-03-25,Tripura,1276,13,1267,15906,1213,136,8.02,0,4.1,673649,5754,670106,29.59,3.32,3.8795121951219516,0.85,99.47
2022-03-26,Tripura,736,3,733,8815,4194,690,8.35,0,4.1,674385,5757,670839,102.29,16.83,2.1500000000000004,0.85,99.47
2022-03-27,Tripura,501,5,493,6056,1643,1208,8.27,3,4.1,674886,5762,671332,40.07,29.46,1.4770731707317075,0.85,99.47
2022-03-28,Tripura,1246,12,1246,15452,1161,791,8.06,0,4.1,676132,5774,672578,28.32,19.29,3.7687804878048783,0.85,99.47
2022-03-29,Tripura,1599,17,1594,19897,1189,148,8.04,0,4.1,677731,5791,674172,29.0,3.61,4.852926829268293,0.85,99.47
2022-03-30,Tripura,129,1,127,1910,3516,664,6.75,1,4.1,677860,5792,674299,85.76,16.2,0.4658536585365854,0.85,99.47
2022-03-31,Tripura,1586,5,1584,19550,2510,1940,8.11,0,4.1,679446,5797,675883,61.22,47.32,4.7682926829268295,0.85,99.48
2022-04-01,Tripura,419,4,417,5003,2605,1998,8.37,0,4.1,679865,5801,676300,63.54,48.73,1.2202439024390246,0.85,99.48
2022-04-02,Tripura,767,7,763,9560,1930,652,8.02,0,4.1,680632,5808,677063,47.07,15.9,2.331707317073171,0.85,99.48
2022-04-03,Tripura,283,3,280,3260,1089,477,8.68,0,4.1,680915,5811,677343,26.56,11.63,0.7951219512195122,0.85,99.48
2022-04-04,Tripura,1435,18,1433,18380,460,128,7.81,0,4.1,682350,5829,678776,11.22,3.12,4.482926829268293,0.85,99.48
2022-04-05,Tripura,333,3,327,4520,3497,2562,7.37,3,4.1,682683,5832,679103,85.29,62.49,1.102439024390244,0.85,99.48
2022-04-06,Tripura,516,1,508,6615,3464,785,7.8,7,4.1,683199,5833,679611,84.49,19.15,1.6134146341463416,0.85,99.47
2022-04-07,Tripura,205,2,201,2375,138,120,8.63,2,4.1,683404,5835,679812,3.37,2.93,0.5792682926829269,0.85,99.47
2022-04-08,Tripura,1413,8,1406,17781,3518,1821,7.95,0,4.1,684817,5843,681218,85.8,44.41,4.336829268292683,0.85,99.47
2022-04-09,Tripura,728,2,725,9160,3775,3733,7.95,1,4.1,685545,5845,681943,92.07,91.05,2.234146341463415,0.85,99.47
2022-04-10,Tripura,914,11,909,11431,3594,2260,8.0,0,4.1,686459,5856,682852,87.66,55.12,2.7880487804878054,0.85,99.47
2022-04-11,Tripura,954,7,947,11752,2987,131,8.12,0,4.1,687413,5863,683799,72.85,3.2,2.8663414634146345,0.85,99.47
2022-04-12,Tripura,185,0,176,2513,4323,2446,7.36,9,4.1,687598,5863,683975,105.44,59.66,0.6129268292682928,0.85,99.47
2022-04-13,Tripura,110,0,107,1495,2499,397,7.36,3,4.1,687708,5863,684082,60.95,9.68,0.36463414634146346,0.85,99.47
2022-04-14,Tripura,336,1,328,4317,3120,1637,7.78,7,4.1,688044,5864,684410,76.1,39.93,1.0529268292682927,0.85,99.47
2022-04-15,Tripura,1392,18,1388,17108,4640,2899,8.14,0,4.1,689436,5882,685798,113.17,70.71,4.1726829268292684,0.85,99.47
2022-04-16,Tripura,34,0,31,540,4334,265,6.3,3,4.1,689470,5882,685829,105.71,6.46,0.13170731707317074,0.85,99.47
2022-04-17,Tripura,1278,9,1269,16078,778,408,7.95,0,4.1,690748,5891,687098,18.98,9.95,3.9214634146341467,0.85,99.47
2022-04-18,Tripura,1294,11,1287,16333,4873,811,7.92,0,4.1,692042,5902,688385,118.85,19.78,3.9836585365853665,0.85,99.47
2022-04-19,Tripura,1574,11,1565,19484,3627,435,8.08,0,4.1,693616,5913,689950,88.46,10.61,4.75219512195122,0.85,99.47
2022-04-20,Tripura,969,7,962,12396,1482,783,7.82,0,4.1,694585,5920,690912,36.15,19.1,3.023414634146342,0.85,99.47
2022-04-21,Tripura,859,3,857,10867,996,176,7.9,0,4.1,695444,5923,691769,24.29,4.29,2.650487804878049,0.85,99.47
2022-04-22,Tripura,905,13,897,11054,1781,1302,8.19,0,4.1,696349,5936,692666,43.44,31.76,2.69609756097561,0.85,99.47
2022-04-23,Tripura,1029,8,1023,12939,3093,1737,7.95,0,4.1,697378,5944,693689,75.44,42.37,3.1558536585365857,0.85,99.47
2022-04-24,Tripura,1560,23,1558,19358,2077,44,8.06,0,4.1,698938,5967,695247,50.66,1.07,4.7214634146341465,0.85,99.47
2022-04-25,Tripura,583,8,578,7321,698,207,7.96,0,4.1,699521,5975,695825,17.02,5.05,1.7856097560975612,0.85,99.47
2022-04-26,Tripura,1058,6,1056,12903,3293,2922,8.2,0,4.1,700579,5981,696881,80.32,71.27,3.1470731707317077,0.85,99.47
2022-04-27,Tripura,428,3,419,5116,3940,2142,8.37,6,4.1,701007,5984,697300,96.1,52.24,1.2478048780487807,0.85,99.47
2022-04-28,Tripura,1361,12,1359,17181,2704,2579,7.92,0,4.1,702368,5996,698659,65.95,62.9,4.19048780487805,0.85,99.47
2022-04-29,Tripura,571,3,562,7536,938,457,7.58,6,4.1,702939,5999,699221,22.88,11.15,1.8380487804878052,0.85,99.47
2022-04-30,Tripura,1283,5,1276,15730,1299,577,8.16,2,4.1,704222,6004,700497,31.68,14.07,3.836585365853659,0.85,99.47
2022-05-01,Tripura,1527,21,1520,19139,4625,2585,7.98,0,4.1,705749,6025,702017,112.8,63.05,4.668048780487806,0.85,99.47
2022-05-02,Tripura,944,12,938,11704,1268,794,8.07,0,4.1,706693,6037,702955,30.93,19.37,2.8546341463414637,0.85,99.47
2022-05-03,Tripura,442,5,438,5027,4165,1029,8.79,0,4.1,707135,6042,703393,101.59,25.1,1.22609756097561,0.85,99.47
2022-05-04,Tripura,1571,6,1568,19926,227,188,7.88,0,4.1,708706,6048,704961,5.54,4.59,4.86,0.85,99.47
2022-05-05,Tripura,880,4,880,10878,1164,687,8.09,0,4.1,709586,6052,705841,28.39,16.76,2.653170731707317,0.85,99.47
2022-05-06,Tripura,680,6,673,8985,2826,2049,7.57,1,4.1,710266,6058,706514,68.93,49.98,2.1914634146341467,0.85,99.47
2022-05-07,Tripura,721,2,712,9535,1937,1661,7.56,7,4.1,710987,6060,707226,47.24,40.51,2.325609756097561,0.85,99.47
2022-05-08,Tripura,1087,10,1087,13587,2711,1139,8.0,0,4.1,712074,6070,708313,66.12,27.78,3.3139024390243907,0.85,99.47
2022-05-09,Tripura,1358,9,1354,17082,3406,492,7.95,0,4.1,713432,6079,709667,83.07,12.0,4.166341463414635,0.85,99.47
2022-05-10,Tripura,441,5,436,5431,3169,2305,8.12,0,4.1,713873,6084,710103,77.29,56.22,1.3246341463414635,0.85,99.47
2022-05-11,Tripura,652,4,648,8359,2770,1157,7.8,0,4.1,714525,6088,710751,67.56,28.22,2.0387804878048783,0.85,99.47
2022-05-12,Tripura,602,7,600,7250,371,72,8.3,0,4.1,715127,6095,711351,9.05,1.76,1.7682926829268295,0.85,99.47
2022-05-13,Tripura,720,6,719,9037,1205,1164,7.97,0,4.1,715847,6101,712070,29.39,28.39,2.204146341463415,0.85,99.47
2022-05-14,Tripura,822,8,813,10287,1627,502,7.99,1,4.1,716669,6109,712883,39.68,12.24,2.5090243902439027,0.85,99.47
2022-05-15,Tripura,1246,13,1242,15674,888,349,7.95,0,4.1,717915,6122,714125,21.66,8.51,3.822926829268293,0.85,99.47
2022-05-16,Tripura,1090,12,1090,13552,2989,700,8.04,0,4.1,719005,6134,715215,72.9,17.07,3.305365853658537,0.85,99.47
2022-05-17,Tripura,437,6,434,5364,3224,2731,8.15,0,4.1,719442,6140,715649,78.63,66.61,1.3082926829268293,0.85,99.47
2022-05-18,Tripura,655,8,654,8315,3215,893,7.88,0,4.1,720097,6148,716303,78.41,21.78,2.028048780487805,0.85,99.47
2022-05-19,Tripura,319,2,319,4164,3623,252,7.66,0,4.1,720416,6150,716622,88.37,6.15,1.015609756097561,0.85,99.47
2022-05-20,Tripura,1535,17,1529,19039,1884,1553,8.06,0,4.1,721951,6167,718151,45.95,37.88,4.643658536585367,0.85,99.47
2022-05-21,Tripura,1086,7,1086,13665,904,651,7.95,0,4.1,723037,6174,719237,22.05,15.88,3.332926829268293,0.85,99.47
2022-05-22,Tripura,485,3,482,6227,492,427,7.79,0,4.1,723522,6177,719719,12.0,10.41,1.5187804878048783,0.85,99.47
2022-05-23,Tripura,255,2,250,3642,816,355,7.0,3,4.1,723777,6179,719969,19.9,8.66,0.8882926829268294,0.85,99.47
2022-05-24,Tripura,846,9,841,10865,201,69,7.79,0,4.1,724623,6188,720810,4.9,1.68,2.6500000000000004,0.85,99.47
2022-05-25,Tripura,291,2,290,3248,3900,611,8.96,0,4.1,724914,6190,721100,95.12,14.9,0.7921951219512195,0.85,99.47
2022-05-26,Tripura,1217,7,1214,15448,4077,977,7.88,0,4.1,726131,6197,722314,99.44,23.83,3.7678048780487807,0.85,99.47
2022-05-27,Tripura,1175,6,1175,14589,3677,2782,8.05,0,4.1,727306,6203,723489,89.68,67.85,3.5582926829268295,0.85,99.48
2022-05-28,Tripura,973,8,969,11867,1261,888,8.2,0,4.1,728279,6211,724458,30.76,21.66,2.894390243902439,0.85,99.48
2022-05-29,Tripura,700,9,693,8636,1981,1826,8.11,0,4.1,728979,6220,725151,48.32,44.54,2.1063414634146342,0.85,99.47
2022-05-30,Tripura,562,1,559,6762,3717,1731,8.31,2,4.1,729541,6221,725710,90.66,42.22,1.649268292682927,0.85,99.47
2022-05-31,Tripura,373,2,370,4717,558,246,7.91,1,4.1,729914,6223,726080,13.61,6.0,1.150487804878049,0.85,99.47
2022-06-01,Tripura,551,8,550,6897,4728,3257,7.99,0,4.1,730465,6231,726630,115.32,79.44,1.6821951219512197,0.85,99.47
2022-06-02,Tripura,778,2,773,9862,4293,3294,7.89,3,4.1,731243,6233,727403,104.71,80.34,2.405365853658537,0.85,99.47
2022-06-03,Tripura,587,5,578,8047,3819,2575,7.29,4,4.1,731830,6238,727981,93.15,62.8,1.9626829268292685,0.85,99.47
2022-06-04,Tripura,342,4,339,4196,4127,225,8.15,0,4.1,732172,6242,728320,100.66,5.49,1.0234146341463415,0.85,99.47
2022-06-05,Tripura,1119,9,1112,14446,3288,1553,7.75,0,4.1,733291,6251,729432,80.2,37.88,3.523414634146342,0.85,99.47
2022-06-06,Tripura,693,4,693,8437,3014,2414,8.21,0,4.1,733984,6255,730125,73.51,58.88,2.0578048780487808,0.85,99.47
2022-06-07,Tripura,584,4,580,7968,2208,1826,7.33,0,4.1,734568,6259,730705,53.85,44.54,1.9434146341463416,0.85,99.47
2022-06-08,Tripura,983,9,981,12747,870,516,7.71,0,4.1,735551,6268,731686,21.22,12.59,3.1090243902439028,0.85,99.47
2022-06-09,Tripura,994,7,993,12662,3458,144,7.85,0,4.1,736545,6275,732679,84.34,3.51,3.08829268292683,0.85,99.48
2022-06-10,Tripura,576,8,570,6761,1668,1036,8.52,0,4.1,737121,6283,733249,40.68,25.27,1.6490243902439026,0.85,99.47
2022-06-11,Tripura,510,2,504,6754,2677,624,7.55,4,4.1,737631,6285,733753,65.29,15.22,1.6473170731707318,0.85,99.47
2022-06-12,Tripura,708,3,702,8848,3365,2009,8.0,3,4.1,738339,6288,734455,82.07,49.0,2.158048780487805,0.85,99.47
2022-06-13,Tripura,45,0,38,1016,390,178,4.43,7,4.1,738384,6288,734493,9.51,4.34,0.2478048780487805,0.85,99.47
2022-06-14,Tripura,930,9,921,11473,3387,661,8.11,0,4.1,739314,6297,735414,82.61,16.12,2.7982926829268298,0.85,99.47
2022-06-15,Tripura,945,9,936,11691,3181,268,8.08,0,4.1,740259,6306,736350,77.59,6.54,2.851463414634147,0.85,99.47
2022-06-16,Tripura,1188,4,1179,14867,761,158,7.99,5,4.1,741447,6310,737529,18.56,3.85,3.62609756097561,0.85,99.47
2022-06-17,Tripura,1254,12,1252,15278,3298,2799,8.21,0,4.1,742701,6322,738781,80.44,68.27,3.726341463414635,0.85,99.47
2022-06-18,Tripura,1459,12,1452,18548,4522,17,7.87,0,4.1,744160,6334,740233,110.29,0.41,4.523902439024391,0.85,99.47
2022-06-19,Tripura,655,5,651,8453,1018,555,7.75,0,4.1,744815,6339,740884,24.83,13.54,2.061707317073171,0.85,99.47
2022-06-20,Tripura,1267,11,1263,15787,4981,2206,8.03,0,4.1,746082,6350,742147,121.49,53.8,3.8504878048780493,0.85,99.47
2022-06-21,Tripura,1519,10,1515,18853,287,211,8.06,0,4.1,747601,6360,743662,7.0,5.15,4.59829268292683,0.85,99.47
2022-06-22,Tripura,415,4,414,5253,4170,2135,7.9,0,4.1,748016,6364,744076,101.71,52.07,1.2812195121951222,0.85,99.47
2022-06-23,Tripura,196,1,189,2050,4009,337,9.56,6,4.1,748212,6365,744265,97.78,8.22,0.5000000000000001,0.85,99.47
2022-06-24,Tripura,405,1,398,5351,2153,572,7.57,6,4.1,748617,6366,744663,52.51,13.95,1.3051219512195122,0.85,99.47
2022-06-25,Tripura,1029,5,1024,12851,364,171,8.01,0,4.1,749646,6371,745687,8.88,4.17,3.1343902439024394,0.85,99.47
2022-06-26,Tripura,747,3,741,9789,3791,244,7.63,3,4.1,750393,6374,746428,92.46,5.95,2.387560975609756,0.85,99.47
2022-06-27,Tripura,1225,6,1218,15382,850,644,7.96,1,4.1,751618,6380,747646,20.73,15.71,3.751707317073171,0.85,99.47
2022-06-28,Tripura,1295,15,1294,16119,4576,3980,8.03,0,4.1,752913,6395,748940,111.61,97.07,3.931463414634147,0.85,99.47
2022-06-29,Tripura,687,5,683,8451,4037,2101,8.13,0,4.1,753600,6400,749623,98.46,51.24,2.0612195121951222,0.85,99.47
2022-06-30,Tripura,251,1,251,3322,1939,515,7.56,0,4.1,753851,6401,749874,47.29,12.56,0.8102439024390244,0.85,99.47
2022-07-01,Tripura,463,3,456,5558,2237,1290,8.33,4,4.1,754314,6404,750330,54.56,31.46,1.355609756097561,0.85,99.47
2022-07-02,Tripura,588,3,587,7632,3541,832,7.7,0,4.1,754902,6407,750917,86.37,20.29,1.8614634146341467,0.85,99.47
2022-07-03,Tripura,1581,20,1580,19679,2430,2102,8.03,0,4.1,756483,6427,752497,59.27,51.27,4.7997560975609765,0.85,99.47
2022-07-04,Tripura,330,2,326,4454,2550,1522,7.41,2,4.1,756813,6429,752823,62.2,37.12,1.0863414634146342,0.85,99.47
2022-07-05,Tripura,345,2,340,4455,3496,2150,7.74,3,4.1,757158,6431,753163,85.27,52.44,1.0865853658536586,0.85,99.47
2022-07-06,Tripura,154,1,151,1732,4269,402,8.89,2,4.1,757312,6432,753314,104.12,9.8,0.42243902439024394,0.85,99.47
2022-07-07,Tripura,609,7,608,7574,2647,403,8.04,0,4.1,757921,6439,753922,64.56,9.83,1.847317073170732,0.85,99.47
2022-07-08,Tripura,868,3,860,10707,4775,2297,8.11,5,4.1,758789,6442,754782,116.46,56.02,2.6114634146341467,0.85,99.47
2022-07-09,Tripura,597,4,594,7822,1712,30,7.63,0,4.1,759386,6446,755376,41.76,0.73,1.9078048780487806,0.85,99.47
2022-07-10,Tripura,979,12,970,12199,3580,3174,8.03,0,4.1,760365,6458,756346,87.32,77.41,2.975365853658537,0.85,99.47
2022-07-11,Tripura,584,7,577,7734,930,677,7.55,0,4.1,760949,6465,756923,22.68,16.51,1.8863414634146343,0.85,99.47
2022-07-12,Tripura,248,2,245,3037,3140,714,8.17,1,4.1,761197,6467,757168,76.59,17.41,0.7407317073170733,0.85,99.47
2022-07-13,Tripura,1185,8,1178,14595,4005,933,8.12,0,4.1,762382,6475,758346,97.68,22.76,3.559756097560976,0.85,99.47
2022-07-14,Tripura,1067,11,1067,13096,4185,923,8.15,0,4.1,763449,6486,759413,102.07,22.51,3.194146341463415,0.85,99.47
2022-07-15,Tripura,1145,4,1139,14473,746,703,7.91,2,4.1,764594,6490,760552,18.2,17.15,3.5300000000000002,0.85,99.47
2022-07-16,Tripura,901,2,894,11212,2324,2292,8.04,5,4.1,765495,6492,761446,56.68,55.9,2.7346341463414636,0.85,99.47
2022-07-17,Tripura,927,3,926,11776,28,18,7.87,0,4.1,766422,6495,762372,0.68,0.44,2.87219512195122,0.85,99.47
2022-07-18,Tripura,453,4,452,5856,2136,254,7.74,0,4.1,766875,6499,762824,52.1,6.2,1.4282926829268294,0.85,99.47
2022-07-19,Tripura,873,6,868,11308,1926,1053,7.72,0,4.1,767748,6505,763692,46.98,25.68,2.758048780487805,0.85,99.47
2022-07-20,Tripura,778,7,773,9791,4863,1691,7.95,0,4.1,768526,6512,764465,118.61,41.24,2.388048780487805,0.85,99.47
2022-07-21,Tripura,848,7,846,10523,3203,2658,8.06,0,4.1,769374,6519,765311,78.12,64.83,2.566585365853659,0.85,99.47
2022-07-22,Tripura,529,3,522,6394,1973,146,8.27,4,4.1,769903,6522,765833,48.12,3.56,1.5595121951219515,0.85,99.47
2022-07-23,Tripura,595,6,591,7468,1814,310,7.97,0,4.1,770498,6528,766424,44.24,7.56,1.8214634146341466,0.85,99.47
2022-07-24,Tripura,163,2,159,1831,3978,1946,8.9,2,4.1,770661,6530,766583,97.02,47.46,0.4465853658536586,0.85,99.47
2022-07-25,Tripura,241,1,235,2709,2892,278,8.9,5,4.1,770902,6531,766818,70.54,6.78,0.6607317073170732,0.85,99.47
2022-07-26,Tripura,432,4,423,5722,2061,1037,7.55,5,4.1,771334,6535,767241,50.27,25.29,1.395609756097561,0.85,99.47
2022-07-27,Tripura,1236,4,1235,15064,3906,1218,8.2,0,4.1,772570,6539,768476,95.27,29.71,3.6741463414634152,0.85,99.47
2022-07-28,Tripura,907,9,900,11309,3379,17,8.02,0,4.1,773477,6548,769376,82.41,0.41,2.7582926829268297,0.85,99.47
2022-07-29,Tripura,751,10,749,9272,4798,34,8.1,0,4.1,774228,6558,770125,117.02,0.83,2.2614634146341466,0.85,99.47
2022-07-30,Tripura,810,4,805,10046,3309,1946,8.06,1,4.1,775038,6562,770930,80.71,47.46,2.450243902439025,0.85,99.47
2022-07-31,Tripura,578,4,571,7181,1541,574,8.05,3,4.1,775616,6566,771501,37.59,14.0,1.7514634146341466,0.85,99.47
2022-08-01,Tripura,1070,12,1070,13195,960,756,8.11,0,4.1,776686,6578,772571,23.41,18.44,3.2182926829268297,0.85,99.47
2022-08-02,Tripura,1527,10,1523,19270,3688,1518,7.92,0,4.1,778213,6588,774094,89.95,37.02,4.7,0.85,99.47
2022-08-03,Tripura,457,5,455,5933,4955,4776,7.7,0,4.1,778670,6593,774549,120.85,116.49,1.4470731707317075,0.85,99.47
2022-08-04,Tripura,855,7,854,10698,4534,3342,7.99,0,4.1,779525,6600,775403,110.59,81.51,2.609268292682927,0.85,99.47
2022-08-05,Tripura,77,0,69,1256,2555,2268,6.13,8,4.1,779602,6600,775472,62.32,55.32,0.3063414634146342,0.85,99.47
2022-08-06,Tripura,739,11,737,9351,1114,1024,7.9,0,4.1,780341,6611,776209,27.17,24.98,2.2807317073170736,0.85,99.47
2022-08-07,Tripura,870,6,861,10940,4279,1695,7.95,3,4.1,781211,6617,777070,104.37,41.34,2.6682926829268294,0.85,99.47
2022-08-08,Tripura,1262,10,1262,15635,1029,729,8.07,0,4.1,782473,6627,778332,25.1,17.78,3.813414634146342,0.85,99.47
2022-08-09,Tripura,685,8,684,8514,2002,1896,8.05,0,4.1,783158,6635,779016,48.83,46.24,2.0765853658536586,0.85,99.47
2022-08-10,Tripura,404,3,404,4963,4969,3390,8.14,0,4.1,783562,6638,779420,121.2,82.68,1.210487804878049,0.85,99.47
2022-08-11,Tripura,707,5,707,9028,2456,1981,7.83,0,4.1,784269,6643,780127,59.9,48.32,2.2019512195121953,0.85,99.47
2022-08-12,Tripura,782,2,781,9814,3973,1887,7.97,0,4.1,785051,6645,780908,96.9,46.02,2.393658536585366,0.85,99.47
2022-08-13,Tripura,850,11,848,10365,1498,257,8.2,0,4.1,785901,6656,781756,36.54,6.27,2.528048780487805,0.85,99.47
2022-08-14,Tripura,1106,12,1106,13741,1125,581,8.05,0,4.1,787007,6668,782862,27.44,14.17,3.351463414634147,0.85,99.47
2022-08-15,Tripura,1258,8,1257,15949,2349,818,7.89,0,4.1,788265,6676,784119,57.29,19.95,3.8900000000000006,0.85,99.47
2022-08-16,Tripura,578,7,576,7226,2966,2376,8.0,0,4.1,788843,6683,784695,72.34,57.95,1.7624390243902441,0.85,99.47
2022-08-17,Tripura,233,1,227,2837,1967,746,8.21,5,4.1,789076,6684,784922,47.98,18.2,0.6919512195121952,0.85,99.47
2022-08-18,Tripura,1254,6,1253,15894,3532,2889,7.89,0,4.1,790330,6690,786175,86.15,70.46,3.876585365853659,0.85,99.47
2022-08-19,Tripura,323,4,323,4062,1275,526,7.95,0,4.1,790653,6694,786498,31.1,12.83,0.9907317073170733,0.85,99.47
2022-08-20,Tripura,498,2,489,6161,4616,3301,8.08,7,4.1,791151,6696,786987,112.59,80.51,1.5026829268292685,0.85,99.47
2022-08-21,Tripura,226,3,219,2269,3206,199,9.96,4,4.1,791377,6699,787206,78.2,4.85,0.5534146341463415,0.85,99.47
2022-08-22,Tripura,828,3,821,10345,1727,986,8.0,4,4.1,792205,6702,788027,42.12,24.05,2.5231707317073173,0.85,99.47
2022-08-23,Tripura,353,3,344,4116,2367,899,8.58,6,4.1,792558,6705,788371,57.73,21.93,1.0039024390243902,0.85,99.47
2022-08-24,Tripura,863,6,861,10953,1301,489,7.88,0,4.1,793421,6711,789232,31.73,11.93,2.6714634146341467,0.85,99.47
2022-08-25,Tripura,1474,11,1469,18994,2408,1872,7.76,0,4.1,794895,6722,790701,58.73,45.66,4.632682926829268,0.85,99.47
2022-08-26,Tripura,481,4,474,6520,4979,1113,7.38,3,4.1,795376,6726,791175,121.44,27.15,1.5902439024390245,0.85,99.47
2022-08-27,Tripura,365,4,360,4518,4868,4665,8.08,1,4.1,795741,6730,791535,118.73,113.78,1.1019512195121952,0.85,99.47
2022-08-28,Tripura,63,0,60,835,423,11,7.54,3,4.1,795804,6730,791595,10.32,0.27,0.20365853658536587,0.85,99.47
2022-08-29,Tripura,176,0,173,2437,2637,1704,7.22,3,4.1,795980,6730,791768,64.32,41.56,0.5943902439024391,0.85,99.47
2022-08-30,Tripura,555,7,555,6759,1030,122,8.21,0,4.1,796535,6737,792323,25.12,2.98,1.6485365853658538,0.85,99.47
2022-08-31,Tripura,169,0,165,2051,3300,166,8.24,4,4.1,796704,6737,792488,80.49,4.05,0.5002439024390245,0.85,99.47
2022-09-01,Tripura,1110,12,1109,13851,1148,525,8.01,0,4.1,797814,6749,793597,28.0,12.8,3.37829268292683,0.85,99.47
2022-09-02,Tripura,1043,12,1035,12748,2321,850,8.18,0,4.1,798857,6761,794632,56.61,20.73,3.1092682926829274,0.85,99.47
2022-09-03,Tripura,175,1,166,2378,980,613,7.36,8,4.1,799032,6762,794798,23.9,14.95,0.5800000000000001,0.85,99.47
2022-09-04,Tripura,1172,11,1172,14516,2916,1541,8.07,0,4.1,800204,6773,795970,71.12,37.59,3.5404878048780493,0.85,99.47
2022-09-05,Tripura,758,2,755,9515,2173,426,7.97,1,4.1,800962,6775,796725,53.0,10.39,2.3207317073170732,0.85,99.47
2022-09-06,Tripura,416,2,407,5264,3298,1021,7.9,7,4.1,801378,6777,797132,80.44,24.9,1.2839024390243905,0.85,99.47
2022-09-07,Tripura,841,7,841,11011,1132,294,7.64,0,4.1,802219,6784,797973,27.61,7.17,2.6856097560975614,0.85,99.47
2022-09-08,Tripura,373,2,366,4700,288,247,7.94,5,4.1,802592,6786,798339,7.02,6.02,1.1463414634146343,0.85,99.47
2022-09-09,Tripura,887,6,884,11084,2008,680,8.0,0,4.1,803479,6792,799223,48.98,16.59,2.7034146341463416,0.85,99.47
2022-09-10,Tripura,852,11,849,10720,711,139,7.95,0,4.1,804331,6803,800072,17.34,3.39,2.6146341463414635,0.85,99.47
2022-09-11,Tripura,978,13,970,12429,2659,2438,7.87,0,4.1,805309,6816,801042,64.85,59.46,3.0314634146341466,0.85,99.47
2022-09-12,Tripura,1308,7,1305,16652,485,20,7.85,0,4.1,806617,6823,802347,11.83,0.49,4.061463414634146,0.85,99.47
2022-09-13,Tripura,919,5,916,11242,3940,3368,8.17,0,4.1,807536,6828,803263,96.1,82.15,2.7419512195121953,0.85,99.47
2022-09-14,Tripura,1303,5,1295,16254,2551,1481,8.02,3,4.1,808839,6833,804558,62.22,36.12,3.9643902439024394,0.84,99.47
2022-09-15,Tripura,1272,15,1265,16007,3235,952,7.95,0,4.1,810111,6848,805823,78.9,23.22,3.904146341463415,0.85,99.47
2022-09-16,Tripura,773,10,769,9313,948,726,8.3,0,4.1,810884,6858,806592,23.12,17.71,2.271463414634147,0.85,99.47
2022-09-17,Tripura,355,1,353,4662,448,362,7.61,1,4.1,811239,6859,806945,10.93,8.83,1.1370731707317074,0.85,99.47
2022-09-18,Tripura,1490,8,1482,19061,4796,4038,7.82,0,4.1,812729,6867,808427,116.98,98.49,4.649024390243903,0.84,99.47
2022-09-19,Tripura,255,0,251,2611,2462,1443,9.77,4,4.1,812984,6867,808678,60.05,35.2,0.636829268292683,0.84,99.47
2022-09-20,Tripura,516,2,512,6222,2758,111,8.29,2,4.1,813500,6869,809190,67.27,2.71,1.5175609756097563,0.84,99.47
2022-09-21,Tripura,1576,8,1571,19359,529,209,8.14,0,4.1,815076,6877,810761,12.9,5.1,4.721707317073172,0.84,99.47
2022-09-22,Tripura,253,2,249,3115,3057,2234,8.12,2,4.1,815329,6879,811010,74.56,54.49,0.7597560975609757,0.84,99.47
2022-09-23,Tripura,210,0,205,2610,4740,3056,8.05,5,4.1,815539,6879,811215,115.61,74.54,0.6365853658536587,0.84,99.47
2022-09-24,Tripura,1187,8,1178,14408,982,965,8.24,1,4.1,816726,6887,812393,23.95,23.54,3.514146341463415,0.84,99.47
2022-09-25,Tripura,1335,4,1328,16798,304,258,7.95,3,4.1,818061,6891,813721,7.41,6.29,4.097073170731708,0.84,99.47
2022-09-26,Tripura,757,9,750,9481,2763,777,7.98,0,4.1,818818,6900,814471,67.39,18.95,2.312439024390244,0.84,99.47
2022-09-27,Tripura,1483,12,1478,18595,590,74,7.98,0,4.1,820301,6912,815949,14.39,1.8,4.535365853658537,0.84,99.47
2022-09-28,Tripura,264,3,255,3181,2707,797,8.3,6,4.1,820565,6915,816204,66.02,19.44,0.7758536585365855,0.84,99.47
2022-09-29,Tripura,868,4,862,10964,2382,1420,7.92,2,4.1,821433,6919,817066,58.1,34.63,2.674146341463415,0.84,99.47
2022-09-30,Tripura,494,2,493,6032,4412,581,8.19,0,4.1,821927,6921,817559,107.61,14.17,1.4712195121951221,0.84,99.47
2022-10-01,Tripura,1359,7,1357,16946,2279,1371,8.02,0,4.1,823286,6928,818916,55.59,33.44,4.133170731707318,0.84,99.47
2022-10-02,Tripura,1096,7,1094,13803,2246,1784,7.94,0,4.1,824382,6935,820010,54.78,43.51,3.366585365853659,0.84,99.47
2022-10-03,Tripura,344,3,342,3867,4605,813,8.9,0,4.1,824726,6938,820352,112.32,19.83,0.9431707317073171,0.84,99.47
2022-10-04,Tripura,1616,10,1616,19997,4976,302,8.08,0,4.1,826342,6948,821968,121.37,7.37,4.877317073170732,0.84,99.47
2022-10-05,Tripura,1164,7,1164,15098,2428,1884,7.71,0,4.1,827506,6955,823132,59.22,45.95,3.6824390243902445,0.84,99.47
2022-10-06,Tripura,1371,11,1366,17035,4598,1342,8.05,0,4.1,828877,6966,824498,112.15,32.73,4.154878048780488,0.84,99.47
2022-10-07,Tripura,1458,17,1450,18557,2471,681,7.86,0,4.1,830335,6983,825948,60.27,16.61,4.52609756097561,0.84,99.47
2022-10-08,Tripura,381,5,379,4660,4563,966,8.18,0,4.1,830716,6988,826327,111.29,23.56,1.1365853658536587,0.84,99.47
2022-10-09,Tripura,664,2,656,8453,4912,50,7.86,6,4.1,831380,6990,826983,119.8,1.22,2.061707317073171,0.84,99.47
2022-10-10,Tripura,359,4,354,4320,2134,79,8.31,1,4.1,831739,6994,827337,52.05,1.93,1.053658536585366,0.84,99.47
2022-10-11,Tripura,405,1,403,4651,721,241,8.71,1,4.1,832144,6995,827740,17.59,5.88,1.1343902439024391,0.84,99.47
2022-10-12,Tripura,1191,7,1183,15166,421,25,7.85,1,4.1,833335,7002,828923,10.27,0.61,3.699024390243903,0.84,99.47
2022-10-13,Tripura,1599,23,1596,19851,4291,2680,8.06,0,4.1,834934,7025,830519,104.66,65.37,4.841707317073172,0.84,99.47
2022-10-14,Tripura,396,1,393,4387,4346,3914,9.03,2,4.1,835330,7026,830912,106.0,95.46,1.07,0.84,99.47
2022-10-15,Tripura,1419,10,1415,17937,2183,1433,7.91,0,4.1,836749,7036,832327,53.24,34.95,4.374878048780488,0.84,99.47
2022-10-16,Tripura,656,2,649,8855,1783,118,7.41,5,4.1,837405,7038,832976,43.49,2.88,2.159756097560976,0.84,99.47
2022-10-17,Tripura,697,4,697,8730,628,532,7.98,0,4.1,838102,7042,833673,15.32,12.98,2.129268292682927,0.84,99.47
2022-10-18,Tripura,1360,10,1355,16832,4660,935,8.08,0,4.1,839462,7052,835028,113.66,22.8,4.105365853658537,0.84,99.47
2022-10-19,Tripura,1580,19,1576,19677,351,208,8.03,0,4.1,841042,7071,836604,8.56,5.07,4.799268292682927,0.84,99.47
2022-10-20,Tripura,50,0,46,1071,3773,978,4.67,4,4.1,841092,7071,836650,92.02,23.85,0.26121951219512196,0.84,99.47
2022-10-21,Tripura,1560,18,1554,19484,2778,1709,8.01,0,4.1,842652,7089,838204,67.76,41.68,4.75219512195122,0.84,99.47
2022-10-22,Tripura,32,0,24,646,1153,338,4.95,8,4.1,842684,7089,838228,28.12,8.24,0.15756097560975613,0.84,99.47
2022-10-23,Tripura,1409,15,1406,17611,3493,278,8.0,0,4.1,844093,7104,839634,85.2,6.78,4.295365853658537,0.84,99.47
2022-10-24,Tripura,710,6,703,9017,2495,1640,7.87,1,4.1,844803,7110,840337,60.85,40.0,2.1992682926829272,0.84,99.47
2022-10-25,Tripura,1510,18,1504,18900,2020,292,7.99,0,4.1,846313,7128,841841,49.27,7.12,4.609756097560976,0.84,99.47
2022-10-26,Tripura,522,3,522,6874,4319,3430,7.59,0,4.1,846835,7131,842363,105.34,83.66,1.6765853658536587,0.84,99.47
2022-10-27,Tripura,1030,6,1025,12502,409,384,8.24,0,4.1,847865,7137,843388,9.98,9.37,3.0492682926829273,0.84,99.47
2022-10-28,Tripura,487,2,481,6436,1571,38,7.57,4,4.1,848352,7139,843869,38.32,0.93,1.569756097560976,0.84,99.47
2022-10-29,Tripura,359,2,358,4806,4748,1040,7.47,0,4.1,848711,7141,844227,115.8,25.37,1.1721951219512197,0.84,99.47
2022-10-30,Tripura,1431,21,1422,18417,2889,625,7.77,0,4.1,850142,7162,845649,70.46,15.24,4.491951219512195,0.84,99.47
2022-10-31,Tripura,753,10,751,9681,3207,433,7.78,0,4.1,850895,7172,846400,78.22,10.56,2.361219512195122,0.84,99.47
2022-11-01,Tripura,874,4,869,10884,2585,486,8.03,1,4.1,851769,7176,847269,63.05,11.85,2.6546341463414636,0.84,99.47
2022-11-02,Tripura,369,4,361,4657,802,159,7.92,4,4.1,852138,7180,847630,19.56,3.88,1.1358536585365855,0.84,99.47
2022-11-03,Tripura,639,8,633,7802,1443,390,8.19,0,4.1,852777,7188,848263,35.2,9.51,1.9029268292682928,0.84,99.47
2022-11-04,Tripura,1430,8,1422,17577,3297,1609,8.14,0,4.1,854207,7196,849685,80.41,39.24,4.287073170731708,0.84,99.47
2022-11-05,Tripura,639,8,634,8365,4824,2746,7.64,0,4.1,854846,7204,850319,117.66,66.98,2.0402439024390246,0.84,99.47
2022-11-06,Tripura,381,3,374,4555,1865,1202,8.36,4,4.1,855227,7207,850693,45.49,29.32,1.1109756097560977,0.84,99.47
2022-11-07,Tripura,1377,17,1375,16880,687,284,8.16,0,4.1,856604,7224,852068,16.76,6.93,4.117073170731707,0.84,99.47
2022-11-08,Tripura,1432,7,1427,17763,4771,1662,8.06,0,4.1,858036,7231,853495,116.37,40.54,4.332439024390244,0.84,99.47
2022-11-09,Tripura,623,6,614,7733,2581,2223,8.06,3,4.1,858659,7237,854109,62.95,54.22,1.8860975609756099,0.84,99.47
2022-11-10,Tripura,1054,6,1046,13389,1186,297,7.87,2,4.1,859713,7243,855155,28.93,7.24,3.2656097560975614,0.84,99.47
2022-11-11,Tripura,1186,6,1186,14913,1016,577,7.95,0,4.1,860899,7249,856341,24.78,14.07,3.637317073170732,0.84,99.47
2022-11-12,Tripura,227,2,218,3002,3410,398,7.56,7,4.1,861126,7251,856559,83.17,9.71,0.7321951219512196,0.84,99.47
2022-11-13,Tripura,368,1,366,4708,236,119,7.82,1,4.1,861494,7252,856925,5.76,2.9,1.1482926829268294,0.84,99.47
2022-11-14,Tripura,825,8,816,10152,2836,2080,8.13,1,4.1,862319,7260,857741,69.17,50.73,2.47609756097561,0.84,99.47
2022-11-15,Tripura,174,2,171,2050,2611,1159,8.49,1,4.1,862493,7262,857912,63.68,28.27,0.5000000000000001,0.84,99.47
2022-11-16,Tripura,762,3,761,10277,69,58,7.41,0,4.1,863255,7265,858673,1.68,1.41,2.5065853658536588,0.84,99.47
2022-11-17,Tripura,642,2,637,7942,4854,2502,8.08,3,4.1,863897,7267,859310,118.39,61.02,1.9370731707317075,0.84,99.47
2022-11-18,Tripura,743,9,741,9632,2938,783,7.71,0,4.1,864640,7276,860051,71.66,19.1,2.349268292682927,0.84,99.47
2022-11-19,Tripura,497,1,496,6344,2439,378,7.83,0,4.1,865137,7277,860547,59.49,9.22,1.547317073170732,0.84,99.47
2022-11-20,Tripura,494,1,494,6176,1843,1322,8.0,0,4.1,865631,7278,861041,44.95,32.24,1.5063414634146344,0.84,99.47
2022-11-21,Tripura,527,3,526,6627,3792,2773,7.95,0,4.1,866158,7281,861567,92.49,67.63,1.6163414634146342,0.84,99.47
2022-11-22,Tripura,876,8,868,10631,4953,3592,8.24,0,4.1,867034,7289,862435,120.8,87.61,2.592926829268293,0.84,99.47
2022-11-23,Tripura,1292,16,1285,16244,3176,923,7.95,0,4.1,868326,7305,863720,77.46,22.51,3.9619512195121955,0.84,99.47
2022-11-24,Tripura,1047,5,1039,12457,2231,136,8.4,3,4.1,869373,7310,864759,54.41,3.32,3.0382926829268295,0.84,99.47
2022-11-25,Tripura,1201,17,1198,15083,1218,565,7.96,0,4.1,870574,7327,865957,29.71,13.78,3.6787804878048784,0.84,99.47
2022-11-26,Tripura,695,9,687,8514,851,504,8.16,0,4.1,871269,7336,866644,20.76,12.29,2.0765853658536586,0.84,99.47
2022-11-27,Tripura,326,4,320,4218,4945,2518,7.73,2,4.1,871595,7340,866964,120.61,61.41,1.028780487804878,0.84,99.47
2022-11-28,Tripura,170,2,170,2045,2994,564,8.31,0,4.1,871765,7342,867134,73.02,13.76,0.4987804878048781,0.84,99.47
2022-11-29,Tripura,1090,13,1087,13448,2400,256,8.11,0,4.1,872855,7355,868221,58.54,6.24,3.2800000000000002,0.84,99.47
2022-11-30,Tripura,257,3,249,3200,436,55,8.03,5,4.1,873112,7358,868470,10.63,1.34,0.7804878048780489,0.84,99.47
2022-12-01,Tripura,685,6,679,8552,3679,2919,8.01,0,4.1,873797,7364,869149,89.73,71.2,2.0858536585365854,0.84,99.47
2022-12-02,Tripura,1341,14,1333,17048,3263,426,7.87,0,4.1,875138,7378,870482,79.59,10.39,4.158048780487805,0.84,99.47
2022-12-03,Tripura,390,5,388,5104,184,18,7.64,0,4.1,875528,7383,870870,4.49,0.44,1.244878048780488,0.84,99.47
2022-12-04,Tripura,1569,9,1566,19849,86,45,7.9,0,4.1,877097,7392,872436,2.1,1.1,4.8412195121951225,0.84,99.47
2022-12-05,Tripura,350,3,346,5021,4684,1904,6.97,1,4.1,877447,7395,872782,114.24,46.44,1.2246341463414636,0.84,99.47
2022-12-06,Tripura,719,4,716,9356,3958,369,7.68,0,4.1,878166,7399,873498,96.54,9.0,2.2819512195121954,0.84,99.47
2022-12-07,Tripura,589,2,584,7421,371,183,7.94,3,4.1,878755,7401,874082,9.05,4.46,1.8100000000000003,0.84,99.47
2022-12-08,Tripura,1505,12,1505,18317,2965,1097,8.22,0,4.1,880260,7413,875587,72.32,26.76,4.467560975609756,0.84,99.47
2022-12-09,Tripura,219,1,214,2831,3679,1532,7.74,4,4.1,880479,7414,875801,89.73,37.37,0.6904878048780488,0.84,99.47
2022-12-10,Tripura,1139,10,1138,13912,3344,2989,8.19,0,4.1,881618,7424,876939,81.56,72.9,3.3931707317073174,0.84,99.47
2022-12-11,Tripura,326,0,326,3911,3441,3252,8.34,0,4.1,881944,7424,877265,83.93,79.32,0.9539024390243903,0.84,99.47
2022-12-12,Tripura,1300,16,1295,16463,2202,690,7.9,0,4.1,883244,7440,878560,53.71,16.83,4.015365853658537,0.84,99.47
2022-12-13,Tripura,874,4,867,10844,21,18,8.06,3,4.1,884118,7444,879427,0.51,0.44,2.644878048780488,0.84,99.47
2022-12-14,Tripura,1608,20,1599,19824,4411,1667,8.11,0,4.1,885726,7464,881026,107.59,40.66,4.835121951219513,0.84,99.47
2022-12-15,Tripura,632,2,631,7890,2707,291,8.01,0,4.1,886358,7466,881657,66.02,7.1,1.9243902439024392,0.84,99.47
2022-12-16,Tripura,1082,9,1076,13662,2650,2620,7.92,0,4.1,887440,7475,882733,64.63,63.9,3.33219512195122,0.84,99.47
2022-12-17,Tripura,840,5,837,10196,2060,1320,8.24,0,4.1,888280,7480,883570,50.24,32.2,2.4868292682926834,0.84,99.47
2022-12-18,Tripura,857,5,850,10550,4549,2593,8.12,2,4.1,889137,7485,884420,110.95,63.24,2.5731707317073176,0.84,99.47
2022-12-19,Tripura,1081,12,1075,13116,431,143,8.24,0,4.1,890218,7497,885495,10.51,3.49,3.1990243902439026,0.84,99.47
2022-12-20,Tripura,988,14,983,12325,523,384,8.02,0,4.1,891206,7511,886478,12.76,9.37,3.00609756097561,0.84,99.47
2022-12-21,Tripura,855,4,852,10363,3060,2869,8.25,0,4.1,892061,7515,887330,74.63,69.98,2.5275609756097563,0.84,99.47
2022-12-22,Tripura,372,1,364,4464,1670,1536,8.33,7,4.1,892433,7516,887694,40.73,37.46,1.0887804878048781,0.84,99.47
2022-12-23,Tripura,1146,8,1141,14162,1899,590,8.09,0,4.1,893579,7524,888835,46.32,14.39,3.454146341463415,0.84,99.47
2022-12-24,Tripura,110,1,101,1559,643,270,7.06,8,4.1,893689,7525,888936,15.68,6.59,0.38024390243902445,0.84,99.47
2022-12-25,Tripura,411,5,406,5104,3189,1056,8.05,0,4.1,894100,7530,889342,77.78,25.76,1.244878048780488,0.84,99.47
2022-12-26,Tripura,514,5,507,6337,4112,811,8.11,2,4.1,894614,7535,889849,100.29,19.78,1.5456097560975612,0.84,99.47
2022-12-27,Tripura,1215,13,1215,14887,265,248,8.16,0,4.1,895829,7548,891064,6.46,6.05,3.630975609756098,0.84,99.47
2022-12-28,Tripura,772,2,769,9493,370,73,8.13,1,4.1,896601,7550,891833,9.02,1.78,2.3153658536585366,0.84,99.47
2022-12-29,Tripura,644,7,635,8281,2114,1169,7.78,2,4.1,897245,7557,892468,51.56,28.51,2.019756097560976,0.84,99.47
2022-12-30,Tripura,1036,12,1030,12685,2253,765,8.17,0,4.1,898281,7569,893498,54.95,18.66,3.0939024390243905,0.84,99.47
2022-12-31,Tripura,1533,14,1530,19063,789,258,8.04,0,4.1,899814,7583,895028,19.24,6.29,4.649512195121952,0.84,99.47
2020-01-01,Uttar Pradesh,814,9,811,9771,3722,2286,8.33,0,248.0,814,9,811,1.5,0.92,0.0393991935483871,1.11,99.63
2020-01-02,Uttar Pradesh,1258,10,1256,16330,3169,1145,7.7,0,248.0,2072,19,2067,1.28,0.46,0.06584677419354838,0.92,99.76
2020-01-03,Uttar Pradesh,850,5,841,10579,2624,1111,8.03,4,248.0,2922,24,2908,1.06,0.45,0.04265725806451613,0.82,99.52
2020-01-04,Uttar Pradesh,887,10,883,10726,3200,3086,8.27,0,248.0,3809,34,3791,1.29,1.24,0.04325,0.89,99.53
2020-01-05,Uttar Pradesh,968,12,960,11763,3791,2096,8.23,0,248.0,4777,46,4751,1.53,0.85,0.04743145161290323,0.96,99.46
2020-01-06,Uttar Pradesh,1397,19,1395,17258,998,192,8.09,0,248.0,6174,65,6146,0.4,0.08,0.06958870967741936,1.05,99.55
2020-01-07,Uttar Pradesh,1336,11,1331,17043,4669,3801,7.84,0,248.0,7510,76,7477,1.88,1.53,0.06872177419354839,1.01,99.56
2020-01-08,Uttar Pradesh,253,2,253,2888,2558,249,8.76,0,248.0,7763,78,7730,1.03,0.1,0.011645161290322581,1.0,99.57
2020-01-09,Uttar Pradesh,1227,6,1225,15332,4911,1429,8.0,0,248.0,8990,84,8955,1.98,0.58,0.06182258064516129,0.93,99.61
2020-01-10,Uttar Pradesh,278,3,278,3727,4045,2506,7.46,0,248.0,9268,87,9233,1.63,1.01,0.015028225806451613,0.94,99.62
2020-01-11,Uttar Pradesh,1480,17,1479,18559,777,406,7.97,0,248.0,10748,104,10712,0.31,0.16,0.07483467741935484,0.97,99.67
2020-01-12,Uttar Pradesh,1572,5,1566,19775,3045,1117,7.95,1,248.0,12320,109,12278,1.23,0.45,0.07973790322580646,0.88,99.66
2020-01-13,Uttar Pradesh,205,1,197,2446,164,130,8.38,7,248.0,12525,110,12475,0.07,0.05,0.009862903225806451,0.88,99.6
2020-01-14,Uttar Pradesh,447,3,443,5443,153,91,8.21,1,248.0,12972,113,12918,0.06,0.04,0.02194758064516129,0.87,99.58
2020-01-15,Uttar Pradesh,342,2,339,4211,2184,1533,8.12,1,248.0,13314,115,13257,0.88,0.62,0.016979838709677418,0.86,99.57
2020-01-16,Uttar Pradesh,1198,11,1193,15021,522,183,7.98,0,248.0,14512,126,14450,0.21,0.07,0.06056854838709677,0.87,99.57
2020-01-17,Uttar Pradesh,896,9,894,11602,733,480,7.72,0,248.0,15408,135,15344,0.3,0.19,0.04678225806451613,0.88,99.58
2020-01-18,Uttar Pradesh,767,9,763,9823,1458,232,7.81,0,248.0,16175,144,16107,0.59,0.09,0.03960887096774193,0.89,99.58
2020-01-19,Uttar Pradesh,512,2,511,6410,848,29,7.99,0,248.0,16687,146,16618,0.34,0.01,0.02584677419354839,0.87,99.59
2020-01-20,Uttar Pradesh,504,3,502,6582,3130,1074,7.66,0,248.0,17191,149,17120,1.26,0.43,0.026540322580645162,0.87,99.59
2020-01-21,Uttar Pradesh,807,9,802,10138,1106,937,7.96,0,248.0,17998,158,17922,0.45,0.38,0.04087903225806452,0.88,99.58
2020-01-22,Uttar Pradesh,734,10,733,8939,2431,4,8.21,0,248.0,18732,168,18655,0.98,0.0,0.03604435483870968,0.9,99.59
2020-01-23,Uttar Pradesh,1039,14,1034,12688,4224,3105,8.19,0,248.0,19771,182,19689,1.7,1.25,0.05116129032258065,0.92,99.59
2020-01-24,Uttar Pradesh,348,3,344,4120,1223,677,8.45,1,248.0,20119,185,20033,0.49,0.27,0.01661290322580645,0.92,99.57
2020-01-25,Uttar Pradesh,1162,17,1155,14705,4818,3581,7.9,0,248.0,21281,202,21188,1.94,1.44,0.05929435483870968,0.95,99.56
2020-01-26,Uttar Pradesh,212,2,211,2608,2101,258,8.13,0,248.0,21493,204,21399,0.85,0.1,0.010516129032258065,0.95,99.56
2020-01-27,Uttar Pradesh,1017,13,1015,12603,3698,1242,8.07,0,248.0,22510,217,22414,1.49,0.5,0.050818548387096776,0.96,99.57
2020-01-28,Uttar Pradesh,38,0,35,818,1494,1094,4.65,3,248.0,22548,217,22449,0.6,0.44,0.0032983870967741935,0.96,99.56
2020-01-29,Uttar Pradesh,395,1,389,5079,2404,55,7.78,5,248.0,22943,218,22838,0.97,0.02,0.020479838709677418,0.95,99.54
2020-01-30,Uttar Pradesh,1604,20,1602,19954,4476,707,8.04,0,248.0,24547,238,24440,1.8,0.29,0.08045967741935484,0.97,99.56
2020-01-31,Uttar Pradesh,85,1,77,1315,4503,4445,6.46,7,248.0,24632,239,24517,1.82,1.79,0.00530241935483871,0.97,99.53
2020-02-01,Uttar Pradesh,667,4,659,8244,2966,1970,8.09,4,248.0,25299,243,25176,1.2,0.79,0.033241935483870964,0.96,99.51
2020-02-02,Uttar Pradesh,1037,5,1029,12915,846,706,8.03,3,248.0,26336,248,26205,0.34,0.28,0.05207661290322581,0.94,99.5
2020-02-03,Uttar Pradesh,1151,17,1146,14653,189,84,7.86,0,248.0,27487,265,27351,0.08,0.03,0.05908467741935484,0.96,99.51
2020-02-04,Uttar Pradesh,777,10,769,9486,1755,1,8.19,0,248.0,28264,275,28120,0.71,0.0,0.03825,0.97,99.49
2020-02-05,Uttar Pradesh,222,2,216,2416,2930,2723,9.19,4,248.0,28486,277,28336,1.18,1.1,0.009741935483870968,0.97,99.47
2020-02-06,Uttar Pradesh,1594,7,1594,19917,1663,687,8.0,0,248.0,30080,284,29930,0.67,0.28,0.08031048387096774,0.94,99.5
2020-02-07,Uttar Pradesh,913,8,913,10893,4024,2265,8.38,0,248.0,30993,292,30843,1.62,0.91,0.043923387096774194,0.94,99.52
2020-02-08,Uttar Pradesh,465,2,456,5764,1127,993,8.07,7,248.0,31458,294,31299,0.45,0.4,0.02324193548387097,0.93,99.49
2020-02-09,Uttar Pradesh,634,8,631,7965,4362,4114,7.96,0,248.0,32092,302,31930,1.76,1.66,0.03211693548387097,0.94,99.5
2020-02-10,Uttar Pradesh,1048,7,1043,13346,3925,597,7.85,0,248.0,33140,309,32973,1.58,0.24,0.05381451612903226,0.93,99.5
2020-02-11,Uttar Pradesh,988,9,979,12281,1631,551,8.04,0,248.0,34128,318,33952,0.66,0.22,0.04952016129032258,0.93,99.48
2020-02-12,Uttar Pradesh,631,4,628,8084,723,301,7.81,0,248.0,34759,322,34580,0.29,0.12,0.03259677419354839,0.93,99.49
2020-02-13,Uttar Pradesh,1130,8,1123,13754,343,287,8.22,0,248.0,35889,330,35703,0.14,0.12,0.05545967741935484,0.92,99.48
2020-02-14,Uttar Pradesh,282,3,280,3534,4751,3535,7.98,0,248.0,36171,333,35983,1.92,1.43,0.01425,0.92,99.48
2020-02-15,Uttar Pradesh,1596,9,1594,19936,109,52,8.01,0,248.0,37767,342,37577,0.04,0.02,0.08038709677419355,0.91,99.5
2020-02-16,Uttar Pradesh,1102,9,1093,13652,4933,2837,8.07,0,248.0,38869,351,38670,1.99,1.14,0.0550483870967742,0.9,99.49
2020-02-17,Uttar Pradesh,655,6,647,8289,9,1,7.9,2,248.0,39524,357,39317,0.0,0.0,0.03342338709677419,0.9,99.48
2020-02-18,Uttar Pradesh,435,5,430,5437,4257,4232,8.0,0,248.0,39959,362,39747,1.72,1.71,0.021923387096774192,0.91,99.47
2020-02-19,Uttar Pradesh,1114,14,1110,13805,2971,2900,8.07,0,248.0,41073,376,40857,1.2,1.17,0.05566532258064516,0.92,99.47
2020-02-20,Uttar Pradesh,825,5,816,10197,1451,39,8.09,4,248.0,41898,381,41673,0.59,0.02,0.041116935483870964,0.91,99.46
2020-02-21,Uttar Pradesh,322,1,319,4105,1373,1195,7.84,2,248.0,42220,382,41992,0.55,0.48,0.01655241935483871,0.9,99.46
2020-02-22,Uttar Pradesh,446,2,439,5417,610,221,8.23,5,248.0,42666,384,42431,0.25,0.09,0.02184274193548387,0.9,99.45
2020-02-23,Uttar Pradesh,1004,5,996,12237,824,619,8.2,3,248.0,43670,389,43427,0.33,0.25,0.04934274193548387,0.89,99.44
2020-02-24,Uttar Pradesh,903,9,896,11300,2828,1795,7.99,0,248.0,44573,398,44323,1.14,0.72,0.045564516129032256,0.89,99.44
2020-02-25,Uttar Pradesh,457,2,450,6508,2115,362,7.02,5,248.0,45030,400,44773,0.85,0.15,0.02624193548387097,0.89,99.43
2020-02-26,Uttar Pradesh,739,10,732,9087,3340,1137,8.13,0,248.0,45769,410,45505,1.35,0.46,0.036641129032258066,0.9,99.42
2020-02-27,Uttar Pradesh,410,5,408,5250,1025,858,7.81,0,248.0,46179,415,45913,0.41,0.35,0.021169354838709676,0.9,99.42
2020-02-28,Uttar Pradesh,1190,11,1189,15024,620,220,7.92,0,248.0,47369,426,47102,0.25,0.09,0.060580645161290324,0.9,99.44
2020-02-29,Uttar Pradesh,408,3,400,4970,1313,1186,8.21,5,248.0,47777,429,47502,0.53,0.48,0.02004032258064516,0.9,99.42
2020-03-01,Uttar Pradesh,232,0,232,2973,3136,3038,7.8,0,248.0,48009,429,47734,1.26,1.23,0.011987903225806451,0.89,99.43
2020-03-02,Uttar Pradesh,1128,13,1120,14152,2335,1725,7.97,0,248.0,49137,442,48854,0.94,0.7,0.05706451612903226,0.9,99.42
2020-03-03,Uttar Pradesh,726,9,725,9126,2306,2057,7.96,0,248.0,49863,451,49579,0.93,0.83,0.036798387096774195,0.9,99.43
2020-03-04,Uttar Pradesh,1184,11,1179,14610,1787,615,8.1,0,248.0,51047,462,50758,0.72,0.25,0.05891129032258065,0.91,99.43
2020-03-05,Uttar Pradesh,1567,12,1564,19367,4707,711,8.09,0,248.0,52614,474,52322,1.9,0.29,0.07809274193548386,0.9,99.45
2020-03-06,Uttar Pradesh,575,7,572,7440,4630,2672,7.73,0,248.0,53189,481,52894,1.87,1.08,0.03,0.9,99.45
2020-03-07,Uttar Pradesh,655,5,646,8087,34,33,8.1,4,248.0,53844,486,53540,0.01,0.01,0.03260887096774193,0.9,99.44
2020-03-08,Uttar Pradesh,174,0,167,1848,818,39,9.42,7,248.0,54018,486,53707,0.33,0.02,0.0074516129032258065,0.9,99.42
2020-03-09,Uttar Pradesh,988,11,979,12770,748,604,7.74,0,248.0,55006,497,54686,0.3,0.24,0.05149193548387097,0.9,99.42
2020-03-10,Uttar Pradesh,210,1,209,2621,4026,2166,8.01,0,248.0,55216,498,54895,1.62,0.87,0.010568548387096774,0.9,99.42
2020-03-11,Uttar Pradesh,239,2,239,2761,1760,783,8.66,0,248.0,55455,500,55134,0.71,0.32,0.011133064516129032,0.9,99.42
2020-03-12,Uttar Pradesh,205,3,205,2518,647,356,8.14,0,248.0,55660,503,55339,0.26,0.14,0.010153225806451612,0.9,99.42
2020-03-13,Uttar Pradesh,953,13,944,11920,3140,1700,7.99,0,248.0,56613,516,56283,1.27,0.69,0.04806451612903226,0.91,99.42
2020-03-14,Uttar Pradesh,1311,9,1311,15961,1902,1887,8.21,0,248.0,57924,525,57594,0.77,0.76,0.06435887096774194,0.91,99.43
2020-03-15,Uttar Pradesh,475,2,466,5860,1377,1213,8.11,7,248.0,58399,527,58060,0.56,0.49,0.023629032258064515,0.9,99.42
2020-03-16,Uttar Pradesh,1000,9,992,12460,3619,2538,8.03,0,248.0,59399,536,59052,1.46,1.02,0.050241935483870966,0.9,99.42
2020-03-17,Uttar Pradesh,666,3,657,8275,4135,2674,8.05,6,248.0,60065,539,59709,1.67,1.08,0.033366935483870964,0.9,99.41
2020-03-18,Uttar Pradesh,1310,15,1307,16754,4863,787,7.82,0,248.0,61375,554,61016,1.96,0.32,0.06755645161290323,0.9,99.42
2020-03-19,Uttar Pradesh,609,7,602,7622,604,233,7.99,0,248.0,61984,561,61618,0.24,0.09,0.030733870967741935,0.91,99.41
2020-03-20,Uttar Pradesh,1015,13,1010,12592,2043,1302,8.06,0,248.0,62999,574,62628,0.82,0.52,0.050774193548387095,0.91,99.41
2020-03-21,Uttar Pradesh,596,5,588,7184,4461,1835,8.3,3,248.0,63595,579,63216,1.8,0.74,0.028967741935483873,0.91,99.4
2020-03-22,Uttar Pradesh,523,6,517,6645,3913,296,7.87,0,248.0,64118,585,63733,1.58,0.12,0.026794354838709677,0.91,99.4
2020-03-23,Uttar Pradesh,1196,5,1187,15231,3752,1717,7.85,4,248.0,65314,590,64920,1.51,0.69,0.06141532258064516,0.9,99.4
2020-03-24,Uttar Pradesh,435,2,432,5106,373,251,8.52,1,248.0,65749,592,65352,0.15,0.1,0.020588709677419353,0.9,99.4
2020-03-25,Uttar Pradesh,1257,15,1252,15512,918,174,8.1,0,248.0,67006,607,66604,0.37,0.07,0.0625483870967742,0.91,99.4
2020-03-26,Uttar Pradesh,1240,17,1237,15368,781,77,8.07,0,248.0,68246,624,67841,0.31,0.03,0.06196774193548387,0.91,99.41
2020-03-27,Uttar Pradesh,1222,12,1217,14852,3508,840,8.23,0,248.0,69468,636,69058,1.41,0.34,0.05988709677419355,0.92,99.41
2020-03-28,Uttar Pradesh,281,3,278,3508,1462,1218,8.01,0,248.0,69749,639,69336,0.59,0.49,0.01414516129032258,0.92,99.41
2020-03-29,Uttar Pradesh,194,2,188,2402,394,316,8.08,4,248.0,69943,641,69524,0.16,0.13,0.009685483870967742,0.92,99.4
2020-03-30,Uttar Pradesh,1529,8,1525,18884,1228,756,8.1,0,248.0,71472,649,71049,0.5,0.3,0.07614516129032257,0.91,99.41
2020-03-31,Uttar Pradesh,778,9,773,9749,3957,2097,7.98,0,248.0,72250,658,71822,1.6,0.85,0.03931048387096774,0.91,99.41
2020-04-01,Uttar Pradesh,175,1,170,2058,4660,4645,8.5,4,248.0,72425,659,71992,1.88,1.87,0.008298387096774194,0.91,99.4
2020-04-02,Uttar Pradesh,568,2,559,7304,354,142,7.78,7,248.0,72993,661,72551,0.14,0.06,0.029451612903225805,0.91,99.39
2020-04-03,Uttar Pradesh,312,2,305,3660,3390,135,8.52,5,248.0,73305,663,72856,1.37,0.05,0.014758064516129031,0.9,99.39
2020-04-04,Uttar Pradesh,1172,7,1167,14754,4705,2886,7.94,0,248.0,74477,670,74023,1.9,1.16,0.05949193548387097,0.9,99.39
2020-04-05,Uttar Pradesh,781,8,774,9555,4608,1309,8.17,0,248.0,75258,678,74797,1.86,0.53,0.03852822580645161,0.9,99.39
2020-04-06,Uttar Pradesh,273,2,273,3503,613,350,7.79,0,248.0,75531,680,75070,0.25,0.14,0.014125,0.9,99.39
2020-04-07,Uttar Pradesh,541,6,534,6867,4450,3221,7.88,1,248.0,76072,686,75604,1.79,1.3,0.027689516129032258,0.9,99.38
2020-04-08,Uttar Pradesh,1323,11,1314,16293,1889,1097,8.12,0,248.0,77395,697,76918,0.76,0.44,0.06569758064516129,0.9,99.38
2020-04-09,Uttar Pradesh,898,11,889,11395,1354,1112,7.88,0,248.0,78293,708,77807,0.55,0.45,0.04594758064516129,0.9,99.38
2020-04-10,Uttar Pradesh,1202,6,1198,14999,626,167,8.01,0,248.0,79495,714,79005,0.25,0.07,0.06047983870967742,0.9,99.38
2020-04-11,Uttar Pradesh,314,2,310,4117,2997,443,7.63,2,248.0,79809,716,79315,1.21,0.18,0.016600806451612903,0.9,99.38
2020-04-12,Uttar Pradesh,1375,18,1375,17227,3342,319,7.98,0,248.0,81184,734,80690,1.35,0.13,0.06946370967741936,0.9,99.39
2020-04-13,Uttar Pradesh,528,5,526,6524,4023,2129,8.09,0,248.0,81712,739,81216,1.62,0.86,0.026306451612903226,0.9,99.39
2020-04-14,Uttar Pradesh,251,1,249,2992,2548,241,8.39,1,248.0,81963,740,81465,1.03,0.1,0.012064516129032258,0.9,99.39
2020-04-15,Uttar Pradesh,1007,12,1001,12547,4878,4789,8.03,0,248.0,82970,752,82466,1.97,1.93,0.05059274193548387,0.91,99.39
2020-04-16,Uttar Pradesh,613,2,607,7731,1577,903,7.93,4,248.0,83583,754,83073,0.64,0.36,0.031173387096774193,0.9,99.39
2020-04-17,Uttar Pradesh,529,3,521,6293,985,738,8.41,5,248.0,84112,757,83594,0.4,0.3,0.025375,0.9,99.38
2020-04-18,Uttar Pradesh,316,1,314,4453,2990,71,7.1,1,248.0,84428,758,83908,1.21,0.03,0.017955645161290324,0.9,99.38
2020-04-19,Uttar Pradesh,60,0,51,935,3063,857,6.42,9,248.0,84488,758,83959,1.24,0.35,0.003770161290322581,0.9,99.37
2020-04-20,Uttar Pradesh,1270,13,1262,15850,3045,2828,8.01,0,248.0,85758,771,85221,1.23,1.14,0.06391129032258064,0.9,99.37
2020-04-21,Uttar Pradesh,1049,12,1047,13421,516,307,7.82,0,248.0,86807,783,86268,0.21,0.12,0.05411693548387097,0.9,99.38
2020-04-22,Uttar Pradesh,993,11,986,12551,4788,1668,7.91,0,248.0,87800,794,87254,1.93,0.67,0.050608870967741935,0.9,99.38
2020-04-23,Uttar Pradesh,883,12,878,11024,4047,3502,8.01,0,248.0,88683,806,88132,1.63,1.41,0.04445161290322581,0.91,99.38
2020-04-24,Uttar Pradesh,731,8,731,9183,3432,1858,7.96,0,248.0,89414,814,88863,1.38,0.75,0.03702822580645161,0.91,99.38
2020-04-25,Uttar Pradesh,1198,7,1192,14740,2214,2156,8.13,0,248.0,90612,821,90055,0.89,0.87,0.05943548387096774,0.91,99.39
2020-04-26,Uttar Pradesh,562,6,562,7179,881,21,7.83,0,248.0,91174,827,90617,0.36,0.01,0.02894758064516129,0.91,99.39
2020-04-27,Uttar Pradesh,214,1,209,3110,2684,1415,6.88,4,248.0,91388,828,90826,1.08,0.57,0.012540322580645162,0.91,99.39
2020-04-28,Uttar Pradesh,489,3,481,5972,608,304,8.19,5,248.0,91877,831,91307,0.25,0.12,0.024080645161290323,0.9,99.38
2020-04-29,Uttar Pradesh,596,4,596,7659,1166,1114,7.78,0,248.0,92473,835,91903,0.47,0.45,0.030883064516129034,0.9,99.38
2020-04-30,Uttar Pradesh,1248,18,1246,15455,2392,22,8.08,0,248.0,93721,853,93149,0.96,0.01,0.06231854838709677,0.91,99.39
2020-05-01,Uttar Pradesh,796,3,791,9637,2826,157,8.26,2,248.0,94517,856,93940,1.14,0.06,0.03885887096774194,0.91,99.39
2020-05-02,Uttar Pradesh,1185,9,1182,14658,2678,2421,8.08,0,248.0,95702,865,95122,1.08,0.98,0.05910483870967742,0.9,99.39
2020-05-03,Uttar Pradesh,823,11,818,10281,185,137,8.01,0,248.0,96525,876,95940,0.07,0.06,0.04145564516129032,0.91,99.39
2020-05-04,Uttar Pradesh,761,3,756,9265,2636,834,8.21,2,248.0,97286,879,96696,1.06,0.34,0.03735887096774194,0.9,99.39
2020-05-05,Uttar Pradesh,412,2,407,4937,4235,466,8.35,3,248.0,97698,881,97103,1.71,0.19,0.01990725806451613,0.9,99.39
2020-05-06,Uttar Pradesh,663,4,663,8162,3149,1171,8.12,0,248.0,98361,885,97766,1.27,0.47,0.032911290322580646,0.9,99.4
2020-05-07,Uttar Pradesh,1219,14,1214,15645,4911,1496,7.79,0,248.0,99580,899,98980,1.98,0.6,0.06308467741935483,0.9,99.4
2020-05-08,Uttar Pradesh,488,4,486,6146,4092,2399,7.94,0,248.0,100068,903,99466,1.65,0.97,0.02478225806451613,0.9,99.4
2020-05-09,Uttar Pradesh,1280,5,1280,16043,308,194,7.98,0,248.0,101348,908,100746,0.12,0.08,0.06468951612903226,0.9,99.41
2020-05-10,Uttar Pradesh,1330,18,1329,16315,3921,229,8.15,0,248.0,102678,926,102075,1.58,0.09,0.06578629032258064,0.9,99.41
2020-05-11,Uttar Pradesh,171,2,164,1891,2484,1356,9.04,5,248.0,102849,928,102239,1.0,0.55,0.007625,0.9,99.41
2020-05-12,Uttar Pradesh,1194,4,1194,15633,2222,1461,7.64,0,248.0,104043,932,103433,0.9,0.59,0.06303629032258065,0.9,99.41
2020-05-13,Uttar Pradesh,197,0,188,2298,2778,685,8.57,9,248.0,104240,932,103621,1.12,0.28,0.009266129032258064,0.89,99.41
2020-05-14,Uttar Pradesh,1175,11,1170,14792,4174,1112,7.94,0,248.0,105415,943,104791,1.68,0.45,0.05964516129032258,0.89,99.41
2020-05-15,Uttar Pradesh,414,1,408,4743,73,59,8.73,5,248.0,105829,944,105199,0.03,0.02,0.019125,0.89,99.4
2020-05-16,Uttar Pradesh,582,3,573,6579,4329,2303,8.85,6,248.0,106411,947,105772,1.75,0.93,0.026528225806451613,0.89,99.4
2020-05-17,Uttar Pradesh,412,2,410,5089,1509,379,8.1,0,248.0,106823,949,106182,0.61,0.15,0.02052016129032258,0.89,99.4
2020-05-18,Uttar Pradesh,776,2,768,9982,224,125,7.77,6,248.0,107599,951,106950,0.09,0.05,0.04025,0.88,99.4
2020-05-19,Uttar Pradesh,1319,11,1318,16702,4557,241,7.9,0,248.0,108918,962,108268,1.84,0.1,0.06734677419354838,0.88,99.4
2020-05-20,Uttar Pradesh,727,4,720,8822,802,279,8.24,3,248.0,109645,966,108988,0.32,0.11,0.03557258064516129,0.88,99.4
2020-05-21,Uttar Pradesh,837,10,830,10260,9,2,8.16,0,248.0,110482,976,109818,0.0,0.0,0.04137096774193549,0.88,99.4
2020-05-22,Uttar Pradesh,1575,9,1570,19552,2144,788,8.06,0,248.0,112057,985,111388,0.86,0.32,0.07883870967741935,0.88,99.4
2020-05-23,Uttar Pradesh,1557,7,1553,19823,4063,650,7.85,0,248.0,113614,992,112941,1.64,0.26,0.07993145161290323,0.87,99.41
2020-05-24,Uttar Pradesh,999,5,995,12517,4038,2998,7.98,0,248.0,114613,997,113936,1.63,1.21,0.05047177419354839,0.87,99.41
2020-05-25,Uttar Pradesh,1057,14,1051,13382,4442,2144,7.9,0,248.0,115670,1011,114987,1.79,0.86,0.05395967741935484,0.87,99.41
2020-05-26,Uttar Pradesh,78,0,72,1138,411,87,6.85,6,248.0,115748,1011,115059,0.17,0.04,0.004588709677419355,0.87,99.4
2020-05-27,Uttar Pradesh,1384,16,1384,17438,4456,1435,7.94,0,248.0,117132,1027,116443,1.8,0.58,0.07031451612903226,0.88,99.41
2020-05-28,Uttar Pradesh,1372,6,1368,17400,2935,1406,7.89,0,248.0,118504,1033,117811,1.18,0.57,0.07016129032258064,0.87,99.42
2020-05-29,Uttar Pradesh,881,8,875,11501,2906,2725,7.66,0,248.0,119385,1041,118686,1.17,1.1,0.046375,0.87,99.41
2020-05-30,Uttar Pradesh,721,10,717,9477,501,460,7.61,0,248.0,120106,1051,119403,0.2,0.19,0.038213709677419355,0.88,99.41
2020-05-31,Uttar Pradesh,1538,16,1531,19368,1217,525,7.94,0,248.0,121644,1067,120934,0.49,0.21,0.0780967741935484,0.88,99.42
2020-06-01,Uttar Pradesh,636,5,627,8010,3704,1993,7.94,4,248.0,122280,1072,121561,1.49,0.8,0.03229838709677419,0.88,99.41
2020-06-02,Uttar Pradesh,479,6,475,5925,3538,2385,8.08,0,248.0,122759,1078,122036,1.43,0.96,0.023891129032258065,0.88,99.41
2020-06-03,Uttar Pradesh,403,3,400,4525,218,204,8.91,0,248.0,123162,1081,122436,0.09,0.08,0.018245967741935484,0.88,99.41
2020-06-04,Uttar Pradesh,1112,14,1111,13726,2512,2461,8.1,0,248.0,124274,1095,123547,1.01,0.99,0.05534677419354839,0.88,99.42
2020-06-05,Uttar Pradesh,1101,16,1098,13764,2262,527,8.0,0,248.0,125375,1111,124645,0.91,0.21,0.0555,0.89,99.42
2020-06-06,Uttar Pradesh,1397,12,1391,17437,3236,1583,8.01,0,248.0,126772,1123,126036,1.3,0.64,0.07031048387096774,0.89,99.42
2020-06-07,Uttar Pradesh,722,6,716,9292,3558,2278,7.77,0,248.0,127494,1129,126752,1.43,0.92,0.03746774193548387,0.89,99.42
2020-06-08,Uttar Pradesh,1576,13,1576,19650,841,188,8.02,0,248.0,129070,1142,128328,0.34,0.08,0.07923387096774194,0.88,99.43
2020-06-09,Uttar Pradesh,630,7,629,7678,3566,985,8.21,0,248.0,129700,1149,128957,1.44,0.4,0.030959677419354837,0.89,99.43
2020-06-10,Uttar Pradesh,495,4,486,6671,341,1,7.42,5,248.0,130195,1153,129443,0.14,0.0,0.026899193548387098,0.89,99.42
2020-06-11,Uttar Pradesh,705,8,701,8701,2428,629,8.1,0,248.0,130900,1161,130144,0.98,0.25,0.03508467741935484,0.89,99.42
2020-06-12,Uttar Pradesh,87,0,83,1077,2977,856,8.08,4,248.0,130987,1161,130227,1.2,0.35,0.004342741935483871,0.89,99.42
2020-06-13,Uttar Pradesh,968,3,963,11822,4632,2365,8.19,2,248.0,131955,1164,131190,1.87,0.95,0.047669354838709675,0.88,99.42
2020-06-14,Uttar Pradesh,496,5,492,6305,853,37,7.87,0,248.0,132451,1169,131682,0.34,0.01,0.025423387096774195,0.88,99.42
2020-06-15,Uttar Pradesh,1489,17,1487,19147,4785,3873,7.78,0,248.0,133940,1186,133169,1.93,1.56,0.07720564516129032,0.89,99.42
2020-06-16,Uttar Pradesh,1351,12,1351,16604,3147,1433,8.14,0,248.0,135291,1198,134520,1.27,0.58,0.06695161290322581,0.89,99.43
2020-06-17,Uttar Pradesh,654,6,648,8024,1856,330,8.15,0,248.0,135945,1204,135168,0.75,0.13,0.03235483870967742,0.89,99.43
2020-06-18,Uttar Pradesh,696,9,696,8732,718,245,7.97,0,248.0,136641,1213,135864,0.29,0.1,0.03520967741935484,0.89,99.43
2020-06-19,Uttar Pradesh,877,7,872,11289,2395,444,7.77,0,248.0,137518,1220,136736,0.97,0.18,0.04552016129032258,0.89,99.43
2020-06-20,Uttar Pradesh,442,3,439,5599,3844,3694,7.89,0,248.0,137960,1223,137175,1.55,1.49,0.022576612903225806,0.89,99.43
2020-06-21,Uttar Pradesh,1361,18,1353,17184,4732,239,7.92,0,248.0,139321,1241,138528,1.91,0.1,0.06929032258064516,0.89,99.43
2020-06-22,Uttar Pradesh,843,7,840,10442,3642,2470,8.07,0,248.0,140164,1248,139368,1.47,1.0,0.04210483870967742,0.89,99.43
2020-06-23,Uttar Pradesh,727,7,726,9350,4644,4011,7.78,0,248.0,140891,1255,140094,1.87,1.62,0.03770161290322581,0.89,99.43
2020-06-24,Uttar Pradesh,847,4,841,10874,1519,367,7.79,2,248.0,141738,1259,140935,0.61,0.15,0.043846774193548384,0.89,99.43
2020-06-25,Uttar Pradesh,272,1,266,2910,2174,2111,9.35,5,248.0,142010,1260,141201,0.88,0.85,0.011733870967741936,0.89,99.43
2020-06-26,Uttar Pradesh,774,7,765,9103,1335,535,8.5,2,248.0,142784,1267,141966,0.54,0.22,0.03670564516129032,0.89,99.43
2020-06-27,Uttar Pradesh,1037,9,1028,12463,3218,799,8.32,0,248.0,143821,1276,142994,1.3,0.32,0.05025403225806452,0.89,99.42
2020-06-28,Uttar Pradesh,860,7,858,10584,3715,585,8.13,0,248.0,144681,1283,143852,1.5,0.24,0.04267741935483871,0.89,99.43
2020-06-29,Uttar Pradesh,1519,11,1513,18979,2639,392,8.0,0,248.0,146200,1294,145365,1.06,0.16,0.07652822580645162,0.89,99.43
2020-06-30,Uttar Pradesh,1491,22,1486,18056,1037,1015,8.26,0,248.0,147691,1316,146851,0.42,0.41,0.07280645161290322,0.89,99.43
2020-07-01,Uttar Pradesh,1540,15,1537,19561,2456,313,7.87,0,248.0,149231,1331,148388,0.99,0.13,0.078875,0.89,99.44
2020-07-02,Uttar Pradesh,1178,16,1174,14586,4814,3179,8.08,0,248.0,150409,1347,149562,1.94,1.28,0.05881451612903226,0.9,99.44
2020-07-03,Uttar Pradesh,205,0,204,2556,3497,1282,8.02,1,248.0,150614,1347,149766,1.41,0.52,0.010306451612903226,0.89,99.44
2020-07-04,Uttar Pradesh,1363,15,1361,17397,3212,859,7.83,0,248.0,151977,1362,151127,1.3,0.35,0.0701491935483871,0.9,99.44
2020-07-05,Uttar Pradesh,925,9,923,11662,212,21,7.93,0,248.0,152902,1371,152050,0.09,0.01,0.0470241935483871,0.9,99.44
2020-07-06,Uttar Pradesh,1418,9,1415,17636,1263,521,8.04,0,248.0,154320,1380,153465,0.51,0.21,0.07111290322580645,0.89,99.45
2020-07-07,Uttar Pradesh,290,1,287,4057,2603,1,7.15,2,248.0,154610,1381,153752,1.05,0.0,0.016358870967741936,0.89,99.45
2020-07-08,Uttar Pradesh,1080,7,1072,13474,3822,32,8.02,1,248.0,155690,1388,154824,1.54,0.01,0.054330645161290325,0.89,99.44
2020-07-09,Uttar Pradesh,534,5,528,6634,3500,2368,8.05,1,248.0,156224,1393,155352,1.41,0.95,0.02675,0.89,99.44
2020-07-10,Uttar Pradesh,1305,9,1302,16611,1461,47,7.86,0,248.0,157529,1402,156654,0.59,0.02,0.06697983870967741,0.89,99.44
2020-07-11,Uttar Pradesh,1538,9,1537,19214,2769,1219,8.0,0,248.0,159067,1411,158191,1.12,0.49,0.07747580645161291,0.89,99.45
2020-07-12,Uttar Pradesh,1519,18,1518,18888,3653,318,8.04,0,248.0,160586,1429,159709,1.47,0.13,0.07616129032258065,0.89,99.45
2020-07-13,Uttar Pradesh,783,10,781,9876,2007,685,7.93,0,248.0,161369,1439,160490,0.81,0.28,0.03982258064516129,0.89,99.46
2020-07-14,Uttar Pradesh,933,7,925,12244,4647,2256,7.62,1,248.0,162302,1446,161415,1.87,0.91,0.04937096774193549,0.89,99.45
2020-07-15,Uttar Pradesh,851,11,844,10498,4678,1408,8.11,0,248.0,163153,1457,162259,1.89,0.57,0.04233064516129032,0.89,99.45
2020-07-16,Uttar Pradesh,723,3,720,9396,3232,1885,7.69,0,248.0,163876,1460,162979,1.3,0.76,0.03788709677419355,0.89,99.45
2020-07-17,Uttar Pradesh,730,7,721,9267,4759,2914,7.88,2,248.0,164606,1467,163700,1.92,1.18,0.03736693548387097,0.89,99.45
2020-07-18,Uttar Pradesh,184,0,183,2543,2729,1476,7.24,1,248.0,164790,1467,163883,1.1,0.6,0.010254032258064516,0.89,99.45
2020-07-19,Uttar Pradesh,1535,9,1530,18782,2797,706,8.17,0,248.0,166325,1476,165413,1.13,0.28,0.07573387096774194,0.89,99.45
2020-07-20,Uttar Pradesh,1045,14,1041,12784,172,54,8.17,0,248.0,167370,1490,166454,0.07,0.02,0.051548387096774194,0.89,99.45
2020-07-21,Uttar Pradesh,916,13,909,11545,1395,534,7.93,0,248.0,168286,1503,167363,0.56,0.22,0.04655241935483871,0.89,99.45
2020-07-22,Uttar Pradesh,331,3,325,3870,2926,541,8.55,3,248.0,168617,1506,167688,1.18,0.22,0.015604838709677419,0.89,99.45
2020-07-23,Uttar Pradesh,1143,4,1141,14164,4860,647,8.07,0,248.0,169760,1510,168829,1.96,0.26,0.05711290322580645,0.89,99.45
2020-07-24,Uttar Pradesh,996,13,994,12638,3488,196,7.88,0,248.0,170756,1523,169823,1.41,0.08,0.05095967741935484,0.89,99.45
2020-07-25,Uttar Pradesh,665,9,663,8323,2292,903,7.99,0,248.0,171421,1532,170486,0.92,0.36,0.033560483870967744,0.89,99.45
2020-07-26,Uttar Pradesh,1338,9,1331,16994,3101,474,7.87,0,248.0,172759,1541,171817,1.25,0.19,0.0685241935483871,0.89,99.45
2020-07-27,Uttar Pradesh,1231,7,1224,14805,1577,1436,8.31,0,248.0,173990,1548,173041,0.64,0.58,0.05969758064516129,0.89,99.45
2020-07-28,Uttar Pradesh,1236,4,1229,15315,3834,969,8.07,3,248.0,175226,1552,174270,1.55,0.39,0.061754032258064515,0.89,99.45
2020-07-29,Uttar Pradesh,956,13,955,11749,2115,792,8.14,0,248.0,176182,1565,175225,0.85,0.32,0.047375,0.89,99.46
2020-07-30,Uttar Pradesh,609,7,608,7601,715,435,8.01,0,248.0,176791,1572,175833,0.29,0.18,0.030649193548387098,0.89,99.46
2020-07-31,Uttar Pradesh,550,3,542,7027,992,42,7.83,5,248.0,177341,1575,176375,0.4,0.02,0.028334677419354838,0.89,99.46
2020-08-01,Uttar Pradesh,52,0,47,1100,4735,4512,4.73,5,248.0,177393,1575,176422,1.91,1.82,0.004435483870967742,0.89,99.45
2020-08-02,Uttar Pradesh,691,4,685,8404,4908,4311,8.22,2,248.0,178084,1579,177107,1.98,1.74,0.03388709677419355,0.89,99.45
2020-08-03,Uttar Pradesh,129,1,125,1517,1369,1062,8.5,3,248.0,178213,1580,177232,0.55,0.43,0.006116935483870968,0.89,99.45
2020-08-04,Uttar Pradesh,324,2,323,3879,1413,1248,8.35,0,248.0,178537,1582,177555,0.57,0.5,0.015641129032258064,0.89,99.45
2020-08-05,Uttar Pradesh,331,4,330,3664,255,210,9.03,0,248.0,178868,1586,177885,0.1,0.08,0.014774193548387098,0.89,99.45
2020-08-06,Uttar Pradesh,1346,8,1338,16994,192,116,7.92,0,248.0,180214,1594,179223,0.08,0.05,0.0685241935483871,0.88,99.45
2020-08-07,Uttar Pradesh,1002,3,1002,12882,1386,472,7.78,0,248.0,181216,1597,180225,0.56,0.19,0.05194354838709678,0.88,99.45
2020-08-08,Uttar Pradesh,1055,8,1050,13344,1964,1539,7.91,0,248.0,182271,1605,181275,0.79,0.62,0.053806451612903226,0.88,99.45
2020-08-09,Uttar Pradesh,1221,18,1216,15266,4683,1664,8.0,0,248.0,183492,1623,182491,1.89,0.67,0.061556451612903226,0.88,99.45
2020-08-10,Uttar Pradesh,398,3,395,5381,870,4,7.4,0,248.0,183890,1626,182886,0.35,0.0,0.02169758064516129,0.88,99.45
2020-08-11,Uttar Pradesh,881,6,878,10438,832,765,8.44,0,248.0,184771,1632,183764,0.34,0.31,0.04208870967741935,0.88,99.46
2020-08-12,Uttar Pradesh,1083,8,1082,13596,684,170,7.97,0,248.0,185854,1640,184846,0.28,0.07,0.05482258064516129,0.88,99.46
2020-08-13,Uttar Pradesh,433,6,426,5073,4078,1679,8.54,1,248.0,186287,1646,185272,1.64,0.68,0.020455645161290323,0.88,99.46
2020-08-14,Uttar Pradesh,1089,5,1086,13940,4671,4151,7.81,0,248.0,187376,1651,186358,1.88,1.67,0.05620967741935484,0.88,99.46
2020-08-15,Uttar Pradesh,80,1,72,1047,3857,1423,7.64,7,248.0,187456,1652,186430,1.56,0.57,0.004221774193548387,0.88,99.45
2020-08-16,Uttar Pradesh,648,9,639,7755,4639,3120,8.36,0,248.0,188104,1661,187069,1.87,1.26,0.03127016129032258,0.88,99.45
2020-08-17,Uttar Pradesh,491,6,487,5944,2296,1278,8.26,0,248.0,188595,1667,187556,0.93,0.52,0.02396774193548387,0.88,99.45
2020-08-18,Uttar Pradesh,367,5,358,4267,992,422,8.6,4,248.0,188962,1672,187914,0.4,0.17,0.017205645161290323,0.88,99.45
2020-08-19,Uttar Pradesh,959,6,950,11617,3095,1361,8.26,3,248.0,189921,1678,188864,1.25,0.55,0.04684274193548387,0.88,99.44
2020-08-20,Uttar Pradesh,54,0,54,791,843,467,6.83,0,248.0,189975,1678,188918,0.34,0.19,0.0031895161290322583,0.88,99.44
2020-08-21,Uttar Pradesh,811,4,808,10358,901,488,7.83,0,248.0,190786,1682,189726,0.36,0.2,0.04176612903225806,0.88,99.44
2020-08-22,Uttar Pradesh,623,3,623,7918,3587,2579,7.87,0,248.0,191409,1685,190349,1.45,1.04,0.03192741935483871,0.88,99.45
2020-08-23,Uttar Pradesh,499,2,497,6374,3111,3101,7.83,0,248.0,191908,1687,190846,1.25,1.25,0.025701612903225805,0.88,99.45
2020-08-24,Uttar Pradesh,453,5,452,5878,2360,337,7.71,0,248.0,192361,1692,191298,0.95,0.14,0.023701612903225807,0.88,99.45
2020-08-25,Uttar Pradesh,1443,17,1436,17909,2309,979,8.06,0,248.0,193804,1709,192734,0.93,0.39,0.07221370967741936,0.88,99.45
2020-08-26,Uttar Pradesh,512,4,508,6698,1565,1142,7.64,0,248.0,194316,1713,193242,0.63,0.46,0.027008064516129034,0.88,99.45
2020-08-27,Uttar Pradesh,821,3,821,10008,4998,3253,8.2,0,248.0,195137,1716,194063,2.02,1.31,0.04035483870967742,0.88,99.45
2020-08-28,Uttar Pradesh,63,0,56,762,4465,752,8.27,7,248.0,195200,1716,194119,1.8,0.3,0.0030725806451612904,0.88,99.45
2020-08-29,Uttar Pradesh,1175,8,1167,15286,4374,3630,7.69,0,248.0,196375,1724,195286,1.76,1.46,0.061637096774193545,0.88,99.45
2020-08-30,Uttar Pradesh,1006,9,1004,12880,3650,3416,7.81,0,248.0,197381,1733,196290,1.47,1.38,0.05193548387096774,0.88,99.45
2020-08-31,Uttar Pradesh,866,8,857,10883,169,155,7.96,1,248.0,198247,1741,197147,0.07,0.06,0.043883064516129035,0.88,99.45
2020-09-01,Uttar Pradesh,349,2,349,4395,2165,1109,7.94,0,248.0,198596,1743,197496,0.87,0.45,0.01772177419354839,0.88,99.45
2020-09-02,Uttar Pradesh,163,1,158,1786,4893,4269,9.13,4,248.0,198759,1744,197654,1.97,1.72,0.007201612903225806,0.88,99.44
2020-09-03,Uttar Pradesh,1507,16,1507,18859,1334,910,7.99,0,248.0,200266,1760,199161,0.54,0.37,0.07604435483870968,0.88,99.45
2020-09-04,Uttar Pradesh,202,1,201,2796,3898,2982,7.22,0,248.0,200468,1761,199362,1.57,1.2,0.011274193548387096,0.88,99.45
2020-09-05,Uttar Pradesh,651,6,643,8510,2157,1669,7.65,2,248.0,201119,1767,200005,0.87,0.67,0.03431451612903226,0.88,99.45
2020-09-06,Uttar Pradesh,1379,4,1371,17001,1408,1372,8.11,4,248.0,202498,1771,201376,0.57,0.55,0.0685524193548387,0.87,99.45
2020-09-07,Uttar Pradesh,595,2,586,7674,746,118,7.75,7,248.0,203093,1773,201962,0.3,0.05,0.030943548387096773,0.87,99.44
2020-09-08,Uttar Pradesh,859,7,856,10880,880,764,7.9,0,248.0,203952,1780,202818,0.35,0.31,0.04387096774193548,0.87,99.44
2020-09-09,Uttar Pradesh,1196,16,1194,14826,4796,837,8.07,0,248.0,205148,1796,204012,1.93,0.34,0.059782258064516126,0.88,99.45
2020-09-10,Uttar Pradesh,929,11,922,11140,3660,2639,8.34,0,248.0,206077,1807,204934,1.48,1.06,0.04491935483870968,0.88,99.45
2020-09-11,Uttar Pradesh,1073,15,1064,13012,4720,148,8.25,0,248.0,207150,1822,205998,1.9,0.06,0.05246774193548387,0.88,99.44
2020-09-12,Uttar Pradesh,1287,11,1286,16114,4866,366,7.99,0,248.0,208437,1833,207284,1.96,0.15,0.0649758064516129,0.88,99.45
2020-09-13,Uttar Pradesh,1204,7,1198,15055,1002,663,8.0,0,248.0,209641,1840,208482,0.4,0.27,0.060705645161290324,0.88,99.45
2020-09-14,Uttar Pradesh,1207,12,1206,14736,214,95,8.19,0,248.0,210848,1852,209688,0.09,0.04,0.05941935483870968,0.88,99.45
2020-09-15,Uttar Pradesh,1063,5,1061,13323,1591,55,7.98,0,248.0,211911,1857,210749,0.64,0.02,0.053721774193548386,0.88,99.45
2020-09-16,Uttar Pradesh,965,13,959,12515,229,19,7.71,0,248.0,212876,1870,211708,0.09,0.01,0.05046370967741935,0.88,99.45
2020-09-17,Uttar Pradesh,947,7,938,11898,2659,90,7.96,2,248.0,213823,1877,212646,1.07,0.04,0.0479758064516129,0.88,99.45
2020-09-18,Uttar Pradesh,578,3,576,7079,2796,1114,8.16,0,248.0,214401,1880,213222,1.13,0.45,0.02854435483870968,0.88,99.45
2020-09-19,Uttar Pradesh,78,0,78,1067,4922,1052,7.31,0,248.0,214479,1880,213300,1.98,0.42,0.00430241935483871,0.88,99.45
2020-09-20,Uttar Pradesh,399,4,391,5347,3702,106,7.46,4,248.0,214878,1884,213691,1.49,0.04,0.02156048387096774,0.88,99.45
2020-09-21,Uttar Pradesh,651,7,644,8311,3832,964,7.83,0,248.0,215529,1891,214335,1.55,0.39,0.03351209677419355,0.88,99.45
2020-09-22,Uttar Pradesh,384,4,382,5075,2202,1484,7.57,0,248.0,215913,1895,214717,0.89,0.6,0.020463709677419353,0.88,99.45
2020-09-23,Uttar Pradesh,1063,11,1055,13011,277,178,8.17,0,248.0,216976,1906,215772,0.11,0.07,0.052463709677419354,0.88,99.45
2020-09-24,Uttar Pradesh,1163,15,1161,14896,2999,462,7.81,0,248.0,218139,1921,216933,1.21,0.19,0.060064516129032255,0.88,99.45
2020-09-25,Uttar Pradesh,871,4,869,10862,4819,169,8.02,0,248.0,219010,1925,217802,1.94,0.07,0.043798387096774194,0.88,99.45
2020-09-26,Uttar Pradesh,1599,5,1597,19706,3991,400,8.11,0,248.0,220609,1930,219399,1.61,0.16,0.07945967741935483,0.87,99.45
2020-09-27,Uttar Pradesh,863,6,862,10847,3407,2572,7.96,0,248.0,221472,1936,220261,1.37,1.04,0.04373790322580645,0.87,99.45
2020-09-28,Uttar Pradesh,583,2,576,7129,837,287,8.18,5,248.0,222055,1938,220837,0.34,0.12,0.028745967741935483,0.87,99.45
2020-09-29,Uttar Pradesh,1063,12,1062,13348,398,203,7.96,0,248.0,223118,1950,221899,0.16,0.08,0.05382258064516129,0.87,99.45
2020-09-30,Uttar Pradesh,154,0,153,1645,3846,3181,9.36,1,248.0,223272,1950,222052,1.55,1.28,0.006633064516129032,0.87,99.45
2020-10-01,Uttar Pradesh,1029,4,1026,13239,2831,2801,7.77,0,248.0,224301,1954,223078,1.14,1.13,0.05338306451612903,0.87,99.45
2020-10-02,Uttar Pradesh,844,10,842,10349,876,543,8.16,0,248.0,225145,1964,223920,0.35,0.22,0.04172983870967742,0.87,99.46
2020-10-03,Uttar Pradesh,1267,8,1258,15988,3064,2725,7.92,1,248.0,226412,1972,225178,1.24,1.1,0.06446774193548387,0.87,99.45
2020-10-04,Uttar Pradesh,308,2,305,4149,1381,824,7.42,1,248.0,226720,1974,225483,0.56,0.33,0.016729838709677418,0.87,99.45
2020-10-05,Uttar Pradesh,873,7,868,10997,1956,1279,7.94,0,248.0,227593,1981,226351,0.79,0.52,0.04434274193548387,0.87,99.45
2020-10-06,Uttar Pradesh,1246,3,1239,15252,3884,163,8.17,4,248.0,228839,1984,227590,1.57,0.07,0.0615,0.87,99.45
2020-10-07,Uttar Pradesh,798,10,790,10033,4051,3004,7.95,0,248.0,229637,1994,228380,1.63,1.21,0.04045564516129032,0.87,99.45
2020-10-08,Uttar Pradesh,490,5,483,6068,987,845,8.08,2,248.0,230127,1999,228863,0.4,0.34,0.024467741935483872,0.87,99.45
2020-10-09,Uttar Pradesh,1080,12,1072,13082,4466,4366,8.26,0,248.0,231207,2011,229935,1.8,1.76,0.05275,0.87,99.45
2020-10-10,Uttar Pradesh,121,1,115,1970,821,253,6.14,5,248.0,231328,2012,230050,0.33,0.1,0.007943548387096775,0.87,99.45
2020-10-11,Uttar Pradesh,536,2,534,6662,1865,496,8.05,0,248.0,231864,2014,230584,0.75,0.2,0.02686290322580645,0.87,99.45
2020-10-12,Uttar Pradesh,204,1,197,2452,4863,846,8.32,6,248.0,232068,2015,230781,1.96,0.34,0.009887096774193548,0.87,99.45
2020-10-13,Uttar Pradesh,459,3,453,5537,4718,2846,8.29,3,248.0,232527,2018,231234,1.9,1.15,0.022326612903225806,0.87,99.44
2020-10-14,Uttar Pradesh,143,1,143,1867,4019,2809,7.66,0,248.0,232670,2019,231377,1.62,1.13,0.007528225806451613,0.87,99.44
2020-10-15,Uttar Pradesh,1281,7,1277,16305,4455,243,7.86,0,248.0,233951,2026,232654,1.8,0.1,0.06574596774193549,0.87,99.45
2020-10-16,Uttar Pradesh,1305,14,1304,16533,2413,449,7.89,0,248.0,235256,2040,233958,0.97,0.18,0.06666532258064516,0.87,99.45
2020-10-17,Uttar Pradesh,525,7,525,6617,3889,3705,7.93,0,248.0,235781,2047,234483,1.57,1.49,0.026681451612903227,0.87,99.45
2020-10-18,Uttar Pradesh,1520,17,1516,19035,4284,3619,7.99,0,248.0,237301,2064,235999,1.73,1.46,0.07675403225806451,0.87,99.45
2020-10-19,Uttar Pradesh,1281,9,1274,15711,3856,2892,8.15,0,248.0,238582,2073,237273,1.55,1.17,0.06335080645161291,0.87,99.45
2020-10-20,Uttar Pradesh,624,8,621,7791,2957,940,8.01,0,248.0,239206,2081,237894,1.19,0.38,0.03141532258064516,0.87,99.45
2020-10-21,Uttar Pradesh,675,2,672,8289,4958,3552,8.14,1,248.0,239881,2083,238566,2.0,1.43,0.03342338709677419,0.87,99.45
2020-10-22,Uttar Pradesh,162,1,162,2169,2482,433,7.47,0,248.0,240043,2084,238728,1.0,0.17,0.008745967741935484,0.87,99.45
2020-10-23,Uttar Pradesh,638,6,635,7942,3157,1286,8.03,0,248.0,240681,2090,239363,1.27,0.52,0.0320241935483871,0.87,99.45
2020-10-24,Uttar Pradesh,1042,6,1039,12237,960,712,8.52,0,248.0,241723,2096,240402,0.39,0.29,0.04934274193548387,0.87,99.45
2020-10-25,Uttar Pradesh,450,4,443,5515,4076,838,8.16,3,248.0,242173,2100,240845,1.64,0.34,0.022237903225806453,0.87,99.45
2020-10-26,Uttar Pradesh,392,3,391,5020,839,293,7.81,0,248.0,242565,2103,241236,0.34,0.12,0.020241935483870967,0.87,99.45
2020-10-27,Uttar Pradesh,90,1,86,1243,1137,418,7.24,3,248.0,242655,2104,241322,0.46,0.17,0.005012096774193548,0.87,99.45
2020-10-28,Uttar Pradesh,267,1,264,3206,4241,1162,8.33,2,248.0,242922,2105,241586,1.71,0.47,0.01292741935483871,0.87,99.45
2020-10-29,Uttar Pradesh,396,1,394,5060,2933,30,7.83,1,248.0,243318,2106,241980,1.18,0.01,0.020403225806451614,0.87,99.45
2020-10-30,Uttar Pradesh,676,6,667,8336,3277,3053,8.11,3,248.0,243994,2112,242647,1.32,1.23,0.03361290322580645,0.87,99.45
2020-10-31,Uttar Pradesh,176,2,170,2093,4546,1780,8.41,4,248.0,244170,2114,242817,1.83,0.72,0.008439516129032258,0.87,99.45
2020-11-01,Uttar Pradesh,1355,6,1354,17040,519,484,7.95,0,248.0,245525,2120,244171,0.21,0.2,0.06870967741935484,0.86,99.45
2020-11-02,Uttar Pradesh,321,3,313,4287,1017,904,7.49,5,248.0,245846,2123,244484,0.41,0.36,0.017286290322580646,0.86,99.45
2020-11-03,Uttar Pradesh,938,4,938,11815,4831,1363,7.94,0,248.0,246784,2127,245422,1.95,0.55,0.04764112903225806,0.86,99.45
2020-11-04,Uttar Pradesh,1346,6,1337,16585,1745,1196,8.12,3,248.0,248130,2133,246759,0.7,0.48,0.066875,0.86,99.45
2020-11-05,Uttar Pradesh,1061,10,1054,12826,2364,1673,8.27,0,248.0,249191,2143,247813,0.95,0.67,0.05171774193548387,0.86,99.45
2020-11-06,Uttar Pradesh,493,6,492,6100,1009,310,8.08,0,248.0,249684,2149,248305,0.41,0.12,0.024596774193548387,0.86,99.45
2020-11-07,Uttar Pradesh,392,1,386,5166,1912,1499,7.59,5,248.0,250076,2150,248691,0.77,0.6,0.020830645161290323,0.86,99.45
2020-11-08,Uttar Pradesh,364,1,363,4784,1549,370,7.61,0,248.0,250440,2151,249054,0.62,0.15,0.019290322580645163,0.86,99.45
2020-11-09,Uttar Pradesh,1557,8,1552,19408,4441,2898,8.02,0,248.0,251997,2159,250606,1.79,1.17,0.07825806451612903,0.86,99.45
2020-11-10,Uttar Pradesh,1190,4,1183,14927,1826,1154,7.97,3,248.0,253187,2163,251789,0.74,0.47,0.060189516129032256,0.85,99.45
2020-11-11,Uttar Pradesh,1486,17,1481,18650,707,642,7.97,0,248.0,254673,2180,253270,0.29,0.26,0.0752016129032258,0.86,99.45
2020-11-12,Uttar Pradesh,225,1,219,3256,2431,1809,6.91,5,248.0,254898,2181,253489,0.98,0.73,0.013129032258064516,0.86,99.45
2020-11-13,Uttar Pradesh,468,1,464,5293,2670,2146,8.84,3,248.0,255366,2182,253953,1.08,0.87,0.02134274193548387,0.85,99.45
2020-11-14,Uttar Pradesh,1552,21,1546,19149,2143,1216,8.1,0,248.0,256918,2203,255499,0.86,0.49,0.07721370967741935,0.86,99.45
2020-11-15,Uttar Pradesh,120,0,112,1454,1456,1191,8.25,8,248.0,257038,2203,255611,0.59,0.48,0.005862903225806452,0.86,99.44
2020-11-16,Uttar Pradesh,986,4,980,12019,2565,356,8.2,2,248.0,258024,2207,256591,1.03,0.14,0.04846370967741936,0.86,99.44
2020-11-17,Uttar Pradesh,1488,4,1479,18557,1346,727,8.02,5,248.0,259512,2211,258070,0.54,0.29,0.0748266129032258,0.85,99.44
2020-11-18,Uttar Pradesh,1529,12,1524,18808,137,134,8.13,0,248.0,261041,2223,259594,0.06,0.05,0.07583870967741936,0.85,99.45
2020-11-19,Uttar Pradesh,1374,8,1367,17690,4461,180,7.77,0,248.0,262415,2231,260961,1.8,0.07,0.07133064516129033,0.85,99.45
2020-11-20,Uttar Pradesh,1433,20,1427,17622,3130,181,8.13,0,248.0,263848,2251,262388,1.26,0.07,0.07105645161290322,0.85,99.45
2020-11-21,Uttar Pradesh,1506,5,1499,18573,3842,3597,8.11,2,248.0,265354,2256,263887,1.55,1.45,0.07489112903225806,0.85,99.45
2020-11-22,Uttar Pradesh,116,1,111,1811,157,7,6.41,4,248.0,265470,2257,263998,0.06,0.0,0.00730241935483871,0.85,99.45
2020-11-23,Uttar Pradesh,339,1,333,4304,363,360,7.88,5,248.0,265809,2258,264331,0.15,0.15,0.01735483870967742,0.85,99.44
2020-11-24,Uttar Pradesh,936,11,929,11805,2718,1006,7.93,0,248.0,266745,2269,265260,1.1,0.41,0.0476008064516129,0.85,99.44
2020-11-25,Uttar Pradesh,318,4,317,3705,2923,2083,8.58,0,248.0,267063,2273,265577,1.18,0.84,0.014939516129032259,0.85,99.44
2020-11-26,Uttar Pradesh,345,1,344,4066,1237,427,8.48,0,248.0,267408,2274,265921,0.5,0.17,0.01639516129032258,0.85,99.44
2020-11-27,Uttar Pradesh,1029,13,1021,12760,3295,1628,8.06,0,248.0,268437,2287,266942,1.33,0.66,0.05145161290322581,0.85,99.44
2020-11-28,Uttar Pradesh,981,5,980,11967,3623,1940,8.2,0,248.0,269418,2292,267922,1.46,0.78,0.048254032258064516,0.85,99.44
2020-11-29,Uttar Pradesh,675,4,669,8321,406,149,8.11,2,248.0,270093,2296,268591,0.16,0.06,0.03355241935483871,0.85,99.44
2020-11-30,Uttar Pradesh,1173,14,1165,14411,3544,106,8.14,0,248.0,271266,2310,269756,1.43,0.04,0.058108870967741935,0.85,99.44
2020-12-01,Uttar Pradesh,193,2,192,2589,2196,2038,7.45,0,248.0,271459,2312,269948,0.89,0.82,0.010439516129032258,0.85,99.44
2020-12-02,Uttar Pradesh,554,6,554,7091,2428,2163,7.81,0,248.0,272013,2318,270502,0.98,0.87,0.028592741935483872,0.85,99.44
2020-12-03,Uttar Pradesh,1097,8,1093,13973,349,296,7.85,0,248.0,273110,2326,271595,0.14,0.12,0.05634274193548387,0.85,99.45
2020-12-04,Uttar Pradesh,974,12,970,11776,3909,2671,8.27,0,248.0,274084,2338,272565,1.58,1.08,0.04748387096774193,0.85,99.45
2020-12-05,Uttar Pradesh,511,2,507,6596,2078,376,7.75,2,248.0,274595,2340,273072,0.84,0.15,0.026596774193548386,0.85,99.45
2020-12-06,Uttar Pradesh,407,5,399,4759,4198,4111,8.55,3,248.0,275002,2345,273471,1.69,1.66,0.019189516129032257,0.85,99.44
2020-12-07,Uttar Pradesh,885,9,878,11163,609,95,7.93,0,248.0,275887,2354,274349,0.25,0.04,0.04501209677419355,0.85,99.44
2020-12-08,Uttar Pradesh,644,8,641,8040,3331,2,8.01,0,248.0,276531,2362,274990,1.34,0.0,0.032419354838709676,0.85,99.44
2020-12-09,Uttar Pradesh,1220,8,1217,15464,2832,128,7.89,0,248.0,277751,2370,276207,1.14,0.05,0.06235483870967742,0.85,99.44
2020-12-10,Uttar Pradesh,556,8,550,7291,3870,1282,7.63,0,248.0,278307,2378,276757,1.56,0.52,0.029399193548387097,0.85,99.44
2020-12-11,Uttar Pradesh,380,2,378,4888,2287,1655,7.77,0,248.0,278687,2380,277135,0.92,0.67,0.019709677419354837,0.85,99.44
2020-12-12,Uttar Pradesh,771,10,763,9551,1490,482,8.07,0,248.0,279458,2390,277898,0.6,0.19,0.038512096774193545,0.86,99.44
2020-12-13,Uttar Pradesh,668,4,667,8080,3587,437,8.27,0,248.0,280126,2394,278565,1.45,0.18,0.03258064516129032,0.85,99.44
2020-12-14,Uttar Pradesh,916,6,915,11317,2782,466,8.09,0,248.0,281042,2400,279480,1.12,0.19,0.04563306451612903,0.85,99.44
2020-12-15,Uttar Pradesh,334,1,331,4395,4136,763,7.6,2,248.0,281376,2401,279811,1.67,0.31,0.01772177419354839,0.85,99.44
2020-12-16,Uttar Pradesh,867,9,864,10410,2553,2494,8.33,0,248.0,282243,2410,280675,1.03,1.01,0.041975806451612904,0.85,99.44
2020-12-17,Uttar Pradesh,1182,8,1179,14475,1057,785,8.17,0,248.0,283425,2418,281854,0.43,0.32,0.058366935483870966,0.85,99.45
2020-12-18,Uttar Pradesh,1219,14,1212,15140,507,479,8.05,0,248.0,284644,2432,283066,0.2,0.19,0.061048387096774195,0.85,99.45
2020-12-19,Uttar Pradesh,1405,16,1397,17450,864,424,8.05,0,248.0,286049,2448,284463,0.35,0.17,0.07036290322580645,0.86,99.45
2020-12-20,Uttar Pradesh,295,4,295,3566,3716,235,8.27,0,248.0,286344,2452,284758,1.5,0.09,0.014379032258064516,0.86,99.45
2020-12-21,Uttar Pradesh,369,1,363,4813,4068,3656,7.67,5,248.0,286713,2453,285121,1.64,1.47,0.01940725806451613,0.86,99.44
2020-12-22,Uttar Pradesh,1544,19,1540,19846,2298,1190,7.78,0,248.0,288257,2472,286661,0.93,0.48,0.0800241935483871,0.86,99.45
2020-12-23,Uttar Pradesh,1415,10,1411,17259,2307,566,8.2,0,248.0,289672,2482,288072,0.93,0.23,0.06959274193548387,0.86,99.45
2020-12-24,Uttar Pradesh,618,4,613,7546,2909,121,8.19,1,248.0,290290,2486,288685,1.17,0.05,0.03042741935483871,0.86,99.45
2020-12-25,Uttar Pradesh,1089,14,1087,13659,3349,787,7.97,0,248.0,291379,2500,289772,1.35,0.32,0.055076612903225804,0.86,99.45
2020-12-26,Uttar Pradesh,837,7,832,10481,3727,1081,7.99,0,248.0,292216,2507,290604,1.5,0.44,0.04226209677419355,0.86,99.45
2020-12-27,Uttar Pradesh,876,5,869,10969,4854,943,7.99,2,248.0,293092,2512,291473,1.96,0.38,0.04422983870967742,0.86,99.45
2020-12-28,Uttar Pradesh,1275,4,1275,15691,1917,300,8.13,0,248.0,294367,2516,292748,0.77,0.12,0.06327016129032258,0.85,99.45
2020-12-29,Uttar Pradesh,1063,4,1060,13136,4006,2039,8.09,0,248.0,295430,2520,293808,1.62,0.82,0.05296774193548387,0.85,99.45
2020-12-30,Uttar Pradesh,260,1,255,2638,1025,908,9.86,4,248.0,295690,2521,294063,0.41,0.37,0.010637096774193548,0.85,99.45
2020-12-31,Uttar Pradesh,437,4,436,5440,2523,726,8.03,0,248.0,296127,2525,294499,1.02,0.29,0.02193548387096774,0.85,99.45
2021-01-01,Uttar Pradesh,750,5,743,9847,4398,4065,7.62,2,248.0,296877,2530,295242,1.77,1.64,0.03970564516129032,0.85,99.45
2021-01-02,Uttar Pradesh,295,1,293,3454,4754,324,8.54,1,248.0,297172,2531,295535,1.92,0.13,0.01392741935483871,0.85,99.45
2021-01-03,Uttar Pradesh,759,10,755,9617,802,314,7.89,0,248.0,297931,2541,296290,0.32,0.13,0.03877822580645161,0.85,99.45
2021-01-04,Uttar Pradesh,699,4,693,8478,1704,1164,8.24,2,248.0,298630,2545,296983,0.69,0.47,0.034185483870967745,0.85,99.45
2021-01-05,Uttar Pradesh,1085,10,1080,12880,2697,129,8.42,0,248.0,299715,2555,298063,1.09,0.05,0.05193548387096774,0.85,99.45
2021-01-06,Uttar Pradesh,1259,18,1250,16193,461,237,7.77,0,248.0,300974,2573,299313,0.19,0.1,0.06529435483870968,0.85,99.45
2021-01-07,Uttar Pradesh,233,2,228,2891,4075,2693,8.06,3,248.0,301207,2575,299541,1.64,1.09,0.011657258064516129,0.85,99.45
2021-01-08,Uttar Pradesh,1281,8,1272,15890,3241,1839,8.06,1,248.0,302488,2583,300813,1.31,0.74,0.06407258064516129,0.85,99.45
2021-01-09,Uttar Pradesh,1285,14,1285,15991,3773,1253,8.04,0,248.0,303773,2597,302098,1.52,0.51,0.06447983870967743,0.85,99.45
2021-01-10,Uttar Pradesh,822,6,815,10232,158,89,8.03,1,248.0,304595,2603,302913,0.06,0.04,0.04125806451612903,0.85,99.45
2021-01-11,Uttar Pradesh,1314,17,1310,16407,3466,2444,8.01,0,248.0,305909,2620,304223,1.4,0.99,0.06615725806451613,0.86,99.45
2021-01-12,Uttar Pradesh,1041,10,1036,12900,2771,1922,8.07,0,248.0,306950,2630,305259,1.12,0.78,0.052016129032258066,0.86,99.45
2021-01-13,Uttar Pradesh,1299,4,1295,16498,4008,3841,7.87,0,248.0,308249,2634,306554,1.62,1.55,0.0665241935483871,0.85,99.45
2021-01-14,Uttar Pradesh,525,6,518,6351,4393,1447,8.27,1,248.0,308774,2640,307072,1.77,0.58,0.025608870967741934,0.85,99.45
2021-01-15,Uttar Pradesh,755,8,746,9530,4278,2324,7.92,1,248.0,309529,2648,307818,1.72,0.94,0.03842741935483871,0.86,99.45
2021-01-16,Uttar Pradesh,109,0,108,1243,1186,1028,8.77,1,248.0,309638,2648,307926,0.48,0.41,0.005012096774193548,0.86,99.45
2021-01-17,Uttar Pradesh,682,8,679,8309,3330,882,8.21,0,248.0,310320,2656,308605,1.34,0.36,0.03350403225806452,0.86,99.45
2021-01-18,Uttar Pradesh,1469,9,1466,18862,3659,2922,7.79,0,248.0,311789,2665,310071,1.48,1.18,0.07605645161290323,0.85,99.45
2021-01-19,Uttar Pradesh,791,11,783,10397,3989,349,7.61,0,248.0,312580,2676,310854,1.61,0.14,0.04192338709677419,0.86,99.45
2021-01-20,Uttar Pradesh,404,3,400,5023,4494,1344,8.04,1,248.0,312984,2679,311254,1.81,0.54,0.020254032258064516,0.86,99.45
2021-01-21,Uttar Pradesh,1174,4,1171,14402,1394,203,8.15,0,248.0,314158,2683,312425,0.56,0.08,0.05807258064516129,0.85,99.45
2021-01-22,Uttar Pradesh,1202,12,1194,15240,1783,707,7.89,0,248.0,315360,2695,313619,0.72,0.29,0.06145161290322581,0.85,99.45
2021-01-23,Uttar Pradesh,814,8,811,10348,1456,716,7.87,0,248.0,316174,2703,314430,0.59,0.29,0.041725806451612904,0.85,99.45
2021-01-24,Uttar Pradesh,268,1,266,3518,1691,37,7.62,1,248.0,316442,2704,314696,0.68,0.01,0.014185483870967741,0.85,99.45
2021-01-25,Uttar Pradesh,325,3,320,4091,1505,247,7.94,2,248.0,316767,2707,315016,0.61,0.1,0.016495967741935486,0.85,99.45
2021-01-26,Uttar Pradesh,577,4,576,7268,3006,1178,7.94,0,248.0,317344,2711,315592,1.21,0.48,0.029306451612903225,0.85,99.45
2021-01-27,Uttar Pradesh,996,14,988,12161,4625,1692,8.19,0,248.0,318340,2725,316580,1.86,0.68,0.049036290322580646,0.86,99.45
2021-01-28,Uttar Pradesh,1181,8,1181,15027,1007,518,7.86,0,248.0,319521,2733,317761,0.41,0.21,0.06059274193548387,0.86,99.45
2021-01-29,Uttar Pradesh,1064,13,1059,12916,366,233,8.24,0,248.0,320585,2746,318820,0.15,0.09,0.05208064516129032,0.86,99.45
2021-01-30,Uttar Pradesh,1402,7,1401,17446,3851,14,8.04,0,248.0,321987,2753,320221,1.55,0.01,0.07034677419354839,0.86,99.45
2021-01-31,Uttar Pradesh,939,8,938,11834,4901,3809,7.93,0,248.0,322926,2761,321159,1.98,1.54,0.04771774193548387,0.85,99.45
2021-02-01,Uttar Pradesh,914,8,912,11073,2447,1755,8.25,0,248.0,323840,2769,322071,0.99,0.71,0.044649193548387096,0.86,99.45
2021-02-02,Uttar Pradesh,674,9,670,8788,4859,4253,7.67,0,248.0,324514,2778,322741,1.96,1.71,0.03543548387096774,0.86,99.45
2021-02-03,Uttar Pradesh,1207,12,1201,14894,2492,2487,8.1,0,248.0,325721,2790,323942,1.0,1.0,0.060056451612903225,0.86,99.45
2021-02-04,Uttar Pradesh,236,1,232,2984,2138,1980,7.91,3,248.0,325957,2791,324174,0.86,0.8,0.012032258064516129,0.86,99.45
2021-02-05,Uttar Pradesh,551,6,543,6569,32,13,8.39,2,248.0,326508,2797,324717,0.01,0.01,0.02648790322580645,0.86,99.45
2021-02-06,Uttar Pradesh,346,4,346,4365,3658,852,7.93,0,248.0,326854,2801,325063,1.48,0.34,0.017600806451612903,0.86,99.45
2021-02-07,Uttar Pradesh,1012,10,1004,12933,168,22,7.82,0,248.0,327866,2811,326067,0.07,0.01,0.052149193548387096,0.86,99.45
2021-02-08,Uttar Pradesh,860,10,860,11068,3654,2988,7.77,0,248.0,328726,2821,326927,1.47,1.2,0.04462903225806451,0.86,99.45
2021-02-09,Uttar Pradesh,929,9,920,11928,403,256,7.79,0,248.0,329655,2830,327847,0.16,0.1,0.04809677419354839,0.86,99.45
2021-02-10,Uttar Pradesh,1234,11,1228,15309,484,275,8.06,0,248.0,330889,2841,329075,0.2,0.11,0.061729838709677416,0.86,99.45
2021-02-11,Uttar Pradesh,715,6,711,9089,1862,100,7.87,0,248.0,331604,2847,329786,0.75,0.04,0.036649193548387096,0.86,99.45
2021-02-12,Uttar Pradesh,119,1,115,1654,1315,638,7.19,3,248.0,331723,2848,329901,0.53,0.26,0.006669354838709678,0.86,99.45
2021-02-13,Uttar Pradesh,1045,7,1045,13407,307,248,7.79,0,248.0,332768,2855,330946,0.12,0.1,0.05406048387096774,0.86,99.45
2021-02-14,Uttar Pradesh,190,2,183,2827,335,77,6.72,5,248.0,332958,2857,331129,0.14,0.03,0.011399193548387096,0.86,99.45
2021-02-15,Uttar Pradesh,292,3,283,3928,3239,2285,7.43,6,248.0,333250,2860,331412,1.31,0.92,0.015838709677419356,0.86,99.45
2021-02-16,Uttar Pradesh,1067,10,1058,13226,1655,1420,8.07,0,248.0,334317,2870,332470,0.67,0.57,0.053330645161290324,0.86,99.45
2021-02-17,Uttar Pradesh,975,3,972,12175,4371,2571,8.01,0,248.0,335292,2873,333442,1.76,1.04,0.04909274193548387,0.86,99.45
2021-02-18,Uttar Pradesh,257,3,249,3087,4285,1886,8.33,5,248.0,335549,2876,333691,1.73,0.76,0.01244758064516129,0.86,99.45
2021-02-19,Uttar Pradesh,1093,4,1089,13717,1332,537,7.97,0,248.0,336642,2880,334780,0.54,0.22,0.05531048387096774,0.86,99.45
2021-02-20,Uttar Pradesh,1123,6,1116,14108,2750,809,7.96,1,248.0,337765,2886,335896,1.11,0.33,0.05688709677419355,0.85,99.45
2021-02-21,Uttar Pradesh,1262,10,1256,15531,1927,1903,8.13,0,248.0,339027,2896,337152,0.78,0.77,0.062625,0.85,99.45
2021-02-22,Uttar Pradesh,703,3,697,9139,1834,695,7.69,3,248.0,339730,2899,337849,0.74,0.28,0.03685080645161291,0.85,99.45
2021-02-23,Uttar Pradesh,1184,10,1180,14963,2898,2194,7.91,0,248.0,340914,2909,339029,1.17,0.88,0.06033467741935484,0.85,99.45
2021-02-24,Uttar Pradesh,1209,15,1201,15084,4065,1648,8.02,0,248.0,342123,2924,340230,1.64,0.66,0.060822580645161294,0.85,99.45
2021-02-25,Uttar Pradesh,1040,6,1035,12893,2588,1858,8.07,0,248.0,343163,2930,341265,1.04,0.75,0.05198790322580645,0.85,99.45
2021-02-26,Uttar Pradesh,175,0,174,2496,1997,87,7.01,1,248.0,343338,2930,341439,0.81,0.04,0.010064516129032258,0.85,99.45
2021-02-27,Uttar Pradesh,872,10,867,10656,1816,1309,8.18,0,248.0,344210,2940,342306,0.73,0.53,0.04296774193548387,0.85,99.45
2021-02-28,Uttar Pradesh,1302,16,1302,16478,1611,560,7.9,0,248.0,345512,2956,343608,0.65,0.23,0.06644354838709678,0.86,99.45
2021-03-01,Uttar Pradesh,1087,11,1084,13823,4417,98,7.86,0,248.0,346599,2967,344692,1.78,0.04,0.05573790322580645,0.86,99.45
2021-03-02,Uttar Pradesh,1321,5,1318,16573,3597,209,7.97,0,248.0,347920,2972,346010,1.45,0.08,0.06682661290322581,0.85,99.45
2021-03-03,Uttar Pradesh,1156,7,1147,14155,3072,2288,8.17,2,248.0,349076,2979,347157,1.24,0.92,0.057076612903225805,0.85,99.45
2021-03-04,Uttar Pradesh,1010,7,1004,12347,152,68,8.18,0,248.0,350086,2986,348161,0.06,0.03,0.04978629032258065,0.85,99.45
2021-03-05,Uttar Pradesh,881,5,878,11150,2884,1998,7.9,0,248.0,350967,2991,349039,1.16,0.81,0.04495967741935484,0.85,99.45
2021-03-06,Uttar Pradesh,1032,4,1023,13278,4319,1782,7.77,5,248.0,351999,2995,350062,1.74,0.72,0.05354032258064516,0.85,99.45
2021-03-07,Uttar Pradesh,250,2,245,3461,1675,1576,7.22,3,248.0,352249,2997,350307,0.68,0.64,0.013955645161290322,0.85,99.45
2021-03-08,Uttar Pradesh,1550,10,1541,19221,4362,3920,8.06,0,248.0,353799,3007,351848,1.76,1.58,0.07750403225806451,0.85,99.45
2021-03-09,Uttar Pradesh,1279,3,1273,15879,2136,348,8.05,3,248.0,355078,3010,353121,0.86,0.14,0.06402822580645161,0.85,99.45
2021-03-10,Uttar Pradesh,326,1,319,3924,3976,785,8.31,6,248.0,355404,3011,353440,1.6,0.32,0.01582258064516129,0.85,99.45
2021-03-11,Uttar Pradesh,778,7,776,9393,857,393,8.28,0,248.0,356182,3018,354216,0.35,0.16,0.037875,0.85,99.45
2021-03-12,Uttar Pradesh,1332,9,1324,16834,4318,847,7.91,0,248.0,357514,3027,355540,1.74,0.34,0.06787903225806452,0.85,99.45
2021-03-13,Uttar Pradesh,278,2,274,3809,3075,1362,7.3,2,248.0,357792,3029,355814,1.24,0.55,0.015358870967741935,0.85,99.45
2021-03-14,Uttar Pradesh,780,3,776,9744,2603,1221,8.0,1,248.0,358572,3032,356590,1.05,0.49,0.03929032258064516,0.85,99.45
2021-03-15,Uttar Pradesh,1134,8,1126,13608,2733,1303,8.33,0,248.0,359706,3040,357716,1.1,0.53,0.054870967741935485,0.85,99.45
2021-03-16,Uttar Pradesh,364,5,358,5002,567,306,7.28,1,248.0,360070,3045,358074,0.23,0.12,0.02016935483870968,0.85,99.45
2021-03-17,Uttar Pradesh,708,5,701,9226,4896,4828,7.67,2,248.0,360778,3050,358775,1.97,1.95,0.03720161290322581,0.85,99.44
2021-03-18,Uttar Pradesh,1405,20,1403,17703,4401,3319,7.94,0,248.0,362183,3070,360178,1.77,1.34,0.07138306451612904,0.85,99.45
2021-03-19,Uttar Pradesh,301,1,294,3589,3863,1275,8.39,6,248.0,362484,3071,360472,1.56,0.51,0.014471774193548387,0.85,99.44
2021-03-20,Uttar Pradesh,199,2,190,2150,2654,614,9.26,7,248.0,362683,3073,360662,1.07,0.25,0.008669354838709677,0.85,99.44
2021-03-21,Uttar Pradesh,447,3,444,5753,1902,740,7.77,0,248.0,363130,3076,361106,0.77,0.3,0.02319758064516129,0.85,99.44
2021-03-22,Uttar Pradesh,637,2,634,7915,321,205,8.05,1,248.0,363767,3078,361740,0.13,0.08,0.03191532258064516,0.85,99.44
2021-03-23,Uttar Pradesh,784,2,783,9652,2221,1756,8.12,0,248.0,364551,3080,362523,0.9,0.71,0.038919354838709674,0.84,99.44
2021-03-24,Uttar Pradesh,387,3,381,4958,1127,867,7.81,3,248.0,364938,3083,362904,0.45,0.35,0.019991935483870966,0.84,99.44
2021-03-25,Uttar Pradesh,801,5,796,10504,4133,3792,7.63,0,248.0,365739,3088,363700,1.67,1.53,0.04235483870967742,0.84,99.44
2021-03-26,Uttar Pradesh,843,3,834,11304,4342,4152,7.46,6,248.0,366582,3091,364534,1.75,1.67,0.045580645161290324,0.84,99.44
2021-03-27,Uttar Pradesh,875,10,869,10652,1995,543,8.21,0,248.0,367457,3101,365403,0.8,0.22,0.04295161290322581,0.84,99.44
2021-03-28,Uttar Pradesh,199,0,193,2169,1200,188,9.17,6,248.0,367656,3101,365596,0.48,0.08,0.008745967741935484,0.84,99.44
2021-03-29,Uttar Pradesh,1463,11,1461,18047,1759,1117,8.11,0,248.0,369119,3112,367057,0.71,0.45,0.07277016129032259,0.84,99.44
2021-03-30,Uttar Pradesh,1526,10,1524,18856,4173,1149,8.09,0,248.0,370645,3122,368581,1.68,0.46,0.07603225806451613,0.84,99.44
2021-03-31,Uttar Pradesh,1321,5,1314,16334,589,467,8.09,2,248.0,371966,3127,369895,0.24,0.19,0.06586290322580646,0.84,99.44
2021-04-01,Uttar Pradesh,1554,9,1551,19319,1053,44,8.04,0,248.0,373520,3136,371446,0.42,0.02,0.07789919354838709,0.84,99.44
2021-04-02,Uttar Pradesh,1351,17,1349,17015,4332,4068,7.94,0,248.0,374871,3153,372795,1.75,1.64,0.06860887096774193,0.84,99.45
2021-04-03,Uttar Pradesh,152,1,148,1974,934,12,7.7,3,248.0,375023,3154,372943,0.38,0.0,0.007959677419354839,0.84,99.45
2021-04-04,Uttar Pradesh,578,4,572,6720,3328,1914,8.6,2,248.0,375601,3158,373515,1.34,0.77,0.027096774193548386,0.84,99.44
2021-04-05,Uttar Pradesh,750,7,749,9334,1840,975,8.04,0,248.0,376351,3165,374264,0.74,0.39,0.03763709677419355,0.84,99.45
2021-04-06,Uttar Pradesh,966,10,963,12195,3107,1033,7.92,0,248.0,377317,3175,375227,1.25,0.42,0.04917338709677419,0.84,99.45
2021-04-07,Uttar Pradesh,1041,5,1032,12997,4567,2041,8.01,4,248.0,378358,3180,376259,1.84,0.82,0.05240725806451613,0.84,99.45
2021-04-08,Uttar Pradesh,1510,15,1502,18813,159,2,8.03,0,248.0,379868,3195,377761,0.06,0.0,0.07585887096774194,0.84,99.45
2021-04-09,Uttar Pradesh,656,8,647,8231,626,432,7.97,1,248.0,380524,3203,378408,0.25,0.17,0.03318951612903226,0.84,99.44
2021-04-10,Uttar Pradesh,895,10,887,11484,2917,1196,7.79,0,248.0,381419,3213,379295,1.18,0.48,0.04630645161290323,0.84,99.44
2021-04-11,Uttar Pradesh,505,5,504,6778,1141,407,7.45,0,248.0,381924,3218,379799,0.46,0.16,0.027330645161290322,0.84,99.44
2021-04-12,Uttar Pradesh,1408,11,1400,17373,1138,63,8.1,0,248.0,383332,3229,381199,0.46,0.03,0.0700524193548387,0.84,99.44
2021-04-13,Uttar Pradesh,1162,4,1154,14677,4774,3767,7.92,4,248.0,384494,3233,382353,1.92,1.52,0.059181451612903224,0.84,99.44
2021-04-14,Uttar Pradesh,508,2,508,6185,1505,715,8.21,0,248.0,385002,3235,382861,0.61,0.29,0.02493951612903226,0.84,99.44
2021-04-15,Uttar Pradesh,753,3,748,9389,3150,1254,8.02,2,248.0,385755,3238,383609,1.27,0.51,0.03785887096774194,0.84,99.44
2021-04-16,Uttar Pradesh,804,10,798,9965,1841,1115,8.07,0,248.0,386559,3248,384407,0.74,0.45,0.04018145161290323,0.84,99.44
2021-04-17,Uttar Pradesh,33,0,25,639,440,73,5.16,8,248.0,386592,3248,384432,0.18,0.03,0.0025766129032258065,0.84,99.44
2021-04-18,Uttar Pradesh,1290,16,1285,16394,2647,135,7.87,0,248.0,387882,3264,385717,1.07,0.05,0.06610483870967741,0.84,99.44
2021-04-19,Uttar Pradesh,574,8,569,7506,2536,329,7.65,0,248.0,388456,3272,386286,1.02,0.13,0.030266129032258064,0.84,99.44
2021-04-20,Uttar Pradesh,253,3,246,3215,1927,307,7.87,4,248.0,388709,3275,386532,0.78,0.12,0.012963709677419355,0.84,99.44
2021-04-21,Uttar Pradesh,981,11,974,12541,2407,1661,7.82,0,248.0,389690,3286,387506,0.97,0.67,0.050568548387096776,0.84,99.44
2021-04-22,Uttar Pradesh,401,4,395,4754,3371,570,8.44,2,248.0,390091,3290,387901,1.36,0.23,0.019169354838709678,0.84,99.44
2021-04-23,Uttar Pradesh,1152,13,1147,14581,1028,570,7.9,0,248.0,391243,3303,389048,0.41,0.23,0.05879435483870968,0.84,99.44
2021-04-24,Uttar Pradesh,1411,8,1410,17564,3912,3372,8.03,0,248.0,392654,3311,390458,1.58,1.36,0.0708225806451613,0.84,99.44
2021-04-25,Uttar Pradesh,1017,4,1015,12436,391,237,8.18,0,248.0,393671,3315,391473,0.16,0.1,0.05014516129032258,0.84,99.44
2021-04-26,Uttar Pradesh,1486,7,1485,18766,2713,823,7.92,0,248.0,395157,3322,392958,1.09,0.33,0.07566935483870968,0.84,99.44
2021-04-27,Uttar Pradesh,352,4,349,4186,3542,889,8.41,0,248.0,395509,3326,393307,1.43,0.36,0.016879032258064516,0.84,99.44
2021-04-28,Uttar Pradesh,579,6,575,7327,2706,1344,7.9,0,248.0,396088,3332,393882,1.09,0.54,0.029544354838709676,0.84,99.44
2021-04-29,Uttar Pradesh,899,10,890,11324,2414,17,7.94,0,248.0,396987,3342,394772,0.97,0.01,0.04566129032258064,0.84,99.44
2021-04-30,Uttar Pradesh,1207,16,1204,14798,924,712,8.16,0,248.0,398194,3358,395976,0.37,0.29,0.05966935483870968,0.84,99.44
2021-05-01,Uttar Pradesh,666,4,664,8325,3053,2565,8.0,0,248.0,398860,3362,396640,1.23,1.03,0.033568548387096775,0.84,99.44
2021-05-02,Uttar Pradesh,336,1,335,4107,318,282,8.18,0,248.0,399196,3363,396975,0.13,0.11,0.016560483870967743,0.84,99.44
2021-05-03,Uttar Pradesh,1167,15,1161,14549,1329,1267,8.02,0,248.0,400363,3378,398136,0.54,0.51,0.05866532258064516,0.84,99.44
2021-05-04,Uttar Pradesh,1359,20,1357,16561,3492,716,8.21,0,248.0,401722,3398,399493,1.41,0.29,0.06677822580645161,0.85,99.45
2021-05-05,Uttar Pradesh,1169,7,1168,14545,2590,724,8.04,0,248.0,402891,3405,400661,1.04,0.29,0.058649193548387095,0.85,99.45
2021-05-06,Uttar Pradesh,638,6,637,8280,134,28,7.71,0,248.0,403529,3411,401298,0.05,0.01,0.03338709677419355,0.85,99.45
2021-05-07,Uttar Pradesh,1276,17,1275,16112,4145,2469,7.92,0,248.0,404805,3428,402573,1.67,1.0,0.06496774193548387,0.85,99.45
2021-05-08,Uttar Pradesh,1321,19,1317,16915,4878,1895,7.81,0,248.0,406126,3447,403890,1.97,0.76,0.06820564516129032,0.85,99.45
2021-05-09,Uttar Pradesh,1285,13,1276,15780,1299,24,8.14,0,248.0,407411,3460,405166,0.52,0.01,0.06362903225806452,0.85,99.45
2021-05-10,Uttar Pradesh,434,3,426,5489,2211,2098,7.91,5,248.0,407845,3463,405592,0.89,0.85,0.022133064516129033,0.85,99.45
2021-05-11,Uttar Pradesh,1531,16,1524,19380,4063,589,7.9,0,248.0,409376,3479,407116,1.64,0.24,0.07814516129032258,0.85,99.45
2021-05-12,Uttar Pradesh,509,4,501,6185,2021,1373,8.23,4,248.0,409885,3483,407617,0.81,0.55,0.02493951612903226,0.85,99.45
2021-05-13,Uttar Pradesh,988,8,987,12217,2556,145,8.09,0,248.0,410873,3491,408604,1.03,0.06,0.04926209677419355,0.85,99.45
2021-05-14,Uttar Pradesh,930,8,928,11236,2120,801,8.28,0,248.0,411803,3499,409532,0.85,0.32,0.045306451612903226,0.85,99.45
2021-05-15,Uttar Pradesh,1233,4,1228,15271,4294,271,8.07,1,248.0,413036,3503,410760,1.73,0.11,0.06157661290322581,0.85,99.45
2021-05-16,Uttar Pradesh,844,5,843,10710,3439,1310,7.88,0,248.0,413880,3508,411603,1.39,0.53,0.04318548387096774,0.85,99.45
2021-05-17,Uttar Pradesh,1168,15,1163,14822,113,39,7.88,0,248.0,415048,3523,412766,0.05,0.02,0.059766129032258065,0.85,99.45
2021-05-18,Uttar Pradesh,703,2,703,8548,2201,2089,8.22,0,248.0,415751,3525,413469,0.89,0.84,0.034467741935483874,0.85,99.45
2021-05-19,Uttar Pradesh,1184,5,1182,14739,2639,2569,8.03,0,248.0,416935,3530,414651,1.06,1.04,0.059431451612903224,0.85,99.45
2021-05-20,Uttar Pradesh,283,1,276,3204,2525,2378,8.83,6,248.0,417218,3531,414927,1.02,0.96,0.012919354838709677,0.85,99.45
2021-05-21,Uttar Pradesh,37,0,29,818,3939,1269,4.52,8,248.0,417255,3531,414956,1.59,0.51,0.0032983870967741935,0.85,99.45
2021-05-22,Uttar Pradesh,1106,13,1100,13833,1275,945,8.0,0,248.0,418361,3544,416056,0.51,0.38,0.055778225806451615,0.85,99.45
2021-05-23,Uttar Pradesh,629,6,621,8546,3817,3029,7.36,2,248.0,418990,3550,416677,1.54,1.22,0.03445967741935484,0.85,99.45
2021-05-24,Uttar Pradesh,296,1,288,3630,3140,1214,8.15,7,248.0,419286,3551,416965,1.27,0.49,0.014637096774193548,0.85,99.45
2021-05-25,Uttar Pradesh,1379,12,1375,17263,2196,900,7.99,0,248.0,420665,3563,418340,0.89,0.36,0.06960887096774193,0.85,99.45
2021-05-26,Uttar Pradesh,238,1,230,3035,1140,1042,7.84,7,248.0,420903,3564,418570,0.46,0.42,0.012237903225806451,0.85,99.45
2021-05-27,Uttar Pradesh,948,10,945,11947,3697,3627,7.94,0,248.0,421851,3574,419515,1.49,1.46,0.04817338709677419,0.85,99.45
2021-05-28,Uttar Pradesh,201,2,194,2451,2382,1768,8.2,5,248.0,422052,3576,419709,0.96,0.71,0.009883064516129032,0.85,99.44
2021-05-29,Uttar Pradesh,205,0,201,2545,2252,1533,8.06,4,248.0,422257,3576,419910,0.91,0.62,0.010262096774193548,0.85,99.44
2021-05-30,Uttar Pradesh,746,10,737,9388,766,323,7.95,0,248.0,423003,3586,420647,0.31,0.13,0.03785483870967742,0.85,99.44
2021-05-31,Uttar Pradesh,1513,10,1506,19097,1159,880,7.92,0,248.0,424516,3596,422153,0.47,0.35,0.07700403225806451,0.85,99.44
2021-06-01,Uttar Pradesh,231,1,223,2598,1109,109,8.89,7,248.0,424747,3597,422376,0.45,0.04,0.010475806451612904,0.85,99.44
2021-06-02,Uttar Pradesh,1288,16,1284,16087,1951,551,8.01,0,248.0,426035,3613,423660,0.79,0.22,0.06486693548387097,0.85,99.44
2021-06-03,Uttar Pradesh,1060,11,1056,13293,4509,3659,7.97,0,248.0,427095,3624,424716,1.82,1.48,0.0536008064516129,0.85,99.44
2021-06-04,Uttar Pradesh,1449,16,1444,18058,3507,3466,8.02,0,248.0,428544,3640,426160,1.41,1.4,0.07281451612903225,0.85,99.44
2021-06-05,Uttar Pradesh,1482,19,1476,18612,2654,1307,7.96,0,248.0,430026,3659,427636,1.07,0.53,0.0750483870967742,0.85,99.44
2021-06-06,Uttar Pradesh,403,1,402,4699,3896,3391,8.58,0,248.0,430429,3660,428038,1.57,1.37,0.01894758064516129,0.85,99.44
2021-06-07,Uttar Pradesh,29,0,20,558,4637,2343,5.2,9,248.0,430458,3660,428058,1.87,0.94,0.00225,0.85,99.44
2021-06-08,Uttar Pradesh,635,3,626,7782,3529,2643,8.16,6,248.0,431093,3663,428684,1.42,1.07,0.031379032258064515,0.85,99.44
2021-06-09,Uttar Pradesh,678,4,675,8181,1528,389,8.29,0,248.0,431771,3667,429359,0.62,0.16,0.03298790322580645,0.85,99.44
2021-06-10,Uttar Pradesh,286,2,286,3341,1215,123,8.56,0,248.0,432057,3669,429645,0.49,0.05,0.013471774193548386,0.85,99.44
2021-06-11,Uttar Pradesh,1551,11,1547,19759,3638,2632,7.85,0,248.0,433608,3680,431192,1.47,1.06,0.0796733870967742,0.85,99.44
2021-06-12,Uttar Pradesh,368,1,365,4608,3405,1171,7.99,2,248.0,433976,3681,431557,1.37,0.47,0.01858064516129032,0.85,99.44
2021-06-13,Uttar Pradesh,158,1,157,1856,695,256,8.51,0,248.0,434134,3682,431714,0.28,0.1,0.007483870967741935,0.85,99.44
2021-06-14,Uttar Pradesh,43,0,36,791,633,222,5.44,7,248.0,434177,3682,431750,0.26,0.09,0.0031895161290322583,0.85,99.44
2021-06-15,Uttar Pradesh,509,5,503,6186,3554,1320,8.23,1,248.0,434686,3687,432253,1.43,0.53,0.024943548387096774,0.85,99.44
2021-06-16,Uttar Pradesh,941,3,932,11824,868,833,7.96,6,248.0,435627,3690,433185,0.35,0.34,0.04767741935483871,0.85,99.44
2021-06-17,Uttar Pradesh,1606,17,1598,19924,80,20,8.06,0,248.0,437233,3707,434783,0.03,0.01,0.08033870967741935,0.85,99.44
2021-06-18,Uttar Pradesh,579,7,572,7454,2536,1938,7.77,0,248.0,437812,3714,435355,1.02,0.78,0.030056451612903226,0.85,99.44
2021-06-19,Uttar Pradesh,886,3,884,10794,1137,937,8.21,0,248.0,438698,3717,436239,0.46,0.38,0.043524193548387095,0.85,99.44
2021-06-20,Uttar Pradesh,279,1,272,3594,2118,1044,7.76,6,248.0,438977,3718,436511,0.85,0.42,0.014491935483870969,0.85,99.44
2021-06-21,Uttar Pradesh,205,1,202,2759,1248,1047,7.43,2,248.0,439182,3719,436713,0.5,0.42,0.011125,0.85,99.44
2021-06-22,Uttar Pradesh,688,10,682,8742,4498,2172,7.87,0,248.0,439870,3729,437395,1.81,0.88,0.03525,0.85,99.44
2021-06-23,Uttar Pradesh,1023,4,1020,12875,3301,47,7.95,0,248.0,440893,3733,438415,1.33,0.02,0.051915322580645164,0.85,99.44
2021-06-24,Uttar Pradesh,875,2,868,10808,2964,2335,8.1,5,248.0,441768,3735,439283,1.2,0.94,0.04358064516129032,0.85,99.44
2021-06-25,Uttar Pradesh,1322,6,1321,16894,255,70,7.83,0,248.0,443090,3741,440604,0.1,0.03,0.06812096774193549,0.84,99.44
2021-06-26,Uttar Pradesh,855,3,851,10915,1442,1263,7.83,1,248.0,443945,3744,441455,0.58,0.51,0.04401209677419355,0.84,99.44
2021-06-27,Uttar Pradesh,749,5,742,9368,429,200,8.0,2,248.0,444694,3749,442197,0.17,0.08,0.0377741935483871,0.84,99.44
2021-06-28,Uttar Pradesh,981,3,980,12379,4699,509,7.92,0,248.0,445675,3752,443177,1.89,0.21,0.04991532258064516,0.84,99.44
2021-06-29,Uttar Pradesh,1292,11,1290,16188,2173,1113,7.98,0,248.0,446967,3763,444467,0.88,0.45,0.0652741935483871,0.84,99.44
2021-06-30,Uttar Pradesh,1032,13,1023,12856,514,136,8.03,0,248.0,447999,3776,445490,0.21,0.05,0.05183870967741935,0.84,99.44
2021-07-01,Uttar Pradesh,1307,11,1302,16716,546,468,7.82,0,248.0,449306,3787,446792,0.22,0.19,0.06740322580645161,0.84,99.44
2021-07-02,Uttar Pradesh,1508,18,1506,18651,130,58,8.09,0,248.0,450814,3805,448298,0.05,0.02,0.07520564516129032,0.84,99.44
2021-07-03,Uttar Pradesh,1150,7,1143,14464,3259,3075,7.95,0,248.0,451964,3812,449441,1.31,1.24,0.05832258064516129,0.84,99.44
2021-07-04,Uttar Pradesh,660,2,657,8194,4216,3637,8.05,1,248.0,452624,3814,450098,1.7,1.47,0.03304032258064516,0.84,99.44
2021-07-05,Uttar Pradesh,125,1,121,1527,3242,2958,8.19,3,248.0,452749,3815,450219,1.31,1.19,0.006157258064516129,0.84,99.44
2021-07-06,Uttar Pradesh,667,6,660,8380,4866,1147,7.96,1,248.0,453416,3821,450879,1.96,0.46,0.03379032258064516,0.84,99.44
2021-07-07,Uttar Pradesh,1478,11,1474,18517,4678,39,7.98,0,248.0,454894,3832,452353,1.89,0.02,0.07466532258064516,0.84,99.44
2021-07-08,Uttar Pradesh,628,7,628,7862,4075,2583,7.99,0,248.0,455522,3839,452981,1.64,1.04,0.031701612903225804,0.84,99.44
2021-07-09,Uttar Pradesh,1493,12,1486,18819,2047,504,7.93,0,248.0,457015,3851,454467,0.83,0.2,0.07588306451612903,0.84,99.44
2021-07-10,Uttar Pradesh,436,4,431,5819,100,21,7.49,1,248.0,457451,3855,454898,0.04,0.01,0.023463709677419356,0.84,99.44
2021-07-11,Uttar Pradesh,354,3,354,4433,2701,884,7.99,0,248.0,457805,3858,455252,1.09,0.36,0.017875,0.84,99.44
2021-07-12,Uttar Pradesh,1425,17,1424,17559,196,106,8.12,0,248.0,459230,3875,456676,0.08,0.04,0.0708024193548387,0.84,99.44
2021-07-13,Uttar Pradesh,1305,7,1297,16460,1412,294,7.93,1,248.0,460535,3882,457973,0.57,0.12,0.06637096774193549,0.84,99.44
2021-07-14,Uttar Pradesh,920,9,918,11579,483,294,7.95,0,248.0,461455,3891,458891,0.19,0.12,0.04668951612903226,0.84,99.44
2021-07-15,Uttar Pradesh,507,3,504,6406,2253,525,7.91,0,248.0,461962,3894,459395,0.91,0.21,0.025830645161290324,0.84,99.44
2021-07-16,Uttar Pradesh,1466,6,1466,18009,3055,1158,8.14,0,248.0,463428,3900,460861,1.23,0.47,0.07261693548387096,0.84,99.45
2021-07-17,Uttar Pradesh,305,1,296,3903,1230,386,7.81,8,248.0,463733,3901,461157,0.5,0.16,0.01573790322580645,0.84,99.44
2021-07-18,Uttar Pradesh,1111,11,1110,14378,815,225,7.73,0,248.0,464844,3912,462267,0.33,0.09,0.057975806451612905,0.84,99.45
2021-07-19,Uttar Pradesh,1410,4,1402,17622,3454,645,8.0,4,248.0,466254,3916,463669,1.39,0.26,0.07105645161290322,0.84,99.45
2021-07-20,Uttar Pradesh,466,6,460,5929,3641,2271,7.86,0,248.0,466720,3922,464129,1.47,0.92,0.02390725806451613,0.84,99.44
2021-07-21,Uttar Pradesh,1019,7,1011,13066,967,841,7.8,1,248.0,467739,3929,465140,0.39,0.34,0.05268548387096774,0.84,99.44
2021-07-22,Uttar Pradesh,1151,4,1146,14828,2880,1557,7.76,1,248.0,468890,3933,466286,1.16,0.63,0.059790322580645164,0.84,99.44
2021-07-23,Uttar Pradesh,204,2,204,2695,1901,1408,7.57,0,248.0,469094,3935,466490,0.77,0.57,0.010866935483870967,0.84,99.44
2021-07-24,Uttar Pradesh,609,3,601,7431,4151,1223,8.2,5,248.0,469703,3938,467091,1.67,0.49,0.029963709677419355,0.84,99.44
2021-07-25,Uttar Pradesh,1299,14,1293,16211,3939,2117,8.01,0,248.0,471002,3952,468384,1.59,0.85,0.06536693548387097,0.84,99.44
2021-07-26,Uttar Pradesh,383,1,378,4463,2193,2184,8.58,4,248.0,471385,3953,468762,0.88,0.88,0.017995967741935483,0.84,99.44
2021-07-27,Uttar Pradesh,1170,15,1165,14589,2588,39,8.02,0,248.0,472555,3968,469927,1.04,0.02,0.05882661290322581,0.84,99.44
2021-07-28,Uttar Pradesh,1426,15,1418,17249,2590,137,8.27,0,248.0,473981,3983,471345,1.04,0.06,0.0695524193548387,0.84,99.44
2021-07-29,Uttar Pradesh,267,3,264,3601,2444,1798,7.41,0,248.0,474248,3986,471609,0.99,0.73,0.01452016129032258,0.84,99.44
2021-07-30,Uttar Pradesh,1408,15,1401,17072,829,162,8.25,0,248.0,475656,4001,473010,0.33,0.07,0.06883870967741935,0.84,99.44
2021-07-31,Uttar Pradesh,1570,7,1567,19367,3478,748,8.11,0,248.0,477226,4008,474577,1.4,0.3,0.07809274193548386,0.84,99.44
2021-08-01,Uttar Pradesh,60,0,52,768,4843,2202,7.81,8,248.0,477286,4008,474629,1.95,0.89,0.003096774193548387,0.84,99.44
2021-08-02,Uttar Pradesh,1295,5,1293,16630,3825,2095,7.79,0,248.0,478581,4013,475922,1.54,0.84,0.06705645161290323,0.84,99.44
2021-08-03,Uttar Pradesh,850,6,847,10639,4184,2731,7.99,0,248.0,479431,4019,476769,1.69,1.1,0.042899193548387095,0.84,99.44
2021-08-04,Uttar Pradesh,572,5,572,6887,4718,2603,8.31,0,248.0,480003,4024,477341,1.9,1.05,0.02777016129032258,0.84,99.45
2021-08-05,Uttar Pradesh,931,5,928,11354,2333,392,8.2,0,248.0,480934,4029,478269,0.94,0.16,0.04578225806451613,0.84,99.45
2021-08-06,Uttar Pradesh,981,6,975,12639,3723,851,7.76,0,248.0,481915,4035,479244,1.5,0.34,0.05096370967741935,0.84,99.45
2021-08-07,Uttar Pradesh,206,1,198,2583,1755,326,7.98,7,248.0,482121,4036,479442,0.71,0.13,0.010415322580645162,0.84,99.44
2021-08-08,Uttar Pradesh,250,1,248,2873,1738,1217,8.7,1,248.0,482371,4037,479690,0.7,0.49,0.011584677419354839,0.84,99.44
2021-08-09,Uttar Pradesh,82,0,80,965,3526,1457,8.5,2,248.0,482453,4037,479770,1.42,0.59,0.0038911290322580644,0.84,99.44
2021-08-10,Uttar Pradesh,1443,19,1437,18095,4569,3157,7.97,0,248.0,483896,4056,481207,1.84,1.27,0.07296370967741936,0.84,99.44
2021-08-11,Uttar Pradesh,963,5,963,12106,1745,1209,7.95,0,248.0,484859,4061,482170,0.7,0.49,0.04881451612903226,0.84,99.45
2021-08-12,Uttar Pradesh,1304,8,1295,16318,536,501,7.99,1,248.0,486163,4069,483465,0.22,0.2,0.0657983870967742,0.84,99.45
2021-08-13,Uttar Pradesh,1237,6,1233,15306,2837,1685,8.08,0,248.0,487400,4075,484698,1.14,0.68,0.06171774193548387,0.84,99.45
2021-08-14,Uttar Pradesh,1487,8,1487,18314,2200,519,8.12,0,248.0,488887,4083,486185,0.89,0.21,0.07384677419354839,0.84,99.45
2021-08-15,Uttar Pradesh,1257,10,1256,15169,3498,612,8.29,0,248.0,490144,4093,487441,1.41,0.25,0.06116532258064516,0.84,99.45
2021-08-16,Uttar Pradesh,682,4,678,8735,1917,1388,7.81,0,248.0,490826,4097,488119,0.77,0.56,0.03522177419354839,0.83,99.45
2021-08-17,Uttar Pradesh,758,2,753,9898,915,402,7.66,3,248.0,491584,4099,488872,0.37,0.16,0.039911290322580645,0.83,99.45
2021-08-18,Uttar Pradesh,1501,16,1497,18664,3753,775,8.04,0,248.0,493085,4115,490369,1.51,0.31,0.07525806451612903,0.83,99.45
2021-08-19,Uttar Pradesh,1592,10,1585,19780,3734,3293,8.05,0,248.0,494677,4125,491954,1.51,1.33,0.07975806451612903,0.83,99.45
2021-08-20,Uttar Pradesh,535,2,531,6467,762,684,8.27,2,248.0,495212,4127,492485,0.31,0.28,0.026076612903225806,0.83,99.45
2021-08-21,Uttar Pradesh,161,2,161,2042,4431,1446,7.88,0,248.0,495373,4129,492646,1.79,0.58,0.008233870967741936,0.83,99.45
2021-08-22,Uttar Pradesh,277,2,268,3202,878,807,8.65,7,248.0,495650,4131,492914,0.35,0.33,0.012911290322580645,0.83,99.45
2021-08-23,Uttar Pradesh,1577,12,1569,19903,4975,2799,7.92,0,248.0,497227,4143,494483,2.01,1.13,0.08025403225806452,0.83,99.45
2021-08-24,Uttar Pradesh,1395,20,1386,17757,4517,126,7.86,0,248.0,498622,4163,495869,1.82,0.05,0.0716008064516129,0.83,99.45
2021-08-25,Uttar Pradesh,869,6,862,10672,4330,1816,8.14,1,248.0,499491,4169,496731,1.75,0.73,0.04303225806451613,0.83,99.45
2021-08-26,Uttar Pradesh,1390,14,1384,17540,1306,12,7.92,0,248.0,500881,4183,498115,0.53,0.0,0.0707258064516129,0.84,99.45
2021-08-27,Uttar Pradesh,1138,4,1130,13795,4427,1209,8.25,4,248.0,502019,4187,499245,1.79,0.49,0.055625,0.83,99.45
2021-08-28,Uttar Pradesh,513,4,507,6330,2119,1936,8.1,2,248.0,502532,4191,499752,0.85,0.78,0.025524193548387097,0.83,99.45
2021-08-29,Uttar Pradesh,982,13,974,12273,243,139,8.0,0,248.0,503514,4204,500726,0.1,0.06,0.04948790322580645,0.83,99.45
2021-08-30,Uttar Pradesh,309,2,307,3774,4108,2995,8.19,0,248.0,503823,4206,501033,1.66,1.21,0.01521774193548387,0.83,99.45
2021-08-31,Uttar Pradesh,559,4,552,6868,2150,1705,8.14,3,248.0,504382,4210,501585,0.87,0.69,0.027693548387096773,0.83,99.45
2021-09-01,Uttar Pradesh,966,11,962,11643,3780,2477,8.3,0,248.0,505348,4221,502547,1.52,1.0,0.04694758064516129,0.84,99.45
2021-09-02,Uttar Pradesh,1163,8,1161,14942,1817,661,7.78,0,248.0,506511,4229,503708,0.73,0.27,0.06025,0.83,99.45
2021-09-03,Uttar Pradesh,1509,9,1501,19138,4311,3851,7.88,0,248.0,508020,4238,505209,1.74,1.55,0.07716935483870968,0.83,99.45
2021-09-04,Uttar Pradesh,934,7,927,11725,419,385,7.97,0,248.0,508954,4245,506136,0.17,0.16,0.047278225806451614,0.83,99.45
2021-09-05,Uttar Pradesh,1252,5,1252,15475,4894,1175,8.09,0,248.0,510206,4250,507388,1.97,0.47,0.0623991935483871,0.83,99.45
2021-09-06,Uttar Pradesh,1325,7,1319,16647,21,9,7.96,0,248.0,511531,4257,508707,0.01,0.0,0.067125,0.83,99.45
2021-09-07,Uttar Pradesh,219,2,212,2965,1336,264,7.39,5,248.0,511750,4259,508919,0.54,0.11,0.011955645161290322,0.83,99.45
2021-09-08,Uttar Pradesh,1226,14,1220,15558,2411,1308,7.88,0,248.0,512976,4273,510139,0.97,0.53,0.06273387096774194,0.83,99.45
2021-09-09,Uttar Pradesh,910,9,903,11235,391,9,8.1,0,248.0,513886,4282,511042,0.16,0.0,0.04530241935483871,0.83,99.45
2021-09-10,Uttar Pradesh,901,13,897,11450,667,318,7.87,0,248.0,514787,4295,511939,0.27,0.13,0.04616935483870968,0.83,99.45
2021-09-11,Uttar Pradesh,652,2,652,8100,2627,865,8.05,0,248.0,515439,4297,512591,1.06,0.35,0.032661290322580645,0.83,99.45
2021-09-12,Uttar Pradesh,261,2,255,3115,1529,1169,8.38,4,248.0,515700,4299,512846,0.62,0.47,0.012560483870967741,0.83,99.45
2021-09-13,Uttar Pradesh,1564,20,1563,19566,3119,1362,7.99,0,248.0,517264,4319,514409,1.26,0.55,0.07889516129032258,0.83,99.45
2021-09-14,Uttar Pradesh,1506,4,1502,19139,2838,927,7.87,0,248.0,518770,4323,515911,1.14,0.37,0.0771733870967742,0.83,99.45
2021-09-15,Uttar Pradesh,246,1,244,3060,998,433,8.04,1,248.0,519016,4324,516155,0.4,0.17,0.012338709677419355,0.83,99.45
2021-09-16,Uttar Pradesh,621,5,616,7915,4360,1803,7.85,0,248.0,519637,4329,516771,1.76,0.73,0.03191532258064516,0.83,99.45
2021-09-17,Uttar Pradesh,1515,7,1511,18924,3554,2158,8.01,0,248.0,521152,4336,518282,1.43,0.87,0.07630645161290323,0.83,99.45
2021-09-18,Uttar Pradesh,819,11,814,10593,3177,677,7.73,0,248.0,521971,4347,519096,1.28,0.27,0.04271370967741935,0.83,99.45
2021-09-19,Uttar Pradesh,598,6,589,7229,4244,3756,8.27,3,248.0,522569,4353,519685,1.71,1.51,0.029149193548387096,0.83,99.45
2021-09-20,Uttar Pradesh,1521,21,1515,18948,341,71,8.03,0,248.0,524090,4374,521200,0.14,0.03,0.07640322580645162,0.83,99.45
2021-09-21,Uttar Pradesh,427,5,418,5275,4355,1128,8.09,4,248.0,524517,4379,521618,1.76,0.45,0.02127016129032258,0.83,99.45
2021-09-22,Uttar Pradesh,1367,7,1364,17194,48,7,7.95,0,248.0,525884,4386,522982,0.02,0.0,0.06933064516129032,0.83,99.45
2021-09-23,Uttar Pradesh,744,4,737,9607,4737,852,7.74,3,248.0,526628,4390,523719,1.91,0.34,0.038737903225806454,0.83,99.45
2021-09-24,Uttar Pradesh,1045,13,1041,13358,3662,3656,7.82,0,248.0,527673,4403,524760,1.48,1.47,0.053862903225806454,0.83,99.45
2021-09-25,Uttar Pradesh,753,6,746,9765,2888,655,7.71,1,248.0,528426,4409,525506,1.16,0.26,0.039375,0.83,99.45
2021-09-26,Uttar Pradesh,156,2,148,1923,4467,2039,8.11,6,248.0,528582,4411,525654,1.8,0.82,0.007754032258064516,0.83,99.45
2021-09-27,Uttar Pradesh,1056,8,1051,13627,4304,3816,7.75,0,248.0,529638,4419,526705,1.74,1.54,0.05494758064516129,0.83,99.45
2021-09-28,Uttar Pradesh,1593,6,1590,19658,1580,1580,8.1,0,248.0,531231,4425,528295,0.64,0.64,0.07926612903225806,0.83,99.45
2021-09-29,Uttar Pradesh,1000,4,996,12484,874,744,8.01,0,248.0,532231,4429,529291,0.35,0.3,0.05033870967741935,0.83,99.45
2021-09-30,Uttar Pradesh,229,1,224,2906,2127,789,7.88,4,248.0,532460,4430,529515,0.86,0.32,0.011717741935483871,0.83,99.45
2021-10-01,Uttar Pradesh,315,3,312,3741,3748,2464,8.42,0,248.0,532775,4433,529827,1.51,0.99,0.015084677419354839,0.83,99.45
2021-10-02,Uttar Pradesh,200,1,196,2395,1805,715,8.35,3,248.0,532975,4434,530023,0.73,0.29,0.009657258064516129,0.83,99.45
2021-10-03,Uttar Pradesh,1540,6,1532,18966,2458,866,8.12,2,248.0,534515,4440,531555,0.99,0.35,0.07647580645161291,0.83,99.45
2021-10-04,Uttar Pradesh,1243,4,1240,15430,4944,1935,8.06,0,248.0,535758,4444,532795,1.99,0.78,0.06221774193548387,0.83,99.45
2021-10-05,Uttar Pradesh,904,12,903,11536,977,183,7.84,0,248.0,536662,4456,533698,0.39,0.07,0.04651612903225807,0.83,99.45
2021-10-06,Uttar Pradesh,1424,12,1424,17782,1608,649,8.01,0,248.0,538086,4468,535122,0.65,0.26,0.07170161290322581,0.83,99.45
2021-10-07,Uttar Pradesh,910,6,910,11444,2034,1763,7.95,0,248.0,538996,4474,536032,0.82,0.71,0.04614516129032258,0.83,99.45
2021-10-08,Uttar Pradesh,159,0,150,2156,3975,3307,7.37,9,248.0,539155,4474,536182,1.6,1.33,0.008693548387096774,0.83,99.45
2021-10-09,Uttar Pradesh,985,14,981,12072,3160,1521,8.16,0,248.0,540140,4488,537163,1.27,0.61,0.04867741935483871,0.83,99.45
2021-10-10,Uttar Pradesh,409,2,400,4938,2056,1708,8.28,7,248.0,540549,4490,537563,0.83,0.69,0.019911290322580644,0.83,99.45
2021-10-11,Uttar Pradesh,66,0,66,929,4776,779,7.1,0,248.0,540615,4490,537629,1.93,0.31,0.0037459677419354838,0.83,99.45
2021-10-12,Uttar Pradesh,89,0,80,960,951,836,9.27,9,248.0,540704,4490,537709,0.38,0.34,0.003870967741935484,0.83,99.45
2021-10-13,Uttar Pradesh,170,0,170,2084,3222,816,8.16,0,248.0,540874,4490,537879,1.3,0.33,0.008403225806451612,0.83,99.45
2021-10-14,Uttar Pradesh,1594,8,1592,19825,3268,2449,8.04,0,248.0,542468,4498,539471,1.32,0.99,0.07993951612903226,0.83,99.45
2021-10-15,Uttar Pradesh,351,2,343,4381,4125,2477,8.01,6,248.0,542819,4500,539814,1.66,1.0,0.01766532258064516,0.83,99.45
2021-10-16,Uttar Pradesh,740,8,735,9201,3925,1384,8.04,0,248.0,543559,4508,540549,1.58,0.56,0.0371008064516129,0.83,99.45
2021-10-17,Uttar Pradesh,585,3,578,7218,1670,25,8.1,4,248.0,544144,4511,541127,0.67,0.01,0.02910483870967742,0.83,99.45
2021-10-18,Uttar Pradesh,263,1,262,3987,4321,1832,6.6,0,248.0,544407,4512,541389,1.74,0.74,0.016076612903225807,0.83,99.45
2021-10-19,Uttar Pradesh,1078,9,1076,13378,655,499,8.06,0,248.0,545485,4521,542465,0.26,0.2,0.05394354838709677,0.83,99.45
2021-10-20,Uttar Pradesh,199,2,199,2281,1971,107,8.72,0,248.0,545684,4523,542664,0.79,0.04,0.009197580645161291,0.83,99.45
2021-10-21,Uttar Pradesh,793,10,787,9958,3992,2994,7.96,0,248.0,546477,4533,543451,1.61,1.21,0.040153225806451615,0.83,99.45
2021-10-22,Uttar Pradesh,692,9,690,8482,3888,1318,8.16,0,248.0,547169,4542,544141,1.57,0.53,0.034201612903225806,0.83,99.45
2021-10-23,Uttar Pradesh,92,0,83,1473,4481,2491,6.25,9,248.0,547261,4542,544224,1.81,1.0,0.005939516129032258,0.83,99.45
2021-10-24,Uttar Pradesh,1039,12,1036,12899,311,119,8.05,0,248.0,548300,4554,545260,0.13,0.05,0.05201209677419355,0.83,99.45
2021-10-25,Uttar Pradesh,631,8,631,7762,3851,3444,8.13,0,248.0,548931,4562,545891,1.55,1.39,0.0312983870967742,0.83,99.45
2021-10-26,Uttar Pradesh,638,7,638,7784,2760,2380,8.2,0,248.0,549569,4569,546529,1.11,0.96,0.031387096774193546,0.83,99.45
2021-10-27,Uttar Pradesh,602,2,596,7981,3471,2207,7.54,4,248.0,550171,4571,547125,1.4,0.89,0.03218145161290323,0.83,99.45
2021-10-28,Uttar Pradesh,1011,11,1010,12388,4664,1556,8.16,0,248.0,551182,4582,548135,1.88,0.63,0.049951612903225806,0.83,99.45
2021-10-29,Uttar Pradesh,873,5,869,11062,4120,3680,7.89,0,248.0,552055,4587,549004,1.66,1.48,0.04460483870967742,0.83,99.45
2021-10-30,Uttar Pradesh,1297,5,1288,16365,1333,1108,7.93,4,248.0,553352,4592,550292,0.54,0.45,0.06598790322580646,0.83,99.45
2021-10-31,Uttar Pradesh,1295,11,1288,16674,3283,1757,7.77,0,248.0,554647,4603,551580,1.32,0.71,0.06723387096774193,0.83,99.45
2021-11-01,Uttar Pradesh,617,7,616,8328,182,111,7.41,0,248.0,555264,4610,552196,0.07,0.04,0.03358064516129032,0.83,99.45
2021-11-02,Uttar Pradesh,1422,17,1422,17600,1824,519,8.08,0,248.0,556686,4627,553618,0.74,0.21,0.07096774193548387,0.83,99.45
2021-11-03,Uttar Pradesh,892,5,892,11452,3488,1882,7.79,0,248.0,557578,4632,554510,1.41,0.76,0.04617741935483871,0.83,99.45
2021-11-04,Uttar Pradesh,1031,8,1023,12204,1982,1709,8.45,0,248.0,558609,4640,555533,0.8,0.69,0.049209677419354836,0.83,99.45
2021-11-05,Uttar Pradesh,1267,17,1266,15690,1999,788,8.08,0,248.0,559876,4657,556799,0.81,0.32,0.06326612903225806,0.83,99.45
2021-11-06,Uttar Pradesh,1485,12,1483,18284,4331,3368,8.12,0,248.0,561361,4669,558282,1.75,1.36,0.0737258064516129,0.83,99.45
2021-11-07,Uttar Pradesh,1044,3,1042,12713,2978,2454,8.21,0,248.0,562405,4672,559324,1.2,0.99,0.05126209677419355,0.83,99.45
2021-11-08,Uttar Pradesh,1432,16,1427,17885,489,368,8.01,0,248.0,563837,4688,560751,0.2,0.15,0.07211693548387096,0.83,99.45
2021-11-09,Uttar Pradesh,1499,10,1497,19120,3291,1707,7.84,0,248.0,565336,4698,562248,1.33,0.69,0.07709677419354839,0.83,99.45
2021-11-10,Uttar Pradesh,74,0,71,984,2042,1746,7.52,3,248.0,565410,4698,562319,0.82,0.7,0.003967741935483871,0.83,99.45
2021-11-11,Uttar Pradesh,783,7,781,9927,1484,562,7.89,0,248.0,566193,4705,563100,0.6,0.23,0.040028225806451614,0.83,99.45
2021-11-12,Uttar Pradesh,406,5,404,5034,1063,171,8.07,0,248.0,566599,4710,563504,0.43,0.07,0.020298387096774194,0.83,99.45
2021-11-13,Uttar Pradesh,821,10,820,10040,1641,1214,8.18,0,248.0,567420,4720,564324,0.66,0.49,0.04048387096774193,0.83,99.45
2021-11-14,Uttar Pradesh,371,2,366,4422,1312,933,8.39,3,248.0,567791,4722,564690,0.53,0.38,0.017830645161290324,0.83,99.45
2021-11-15,Uttar Pradesh,787,7,786,9865,4561,1545,7.98,0,248.0,568578,4729,565476,1.84,0.62,0.039778225806451614,0.83,99.45
2021-11-16,Uttar Pradesh,1122,5,1117,13725,4500,3237,8.17,0,248.0,569700,4734,566593,1.81,1.31,0.05534274193548387,0.83,99.45
2021-11-17,Uttar Pradesh,1208,10,1208,14743,4535,2415,8.19,0,248.0,570908,4744,567801,1.83,0.97,0.05944758064516129,0.83,99.46
2021-11-18,Uttar Pradesh,1288,13,1283,16253,1100,178,7.92,0,248.0,572196,4757,569084,0.44,0.07,0.06553629032258064,0.83,99.46
2021-11-19,Uttar Pradesh,1050,8,1041,13293,4817,1659,7.9,1,248.0,573246,4765,570125,1.94,0.67,0.0536008064516129,0.83,99.46
2021-11-20,Uttar Pradesh,1397,14,1393,16964,4410,3322,8.24,0,248.0,574643,4779,571518,1.78,1.34,0.06840322580645161,0.83,99.46
2021-11-21,Uttar Pradesh,523,5,515,6249,1593,542,8.37,3,248.0,575166,4784,572033,0.64,0.22,0.02519758064516129,0.83,99.46
2021-11-22,Uttar Pradesh,1214,5,1207,15420,2635,1553,7.87,2,248.0,576380,4789,573240,1.06,0.63,0.06217741935483871,0.83,99.46
2021-11-23,Uttar Pradesh,713,9,707,9200,3157,3067,7.75,0,248.0,577093,4798,573947,1.27,1.24,0.037096774193548385,0.83,99.45
2021-11-24,Uttar Pradesh,1156,5,1147,14414,3567,2481,8.02,4,248.0,578249,4803,575094,1.44,1.0,0.05812096774193548,0.83,99.45
2021-11-25,Uttar Pradesh,1539,18,1533,19032,992,47,8.09,0,248.0,579788,4821,576627,0.4,0.02,0.07674193548387097,0.83,99.45
2021-11-26,Uttar Pradesh,535,6,535,6802,4066,3476,7.87,0,248.0,580323,4827,577162,1.64,1.4,0.02742741935483871,0.83,99.46
2021-11-27,Uttar Pradesh,890,10,888,11293,3033,2768,7.88,0,248.0,581213,4837,578050,1.22,1.12,0.04553629032258064,0.83,99.46
2021-11-28,Uttar Pradesh,824,3,821,10213,4029,1936,8.07,0,248.0,582037,4840,578871,1.62,0.78,0.04118145161290323,0.83,99.46
2021-11-29,Uttar Pradesh,955,12,954,12472,3476,3216,7.66,0,248.0,582992,4852,579825,1.4,1.3,0.05029032258064516,0.83,99.46
2021-11-30,Uttar Pradesh,1075,5,1072,13127,3986,860,8.19,0,248.0,584067,4857,580897,1.61,0.35,0.052931451612903226,0.83,99.46
2021-12-01,Uttar Pradesh,452,4,443,5284,3094,620,8.55,5,248.0,584519,4861,581340,1.25,0.25,0.021306451612903225,0.83,99.46
2021-12-02,Uttar Pradesh,1356,13,1355,16641,907,851,8.15,0,248.0,585875,4874,582695,0.37,0.34,0.0671008064516129,0.83,99.46
2021-12-03,Uttar Pradesh,610,4,604,6911,523,15,8.83,2,248.0,586485,4878,583299,0.21,0.01,0.027866935483870967,0.83,99.46
2021-12-04,Uttar Pradesh,995,7,995,12230,3560,2747,8.14,0,248.0,587480,4885,584294,1.44,1.11,0.04931451612903226,0.83,99.46
2021-12-05,Uttar Pradesh,996,4,991,12562,1247,272,7.93,1,248.0,588476,4889,585285,0.5,0.11,0.05065322580645161,0.83,99.46
2021-12-06,Uttar Pradesh,319,1,311,4099,3393,1629,7.78,7,248.0,588795,4890,585596,1.37,0.66,0.016528225806451614,0.83,99.46
2021-12-07,Uttar Pradesh,1423,10,1423,17886,2492,2063,7.96,0,248.0,590218,4900,587019,1.0,0.83,0.07212096774193548,0.83,99.46
2021-12-08,Uttar Pradesh,640,6,632,8115,1422,326,7.89,2,248.0,590858,4906,587651,0.57,0.13,0.03272177419354839,0.83,99.46
2021-12-09,Uttar Pradesh,989,5,987,12497,1057,1030,7.91,0,248.0,591847,4911,588638,0.43,0.42,0.050391129032258064,0.83,99.46
2021-12-10,Uttar Pradesh,832,5,829,10722,2546,1514,7.76,0,248.0,592679,4916,589467,1.03,0.61,0.043233870967741936,0.83,99.46
2021-12-11,Uttar Pradesh,1159,16,1151,14243,4274,3380,8.14,0,248.0,593838,4932,590618,1.72,1.36,0.05743145161290322,0.83,99.46
2021-12-12,Uttar Pradesh,1101,5,1095,13694,2319,1719,8.04,1,248.0,594939,4937,591713,0.94,0.69,0.05521774193548387,0.83,99.46
2021-12-13,Uttar Pradesh,312,4,304,3895,4584,2652,8.01,4,248.0,595251,4941,592017,1.85,1.07,0.015705645161290322,0.83,99.46
2021-12-14,Uttar Pradesh,821,2,819,10471,4682,1438,7.84,0,248.0,596072,4943,592836,1.89,0.58,0.04222177419354839,0.83,99.46
2021-12-15,Uttar Pradesh,311,4,311,3944,3885,3270,7.89,0,248.0,596383,4947,593147,1.57,1.32,0.015903225806451614,0.83,99.46
2021-12-16,Uttar Pradesh,746,3,738,9712,241,13,7.68,5,248.0,597129,4950,593885,0.1,0.01,0.039161290322580644,0.83,99.46
2021-12-17,Uttar Pradesh,597,6,592,7442,874,127,8.02,0,248.0,597726,4956,594477,0.35,0.05,0.030008064516129033,0.83,99.46
2021-12-18,Uttar Pradesh,479,3,471,5999,3842,1652,7.98,5,248.0,598205,4959,594948,1.55,0.67,0.02418951612903226,0.83,99.46
2021-12-19,Uttar Pradesh,1219,7,1210,15432,4427,3340,7.9,2,248.0,599424,4966,596158,1.79,1.35,0.0622258064516129,0.83,99.46
2021-12-20,Uttar Pradesh,1061,4,1061,13030,525,484,8.14,0,248.0,600485,4970,597219,0.21,0.2,0.052540322580645164,0.83,99.46
2021-12-21,Uttar Pradesh,807,4,800,10260,3885,1292,7.87,3,248.0,601292,4974,598019,1.57,0.52,0.04137096774193549,0.83,99.46
2021-12-22,Uttar Pradesh,479,4,476,6150,192,14,7.79,0,248.0,601771,4978,598495,0.08,0.01,0.024798387096774194,0.83,99.46
2021-12-23,Uttar Pradesh,63,0,60,797,3590,2649,7.9,3,248.0,601834,4978,598555,1.45,1.07,0.003213709677419355,0.83,99.46
2021-12-24,Uttar Pradesh,936,8,934,11465,4809,888,8.16,0,248.0,602770,4986,599489,1.94,0.36,0.046229838709677416,0.83,99.46
2021-12-25,Uttar Pradesh,1124,10,1124,13739,2020,882,8.18,0,248.0,603894,4996,600613,0.81,0.36,0.0553991935483871,0.83,99.46
2021-12-26,Uttar Pradesh,1064,4,1056,12653,1148,86,8.41,4,248.0,604958,5000,601669,0.46,0.03,0.05102016129032258,0.83,99.46
2021-12-27,Uttar Pradesh,434,4,434,5267,2222,508,8.24,0,248.0,605392,5004,602103,0.9,0.2,0.021237903225806452,0.83,99.46
2021-12-28,Uttar Pradesh,1443,6,1439,17646,3256,488,8.18,0,248.0,606835,5010,603542,1.31,0.2,0.07115322580645161,0.83,99.46
2021-12-29,Uttar Pradesh,1284,6,1276,16185,3224,199,7.93,2,248.0,608119,5016,604818,1.3,0.08,0.06526209677419355,0.82,99.46
2021-12-30,Uttar Pradesh,829,6,822,10664,908,444,7.77,1,248.0,608948,5022,605640,0.37,0.18,0.043,0.82,99.46
2021-12-31,Uttar Pradesh,1348,8,1343,16930,3669,1903,7.96,0,248.0,610296,5030,606983,1.48,0.77,0.06826612903225807,0.82,99.46
2022-01-01,Uttar Pradesh,1174,3,1165,14864,2708,1940,7.9,6,248.0,611470,5033,608148,1.09,0.78,0.05993548387096774,0.82,99.46
2022-01-02,Uttar Pradesh,452,3,445,5854,657,499,7.72,4,248.0,611922,5036,608593,0.26,0.2,0.02360483870967742,0.82,99.46
2022-01-03,Uttar Pradesh,434,6,430,6229,2330,705,6.97,0,248.0,612356,5042,609023,0.94,0.28,0.025116935483870968,0.82,99.46
2022-01-04,Uttar Pradesh,1368,16,1364,17196,4474,1734,7.96,0,248.0,613724,5058,610387,1.8,0.7,0.06933870967741936,0.82,99.46
2022-01-05,Uttar Pradesh,716,9,716,9442,772,21,7.58,0,248.0,614440,5067,611103,0.31,0.01,0.03807258064516129,0.82,99.46
2022-01-06,Uttar Pradesh,792,3,785,9750,3541,1159,8.12,4,248.0,615232,5070,611888,1.43,0.47,0.03931451612903226,0.82,99.46
2022-01-07,Uttar Pradesh,442,6,441,5919,364,209,7.47,0,248.0,615674,5076,612329,0.15,0.08,0.023866935483870966,0.82,99.46
2022-01-08,Uttar Pradesh,345,1,338,4543,1637,1361,7.59,6,248.0,616019,5077,612667,0.66,0.55,0.018318548387096775,0.82,99.46
2022-01-09,Uttar Pradesh,1317,13,1312,16297,3854,3594,8.08,0,248.0,617336,5090,613979,1.55,1.45,0.06571370967741935,0.82,99.46
2022-01-10,Uttar Pradesh,40,0,31,525,2003,1410,7.62,9,248.0,617376,5090,614010,0.81,0.57,0.002116935483870968,0.82,99.45
2022-01-11,Uttar Pradesh,911,10,904,11359,2363,1277,8.02,0,248.0,618287,5100,614914,0.95,0.51,0.04580241935483871,0.82,99.45
2022-01-12,Uttar Pradesh,1196,17,1188,14671,2764,366,8.15,0,248.0,619483,5117,616102,1.11,0.15,0.059157258064516126,0.83,99.45
2022-01-13,Uttar Pradesh,261,2,252,2967,2037,42,8.8,7,248.0,619744,5119,616354,0.82,0.02,0.011963709677419354,0.83,99.45
2022-01-14,Uttar Pradesh,1007,4,1004,12379,1299,596,8.13,0,248.0,620751,5123,617358,0.52,0.24,0.04991532258064516,0.83,99.45
2022-01-15,Uttar Pradesh,636,8,629,7550,2613,222,8.42,0,248.0,621387,5131,617987,1.05,0.09,0.030443548387096776,0.83,99.45
2022-01-16,Uttar Pradesh,604,3,599,7378,2262,1301,8.19,2,248.0,621991,5134,618586,0.91,0.52,0.02975,0.83,99.45
2022-01-17,Uttar Pradesh,219,2,216,2990,944,383,7.32,1,248.0,622210,5136,618802,0.38,0.15,0.012056451612903226,0.83,99.45
2022-01-18,Uttar Pradesh,1494,17,1485,19510,2713,1529,7.66,0,248.0,623704,5153,620287,1.09,0.62,0.07866935483870968,0.83,99.45
2022-01-19,Uttar Pradesh,531,6,529,6968,2881,2545,7.62,0,248.0,624235,5159,620816,1.16,1.03,0.028096774193548387,0.83,99.45
2022-01-20,Uttar Pradesh,981,3,979,11913,3711,2700,8.23,0,248.0,625216,5162,621795,1.5,1.09,0.048036290322580645,0.83,99.45
2022-01-21,Uttar Pradesh,1060,4,1055,13109,1426,470,8.09,1,248.0,626276,5166,622850,0.57,0.19,0.05285887096774194,0.82,99.45
2022-01-22,Uttar Pradesh,272,3,265,3269,4943,4072,8.32,4,248.0,626548,5169,623115,1.99,1.64,0.013181451612903225,0.82,99.45
2022-01-23,Uttar Pradesh,1549,14,1541,19483,1164,743,7.95,0,248.0,628097,5183,624656,0.47,0.3,0.07856048387096774,0.83,99.45
2022-01-24,Uttar Pradesh,645,3,643,8233,3679,2433,7.83,0,248.0,628742,5186,625299,1.48,0.98,0.03319758064516129,0.82,99.45
2022-01-25,Uttar Pradesh,791,7,785,9987,649,93,7.92,0,248.0,629533,5193,626084,0.26,0.04,0.04027016129032258,0.82,99.45
2022-01-26,Uttar Pradesh,648,2,640,8177,4483,2951,7.92,6,248.0,630181,5195,626724,1.81,1.19,0.03297177419354839,0.82,99.45
2022-01-27,Uttar Pradesh,248,0,240,3122,2519,504,7.94,8,248.0,630429,5195,626964,1.02,0.2,0.012588709677419355,0.82,99.45
2022-01-28,Uttar Pradesh,532,6,524,6727,82,67,7.91,2,248.0,630961,5201,627488,0.03,0.03,0.027125,0.82,99.45
2022-01-29,Uttar Pradesh,856,5,853,11355,951,787,7.54,0,248.0,631817,5206,628341,0.38,0.32,0.04578629032258064,0.82,99.45
2022-01-30,Uttar Pradesh,1518,10,1515,19156,114,9,7.92,0,248.0,633335,5216,629856,0.05,0.0,0.07724193548387097,0.82,99.45
2022-01-31,Uttar Pradesh,1636,21,1627,19973,2889,697,8.19,0,248.0,634971,5237,631483,1.16,0.28,0.08053629032258064,0.82,99.45
2022-02-01,Uttar Pradesh,1551,18,1546,19621,2778,638,7.9,0,248.0,636522,5255,633029,1.12,0.26,0.07911693548387097,0.83,99.45
2022-02-02,Uttar Pradesh,1347,15,1340,16716,1383,1297,8.06,0,248.0,637869,5270,634369,0.56,0.52,0.06740322580645161,0.83,99.45
2022-02-03,Uttar Pradesh,385,2,381,4886,2405,851,7.88,2,248.0,638254,5272,634750,0.97,0.34,0.019701612903225807,0.83,99.45
2022-02-04,Uttar Pradesh,991,14,987,12377,3419,327,8.01,0,248.0,639245,5286,635737,1.38,0.13,0.04990725806451613,0.83,99.45
2022-02-05,Uttar Pradesh,950,3,944,11704,1140,86,8.12,3,248.0,640195,5289,636681,0.46,0.03,0.04719354838709677,0.83,99.45
2022-02-06,Uttar Pradesh,582,5,578,7261,2452,138,8.02,0,248.0,640777,5294,637259,0.99,0.06,0.029278225806451612,0.83,99.45
2022-02-07,Uttar Pradesh,237,1,233,3132,3837,1884,7.57,3,248.0,641014,5295,637492,1.55,0.76,0.012629032258064516,0.83,99.45
2022-02-08,Uttar Pradesh,1121,6,1118,14290,2355,600,7.84,0,248.0,642135,5301,638610,0.95,0.24,0.05762096774193548,0.83,99.45
2022-02-09,Uttar Pradesh,176,1,174,2146,3610,2355,8.2,1,248.0,642311,5302,638784,1.46,0.95,0.008653225806451613,0.83,99.45
2022-02-10,Uttar Pradesh,232,1,225,2822,3380,822,8.22,6,248.0,642543,5303,639009,1.36,0.33,0.011379032258064517,0.83,99.45
2022-02-11,Uttar Pradesh,1223,12,1218,14889,3835,1289,8.21,0,248.0,643766,5315,640227,1.55,0.52,0.06003629032258064,0.83,99.45
2022-02-12,Uttar Pradesh,236,3,235,3100,85,6,7.61,0,248.0,644002,5318,640462,0.03,0.0,0.0125,0.83,99.45
2022-02-13,Uttar Pradesh,319,3,318,3882,187,173,8.22,0,248.0,644321,5321,640780,0.08,0.07,0.015653225806451614,0.83,99.45
2022-02-14,Uttar Pradesh,314,3,310,3638,3315,1540,8.63,1,248.0,644635,5324,641090,1.34,0.62,0.014669354838709677,0.83,99.45
2022-02-15,Uttar Pradesh,447,3,440,5715,2666,2169,7.82,4,248.0,645082,5327,641530,1.08,0.87,0.023044354838709678,0.83,99.45
2022-02-16,Uttar Pradesh,1066,11,1062,13492,230,73,7.9,0,248.0,646148,5338,642592,0.09,0.03,0.05440322580645161,0.83,99.45
2022-02-17,Uttar Pradesh,617,2,616,7711,34,17,8.0,0,248.0,646765,5340,643208,0.01,0.01,0.03109274193548387,0.83,99.45
2022-02-18,Uttar Pradesh,280,3,275,3403,1102,171,8.23,2,248.0,647045,5343,643483,0.44,0.07,0.013721774193548386,0.83,99.45
2022-02-19,Uttar Pradesh,946,10,940,12309,426,366,7.69,0,248.0,647991,5353,644423,0.17,0.15,0.04963306451612903,0.83,99.45
2022-02-20,Uttar Pradesh,1269,3,1260,16070,4036,983,7.9,6,248.0,649260,5356,645683,1.63,0.4,0.0647983870967742,0.82,99.45
2022-02-21,Uttar Pradesh,1567,14,1560,19647,1147,876,7.98,0,248.0,650827,5370,647243,0.46,0.35,0.07922177419354838,0.83,99.45
2022-02-22,Uttar Pradesh,690,4,686,9018,4831,1675,7.65,0,248.0,651517,5374,647929,1.95,0.68,0.03636290322580645,0.82,99.45
2022-02-23,Uttar Pradesh,1089,6,1087,13718,534,151,7.94,0,248.0,652606,5380,649016,0.22,0.06,0.05531451612903226,0.82,99.45
2022-02-24,Uttar Pradesh,1068,10,1059,13396,197,10,7.97,0,248.0,653674,5390,650075,0.08,0.0,0.05401612903225807,0.82,99.45
2022-02-25,Uttar Pradesh,1552,5,1552,19742,1165,279,7.86,0,248.0,655226,5395,651627,0.47,0.11,0.07960483870967743,0.82,99.45
2022-02-26,Uttar Pradesh,1514,8,1512,18798,2563,2323,8.05,0,248.0,656740,5403,653139,1.03,0.94,0.0757983870967742,0.82,99.45
2022-02-27,Uttar Pradesh,480,3,477,5874,1197,1000,8.17,0,248.0,657220,5406,653616,0.48,0.4,0.023685483870967743,0.82,99.45
2022-02-28,Uttar Pradesh,1200,16,1199,15092,3434,1559,7.95,0,248.0,658420,5422,654815,1.38,0.63,0.06085483870967742,0.82,99.45
2022-03-01,Uttar Pradesh,1167,7,1164,14766,1511,1121,7.9,0,248.0,659587,5429,655979,0.61,0.45,0.059540322580645164,0.82,99.45
2022-03-02,Uttar Pradesh,1181,15,1173,15222,2740,2241,7.76,0,248.0,660768,5444,657152,1.1,0.9,0.061379032258064514,0.82,99.45
2022-03-03,Uttar Pradesh,250,3,250,3363,1290,323,7.43,0,248.0,661018,5447,657402,0.52,0.13,0.013560483870967742,0.82,99.45
2022-03-04,Uttar Pradesh,1386,14,1382,17225,4766,3513,8.05,0,248.0,662404,5461,658784,1.92,1.42,0.06945564516129032,0.82,99.45
2022-03-05,Uttar Pradesh,1261,18,1259,15390,595,66,8.19,0,248.0,663665,5479,660043,0.24,0.03,0.06205645161290323,0.83,99.45
2022-03-06,Uttar Pradesh,1167,12,1159,14773,4883,474,7.9,0,248.0,664832,5491,661202,1.97,0.19,0.05956854838709678,0.83,99.45
2022-03-07,Uttar Pradesh,1059,12,1057,13034,523,107,8.12,0,248.0,665891,5503,662259,0.21,0.04,0.052556451612903225,0.83,99.45
2022-03-08,Uttar Pradesh,1384,15,1382,17517,1850,1191,7.9,0,248.0,667275,5518,663641,0.75,0.48,0.07063306451612904,0.83,99.46
2022-03-09,Uttar Pradesh,139,0,135,2018,365,108,6.89,4,248.0,667414,5518,663776,0.15,0.04,0.008137096774193548,0.83,99.45
2022-03-10,Uttar Pradesh,591,6,585,7647,1395,764,7.73,0,248.0,668005,5524,664361,0.56,0.31,0.03083467741935484,0.83,99.45
2022-03-11,Uttar Pradesh,1504,7,1499,18989,4084,1737,7.92,0,248.0,669509,5531,665860,1.65,0.7,0.07656854838709677,0.83,99.45
2022-03-12,Uttar Pradesh,1578,21,1578,19781,4198,1929,7.98,0,248.0,671087,5552,667438,1.69,0.78,0.07976209677419355,0.83,99.46
2022-03-13,Uttar Pradesh,1197,4,1192,15112,2455,155,7.92,1,248.0,672284,5556,668630,0.99,0.06,0.06093548387096774,0.83,99.46
2022-03-14,Uttar Pradesh,764,3,764,9576,67,34,7.98,0,248.0,673048,5559,669394,0.03,0.01,0.038612903225806454,0.83,99.46
2022-03-15,Uttar Pradesh,67,0,62,998,3053,842,6.71,5,248.0,673115,5559,669456,1.23,0.34,0.004024193548387097,0.83,99.46
2022-03-16,Uttar Pradesh,602,6,595,7542,2903,615,7.98,1,248.0,673717,5565,670051,1.17,0.25,0.030411290322580647,0.83,99.46
2022-03-17,Uttar Pradesh,612,3,605,7622,737,727,8.03,4,248.0,674329,5568,670656,0.3,0.29,0.030733870967741935,0.83,99.46
2022-03-18,Uttar Pradesh,1469,10,1460,18660,1170,18,7.87,0,248.0,675798,5578,672116,0.47,0.01,0.07524193548387097,0.83,99.46
2022-03-19,Uttar Pradesh,338,5,329,4383,609,116,7.71,4,248.0,676136,5583,672445,0.25,0.05,0.017673387096774195,0.83,99.45
2022-03-20,Uttar Pradesh,1058,11,1049,12804,4155,1803,8.26,0,248.0,677194,5594,673494,1.68,0.73,0.05162903225806452,0.83,99.45
2022-03-21,Uttar Pradesh,1520,12,1512,19414,2487,1171,7.83,0,248.0,678714,5606,675006,1.0,0.47,0.07828225806451614,0.83,99.45
2022-03-22,Uttar Pradesh,1497,19,1491,19109,21,12,7.83,0,248.0,680211,5625,676497,0.01,0.0,0.07705241935483871,0.83,99.45
2022-03-23,Uttar Pradesh,785,4,785,9814,1548,686,8.0,0,248.0,680996,5629,677282,0.62,0.28,0.03957258064516129,0.83,99.45
2022-03-24,Uttar Pradesh,314,3,310,3990,2613,1294,7.87,1,248.0,681310,5632,677592,1.05,0.52,0.016088709677419356,0.83,99.45
2022-03-25,Uttar Pradesh,727,6,719,8949,2312,252,8.12,2,248.0,682037,5638,678311,0.93,0.1,0.03608467741935484,0.83,99.45
2022-03-26,Uttar Pradesh,1489,9,1487,18309,1341,688,8.13,0,248.0,683526,5647,679798,0.54,0.28,0.07382661290322581,0.83,99.45
2022-03-27,Uttar Pradesh,26,0,19,641,1804,1248,4.06,7,248.0,683552,5647,679817,0.73,0.5,0.0025846774193548387,0.83,99.45
2022-03-28,Uttar Pradesh,900,7,891,10898,4687,2194,8.26,2,248.0,684452,5654,680708,1.89,0.88,0.04394354838709678,0.83,99.45
2022-03-29,Uttar Pradesh,708,3,699,9291,4910,76,7.62,6,248.0,685160,5657,681407,1.98,0.03,0.037463709677419355,0.83,99.45
2022-03-30,Uttar Pradesh,1098,3,1090,13621,1111,417,8.06,5,248.0,686258,5660,682497,0.45,0.17,0.0549233870967742,0.82,99.45
2022-03-31,Uttar Pradesh,1420,9,1416,17708,1089,603,8.02,0,248.0,687678,5669,683913,0.44,0.24,0.07140322580645161,0.82,99.45
2022-04-01,Uttar Pradesh,998,7,994,12636,3542,1997,7.9,0,248.0,688676,5676,684907,1.43,0.81,0.05095161290322581,0.82,99.45
2022-04-02,Uttar Pradesh,294,2,285,3516,93,57,8.36,7,248.0,688970,5678,685192,0.04,0.02,0.014177419354838709,0.82,99.45
2022-04-03,Uttar Pradesh,484,1,481,5775,74,65,8.38,2,248.0,689454,5679,685673,0.03,0.03,0.023286290322580644,0.82,99.45
2022-04-04,Uttar Pradesh,410,5,405,4705,4033,2052,8.71,0,248.0,689864,5684,686078,1.63,0.83,0.018971774193548386,0.82,99.45
2022-04-05,Uttar Pradesh,412,5,405,5025,3575,1688,8.2,2,248.0,690276,5689,686483,1.44,0.68,0.02026209677419355,0.82,99.45
2022-04-06,Uttar Pradesh,1445,5,1437,17846,2098,1109,8.1,3,248.0,691721,5694,687920,0.85,0.45,0.07195967741935484,0.82,99.45
2022-04-07,Uttar Pradesh,369,1,365,4868,3689,2056,7.58,3,248.0,692090,5695,688285,1.49,0.83,0.019629032258064515,0.82,99.45
2022-04-08,Uttar Pradesh,152,0,149,1858,286,143,8.18,3,248.0,692242,5695,688434,0.12,0.06,0.0074919354838709675,0.82,99.45
2022-04-09,Uttar Pradesh,1049,15,1041,12773,2275,524,8.21,0,248.0,693291,5710,689475,0.92,0.21,0.05150403225806452,0.82,99.45
2022-04-10,Uttar Pradesh,980,4,977,12312,4064,3010,7.96,0,248.0,694271,5714,690452,1.64,1.21,0.04964516129032258,0.82,99.45
2022-04-11,Uttar Pradesh,910,9,904,11769,549,21,7.73,0,248.0,695181,5723,691356,0.22,0.01,0.047455645161290326,0.82,99.45
2022-04-12,Uttar Pradesh,938,14,933,11397,874,290,8.23,0,248.0,696119,5737,692289,0.35,0.12,0.045955645161290325,0.82,99.45
2022-04-13,Uttar Pradesh,355,5,354,4100,2051,1184,8.66,0,248.0,696474,5742,692643,0.83,0.48,0.01653225806451613,0.82,99.45
2022-04-14,Uttar Pradesh,1369,13,1365,17148,3631,2630,7.98,0,248.0,697843,5755,694008,1.46,1.06,0.06914516129032258,0.82,99.45
2022-04-15,Uttar Pradesh,1178,14,1174,14865,2342,978,7.92,0,248.0,699021,5769,695182,0.94,0.39,0.059939516129032255,0.83,99.45
2022-04-16,Uttar Pradesh,316,3,314,3822,2076,1118,8.27,0,248.0,699337,5772,695496,0.84,0.45,0.015411290322580646,0.83,99.45
2022-04-17,Uttar Pradesh,740,4,735,9540,3223,893,7.76,1,248.0,700077,5776,696231,1.3,0.36,0.03846774193548387,0.83,99.45
2022-04-18,Uttar Pradesh,533,6,524,6427,166,29,8.29,3,248.0,700610,5782,696755,0.07,0.01,0.02591532258064516,0.83,99.45
2022-04-19,Uttar Pradesh,371,3,371,5000,4197,2153,7.42,0,248.0,700981,5785,697126,1.69,0.87,0.020161290322580645,0.83,99.45
2022-04-20,Uttar Pradesh,1331,11,1328,16171,4060,959,8.23,0,248.0,702312,5796,698454,1.64,0.39,0.06520564516129032,0.83,99.45
2022-04-21,Uttar Pradesh,666,4,666,8397,3414,1766,7.93,0,248.0,702978,5800,699120,1.38,0.71,0.033858870967741934,0.83,99.45
2022-04-22,Uttar Pradesh,1574,14,1573,19655,2037,1930,8.01,0,248.0,704552,5814,700693,0.82,0.78,0.07925403225806452,0.83,99.45
2022-04-23,Uttar Pradesh,1128,6,1120,14049,617,86,8.03,2,248.0,705680,5820,701813,0.25,0.03,0.0566491935483871,0.82,99.45
2022-04-24,Uttar Pradesh,1617,21,1616,19988,1027,74,8.09,0,248.0,707297,5841,703429,0.41,0.03,0.08059677419354838,0.83,99.45
2022-04-25,Uttar Pradesh,488,5,481,6216,2388,217,7.85,2,248.0,707785,5846,703910,0.96,0.09,0.02506451612903226,0.83,99.45
2022-04-26,Uttar Pradesh,1023,9,1019,12906,187,14,7.93,0,248.0,708808,5855,704929,0.08,0.01,0.052040322580645164,0.83,99.45
2022-04-27,Uttar Pradesh,1231,6,1227,15226,958,574,8.08,0,248.0,710039,5861,706156,0.39,0.23,0.06139516129032258,0.83,99.45
2022-04-28,Uttar Pradesh,1292,14,1284,15915,2858,1199,8.12,0,248.0,711331,5875,707440,1.15,0.48,0.0641733870967742,0.83,99.45
2022-04-29,Uttar Pradesh,1015,14,1009,13189,3499,1343,7.7,0,248.0,712346,5889,708449,1.41,0.54,0.053181451612903226,0.83,99.45
2022-04-30,Uttar Pradesh,95,0,90,1208,897,793,7.86,5,248.0,712441,5889,708539,0.36,0.32,0.004870967741935484,0.83,99.45
2022-05-01,Uttar Pradesh,1396,16,1389,17161,4246,1541,8.13,0,248.0,713837,5905,709928,1.71,0.62,0.0691975806451613,0.83,99.45
2022-05-02,Uttar Pradesh,875,2,872,11361,2352,1430,7.7,1,248.0,714712,5907,710800,0.95,0.58,0.04581048387096774,0.83,99.45
2022-05-03,Uttar Pradesh,610,6,610,7362,3732,272,8.29,0,248.0,715322,5913,711410,1.5,0.11,0.02968548387096774,0.83,99.45
2022-05-04,Uttar Pradesh,1473,6,1464,18579,3214,2636,7.93,3,248.0,716795,5919,712874,1.3,1.06,0.07491532258064516,0.83,99.45
2022-05-05,Uttar Pradesh,533,4,533,6830,2767,1914,7.8,0,248.0,717328,5923,713407,1.12,0.77,0.027540322580645163,0.83,99.45
2022-05-06,Uttar Pradesh,1236,6,1230,15644,1412,721,7.9,0,248.0,718564,5929,714637,0.57,0.29,0.06308064516129032,0.83,99.45
2022-05-07,Uttar Pradesh,1476,5,1476,18550,840,134,7.96,0,248.0,720040,5934,716113,0.34,0.05,0.0747983870967742,0.82,99.45
2022-05-08,Uttar Pradesh,1477,20,1470,18640,3565,2063,7.92,0,248.0,721517,5954,717583,1.44,0.83,0.07516129032258065,0.83,99.45
2022-05-09,Uttar Pradesh,400,5,392,5112,2996,134,7.82,3,248.0,721917,5959,717975,1.21,0.05,0.020612903225806452,0.83,99.45
2022-05-10,Uttar Pradesh,308,1,301,3762,286,101,8.19,6,248.0,722225,5960,718276,0.12,0.04,0.015169354838709678,0.83,99.45
2022-05-11,Uttar Pradesh,1210,6,1209,15192,1390,1365,7.96,0,248.0,723435,5966,719485,0.56,0.55,0.06125806451612903,0.82,99.45
2022-05-12,Uttar Pradesh,918,4,910,11457,2190,1491,8.01,4,248.0,724353,5970,720395,0.88,0.6,0.04619758064516129,0.82,99.45
2022-05-13,Uttar Pradesh,1318,5,1316,16459,2798,2409,8.01,0,248.0,725671,5975,721711,1.13,0.97,0.06636693548387097,0.82,99.45
2022-05-14,Uttar Pradesh,318,2,314,3843,3417,1590,8.27,2,248.0,725989,5977,722025,1.38,0.64,0.015495967741935485,0.82,99.45
2022-05-15,Uttar Pradesh,1286,18,1280,15925,3879,3387,8.08,0,248.0,727275,5995,723305,1.56,1.37,0.06421370967741935,0.82,99.45
2022-05-16,Uttar Pradesh,1234,13,1227,15237,2399,1221,8.1,0,248.0,728509,6008,724532,0.97,0.49,0.06143951612903226,0.82,99.45
2022-05-17,Uttar Pradesh,376,4,368,4794,3420,98,7.84,4,248.0,728885,6012,724900,1.38,0.04,0.019330645161290322,0.82,99.45
2022-05-18,Uttar Pradesh,1217,11,1215,15360,3245,3200,7.92,0,248.0,730102,6023,726115,1.31,1.29,0.06193548387096774,0.82,99.45
2022-05-19,Uttar Pradesh,138,1,134,1207,4136,3902,11.43,3,248.0,730240,6024,726249,1.67,1.57,0.004866935483870968,0.82,99.45
2022-05-20,Uttar Pradesh,1053,9,1047,12967,465,211,8.12,0,248.0,731293,6033,727296,0.19,0.09,0.05228629032258064,0.82,99.45
2022-05-21,Uttar Pradesh,434,2,430,5477,2410,471,7.92,2,248.0,731727,6035,727726,0.97,0.19,0.02208467741935484,0.82,99.45
2022-05-22,Uttar Pradesh,688,3,680,8824,3962,731,7.8,5,248.0,732415,6038,728406,1.6,0.29,0.03558064516129032,0.82,99.45
2022-05-23,Uttar Pradesh,606,3,601,7687,2261,886,7.88,2,248.0,733021,6041,729007,0.91,0.36,0.030995967741935485,0.82,99.45
2022-05-24,Uttar Pradesh,178,2,174,2206,2219,1498,8.07,2,248.0,733199,6043,729181,0.89,0.6,0.00889516129032258,0.82,99.45
2022-05-25,Uttar Pradesh,711,4,703,8607,591,142,8.26,4,248.0,733910,6047,729884,0.24,0.06,0.03470564516129032,0.82,99.45
2022-05-26,Uttar Pradesh,589,2,584,7036,179,169,8.37,3,248.0,734499,6049,730468,0.07,0.07,0.028370967741935482,0.82,99.45
2022-05-27,Uttar Pradesh,1584,17,1576,19533,703,638,8.11,0,248.0,736083,6066,732044,0.28,0.26,0.07876209677419355,0.82,99.45
2022-05-28,Uttar Pradesh,825,4,823,10561,1376,919,7.81,0,248.0,736908,6070,732867,0.55,0.37,0.04258467741935484,0.82,99.45
2022-05-29,Uttar Pradesh,360,2,357,4268,4981,584,8.43,1,248.0,737268,6072,733224,2.01,0.24,0.01720967741935484,0.82,99.45
2022-05-30,Uttar Pradesh,36,0,31,656,3953,3100,5.49,5,248.0,737304,6072,733255,1.59,1.25,0.0026451612903225807,0.82,99.45
2022-05-31,Uttar Pradesh,24,0,15,580,1143,293,4.14,9,248.0,737328,6072,733270,0.46,0.12,0.002338709677419355,0.82,99.45
2022-06-01,Uttar Pradesh,1232,10,1223,15173,1420,765,8.12,0,248.0,738560,6082,734493,0.57,0.31,0.061181451612903226,0.82,99.45
2022-06-02,Uttar Pradesh,1421,20,1414,17585,2582,2082,8.08,0,248.0,739981,6102,735907,1.04,0.84,0.07090725806451613,0.82,99.45
2022-06-03,Uttar Pradesh,1316,7,1311,16643,2452,1036,7.91,0,248.0,741297,6109,737218,0.99,0.42,0.06710887096774193,0.82,99.45
2022-06-04,Uttar Pradesh,1227,7,1219,15464,1986,5,7.93,1,248.0,742524,6116,738437,0.8,0.0,0.06235483870967742,0.82,99.45
2022-06-05,Uttar Pradesh,1009,11,1006,12339,4406,4354,8.18,0,248.0,743533,6127,739443,1.78,1.76,0.04975403225806452,0.82,99.45
2022-06-06,Uttar Pradesh,1293,12,1292,16329,4992,1205,7.92,0,248.0,744826,6139,740735,2.01,0.49,0.06584274193548387,0.82,99.45
2022-06-07,Uttar Pradesh,774,6,767,9767,709,631,7.92,1,248.0,745600,6145,741502,0.29,0.25,0.03938306451612903,0.82,99.45
2022-06-08,Uttar Pradesh,1576,13,1567,19460,4282,79,8.1,0,248.0,747176,6158,743069,1.73,0.03,0.07846774193548386,0.82,99.45
2022-06-09,Uttar Pradesh,375,4,367,4697,1897,512,7.98,4,248.0,747551,6162,743436,0.76,0.21,0.018939516129032257,0.82,99.45
2022-06-10,Uttar Pradesh,1348,13,1347,16567,4447,2269,8.14,0,248.0,748899,6175,744783,1.79,0.91,0.06680241935483872,0.82,99.45
2022-06-11,Uttar Pradesh,1401,8,1395,17648,81,54,7.94,0,248.0,750300,6183,746178,0.03,0.02,0.07116129032258064,0.82,99.45
2022-06-12,Uttar Pradesh,324,1,322,3568,1395,486,9.08,1,248.0,750624,6184,746500,0.56,0.2,0.014387096774193548,0.82,99.45
2022-06-13,Uttar Pradesh,649,7,646,8347,2902,202,7.78,0,248.0,751273,6191,747146,1.17,0.08,0.03365725806451613,0.82,99.45
2022-06-14,Uttar Pradesh,1110,7,1101,13812,2749,1538,8.04,2,248.0,752383,6198,748247,1.11,0.62,0.055693548387096774,0.82,99.45
2022-06-15,Uttar Pradesh,902,2,902,11496,2865,1889,7.85,0,248.0,753285,6200,749149,1.16,0.76,0.046354838709677416,0.82,99.45
2022-06-16,Uttar Pradesh,1318,13,1315,16383,4141,3463,8.04,0,248.0,754603,6213,750464,1.67,1.4,0.06606048387096775,0.82,99.45
2022-06-17,Uttar Pradesh,935,5,929,11912,3588,376,7.85,1,248.0,755538,6218,751393,1.45,0.15,0.04803225806451613,0.82,99.45
2022-06-18,Uttar Pradesh,1411,20,1411,17986,4586,2174,7.84,0,248.0,756949,6238,752804,1.85,0.88,0.0725241935483871,0.82,99.45
2022-06-19,Uttar Pradesh,1351,15,1349,16460,1833,715,8.21,0,248.0,758300,6253,754153,0.74,0.29,0.06637096774193549,0.82,99.45
2022-06-20,Uttar Pradesh,1203,14,1202,14616,2540,2034,8.23,0,248.0,759503,6267,755355,1.02,0.82,0.05893548387096774,0.83,99.45
2022-06-21,Uttar Pradesh,823,10,817,10068,401,43,8.17,0,248.0,760326,6277,756172,0.16,0.02,0.04059677419354839,0.83,99.45
2022-06-22,Uttar Pradesh,696,3,691,8460,3035,2810,8.23,2,248.0,761022,6280,756863,1.22,1.13,0.03411290322580645,0.83,99.45
2022-06-23,Uttar Pradesh,1125,3,1125,14242,936,607,7.9,0,248.0,762147,6283,757988,0.38,0.24,0.05742741935483871,0.82,99.45
2022-06-24,Uttar Pradesh,80,1,78,925,2906,2342,8.65,1,248.0,762227,6284,758066,1.17,0.94,0.0037298387096774193,0.82,99.45
2022-06-25,Uttar Pradesh,595,8,587,7785,1674,35,7.64,0,248.0,762822,6292,758653,0.68,0.01,0.03139112903225806,0.82,99.45
2022-06-26,Uttar Pradesh,999,14,995,12710,1794,570,7.86,0,248.0,763821,6306,759648,0.72,0.23,0.05125,0.83,99.45
2022-06-27,Uttar Pradesh,1187,15,1179,14855,3127,410,7.99,0,248.0,765008,6321,760827,1.26,0.17,0.059899193548387096,0.83,99.45
2022-06-28,Uttar Pradesh,872,3,863,10818,2778,936,8.06,6,248.0,765880,6324,761690,1.12,0.38,0.04362096774193548,0.83,99.45
2022-06-29,Uttar Pradesh,1296,15,1291,15997,3148,977,8.1,0,248.0,767176,6339,762981,1.27,0.39,0.06450403225806452,0.83,99.45
2022-06-30,Uttar Pradesh,799,9,790,9942,1407,1384,8.04,0,248.0,767975,6348,763771,0.57,0.56,0.04008870967741936,0.83,99.45
2022-07-01,Uttar Pradesh,874,6,870,11125,1070,127,7.86,0,248.0,768849,6354,764641,0.43,0.05,0.04485887096774194,0.83,99.45
2022-07-02,Uttar Pradesh,1421,8,1418,17772,112,52,8.0,0,248.0,770270,6362,766059,0.05,0.02,0.07166129032258065,0.83,99.45
2022-07-03,Uttar Pradesh,94,0,91,835,4017,1924,11.26,3,248.0,770364,6362,766150,1.62,0.78,0.0033669354838709678,0.83,99.45
2022-07-04,Uttar Pradesh,1485,5,1478,18689,980,363,7.95,2,248.0,771849,6367,767628,0.4,0.15,0.07535887096774194,0.82,99.45
2022-07-05,Uttar Pradesh,464,1,458,5882,3762,308,7.89,5,248.0,772313,6368,768086,1.52,0.12,0.02371774193548387,0.82,99.45
2022-07-06,Uttar Pradesh,623,5,615,7733,1897,877,8.06,3,248.0,772936,6373,768701,0.76,0.35,0.031181451612903227,0.82,99.45
2022-07-07,Uttar Pradesh,52,0,46,616,2677,2247,8.44,6,248.0,772988,6373,768747,1.08,0.91,0.0024838709677419356,0.82,99.45
2022-07-08,Uttar Pradesh,880,7,873,11004,659,341,8.0,0,248.0,773868,6380,769620,0.27,0.14,0.04437096774193548,0.82,99.45
2022-07-09,Uttar Pradesh,1178,5,1172,14672,3616,2777,8.03,1,248.0,775046,6385,770792,1.46,1.12,0.05916129032258065,0.82,99.45
2022-07-10,Uttar Pradesh,246,3,242,3002,1659,313,8.19,1,248.0,775292,6388,771034,0.67,0.13,0.012104838709677419,0.82,99.45
2022-07-11,Uttar Pradesh,884,11,878,11087,3101,2788,7.97,0,248.0,776176,6399,771912,1.25,1.12,0.044705645161290324,0.82,99.45
2022-07-12,Uttar Pradesh,489,4,486,6692,461,309,7.31,0,248.0,776665,6403,772398,0.19,0.12,0.026983870967741935,0.82,99.45
2022-07-13,Uttar Pradesh,665,8,657,8054,135,10,8.26,0,248.0,777330,6411,773055,0.05,0.0,0.0324758064516129,0.82,99.45
2022-07-14,Uttar Pradesh,590,5,582,7278,2265,2226,8.11,3,248.0,777920,6416,773637,0.91,0.9,0.029346774193548388,0.82,99.45
2022-07-15,Uttar Pradesh,770,4,769,9967,4100,894,7.73,0,248.0,778690,6420,774406,1.65,0.36,0.04018951612903226,0.82,99.45
2022-07-16,Uttar Pradesh,935,8,929,11576,3784,3441,8.08,0,248.0,779625,6428,775335,1.53,1.39,0.04667741935483871,0.82,99.45
2022-07-17,Uttar Pradesh,928,8,919,11711,1401,1058,7.92,1,248.0,780553,6436,776254,0.56,0.43,0.04722177419354839,0.82,99.45
2022-07-18,Uttar Pradesh,396,2,388,4927,3141,9,8.04,6,248.0,780949,6438,776642,1.27,0.0,0.019866935483870966,0.82,99.45
2022-07-19,Uttar Pradesh,405,3,398,4915,4175,1892,8.24,4,248.0,781354,6441,777040,1.68,0.76,0.019818548387096773,0.82,99.45
2022-07-20,Uttar Pradesh,705,5,696,8628,1072,772,8.17,4,248.0,782059,6446,777736,0.43,0.31,0.03479032258064516,0.82,99.45
2022-07-21,Uttar Pradesh,1243,7,1235,16153,2284,1986,7.7,1,248.0,783302,6453,778971,0.92,0.8,0.06513306451612903,0.82,99.45
2022-07-22,Uttar Pradesh,225,1,221,2758,3767,3599,8.16,3,248.0,783527,6454,779192,1.52,1.45,0.011120967741935484,0.82,99.45
2022-07-23,Uttar Pradesh,183,1,180,2285,1537,689,8.01,2,248.0,783710,6455,779372,0.62,0.28,0.009213709677419355,0.82,99.45
2022-07-24,Uttar Pradesh,1523,15,1518,18655,1955,1319,8.16,0,248.0,785233,6470,780890,0.79,0.53,0.07522177419354839,0.82,99.45
2022-07-25,Uttar Pradesh,1445,9,1444,17846,740,632,8.1,0,248.0,786678,6479,782334,0.3,0.25,0.07195967741935484,0.82,99.45
2022-07-26,Uttar Pradesh,1330,13,1325,16569,601,73,8.03,0,248.0,788008,6492,783659,0.24,0.03,0.06681048387096775,0.82,99.45
2022-07-27,Uttar Pradesh,1259,8,1258,15515,4198,2939,8.11,0,248.0,789267,6500,784917,1.69,1.19,0.06256048387096774,0.82,99.45
2022-07-28,Uttar Pradesh,1511,13,1507,18967,3001,2883,7.97,0,248.0,790778,6513,786424,1.21,1.16,0.07647983870967742,0.82,99.45
2022-07-29,Uttar Pradesh,475,5,469,5923,3951,1426,8.02,1,248.0,791253,6518,786893,1.59,0.57,0.02388306451612903,0.82,99.45
2022-07-30,Uttar Pradesh,371,4,365,4853,4567,2690,7.64,2,248.0,791624,6522,787258,1.84,1.08,0.019568548387096773,0.82,99.45
2022-07-31,Uttar Pradesh,794,6,793,9962,1765,938,7.97,0,248.0,792418,6528,788051,0.71,0.38,0.040169354838709675,0.82,99.45
2022-08-01,Uttar Pradesh,640,3,634,7921,4929,2081,8.08,3,248.0,793058,6531,788685,1.99,0.84,0.03193951612903226,0.82,99.45
2022-08-02,Uttar Pradesh,595,5,586,7128,1436,1226,8.35,4,248.0,793653,6536,789271,0.58,0.49,0.028741935483870967,0.82,99.45
2022-08-03,Uttar Pradesh,1178,13,1169,14617,314,7,8.06,0,248.0,794831,6549,790440,0.13,0.0,0.05893951612903226,0.82,99.45
2022-08-04,Uttar Pradesh,551,7,547,7259,2889,2660,7.59,0,248.0,795382,6556,790987,1.16,1.07,0.02927016129032258,0.82,99.45
2022-08-05,Uttar Pradesh,1448,13,1442,17941,259,16,8.07,0,248.0,796830,6569,792429,0.1,0.01,0.07234274193548387,0.82,99.45
2022-08-06,Uttar Pradesh,559,2,556,6689,2502,2226,8.36,1,248.0,797389,6571,792985,1.01,0.9,0.026971774193548386,0.82,99.45
2022-08-07,Uttar Pradesh,1147,4,1139,14259,4392,306,8.04,4,248.0,798536,6575,794124,1.77,0.12,0.05749596774193549,0.82,99.45
2022-08-08,Uttar Pradesh,780,10,778,9913,1909,750,7.87,0,248.0,799316,6585,794902,0.77,0.3,0.03997177419354839,0.82,99.45
2022-08-09,Uttar Pradesh,1533,19,1526,19552,2250,1068,7.84,0,248.0,800849,6604,796428,0.91,0.43,0.07883870967741935,0.82,99.45
2022-08-10,Uttar Pradesh,828,12,824,10676,4179,3098,7.76,0,248.0,801677,6616,797252,1.69,1.25,0.04304838709677419,0.83,99.45
2022-08-11,Uttar Pradesh,1001,3,1000,12494,3329,1579,8.01,0,248.0,802678,6619,798252,1.34,0.64,0.05037903225806452,0.82,99.45
2022-08-12,Uttar Pradesh,1278,5,1270,16211,98,72,7.88,3,248.0,803956,6624,799522,0.04,0.03,0.06536693548387097,0.82,99.45
2022-08-13,Uttar Pradesh,520,4,515,6722,2802,2387,7.74,1,248.0,804476,6628,800037,1.13,0.96,0.02710483870967742,0.82,99.45
2022-08-14,Uttar Pradesh,589,2,587,7944,3270,470,7.41,0,248.0,805065,6630,800624,1.32,0.19,0.03203225806451613,0.82,99.45
2022-08-15,Uttar Pradesh,933,4,928,11316,1691,530,8.24,1,248.0,805998,6634,801552,0.68,0.21,0.045629032258064514,0.82,99.45
2022-08-16,Uttar Pradesh,95,0,92,750,1281,148,12.67,3,248.0,806093,6634,801644,0.52,0.06,0.0030241935483870967,0.82,99.45
2022-08-17,Uttar Pradesh,9,0,1,543,3275,2844,1.66,8,248.0,806102,6634,801645,1.32,1.15,0.0021895161290322583,0.82,99.45
2022-08-18,Uttar Pradesh,907,5,905,11523,1287,253,7.87,0,248.0,807009,6639,802550,0.52,0.1,0.046463709677419356,0.82,99.45
2022-08-19,Uttar Pradesh,740,7,737,9339,153,91,7.92,0,248.0,807749,6646,803287,0.06,0.04,0.03765725806451613,0.82,99.45
2022-08-20,Uttar Pradesh,478,3,469,6087,3606,313,7.85,6,248.0,808227,6649,803756,1.45,0.13,0.02454435483870968,0.82,99.45
2022-08-21,Uttar Pradesh,856,4,848,10378,4238,695,8.25,4,248.0,809083,6653,804604,1.71,0.28,0.04184677419354839,0.82,99.45
2022-08-22,Uttar Pradesh,522,4,521,6718,1912,1091,7.77,0,248.0,809605,6657,805125,0.77,0.44,0.027088709677419356,0.82,99.45
2022-08-23,Uttar Pradesh,1005,8,997,12741,1457,878,7.89,0,248.0,810610,6665,806122,0.59,0.35,0.051375,0.82,99.45
2022-08-24,Uttar Pradesh,1508,20,1500,18882,2647,1319,7.99,0,248.0,812118,6685,807622,1.07,0.53,0.07613709677419354,0.82,99.45
2022-08-25,Uttar Pradesh,1541,19,1538,18924,1534,1473,8.14,0,248.0,813659,6704,809160,0.62,0.59,0.07630645161290323,0.82,99.45
2022-08-26,Uttar Pradesh,1305,7,1301,16931,2619,755,7.71,0,248.0,814964,6711,810461,1.06,0.3,0.06827016129032258,0.82,99.45
2022-08-27,Uttar Pradesh,421,4,420,4792,4156,3692,8.79,0,248.0,815385,6715,810881,1.68,1.49,0.01932258064516129,0.82,99.45
2022-08-28,Uttar Pradesh,1194,11,1192,14699,172,15,8.12,0,248.0,816579,6726,812073,0.07,0.01,0.05927016129032258,0.82,99.45
2022-08-29,Uttar Pradesh,642,3,636,7835,1557,233,8.19,3,248.0,817221,6729,812709,0.63,0.09,0.03159274193548387,0.82,99.45
2022-08-30,Uttar Pradesh,994,13,994,12325,154,76,8.06,0,248.0,818215,6742,813703,0.06,0.03,0.04969758064516129,0.82,99.45
2022-08-31,Uttar Pradesh,1455,20,1455,18220,3376,1564,7.99,0,248.0,819670,6762,815158,1.36,0.63,0.07346774193548387,0.82,99.45
2022-09-01,Uttar Pradesh,880,12,880,11176,1300,385,7.87,0,248.0,820550,6774,816038,0.52,0.16,0.045064516129032256,0.83,99.45
2022-09-02,Uttar Pradesh,816,6,809,10114,2405,2137,8.07,1,248.0,821366,6780,816847,0.97,0.86,0.04078225806451613,0.83,99.45
2022-09-03,Uttar Pradesh,1378,16,1371,16820,3039,473,8.19,0,248.0,822744,6796,818218,1.23,0.19,0.06782258064516129,0.83,99.45
2022-09-04,Uttar Pradesh,1601,6,1596,19776,394,391,8.1,0,248.0,824345,6802,819814,0.16,0.16,0.07974193548387097,0.83,99.45
2022-09-05,Uttar Pradesh,177,1,176,2275,4180,3137,7.78,0,248.0,824522,6803,819990,1.69,1.26,0.009173387096774193,0.83,99.45
2022-09-06,Uttar Pradesh,307,2,302,3708,2569,1479,8.28,3,248.0,824829,6805,820292,1.04,0.6,0.014951612903225806,0.83,99.45
2022-09-07,Uttar Pradesh,1016,13,1014,12739,1937,1536,7.98,0,248.0,825845,6818,821306,0.78,0.62,0.05136693548387097,0.83,99.45
2022-09-08,Uttar Pradesh,713,4,704,8938,1581,688,7.98,5,248.0,826558,6822,822010,0.64,0.28,0.036040322580645164,0.83,99.45
2022-09-09,Uttar Pradesh,1612,15,1607,19910,808,421,8.1,0,248.0,828170,6837,823617,0.33,0.17,0.08028225806451612,0.83,99.45
2022-09-10,Uttar Pradesh,594,7,593,7827,1347,1160,7.59,0,248.0,828764,6844,824210,0.54,0.47,0.03156048387096774,0.83,99.45
2022-09-11,Uttar Pradesh,360,1,355,4431,388,311,8.12,4,248.0,829124,6845,824565,0.16,0.13,0.017866935483870968,0.83,99.45
2022-09-12,Uttar Pradesh,509,2,505,6826,3716,2307,7.46,2,248.0,829633,6847,825070,1.5,0.93,0.0275241935483871,0.83,99.45
2022-09-13,Uttar Pradesh,461,2,461,5675,2661,1607,8.12,0,248.0,830094,6849,825531,1.07,0.65,0.022883064516129033,0.83,99.45
2022-09-14,Uttar Pradesh,506,4,502,6361,3906,1331,7.95,0,248.0,830600,6853,826033,1.58,0.54,0.025649193548387097,0.83,99.45
2022-09-15,Uttar Pradesh,1209,13,1205,15281,4991,4942,7.91,0,248.0,831809,6866,827238,2.01,1.99,0.06161693548387097,0.83,99.45
2022-09-16,Uttar Pradesh,1471,16,1464,18210,1492,700,8.08,0,248.0,833280,6882,828702,0.6,0.28,0.07342741935483871,0.83,99.45
2022-09-17,Uttar Pradesh,1520,5,1515,19119,1738,1567,7.95,0,248.0,834800,6887,830217,0.7,0.63,0.07709274193548388,0.82,99.45
2022-09-18,Uttar Pradesh,1581,8,1572,19562,1328,480,8.08,1,248.0,836381,6895,831789,0.54,0.19,0.07887903225806452,0.82,99.45
2022-09-19,Uttar Pradesh,307,2,299,3875,1354,1132,7.92,6,248.0,836688,6897,832088,0.55,0.46,0.015625,0.82,99.45
2022-09-20,Uttar Pradesh,148,1,147,1656,4894,2391,8.94,0,248.0,836836,6898,832235,1.97,0.96,0.00667741935483871,0.82,99.45
2022-09-21,Uttar Pradesh,1273,5,1264,16028,753,560,7.94,4,248.0,838109,6903,833499,0.3,0.23,0.06462903225806452,0.82,99.45
2022-09-22,Uttar Pradesh,270,4,263,3349,140,87,8.06,3,248.0,838379,6907,833762,0.06,0.04,0.013504032258064517,0.82,99.45
2022-09-23,Uttar Pradesh,268,1,261,3576,2980,2958,7.49,6,248.0,838647,6908,834023,1.2,1.19,0.014419354838709677,0.82,99.45
2022-09-24,Uttar Pradesh,1078,10,1077,13056,269,24,8.26,0,248.0,839725,6918,835100,0.11,0.01,0.05264516129032258,0.82,99.45
2022-09-25,Uttar Pradesh,604,4,600,7218,3311,1617,8.37,0,248.0,840329,6922,835700,1.34,0.65,0.02910483870967742,0.82,99.45
2022-09-26,Uttar Pradesh,907,5,899,11361,4486,2665,7.98,3,248.0,841236,6927,836599,1.81,1.07,0.04581048387096774,0.82,99.45
2022-09-27,Uttar Pradesh,242,2,240,2752,2182,521,8.79,0,248.0,841478,6929,836839,0.88,0.21,0.011096774193548388,0.82,99.45
2022-09-28,Uttar Pradesh,816,3,810,10072,865,244,8.1,3,248.0,842294,6932,837649,0.35,0.1,0.04061290322580645,0.82,99.45
2022-09-29,Uttar Pradesh,1151,6,1147,14090,2102,1730,8.17,0,248.0,843445,6938,838796,0.85,0.7,0.05681451612903226,0.82,99.45
2022-09-30,Uttar Pradesh,1574,21,1568,19356,236,234,8.13,0,248.0,845019,6959,840364,0.1,0.09,0.0780483870967742,0.82,99.45
2022-10-01,Uttar Pradesh,1472,15,1463,17757,408,29,8.29,0,248.0,846491,6974,841827,0.16,0.01,0.0716008064516129,0.82,99.45
2022-10-02,Uttar Pradesh,1048,7,1040,13402,3900,1852,7.82,1,248.0,847539,6981,842867,1.57,0.75,0.05404032258064516,0.82,99.45
2022-10-03,Uttar Pradesh,1100,10,1099,13699,1205,36,8.03,0,248.0,848639,6991,843966,0.49,0.01,0.055237903225806455,0.82,99.45
2022-10-04,Uttar Pradesh,355,1,347,4179,625,156,8.49,7,248.0,848994,6992,844313,0.25,0.06,0.016850806451612903,0.82,99.45
2022-10-05,Uttar Pradesh,812,3,805,10253,4094,2821,7.92,4,248.0,849806,6995,845118,1.65,1.14,0.04134274193548387,0.82,99.45
2022-10-06,Uttar Pradesh,79,0,72,777,3054,2396,10.17,7,248.0,849885,6995,845190,1.23,0.97,0.0031330645161290324,0.82,99.45
2022-10-07,Uttar Pradesh,145,1,141,1380,878,97,10.51,3,248.0,850030,6996,845331,0.35,0.04,0.005564516129032258,0.82,99.45
2022-10-08,Uttar Pradesh,1470,16,1468,18377,3748,2324,8.0,0,248.0,851500,7012,846799,1.51,0.94,0.0741008064516129,0.82,99.45
2022-10-09,Uttar Pradesh,826,5,824,10046,3548,452,8.22,0,248.0,852326,7017,847623,1.43,0.18,0.04050806451612903,0.82,99.45
2022-10-10,Uttar Pradesh,1095,14,1087,13425,3642,1951,8.16,0,248.0,853421,7031,848710,1.47,0.79,0.05413306451612903,0.82,99.45
2022-10-11,Uttar Pradesh,1046,15,1045,12948,4922,452,8.08,0,248.0,854467,7046,849755,1.98,0.18,0.05220967741935484,0.82,99.45
2022-10-12,Uttar Pradesh,586,4,582,6981,4982,3808,8.39,0,248.0,855053,7050,850337,2.01,1.54,0.028149193548387096,0.82,99.45
2022-10-13,Uttar Pradesh,1027,6,1026,12785,3760,194,8.03,0,248.0,856080,7056,851363,1.52,0.08,0.05155241935483871,0.82,99.45
2022-10-14,Uttar Pradesh,1368,17,1363,17484,702,512,7.82,0,248.0,857448,7073,852726,0.28,0.21,0.0705,0.82,99.45
2022-10-15,Uttar Pradesh,1360,7,1351,17399,3858,623,7.82,2,248.0,858808,7080,854077,1.56,0.25,0.07015725806451613,0.82,99.45
2022-10-16,Uttar Pradesh,130,1,129,1316,4826,2768,9.88,0,248.0,858938,7081,854206,1.95,1.12,0.005306451612903226,0.82,99.45
2022-10-17,Uttar Pradesh,1032,8,1028,12768,1673,1029,8.08,0,248.0,859970,7089,855234,0.67,0.41,0.051483870967741936,0.82,99.45
2022-10-18,Uttar Pradesh,194,2,189,2535,760,648,7.65,3,248.0,860164,7091,855423,0.31,0.26,0.010221774193548387,0.82,99.45
2022-10-19,Uttar Pradesh,1309,7,1308,16225,425,178,8.07,0,248.0,861473,7098,856731,0.17,0.07,0.0654233870967742,0.82,99.45
2022-10-20,Uttar Pradesh,727,2,724,9077,4008,3909,8.01,1,248.0,862200,7100,857455,1.62,1.58,0.036600806451612906,0.82,99.45
2022-10-21,Uttar Pradesh,914,5,913,11378,1254,206,8.03,0,248.0,863114,7105,858368,0.51,0.08,0.045879032258064514,0.82,99.45
2022-10-22,Uttar Pradesh,300,1,291,3728,4930,1566,8.05,8,248.0,863414,7106,858659,1.99,0.63,0.015032258064516128,0.82,99.45
2022-10-23,Uttar Pradesh,66,0,62,854,2262,1686,7.73,4,248.0,863480,7106,858721,0.91,0.68,0.003443548387096774,0.82,99.45
2022-10-24,Uttar Pradesh,1106,6,1101,14095,4118,2339,7.85,0,248.0,864586,7112,859822,1.66,0.94,0.056834677419354836,0.82,99.45
2022-10-25,Uttar Pradesh,324,3,324,4035,2560,758,8.03,0,248.0,864910,7115,860146,1.03,0.31,0.01627016129032258,0.82,99.45
2022-10-26,Uttar Pradesh,1387,12,1385,17307,3701,3252,8.01,0,248.0,866297,7127,861531,1.49,1.31,0.06978629032258064,0.82,99.45
2022-10-27,Uttar Pradesh,1324,8,1318,16971,1293,1051,7.8,0,248.0,867621,7135,862849,0.52,0.42,0.06843145161290323,0.82,99.45
2022-10-28,Uttar Pradesh,1266,14,1259,15895,3635,3350,7.96,0,248.0,868887,7149,864108,1.47,1.35,0.06409274193548387,0.82,99.45
2022-10-29,Uttar Pradesh,44,0,43,700,625,62,6.29,1,248.0,868931,7149,864151,0.25,0.02,0.00282258064516129,0.82,99.45
2022-10-30,Uttar Pradesh,281,1,280,3749,4106,4025,7.5,0,248.0,869212,7150,864431,1.66,1.62,0.015116935483870967,0.82,99.45
2022-10-31,Uttar Pradesh,1359,7,1359,17337,3887,1295,7.84,0,248.0,870571,7157,865790,1.57,0.52,0.06990725806451613,0.82,99.45
2022-11-01,Uttar Pradesh,938,4,934,11413,2487,830,8.22,0,248.0,871509,7161,866724,1.0,0.33,0.04602016129032258,0.82,99.45
2022-11-02,Uttar Pradesh,1314,13,1313,16268,399,323,8.08,0,248.0,872823,7174,868037,0.16,0.13,0.06559677419354838,0.82,99.45
2022-11-03,Uttar Pradesh,709,7,703,9040,4123,791,7.84,0,248.0,873532,7181,868740,1.66,0.32,0.03645161290322581,0.82,99.45
2022-11-04,Uttar Pradesh,1132,7,1127,13776,247,209,8.22,0,248.0,874664,7188,869867,0.1,0.08,0.05554838709677419,0.82,99.45
2022-11-05,Uttar Pradesh,677,4,669,8445,1567,1168,8.02,4,248.0,875341,7192,870536,0.63,0.47,0.03405241935483871,0.82,99.45
2022-11-06,Uttar Pradesh,1239,14,1234,15278,1927,509,8.11,0,248.0,876580,7206,871770,0.78,0.21,0.061604838709677416,0.82,99.45
2022-11-07,Uttar Pradesh,106,0,106,1107,3540,2451,9.58,0,248.0,876686,7206,871876,1.43,0.99,0.004463709677419355,0.82,99.45
2022-11-08,Uttar Pradesh,472,3,472,5958,974,626,7.92,0,248.0,877158,7209,872348,0.39,0.25,0.024024193548387095,0.82,99.45
2022-11-09,Uttar Pradesh,1342,6,1335,17016,507,2,7.89,1,248.0,878500,7215,873683,0.2,0.0,0.06861290322580645,0.82,99.45
2022-11-10,Uttar Pradesh,65,0,65,1142,4165,1661,5.69,0,248.0,878565,7215,873748,1.68,0.67,0.004604838709677419,0.82,99.45
2022-11-11,Uttar Pradesh,824,5,815,10705,1177,294,7.7,4,248.0,879389,7220,874563,0.47,0.12,0.04316532258064516,0.82,99.45
2022-11-12,Uttar Pradesh,879,7,870,11033,4557,1133,7.97,2,248.0,880268,7227,875433,1.84,0.46,0.04448790322580645,0.82,99.45
2022-11-13,Uttar Pradesh,1421,8,1418,17592,4032,1489,8.08,0,248.0,881689,7235,876851,1.63,0.6,0.07093548387096774,0.82,99.45
2022-11-14,Uttar Pradesh,1456,17,1452,18120,2331,331,8.04,0,248.0,883145,7252,878303,0.94,0.13,0.07306451612903225,0.82,99.45
2022-11-15,Uttar Pradesh,196,1,190,2514,476,64,7.8,5,248.0,883341,7253,878493,0.19,0.03,0.010137096774193548,0.82,99.45
2022-11-16,Uttar Pradesh,1571,13,1565,19743,1658,1522,7.96,0,248.0,884912,7266,880058,0.67,0.61,0.07960887096774194,0.82,99.45
2022-11-17,Uttar Pradesh,824,3,821,10425,2887,2339,7.9,0,248.0,885736,7269,880879,1.16,0.94,0.04203629032258065,0.82,99.45
2022-11-18,Uttar Pradesh,1100,9,1100,13898,1491,382,7.91,0,248.0,886836,7278,881979,0.6,0.15,0.05604032258064516,0.82,99.45
2022-11-19,Uttar Pradesh,1471,5,1464,18287,4281,3020,8.04,2,248.0,888307,7283,883443,1.73,1.22,0.07373790322580645,0.82,99.45
2022-11-20,Uttar Pradesh,1075,12,1072,13523,4795,3734,7.95,0,248.0,889382,7295,884515,1.93,1.51,0.05452822580645161,0.82,99.45
2022-11-21,Uttar Pradesh,193,0,193,2918,4931,2843,6.61,0,248.0,889575,7295,884708,1.99,1.15,0.011766129032258064,0.82,99.45
2022-11-22,Uttar Pradesh,356,1,348,4257,1028,77,8.36,7,248.0,889931,7296,885056,0.41,0.03,0.01716532258064516,0.82,99.45
2022-11-23,Uttar Pradesh,528,6,520,6461,1304,218,8.17,2,248.0,890459,7302,885576,0.53,0.09,0.02605241935483871,0.82,99.45
2022-11-24,Uttar Pradesh,827,9,824,10676,2038,1720,7.75,0,248.0,891286,7311,886400,0.82,0.69,0.04304838709677419,0.82,99.45
2022-11-25,Uttar Pradesh,113,1,106,1497,2722,649,7.55,6,248.0,891399,7312,886506,1.1,0.26,0.006036290322580645,0.82,99.45
2022-11-26,Uttar Pradesh,1309,14,1307,15887,362,9,8.24,0,248.0,892708,7326,887813,0.15,0.0,0.06406048387096774,0.82,99.45
2022-11-27,Uttar Pradesh,1575,23,1573,19028,278,256,8.28,0,248.0,894283,7349,889386,0.11,0.1,0.07672580645161291,0.82,99.45
2022-11-28,Uttar Pradesh,335,3,326,4199,1807,24,7.98,6,248.0,894618,7352,889712,0.73,0.01,0.016931451612903225,0.82,99.45
2022-11-29,Uttar Pradesh,650,6,644,7808,1841,712,8.32,0,248.0,895268,7358,890356,0.74,0.29,0.03148387096774193,0.82,99.45
2022-11-30,Uttar Pradesh,1189,14,1185,15053,4809,1852,7.9,0,248.0,896457,7372,891541,1.94,0.75,0.06069758064516129,0.82,99.45
2022-12-01,Uttar Pradesh,63,0,61,670,2834,1945,9.4,2,248.0,896520,7372,891602,1.14,0.78,0.0027016129032258066,0.82,99.45
2022-12-02,Uttar Pradesh,1212,12,1210,15031,2958,496,8.06,0,248.0,897732,7384,892812,1.19,0.2,0.06060887096774194,0.82,99.45
2022-12-03,Uttar Pradesh,322,4,320,3543,3059,567,9.09,0,248.0,898054,7388,893132,1.23,0.23,0.014286290322580645,0.82,99.45
2022-12-04,Uttar Pradesh,671,7,671,8455,822,161,7.94,0,248.0,898725,7395,893803,0.33,0.06,0.034092741935483874,0.82,99.45
2022-12-05,Uttar Pradesh,514,5,509,6434,524,167,7.99,0,248.0,899239,7400,894312,0.21,0.07,0.025943548387096775,0.82,99.45
2022-12-06,Uttar Pradesh,1308,13,1303,15792,337,100,8.28,0,248.0,900547,7413,895615,0.14,0.04,0.06367741935483871,0.82,99.45
2022-12-07,Uttar Pradesh,50,0,46,987,395,255,5.07,4,248.0,900597,7413,895661,0.16,0.1,0.0039798387096774196,0.82,99.45
2022-12-08,Uttar Pradesh,1570,10,1570,19445,1271,1186,8.07,0,248.0,902167,7423,897231,0.51,0.48,0.07840725806451612,0.82,99.45
2022-12-09,Uttar Pradesh,994,4,988,12068,4674,2572,8.24,2,248.0,903161,7427,898219,1.88,1.04,0.048661290322580646,0.82,99.45
2022-12-10,Uttar Pradesh,1593,20,1586,19706,2884,1116,8.08,0,248.0,904754,7447,899805,1.16,0.45,0.07945967741935483,0.82,99.45
2022-12-11,Uttar Pradesh,1523,10,1523,19065,882,46,7.99,0,248.0,906277,7457,901328,0.36,0.02,0.076875,0.82,99.45
2022-12-12,Uttar Pradesh,978,8,972,12252,1616,195,7.98,0,248.0,907255,7465,902300,0.65,0.08,0.049403225806451616,0.82,99.45
2022-12-13,Uttar Pradesh,344,1,342,4082,3571,3507,8.43,1,248.0,907599,7466,902642,1.44,1.41,0.016459677419354838,0.82,99.45
2022-12-14,Uttar Pradesh,520,5,519,6580,2552,2044,7.9,0,248.0,908119,7471,903161,1.03,0.82,0.026532258064516128,0.82,99.45
2022-12-15,Uttar Pradesh,1018,5,1015,12685,2425,1560,8.03,0,248.0,909137,7476,904176,0.98,0.63,0.051149193548387095,0.82,99.45
2022-12-16,Uttar Pradesh,1430,13,1423,18122,924,176,7.89,0,248.0,910567,7489,905599,0.37,0.07,0.07307258064516128,0.82,99.45
2022-12-17,Uttar Pradesh,190,1,183,2353,3233,1372,8.07,6,248.0,910757,7490,905782,1.3,0.55,0.009487903225806452,0.82,99.45
2022-12-18,Uttar Pradesh,460,5,453,5847,643,580,7.87,2,248.0,911217,7495,906235,0.26,0.23,0.023576612903225807,0.82,99.45
2022-12-19,Uttar Pradesh,1546,19,1538,19363,1679,670,7.98,0,248.0,912763,7514,907773,0.68,0.27,0.0780766129032258,0.82,99.45
2022-12-20,Uttar Pradesh,1281,4,1275,15867,401,369,8.07,2,248.0,914044,7518,909048,0.16,0.15,0.06397983870967743,0.82,99.45
2022-12-21,Uttar Pradesh,1037,14,1037,12925,485,143,8.02,0,248.0,915081,7532,910085,0.2,0.06,0.05211693548387097,0.82,99.45
2022-12-22,Uttar Pradesh,687,4,687,8501,1990,1458,8.08,0,248.0,915768,7536,910772,0.8,0.59,0.034278225806451616,0.82,99.45
2022-12-23,Uttar Pradesh,1378,7,1375,17314,1068,976,7.96,0,248.0,917146,7543,912147,0.43,0.39,0.06981451612903226,0.82,99.45
2022-12-24,Uttar Pradesh,368,4,367,4828,417,45,7.62,0,248.0,917514,7547,912514,0.17,0.02,0.01946774193548387,0.82,99.46
2022-12-25,Uttar Pradesh,159,1,158,2367,4144,4001,6.72,0,248.0,917673,7548,912672,1.67,1.61,0.009544354838709678,0.82,99.46
2022-12-26,Uttar Pradesh,425,2,420,5513,2001,5,7.71,3,248.0,918098,7550,913092,0.81,0.0,0.02222983870967742,0.82,99.45
2022-12-27,Uttar Pradesh,1541,9,1539,19125,299,41,8.06,0,248.0,919639,7559,914631,0.12,0.02,0.07711693548387097,0.82,99.46
2022-12-28,Uttar Pradesh,1097,11,1092,13763,3397,1218,7.97,0,248.0,920736,7570,915723,1.37,0.49,0.055495967741935485,0.82,99.46
2022-12-29,Uttar Pradesh,384,3,382,4733,1734,825,8.11,0,248.0,921120,7573,916105,0.7,0.33,0.01908467741935484,0.82,99.46
2022-12-30,Uttar Pradesh,1378,14,1373,17152,2290,2159,8.03,0,248.0,922498,7587,917478,0.92,0.87,0.06916129032258064,0.82,99.46
2022-12-31,Uttar Pradesh,1569,11,1566,19349,754,24,8.11,0,248.0,924067,7598,919044,0.3,0.01,0.07802016129032258,0.82,99.46
2020-01-01,Uttarakhand,293,4,284,3647,563,473,8.03,5,12.5,293,4,284,4.5,3.78,0.29176,1.37,96.93
2020-01-02,Uttarakhand,1266,11,1265,16135,4464,2967,7.85,0,12.5,1559,15,1549,35.71,23.74,1.2908,0.96,99.36
2020-01-03,Uttarakhand,1231,8,1230,15218,4384,1258,8.09,0,12.5,2790,23,2779,35.07,10.06,1.21744,0.82,99.61
2020-01-04,Uttarakhand,1180,17,1172,14895,2958,630,7.92,0,12.5,3970,40,3951,23.66,5.04,1.1916,1.01,99.52
2020-01-05,Uttarakhand,450,4,447,5623,3049,1123,8.0,0,12.5,4420,44,4398,24.39,8.98,0.44984,1.0,99.5
2020-01-06,Uttarakhand,76,0,70,733,345,81,10.37,6,12.5,4496,44,4468,2.76,0.65,0.05864,0.98,99.38
2020-01-07,Uttarakhand,1134,12,1126,14043,4108,333,8.08,0,12.5,5630,56,5594,32.86,2.66,1.12344,0.99,99.36
2020-01-08,Uttarakhand,551,6,542,6923,2934,1338,7.96,3,12.5,6181,62,6136,23.47,10.7,0.55384,1.0,99.27
2020-01-09,Uttarakhand,775,6,767,9562,2730,1523,8.1,2,12.5,6956,68,6903,21.84,12.18,0.76496,0.98,99.24
2020-01-10,Uttarakhand,295,1,289,3351,2217,1648,8.8,5,12.5,7251,69,7192,17.74,13.18,0.26808,0.95,99.19
2020-01-11,Uttarakhand,1556,14,1549,19321,1188,429,8.05,0,12.5,8807,83,8741,9.5,3.43,1.54568,0.94,99.25
2020-01-12,Uttarakhand,537,2,534,6665,701,503,8.06,1,12.5,9344,85,9275,5.61,4.02,0.5332,0.91,99.26
2020-01-13,Uttarakhand,1034,5,1031,12985,2038,1082,7.96,0,12.5,10378,90,10306,16.3,8.66,1.0388,0.87,99.31
2020-01-14,Uttarakhand,432,3,424,5510,3224,1095,7.84,5,12.5,10810,93,10730,25.79,8.76,0.4408,0.86,99.26
2020-01-15,Uttarakhand,294,2,287,3621,2755,1687,8.12,5,12.5,11104,95,11017,22.04,13.5,0.28968,0.86,99.22
2020-01-16,Uttarakhand,1194,12,1190,14469,4348,3513,8.25,0,12.5,12298,107,12207,34.78,28.1,1.15752,0.87,99.26
2020-01-17,Uttarakhand,993,12,989,12561,3075,776,7.91,0,12.5,13291,119,13196,24.6,6.21,1.00488,0.9,99.29
2020-01-18,Uttarakhand,1167,10,1166,14644,4330,1203,7.97,0,12.5,14458,129,14362,34.64,9.62,1.17152,0.89,99.34
2020-01-19,Uttarakhand,886,10,884,11274,876,73,7.86,0,12.5,15344,139,15246,7.01,0.58,0.90192,0.91,99.36
2020-01-20,Uttarakhand,1295,11,1287,16215,4139,3810,7.99,0,12.5,16639,150,16533,33.11,30.48,1.2972,0.9,99.36
2020-01-21,Uttarakhand,77,0,75,1149,809,722,6.7,2,12.5,16716,150,16608,6.47,5.78,0.09192,0.9,99.35
2020-01-22,Uttarakhand,1405,11,1398,17397,2210,45,8.08,0,12.5,18121,161,18006,17.68,0.36,1.39176,0.89,99.37
2020-01-23,Uttarakhand,1459,15,1455,18470,1256,632,7.9,0,12.5,19580,176,19461,10.05,5.06,1.4776,0.9,99.39
2020-01-24,Uttarakhand,1081,15,1077,13503,334,154,8.01,0,12.5,20661,191,20538,2.67,1.23,1.08024,0.92,99.4
2020-01-25,Uttarakhand,1452,11,1450,17889,1529,472,8.12,0,12.5,22113,202,21988,12.23,3.78,1.43112,0.91,99.43
2020-01-26,Uttarakhand,1242,8,1234,15500,4269,3609,8.01,0,12.5,23355,210,23222,34.15,28.87,1.24,0.9,99.43
2020-01-27,Uttarakhand,1066,3,1060,13619,2938,418,7.83,3,12.5,24421,213,24282,23.5,3.34,1.08952,0.87,99.43
2020-01-28,Uttarakhand,789,3,782,9854,734,247,8.01,4,12.5,25210,216,25064,5.87,1.98,0.78832,0.86,99.42
2020-01-29,Uttarakhand,1012,8,1006,12957,284,99,7.81,0,12.5,26222,224,26070,2.27,0.79,1.03656,0.85,99.42
2020-01-30,Uttarakhand,603,2,597,7350,2178,512,8.2,4,12.5,26825,226,26667,17.42,4.1,0.588,0.84,99.41
2020-01-31,Uttarakhand,87,0,86,1002,2029,1703,8.68,1,12.5,26912,226,26753,16.23,13.62,0.08016,0.84,99.41
2020-02-01,Uttarakhand,993,11,992,12658,2724,1993,7.84,0,12.5,27905,237,27745,21.79,15.94,1.01264,0.85,99.43
2020-02-02,Uttarakhand,1560,17,1559,19271,3633,3424,8.1,0,12.5,29465,254,29304,29.06,27.39,1.54168,0.86,99.45
2020-02-03,Uttarakhand,1601,10,1596,19904,3810,2751,8.04,0,12.5,31066,264,30900,30.48,22.01,1.59232,0.85,99.47
2020-02-04,Uttarakhand,1090,12,1085,13743,4775,1251,7.93,0,12.5,32156,276,31985,38.2,10.01,1.09944,0.86,99.47
2020-02-05,Uttarakhand,261,3,254,3608,753,48,7.23,4,12.5,32417,279,32239,6.02,0.38,0.28864,0.86,99.45
2020-02-06,Uttarakhand,181,2,179,2441,1918,762,7.41,0,12.5,32598,281,32418,15.34,6.1,0.19528,0.86,99.45
2020-02-07,Uttarakhand,28,0,25,697,814,383,4.02,3,12.5,32626,281,32443,6.51,3.06,0.05576,0.86,99.44
2020-02-08,Uttarakhand,1081,16,1074,13390,3248,1865,8.07,0,12.5,33707,297,33517,25.98,14.92,1.0712,0.88,99.44
2020-02-09,Uttarakhand,1083,9,1078,13391,917,263,8.09,0,12.5,34790,306,34595,7.34,2.1,1.07128,0.88,99.44
2020-02-10,Uttarakhand,1375,17,1374,17318,4979,2113,7.94,0,12.5,36165,323,35969,39.83,16.9,1.38544,0.89,99.46
2020-02-11,Uttarakhand,309,4,300,3883,2493,2299,7.96,5,12.5,36474,327,36269,19.94,18.39,0.31064,0.9,99.44
2020-02-12,Uttarakhand,1148,6,1143,14419,2068,533,7.96,0,12.5,37622,333,37412,16.54,4.26,1.15352,0.89,99.44
2020-02-13,Uttarakhand,367,2,359,4114,3722,2103,8.92,6,12.5,37989,335,37771,29.78,16.82,0.32912,0.88,99.43
2020-02-14,Uttarakhand,706,6,706,8905,3421,278,7.93,0,12.5,38695,341,38477,27.37,2.22,0.7124,0.88,99.44
2020-02-15,Uttarakhand,1381,20,1380,17487,3409,1802,7.9,0,12.5,40076,361,39857,27.27,14.42,1.39896,0.9,99.45
2020-02-16,Uttarakhand,1220,9,1215,15343,2637,2607,7.95,0,12.5,41296,370,41072,21.1,20.86,1.22744,0.9,99.46
2020-02-17,Uttarakhand,1429,17,1422,18304,40,23,7.81,0,12.5,42725,387,42494,0.32,0.18,1.46432,0.91,99.46
2020-02-18,Uttarakhand,1503,17,1501,18373,3874,2458,8.18,0,12.5,44228,404,43995,30.99,19.66,1.46984,0.91,99.47
2020-02-19,Uttarakhand,468,2,459,5575,4052,2142,8.39,7,12.5,44696,406,44454,32.42,17.14,0.446,0.91,99.46
2020-02-20,Uttarakhand,829,7,823,10431,1876,1424,7.95,0,12.5,45525,413,45277,15.01,11.39,0.83448,0.91,99.46
2020-02-21,Uttarakhand,396,2,394,5136,739,652,7.71,0,12.5,45921,415,45671,5.91,5.22,0.41088,0.9,99.46
2020-02-22,Uttarakhand,966,4,960,12071,55,16,8.0,2,12.5,46887,419,46631,0.44,0.13,0.96568,0.89,99.45
2020-02-23,Uttarakhand,58,0,51,860,424,35,6.74,7,12.5,46945,419,46682,3.39,0.28,0.0688,0.89,99.44
2020-02-24,Uttarakhand,609,6,609,8026,1159,233,7.59,0,12.5,47554,425,47291,9.27,1.86,0.64208,0.89,99.45
2020-02-25,Uttarakhand,620,3,615,7794,2832,2412,7.95,2,12.5,48174,428,47906,22.66,19.3,0.62352,0.89,99.44
2020-02-26,Uttarakhand,777,7,774,9475,4745,74,8.2,0,12.5,48951,435,48680,37.96,0.59,0.758,0.89,99.45
2020-02-27,Uttarakhand,174,1,171,2047,808,320,8.5,2,12.5,49125,436,48851,6.46,2.56,0.16376,0.89,99.44
2020-02-28,Uttarakhand,565,3,559,6835,2548,804,8.27,3,12.5,49690,439,49410,20.38,6.43,0.5468,0.88,99.44
2020-02-29,Uttarakhand,1246,12,1244,15703,145,83,7.93,0,12.5,50936,451,50654,1.16,0.66,1.25624,0.89,99.45
2020-03-01,Uttarakhand,1176,3,1176,14323,2513,2428,8.21,0,12.5,52112,454,51830,20.1,19.42,1.14584,0.87,99.46
2020-03-02,Uttarakhand,96,1,89,901,1535,739,10.65,6,12.5,52208,455,51919,12.28,5.91,0.07208,0.87,99.45
2020-03-03,Uttarakhand,1253,5,1247,15770,3501,301,7.95,1,12.5,53461,460,53166,28.01,2.41,1.2616,0.86,99.45
2020-03-04,Uttarakhand,447,3,441,5733,4860,1212,7.8,3,12.5,53908,463,53607,38.88,9.7,0.45864,0.86,99.44
2020-03-05,Uttarakhand,102,1,96,1105,3045,1860,9.23,5,12.5,54010,464,53703,24.36,14.88,0.0884,0.86,99.43
2020-03-06,Uttarakhand,1605,14,1598,19955,512,264,8.04,0,12.5,55615,478,55301,4.1,2.11,1.5964,0.86,99.44
2020-03-07,Uttarakhand,538,5,536,6770,3591,2418,7.95,0,12.5,56153,483,55837,28.73,19.34,0.5416,0.86,99.44
2020-03-08,Uttarakhand,547,4,540,6894,2616,1211,7.93,3,12.5,56700,487,56377,20.93,9.69,0.55152,0.86,99.43
2020-03-09,Uttarakhand,1274,15,1266,16322,3955,2161,7.81,0,12.5,57974,502,57643,31.64,17.29,1.30576,0.87,99.43
2020-03-10,Uttarakhand,556,6,547,7057,4066,3573,7.88,3,12.5,58530,508,58190,32.53,28.58,0.56456,0.87,99.42
2020-03-11,Uttarakhand,260,3,259,3475,3786,2756,7.48,0,12.5,58790,511,58449,30.29,22.05,0.278,0.87,99.42
2020-03-12,Uttarakhand,1143,4,1138,14422,61,25,7.93,1,12.5,59933,515,59587,0.49,0.2,1.15376,0.86,99.42
2020-03-13,Uttarakhand,789,9,784,9723,280,79,8.11,0,12.5,60722,524,60371,2.24,0.63,0.77784,0.86,99.42
2020-03-14,Uttarakhand,372,1,370,4989,2691,23,7.46,1,12.5,61094,525,60741,21.53,0.18,0.39912,0.86,99.42
2020-03-15,Uttarakhand,1312,17,1304,16464,950,91,7.97,0,12.5,62406,542,62045,7.6,0.73,1.31712,0.87,99.42
2020-03-16,Uttarakhand,1390,16,1381,17444,4849,3130,7.97,0,12.5,63796,558,63426,38.79,25.04,1.39552,0.87,99.42
2020-03-17,Uttarakhand,1580,14,1577,19774,2569,333,7.99,0,12.5,65376,572,65003,20.55,2.66,1.58192,0.87,99.43
2020-03-18,Uttarakhand,1242,14,1235,15441,4099,751,8.04,0,12.5,66618,586,66238,32.79,6.01,1.23528,0.88,99.43
2020-03-19,Uttarakhand,519,7,518,6661,3903,1328,7.79,0,12.5,67137,593,66756,31.22,10.62,0.53288,0.88,99.43
2020-03-20,Uttarakhand,120,1,116,1180,41,22,10.17,3,12.5,67257,594,66872,0.33,0.18,0.0944,0.88,99.43
2020-03-21,Uttarakhand,978,6,977,12054,3870,2510,8.11,0,12.5,68235,600,67849,30.96,20.08,0.96432,0.88,99.43
2020-03-22,Uttarakhand,1390,17,1390,17322,778,453,8.02,0,12.5,69625,617,69239,6.22,3.62,1.38576,0.89,99.45
2020-03-23,Uttarakhand,489,6,487,6423,1999,958,7.61,0,12.5,70114,623,69726,15.99,7.66,0.51384,0.89,99.45
2020-03-24,Uttarakhand,1411,8,1411,17591,1631,23,8.02,0,12.5,71525,631,71137,13.05,0.18,1.40728,0.88,99.46
2020-03-25,Uttarakhand,535,6,532,6638,4244,3412,8.06,0,12.5,72060,637,71669,33.95,27.3,0.53104,0.88,99.46
2020-03-26,Uttarakhand,1127,3,1124,14125,613,214,7.98,0,12.5,73187,640,72793,4.9,1.71,1.13,0.87,99.46
2020-03-27,Uttarakhand,1142,7,1140,14307,3838,708,7.98,0,12.5,74329,647,73933,30.7,5.66,1.14456,0.87,99.47
2020-03-28,Uttarakhand,1321,11,1317,16886,516,82,7.82,0,12.5,75650,658,75250,4.13,0.66,1.35088,0.87,99.47
2020-03-29,Uttarakhand,227,0,226,2554,4897,1463,8.89,1,12.5,75877,658,75476,39.18,11.7,0.20432,0.87,99.47
2020-03-30,Uttarakhand,502,5,501,6512,885,245,7.71,0,12.5,76379,663,75977,7.08,1.96,0.52096,0.87,99.47
2020-03-31,Uttarakhand,16,0,10,601,635,190,2.66,6,12.5,76395,663,75987,5.08,1.52,0.04808,0.87,99.47
2020-04-01,Uttarakhand,1025,3,1021,12831,664,271,7.99,1,12.5,77420,666,77008,5.31,2.17,1.02648,0.86,99.47
2020-04-02,Uttarakhand,746,10,740,9314,454,54,8.01,0,12.5,78166,676,77748,3.63,0.43,0.74512,0.86,99.47
2020-04-03,Uttarakhand,584,6,582,7489,4386,244,7.8,0,12.5,78750,682,78330,35.09,1.95,0.59912,0.87,99.47
2020-04-04,Uttarakhand,691,5,688,8893,1993,82,7.77,0,12.5,79441,687,79018,15.94,0.66,0.71144,0.86,99.47
2020-04-05,Uttarakhand,364,2,359,4721,1487,207,7.71,3,12.5,79805,689,79377,11.9,1.66,0.37768,0.86,99.46
2020-04-06,Uttarakhand,545,4,543,6958,2881,2384,7.83,0,12.5,80350,693,79920,23.05,19.07,0.55664,0.86,99.46
2020-04-07,Uttarakhand,1600,6,1598,19717,1622,1493,8.11,0,12.5,81950,699,81518,12.98,11.94,1.57736,0.85,99.47
2020-04-08,Uttarakhand,591,5,582,7482,222,139,7.9,4,12.5,82541,704,82100,1.78,1.11,0.59856,0.85,99.47
2020-04-09,Uttarakhand,134,1,125,1940,2109,901,6.91,8,12.5,82675,705,82225,16.87,7.21,0.1552,0.85,99.46
2020-04-10,Uttarakhand,1271,6,1268,15648,4553,3845,8.12,0,12.5,83946,711,83493,36.42,30.76,1.25184,0.85,99.46
2020-04-11,Uttarakhand,180,1,177,2100,3281,2563,8.57,2,12.5,84126,712,83670,26.25,20.5,0.168,0.85,99.46
2020-04-12,Uttarakhand,1031,7,1029,12574,502,63,8.2,0,12.5,85157,719,84699,4.02,0.5,1.00592,0.84,99.46
2020-04-13,Uttarakhand,1422,20,1419,17217,4988,3351,8.26,0,12.5,86579,739,86118,39.9,26.81,1.37736,0.85,99.47
2020-04-14,Uttarakhand,1092,14,1086,13234,1387,1146,8.25,0,12.5,87671,753,87204,11.1,9.17,1.05872,0.86,99.47
2020-04-15,Uttarakhand,1487,11,1484,18528,4756,2886,8.03,0,12.5,89158,764,88688,38.05,23.09,1.48224,0.86,99.47
2020-04-16,Uttarakhand,1247,8,1244,15623,4964,2344,7.98,0,12.5,90405,772,89932,39.71,18.75,1.24984,0.85,99.48
2020-04-17,Uttarakhand,1025,7,1018,12578,1461,0,8.15,0,12.5,91430,779,90950,11.69,0.0,1.00624,0.85,99.48
2020-04-18,Uttarakhand,1511,12,1510,18910,1398,192,7.99,0,12.5,92941,791,92460,11.18,1.54,1.5128,0.85,99.48
2020-04-19,Uttarakhand,939,12,932,11900,1607,474,7.89,0,12.5,93880,803,93392,12.86,3.79,0.952,0.86,99.48
2020-04-20,Uttarakhand,1101,4,1098,14173,2566,1600,7.77,0,12.5,94981,807,94490,20.53,12.8,1.13384,0.85,99.48
2020-04-21,Uttarakhand,374,1,365,4381,128,9,8.54,8,12.5,95355,808,94855,1.02,0.07,0.35048,0.85,99.48
2020-04-22,Uttarakhand,764,8,758,9773,1758,207,7.82,0,12.5,96119,816,95613,14.06,1.66,0.78184,0.85,99.47
2020-04-23,Uttarakhand,1048,13,1039,13353,4899,4698,7.85,0,12.5,97167,829,96652,39.19,37.58,1.06824,0.85,99.47
2020-04-24,Uttarakhand,582,7,577,7200,2246,1736,8.08,0,12.5,97749,836,97229,17.97,13.89,0.576,0.86,99.47
2020-04-25,Uttarakhand,1114,9,1109,14224,4289,1662,7.83,0,12.5,98863,845,98338,34.31,13.3,1.13792,0.85,99.47
2020-04-26,Uttarakhand,900,6,893,11007,2552,1066,8.18,1,12.5,99763,851,99231,20.42,8.53,0.88056,0.85,99.47
2020-04-27,Uttarakhand,1299,11,1296,16310,782,733,7.96,0,12.5,101062,862,100527,6.26,5.86,1.3048,0.85,99.47
2020-04-28,Uttarakhand,1129,6,1129,14033,3862,2258,8.05,0,12.5,102191,868,101656,30.9,18.06,1.12264,0.85,99.48
2020-04-29,Uttarakhand,913,8,913,10973,1022,75,8.32,0,12.5,103104,876,102569,8.18,0.6,0.87784,0.85,99.48
2020-04-30,Uttarakhand,526,1,523,6763,3525,1827,7.78,2,12.5,103630,877,103092,28.2,14.62,0.54104,0.85,99.48
2020-05-01,Uttarakhand,631,5,628,7920,3273,666,7.97,0,12.5,104261,882,103720,26.18,5.33,0.6336,0.85,99.48
2020-05-02,Uttarakhand,173,1,170,2501,520,509,6.92,2,12.5,104434,883,103890,4.16,4.07,0.20008,0.85,99.48
2020-05-03,Uttarakhand,809,5,808,10446,2959,1281,7.74,0,12.5,105243,888,104698,23.67,10.25,0.83568,0.84,99.48
2020-05-04,Uttarakhand,498,7,493,6462,829,737,7.71,0,12.5,105741,895,105191,6.63,5.9,0.51696,0.85,99.48
2020-05-05,Uttarakhand,1534,18,1528,19348,3916,85,7.93,0,12.5,107275,913,106719,31.33,0.68,1.54784,0.85,99.48
2020-05-06,Uttarakhand,947,13,944,12212,4795,4318,7.75,0,12.5,108222,926,107663,38.36,34.54,0.97696,0.86,99.48
2020-05-07,Uttarakhand,1225,5,1216,15776,2612,920,7.76,4,12.5,109447,931,108879,20.9,7.36,1.26208,0.85,99.48
2020-05-08,Uttarakhand,534,5,528,6972,1748,354,7.66,1,12.5,109981,936,109407,13.98,2.83,0.55776,0.85,99.48
2020-05-09,Uttarakhand,817,4,814,10604,3885,347,7.7,0,12.5,110798,940,110221,31.08,2.78,0.84832,0.85,99.48
2020-05-10,Uttarakhand,1233,9,1233,15293,3389,196,8.06,0,12.5,112031,949,111454,27.11,1.57,1.22344,0.85,99.48
2020-05-11,Uttarakhand,1584,17,1581,19584,1679,478,8.09,0,12.5,113615,966,113035,13.43,3.82,1.56672,0.85,99.49
2020-05-12,Uttarakhand,611,7,609,7595,286,146,8.04,0,12.5,114226,973,113644,2.29,1.17,0.6076,0.85,99.49
2020-05-13,Uttarakhand,1456,6,1451,18114,3517,2248,8.04,0,12.5,115682,979,115095,28.14,17.98,1.44912,0.85,99.49
2020-05-14,Uttarakhand,103,0,102,773,2861,1391,13.32,1,12.5,115785,979,115197,22.89,11.13,0.06184,0.85,99.49
2020-05-15,Uttarakhand,1379,15,1371,17556,3191,171,7.85,0,12.5,117164,994,116568,25.53,1.37,1.40448,0.85,99.49
2020-05-16,Uttarakhand,977,3,971,12061,2337,1932,8.1,3,12.5,118141,997,117539,18.7,15.46,0.96488,0.84,99.49
2020-05-17,Uttarakhand,1409,20,1406,17549,4516,2466,8.03,0,12.5,119550,1017,118945,36.13,19.73,1.40392,0.85,99.49
2020-05-18,Uttarakhand,922,12,921,11329,2198,1108,8.14,0,12.5,120472,1029,119866,17.58,8.86,0.90632,0.85,99.5
2020-05-19,Uttarakhand,284,3,284,3586,2332,1682,7.92,0,12.5,120756,1032,120150,18.66,13.46,0.28688,0.85,99.5
2020-05-20,Uttarakhand,1354,12,1351,17084,1635,393,7.93,0,12.5,122110,1044,121501,13.08,3.14,1.36672,0.85,99.5
2020-05-21,Uttarakhand,1167,14,1167,14648,4974,2783,7.97,0,12.5,123277,1058,122668,39.79,22.26,1.17184,0.86,99.51
2020-05-22,Uttarakhand,1231,4,1225,15445,2773,73,7.97,2,12.5,124508,1062,123893,22.18,0.58,1.2356,0.85,99.51
2020-05-23,Uttarakhand,652,4,643,8287,4295,779,7.87,5,12.5,125160,1066,124536,34.36,6.23,0.66296,0.85,99.5
2020-05-24,Uttarakhand,322,3,315,4381,2524,2222,7.35,4,12.5,125482,1069,124851,20.19,17.78,0.35048,0.85,99.5
2020-05-25,Uttarakhand,682,2,679,8314,546,263,8.2,1,12.5,126164,1071,125530,4.37,2.1,0.66512,0.85,99.5
2020-05-26,Uttarakhand,1231,12,1229,15438,1209,888,7.97,0,12.5,127395,1083,126759,9.67,7.1,1.23504,0.85,99.5
2020-05-27,Uttarakhand,1356,6,1351,16751,1197,188,8.1,0,12.5,128751,1089,128110,9.58,1.5,1.34008,0.85,99.5
2020-05-28,Uttarakhand,156,2,149,2018,446,80,7.73,5,12.5,128907,1091,128259,3.57,0.64,0.16144,0.85,99.5
2020-05-29,Uttarakhand,1534,6,1529,19492,333,198,7.87,0,12.5,130441,1097,129788,2.66,1.58,1.55936,0.84,99.5
2020-05-30,Uttarakhand,820,5,814,10253,350,324,8.0,1,12.5,131261,1102,130602,2.8,2.59,0.82024,0.84,99.5
2020-05-31,Uttarakhand,319,3,315,3695,4218,2581,8.63,1,12.5,131580,1105,130917,33.74,20.65,0.2956,0.84,99.5
2020-06-01,Uttarakhand,1589,8,1586,19342,2849,2827,8.22,0,12.5,133169,1113,132503,22.79,22.62,1.54736,0.84,99.5
2020-06-02,Uttarakhand,736,6,734,8949,2620,1223,8.22,0,12.5,133905,1119,133237,20.96,9.78,0.71592,0.84,99.5
2020-06-03,Uttarakhand,1252,16,1251,15930,2176,293,7.86,0,12.5,135157,1135,134488,17.41,2.34,1.2744,0.84,99.51
2020-06-04,Uttarakhand,1062,6,1057,13370,344,288,7.94,0,12.5,136219,1141,135545,2.75,2.3,1.0696,0.84,99.51
2020-06-05,Uttarakhand,717,8,711,8713,388,235,8.23,0,12.5,136936,1149,136256,3.1,1.88,0.69704,0.84,99.5
2020-06-06,Uttarakhand,1164,10,1157,14332,218,194,8.12,0,12.5,138100,1159,137413,1.74,1.55,1.14656,0.84,99.5
2020-06-07,Uttarakhand,588,5,580,7180,507,18,8.19,3,12.5,138688,1164,137993,4.06,0.14,0.5744,0.84,99.5
2020-06-08,Uttarakhand,1385,9,1378,17278,4177,2030,8.02,0,12.5,140073,1173,139371,33.42,16.24,1.38224,0.84,99.5
2020-06-09,Uttarakhand,1538,14,1531,19535,4245,4058,7.87,0,12.5,141611,1187,140902,33.96,32.46,1.5628,0.84,99.5
2020-06-10,Uttarakhand,1160,11,1159,14371,25,17,8.07,0,12.5,142771,1198,142061,0.2,0.14,1.14968,0.84,99.5
2020-06-11,Uttarakhand,1423,20,1415,17626,451,68,8.07,0,12.5,144194,1218,143476,3.61,0.54,1.41008,0.84,99.5
2020-06-12,Uttarakhand,676,8,669,8371,1459,1249,8.08,0,12.5,144870,1226,144145,11.67,9.99,0.66968,0.85,99.5
2020-06-13,Uttarakhand,349,4,340,4644,3911,1273,7.52,5,12.5,145219,1230,144485,31.29,10.18,0.37152,0.85,99.49
2020-06-14,Uttarakhand,204,2,199,2214,878,163,9.21,3,12.5,145423,1232,144684,7.02,1.3,0.17712,0.85,99.49
2020-06-15,Uttarakhand,795,3,795,9881,3527,3127,8.05,0,12.5,146218,1235,145479,28.22,25.02,0.79048,0.84,99.49
2020-06-16,Uttarakhand,477,6,472,5826,4773,3067,8.19,0,12.5,146695,1241,145951,38.18,24.54,0.46608,0.85,99.49
2020-06-17,Uttarakhand,1055,8,1054,13116,1123,255,8.04,0,12.5,147750,1249,147005,8.98,2.04,1.04928,0.85,99.5
2020-06-18,Uttarakhand,1355,11,1347,16517,436,285,8.2,0,12.5,149105,1260,148352,3.49,2.28,1.32136,0.85,99.49
2020-06-19,Uttarakhand,1482,12,1480,18136,1324,1131,8.17,0,12.5,150587,1272,149832,10.59,9.05,1.45088,0.84,99.5
2020-06-20,Uttarakhand,1348,14,1339,16978,1003,557,7.94,0,12.5,151935,1286,151171,8.02,4.46,1.35824,0.85,99.5
2020-06-21,Uttarakhand,659,5,650,8617,2928,2190,7.65,4,12.5,152594,1291,151821,23.42,17.52,0.68936,0.85,99.49
2020-06-22,Uttarakhand,205,1,203,2410,315,93,8.51,1,12.5,152799,1292,152024,2.52,0.74,0.1928,0.85,99.49
2020-06-23,Uttarakhand,1365,6,1362,16767,575,155,8.14,0,12.5,154164,1298,153386,4.6,1.24,1.34136,0.84,99.5
2020-06-24,Uttarakhand,684,8,678,8728,3591,2525,7.84,0,12.5,154848,1306,154064,28.73,20.2,0.69824,0.84,99.49
2020-06-25,Uttarakhand,1065,5,1056,13312,306,122,8.0,4,12.5,155913,1311,155120,2.45,0.98,1.06496,0.84,99.49
2020-06-26,Uttarakhand,701,8,698,8828,823,544,7.94,0,12.5,156614,1319,155818,6.58,4.35,0.70624,0.84,99.49
2020-06-27,Uttarakhand,972,7,970,12455,2312,1235,7.8,0,12.5,157586,1326,156788,18.5,9.88,0.9964,0.84,99.49
2020-06-28,Uttarakhand,1029,7,1024,13022,2910,1286,7.9,0,12.5,158615,1333,157812,23.28,10.29,1.04176,0.84,99.49
2020-06-29,Uttarakhand,818,6,811,9802,3476,790,8.35,1,12.5,159433,1339,158623,27.81,6.32,0.78416,0.84,99.49
2020-06-30,Uttarakhand,1079,9,1077,13783,239,174,7.83,0,12.5,160512,1348,159700,1.91,1.39,1.10264,0.84,99.49
2020-07-01,Uttarakhand,1472,11,1470,18165,3458,766,8.1,0,12.5,161984,1359,161170,27.66,6.13,1.4532,0.84,99.5
2020-07-02,Uttarakhand,1420,17,1417,17504,4298,1894,8.11,0,12.5,163404,1376,162587,34.38,15.15,1.40032,0.84,99.5
2020-07-03,Uttarakhand,1382,16,1377,17244,2086,129,8.01,0,12.5,164786,1392,163964,16.69,1.03,1.37952,0.84,99.5
2020-07-04,Uttarakhand,1114,14,1110,13880,545,62,8.03,0,12.5,165900,1406,165074,4.36,0.5,1.1104,0.85,99.5
2020-07-05,Uttarakhand,1143,11,1138,14259,3050,3040,8.02,0,12.5,167043,1417,166212,24.4,24.32,1.14072,0.85,99.5
2020-07-06,Uttarakhand,648,3,647,7584,4793,2031,8.54,0,12.5,167691,1420,166859,38.34,16.25,0.60672,0.85,99.5
2020-07-07,Uttarakhand,537,3,531,6287,1053,678,8.54,3,12.5,168228,1423,167390,8.42,5.42,0.50296,0.85,99.5
2020-07-08,Uttarakhand,299,1,293,4161,3737,2819,7.19,5,12.5,168527,1424,167683,29.9,22.55,0.33288,0.84,99.5
2020-07-09,Uttarakhand,39,0,30,618,3979,1436,6.31,9,12.5,168566,1424,167713,31.83,11.49,0.04944,0.84,99.49
2020-07-10,Uttarakhand,171,0,170,2128,2765,1840,8.04,1,12.5,168737,1424,167883,22.12,14.72,0.17024,0.84,99.49
2020-07-11,Uttarakhand,1174,8,1165,14547,2999,1185,8.07,1,12.5,169911,1432,169048,23.99,9.48,1.16376,0.84,99.49
2020-07-12,Uttarakhand,580,5,579,6877,1694,487,8.43,0,12.5,170491,1437,169627,13.55,3.9,0.55016,0.84,99.49
2020-07-13,Uttarakhand,1235,10,1233,15232,2038,1050,8.11,0,12.5,171726,1447,170860,16.3,8.4,1.21856,0.84,99.5
2020-07-14,Uttarakhand,1392,15,1392,16751,4072,2717,8.31,0,12.5,173118,1462,172252,32.58,21.74,1.34008,0.84,99.5
2020-07-15,Uttarakhand,1095,11,1094,13527,528,13,8.09,0,12.5,174213,1473,173346,4.22,0.1,1.08216,0.85,99.5
2020-07-16,Uttarakhand,976,5,974,11795,3310,2277,8.27,0,12.5,175189,1478,174320,26.48,18.22,0.9436,0.84,99.5
2020-07-17,Uttarakhand,115,0,107,1195,4555,1012,9.62,8,12.5,175304,1478,174427,36.44,8.1,0.0956,0.84,99.5
2020-07-18,Uttarakhand,1181,11,1176,14647,3640,963,8.06,0,12.5,176485,1489,175603,29.12,7.7,1.17176,0.84,99.5
2020-07-19,Uttarakhand,1416,10,1413,17302,1145,885,8.18,0,12.5,177901,1499,177016,9.16,7.08,1.38416,0.84,99.5
2020-07-20,Uttarakhand,1237,11,1235,15443,1864,1466,8.01,0,12.5,179138,1510,178251,14.91,11.73,1.23544,0.84,99.5
2020-07-21,Uttarakhand,1296,5,1288,15877,3102,2640,8.16,3,12.5,180434,1515,179539,24.82,21.12,1.27016,0.84,99.5
2020-07-22,Uttarakhand,1541,15,1540,18793,4474,2039,8.2,0,12.5,181975,1530,181079,35.79,16.31,1.50344,0.84,99.51
2020-07-23,Uttarakhand,768,3,765,9544,4569,4250,8.05,0,12.5,182743,1533,181844,36.55,34.0,0.76352,0.84,99.51
2020-07-24,Uttarakhand,203,1,199,2577,2067,1918,7.88,3,12.5,182946,1534,182043,16.54,15.34,0.20616,0.84,99.51
2020-07-25,Uttarakhand,758,10,751,9426,1256,383,8.04,0,12.5,183704,1544,182794,10.05,3.06,0.75408,0.84,99.5
2020-07-26,Uttarakhand,608,4,603,7695,139,137,7.9,1,12.5,184312,1548,183397,1.11,1.1,0.6156,0.84,99.5
2020-07-27,Uttarakhand,1240,12,1235,15127,1813,295,8.2,0,12.5,185552,1560,184632,14.5,2.36,1.21016,0.84,99.5
2020-07-28,Uttarakhand,599,7,598,7711,2003,357,7.77,0,12.5,186151,1567,185230,16.02,2.86,0.61688,0.84,99.51
2020-07-29,Uttarakhand,748,4,746,9332,3356,915,8.02,0,12.5,186899,1571,185976,26.85,7.32,0.74656,0.84,99.51
2020-07-30,Uttarakhand,716,9,708,9080,4161,2806,7.89,0,12.5,187615,1580,186684,33.29,22.45,0.7264,0.84,99.5
2020-07-31,Uttarakhand,101,0,95,827,2765,1414,12.21,6,12.5,187716,1580,186779,22.12,11.31,0.06616,0.84,99.5
2020-08-01,Uttarakhand,414,4,410,5469,3816,929,7.57,0,12.5,188130,1584,187189,30.53,7.43,0.43752,0.84,99.5
2020-08-02,Uttarakhand,577,1,575,6966,2032,671,8.28,1,12.5,188707,1585,187764,16.26,5.37,0.55728,0.84,99.5
2020-08-03,Uttarakhand,862,8,860,10473,3527,1613,8.23,0,12.5,189569,1593,188624,28.22,12.9,0.83784,0.84,99.5
2020-08-04,Uttarakhand,737,3,736,9263,178,134,7.96,0,12.5,190306,1596,189360,1.42,1.07,0.74104,0.84,99.5
2020-08-05,Uttarakhand,1402,17,1398,17268,1886,1422,8.12,0,12.5,191708,1613,190758,15.09,11.38,1.38144,0.84,99.5
2020-08-06,Uttarakhand,1412,19,1406,17477,3107,292,8.08,0,12.5,193120,1632,192164,24.86,2.34,1.39816,0.85,99.5
2020-08-07,Uttarakhand,817,7,814,10131,2882,1173,8.06,0,12.5,193937,1639,192978,23.06,9.38,0.81048,0.85,99.51
2020-08-08,Uttarakhand,1193,6,1187,14804,4698,4419,8.06,0,12.5,195130,1645,194165,37.58,35.35,1.18432,0.84,99.51
2020-08-09,Uttarakhand,836,2,830,10695,3696,799,7.82,4,12.5,195966,1647,194995,29.57,6.39,0.8556,0.84,99.5
2020-08-10,Uttarakhand,596,7,593,7311,3255,2198,8.15,0,12.5,196562,1654,195588,26.04,17.58,0.58488,0.84,99.5
2020-08-11,Uttarakhand,813,10,813,10160,2639,1018,8.0,0,12.5,197375,1664,196401,21.11,8.14,0.8128,0.84,99.51
2020-08-12,Uttarakhand,1440,4,1432,18308,4941,4367,7.87,4,12.5,198815,1668,197833,39.53,34.94,1.46464,0.84,99.51
2020-08-13,Uttarakhand,885,9,885,11122,1949,671,7.96,0,12.5,199700,1677,198718,15.59,5.37,0.88976,0.84,99.51
2020-08-14,Uttarakhand,1051,7,1051,13416,4239,2411,7.83,0,12.5,200751,1684,199769,33.91,19.29,1.07328,0.84,99.51
2020-08-15,Uttarakhand,217,2,212,2730,2670,2638,7.95,3,12.5,200968,1686,199981,21.36,21.1,0.2184,0.84,99.51
2020-08-16,Uttarakhand,1040,7,1036,13217,3684,788,7.87,0,12.5,202008,1693,201017,29.47,6.3,1.05736,0.84,99.51
2020-08-17,Uttarakhand,284,3,280,3533,4368,915,8.04,1,12.5,202292,1696,201297,34.94,7.32,0.28264,0.84,99.51
2020-08-18,Uttarakhand,1027,7,1023,12624,38,37,8.14,0,12.5,203319,1703,202320,0.3,0.3,1.00992,0.84,99.51
2020-08-19,Uttarakhand,316,2,315,4017,2601,1591,7.87,0,12.5,203635,1705,202635,20.81,12.73,0.32136,0.84,99.51
2020-08-20,Uttarakhand,78,0,75,626,1575,552,12.46,3,12.5,203713,1705,202710,12.6,4.42,0.05008,0.84,99.51
2020-08-21,Uttarakhand,1129,11,1122,13914,522,52,8.11,0,12.5,204842,1716,203832,4.18,0.42,1.11312,0.84,99.51
2020-08-22,Uttarakhand,1080,11,1071,13120,2098,1892,8.23,0,12.5,205922,1727,204903,16.78,15.14,1.0496,0.84,99.51
2020-08-23,Uttarakhand,437,2,428,5380,117,16,8.12,7,12.5,206359,1729,205331,0.94,0.13,0.4304,0.84,99.5
2020-08-24,Uttarakhand,1056,15,1052,13228,790,725,7.98,0,12.5,207415,1744,206383,6.32,5.8,1.05824,0.84,99.5
2020-08-25,Uttarakhand,1483,7,1477,18034,3461,3065,8.22,0,12.5,208898,1751,207860,27.69,24.52,1.44272,0.84,99.5
2020-08-26,Uttarakhand,1260,9,1257,15612,2930,956,8.07,0,12.5,210158,1760,209117,23.44,7.65,1.24896,0.84,99.5
2020-08-27,Uttarakhand,1267,16,1266,15781,1359,523,8.03,0,12.5,211425,1776,210383,10.87,4.18,1.26248,0.84,99.51
2020-08-28,Uttarakhand,1242,15,1240,15410,658,65,8.06,0,12.5,212667,1791,211623,5.26,0.52,1.2328,0.84,99.51
2020-08-29,Uttarakhand,450,2,448,5281,418,128,8.52,0,12.5,213117,1793,212071,3.34,1.02,0.42248,0.84,99.51
2020-08-30,Uttarakhand,793,4,787,9650,2240,1559,8.22,2,12.5,213910,1797,212858,17.92,12.47,0.772,0.84,99.51
2020-08-31,Uttarakhand,10,0,6,612,2588,1816,1.63,4,12.5,213920,1797,212864,20.7,14.53,0.04896,0.84,99.51
2020-09-01,Uttarakhand,1337,7,1332,16998,4984,4049,7.87,0,12.5,215257,1804,214196,39.87,32.39,1.35984,0.84,99.51
2020-09-02,Uttarakhand,1458,16,1453,18230,1703,1159,8.0,0,12.5,216715,1820,215649,13.62,9.27,1.4584,0.84,99.51
2020-09-03,Uttarakhand,741,7,734,8703,1207,1057,8.51,0,12.5,217456,1827,216383,9.66,8.46,0.69624,0.84,99.51
2020-09-04,Uttarakhand,1276,17,1267,15892,1687,936,8.03,0,12.5,218732,1844,217650,13.5,7.49,1.27136,0.84,99.51
2020-09-05,Uttarakhand,1479,19,1477,18425,2480,1732,8.03,0,12.5,220211,1863,219127,19.84,13.86,1.474,0.85,99.51
2020-09-06,Uttarakhand,1440,14,1435,17931,1911,1402,8.03,0,12.5,221651,1877,220562,15.29,11.22,1.43448,0.85,99.51
2020-09-07,Uttarakhand,1005,14,1000,12622,4865,1402,7.96,0,12.5,222656,1891,221562,38.92,11.22,1.00976,0.85,99.51
2020-09-08,Uttarakhand,1438,10,1433,17995,3860,2804,7.99,0,12.5,224094,1901,222995,30.88,22.43,1.4396,0.85,99.51
2020-09-09,Uttarakhand,385,5,381,4762,4714,2077,8.08,0,12.5,224479,1906,223376,37.71,16.62,0.38096,0.85,99.51
2020-09-10,Uttarakhand,1039,3,1032,13143,3209,343,7.91,4,12.5,225518,1909,224408,25.67,2.74,1.05144,0.85,99.51
2020-09-11,Uttarakhand,1256,9,1248,15485,3042,162,8.11,0,12.5,226774,1918,225656,24.34,1.3,1.2388,0.85,99.51
2020-09-12,Uttarakhand,1362,19,1358,17125,2347,349,7.95,0,12.5,228136,1937,227014,18.78,2.79,1.37,0.85,99.51
2020-09-13,Uttarakhand,725,8,720,8889,2649,585,8.16,0,12.5,228861,1945,227734,21.19,4.68,0.71112,0.85,99.51
2020-09-14,Uttarakhand,175,0,172,2341,4407,222,7.48,3,12.5,229036,1945,227906,35.26,1.78,0.18728,0.85,99.51
2020-09-15,Uttarakhand,726,6,718,8888,2617,2398,8.17,2,12.5,229762,1951,228624,20.94,19.18,0.71104,0.85,99.5
2020-09-16,Uttarakhand,1353,11,1353,16743,1767,1546,8.08,0,12.5,231115,1962,229977,14.14,12.37,1.33944,0.85,99.51
2020-09-17,Uttarakhand,1084,5,1083,14025,162,78,7.73,0,12.5,232199,1967,231060,1.3,0.62,1.122,0.85,99.51
2020-09-18,Uttarakhand,641,8,639,7779,1789,1690,8.24,0,12.5,232840,1975,231699,14.31,13.52,0.62232,0.85,99.51
2020-09-19,Uttarakhand,465,5,464,5666,3560,2470,8.21,0,12.5,233305,1980,232163,28.48,19.76,0.45328,0.85,99.51
2020-09-20,Uttarakhand,929,12,924,11576,3601,3473,8.03,0,12.5,234234,1992,233087,28.81,27.78,0.92608,0.85,99.51
2020-09-21,Uttarakhand,1065,7,1065,13576,4112,2168,7.84,0,12.5,235299,1999,234152,32.9,17.34,1.08608,0.85,99.51
2020-09-22,Uttarakhand,909,10,902,11772,3580,2903,7.72,0,12.5,236208,2009,235054,28.64,23.22,0.94176,0.85,99.51
2020-09-23,Uttarakhand,1555,14,1552,19457,3429,1106,7.99,0,12.5,237763,2023,236606,27.43,8.85,1.55656,0.85,99.51
2020-09-24,Uttarakhand,1451,17,1442,18115,4131,2469,8.01,0,12.5,239214,2040,238048,33.05,19.75,1.4492,0.85,99.51
2020-09-25,Uttarakhand,923,11,914,11803,1888,142,7.82,0,12.5,240137,2051,238962,15.1,1.14,0.94424,0.85,99.51
2020-09-26,Uttarakhand,1468,18,1459,18429,1863,1369,7.97,0,12.5,241605,2069,240421,14.9,10.95,1.47432,0.86,99.51
2020-09-27,Uttarakhand,1386,6,1382,16989,114,30,8.16,0,12.5,242991,2075,241803,0.91,0.24,1.35912,0.85,99.51
2020-09-28,Uttarakhand,126,1,122,1089,4989,1816,11.57,3,12.5,243117,2076,241925,39.91,14.53,0.08712,0.85,99.51
2020-09-29,Uttarakhand,1434,17,1425,17266,452,261,8.31,0,12.5,244551,2093,243350,3.62,2.09,1.38128,0.86,99.51
2020-09-30,Uttarakhand,640,5,635,7945,801,375,8.06,0,12.5,245191,2098,243985,6.41,3.0,0.6356,0.86,99.51
2020-10-01,Uttarakhand,337,2,328,4385,3296,1082,7.69,7,12.5,245528,2100,244313,26.37,8.66,0.3508,0.86,99.51
2020-10-02,Uttarakhand,779,4,774,9509,4420,673,8.19,1,12.5,246307,2104,245087,35.36,5.38,0.76072,0.85,99.5
2020-10-03,Uttarakhand,1496,12,1495,18473,3062,843,8.1,0,12.5,247803,2116,246582,24.5,6.74,1.47784,0.85,99.51
2020-10-04,Uttarakhand,125,1,119,1790,4995,334,6.98,5,12.5,247928,2117,246701,39.96,2.67,0.1432,0.85,99.51
2020-10-05,Uttarakhand,399,2,394,4947,855,404,8.07,3,12.5,248327,2119,247095,6.84,3.23,0.39576,0.85,99.5
2020-10-06,Uttarakhand,355,3,351,4360,3912,819,8.14,1,12.5,248682,2122,247446,31.3,6.55,0.3488,0.85,99.5
2020-10-07,Uttarakhand,459,5,457,5291,2291,2218,8.68,0,12.5,249141,2127,247903,18.33,17.74,0.42328,0.85,99.5
2020-10-08,Uttarakhand,400,3,394,5152,4389,3370,7.76,3,12.5,249541,2130,248297,35.11,26.96,0.41216,0.85,99.5
2020-10-09,Uttarakhand,224,0,215,2552,320,136,8.78,9,12.5,249765,2130,248512,2.56,1.09,0.20416,0.85,99.5
2020-10-10,Uttarakhand,794,5,787,9666,1369,1085,8.21,2,12.5,250559,2135,249299,10.95,8.68,0.77328,0.85,99.5
2020-10-11,Uttarakhand,1327,5,1323,16895,3375,1935,7.85,0,12.5,251886,2140,250622,27.0,15.48,1.3516,0.85,99.5
2020-10-12,Uttarakhand,369,3,368,4903,72,51,7.53,0,12.5,252255,2143,250990,0.58,0.41,0.39224,0.85,99.5
2020-10-13,Uttarakhand,710,4,710,8825,2672,1730,8.05,0,12.5,252965,2147,251700,21.38,13.84,0.706,0.85,99.5
2020-10-14,Uttarakhand,1222,14,1214,15274,4734,3310,8.0,0,12.5,254187,2161,252914,37.87,26.48,1.22192,0.85,99.5
2020-10-15,Uttarakhand,908,3,908,11387,3611,1580,7.97,0,12.5,255095,2164,253822,28.89,12.64,0.91096,0.85,99.5
2020-10-16,Uttarakhand,775,8,771,9693,1720,1119,8.0,0,12.5,255870,2172,254593,13.76,8.95,0.77544,0.85,99.5
2020-10-17,Uttarakhand,725,8,716,9124,372,130,7.95,1,12.5,256595,2180,255309,2.98,1.04,0.72992,0.85,99.5
2020-10-18,Uttarakhand,379,3,379,4856,2587,2121,7.8,0,12.5,256974,2183,255688,20.7,16.97,0.38848,0.85,99.5
2020-10-19,Uttarakhand,1469,6,1462,17761,2507,1227,8.27,1,12.5,258443,2189,257150,20.06,9.82,1.42088,0.85,99.5
2020-10-20,Uttarakhand,1111,4,1108,13493,1831,1236,8.23,0,12.5,259554,2193,258258,14.65,9.89,1.07944,0.84,99.5
2020-10-21,Uttarakhand,700,8,699,9319,2822,1028,7.51,0,12.5,260254,2201,258957,22.58,8.22,0.74552,0.85,99.5
2020-10-22,Uttarakhand,441,6,433,5157,3666,2307,8.55,2,12.5,260695,2207,259390,29.33,18.46,0.41256,0.85,99.5
2020-10-23,Uttarakhand,915,5,910,11535,3803,2305,7.93,0,12.5,261610,2212,260300,30.42,18.44,0.9228,0.85,99.5
2020-10-24,Uttarakhand,1170,16,1166,14660,635,67,7.98,0,12.5,262780,2228,261466,5.08,0.54,1.1728,0.85,99.5
2020-10-25,Uttarakhand,793,11,792,9752,3555,1713,8.13,0,12.5,263573,2239,262258,28.44,13.7,0.78016,0.85,99.5
2020-10-26,Uttarakhand,689,5,686,8617,989,416,8.0,0,12.5,264262,2244,262944,7.91,3.33,0.68936,0.85,99.5
2020-10-27,Uttarakhand,726,5,723,8772,1490,1106,8.28,0,12.5,264988,2249,263667,11.92,8.85,0.70176,0.85,99.5
2020-10-28,Uttarakhand,798,4,792,10214,4900,1044,7.81,2,12.5,265786,2253,264459,39.2,8.35,0.81712,0.85,99.5
2020-10-29,Uttarakhand,90,1,83,1198,284,22,7.51,6,12.5,265876,2254,264542,2.27,0.18,0.09584,0.85,99.5
2020-10-30,Uttarakhand,236,1,228,2994,3707,1268,7.88,7,12.5,266112,2255,264770,29.66,10.14,0.23952,0.85,99.5
2020-10-31,Uttarakhand,757,4,750,8972,3751,3160,8.44,3,12.5,266869,2259,265520,30.01,25.28,0.71776,0.85,99.49
2020-11-01,Uttarakhand,884,11,875,11042,3472,30,8.01,0,12.5,267753,2270,266395,27.78,0.24,0.88336,0.85,99.49
2020-11-02,Uttarakhand,305,4,305,3957,4251,3190,7.71,0,12.5,268058,2274,266700,34.01,25.52,0.31656,0.85,99.49
2020-11-03,Uttarakhand,112,1,106,1575,4917,2008,7.11,5,12.5,268170,2275,266806,39.34,16.06,0.126,0.85,99.49
2020-11-04,Uttarakhand,1274,10,1265,15832,3164,1094,8.05,0,12.5,269444,2285,268071,25.31,8.75,1.26656,0.85,99.49
2020-11-05,Uttarakhand,142,1,140,1722,2493,454,8.25,1,12.5,269586,2286,268211,19.94,3.63,0.13776,0.85,99.49
2020-11-06,Uttarakhand,1483,16,1476,18810,4392,3802,7.88,0,12.5,271069,2302,269687,35.14,30.42,1.5048,0.85,99.49
2020-11-07,Uttarakhand,332,2,325,4575,4489,1130,7.26,5,12.5,271401,2304,270012,35.91,9.04,0.366,0.85,99.49
2020-11-08,Uttarakhand,597,6,594,7480,3296,1110,7.98,0,12.5,271998,2310,270606,26.37,8.88,0.5984,0.85,99.49
2020-11-09,Uttarakhand,943,4,937,11965,793,200,7.88,2,12.5,272941,2314,271543,6.34,1.6,0.9572,0.85,99.49
2020-11-10,Uttarakhand,1013,5,1007,12538,1943,1535,8.08,1,12.5,273954,2319,272550,15.54,12.28,1.00304,0.85,99.49
2020-11-11,Uttarakhand,696,7,688,8639,2457,1797,8.06,1,12.5,274650,2326,273238,19.66,14.38,0.69112,0.85,99.49
2020-11-12,Uttarakhand,322,2,318,3812,4263,2309,8.45,2,12.5,274972,2328,273556,34.1,18.47,0.30496,0.85,99.49
2020-11-13,Uttarakhand,1575,22,1569,19236,2046,796,8.19,0,12.5,276547,2350,275125,16.37,6.37,1.53888,0.85,99.49
2020-11-14,Uttarakhand,1281,17,1277,16253,2856,2128,7.88,0,12.5,277828,2367,276402,22.85,17.02,1.30024,0.85,99.49
2020-11-15,Uttarakhand,1540,17,1535,19166,616,1,8.04,0,12.5,279368,2384,277937,4.93,0.01,1.53328,0.85,99.49
2020-11-16,Uttarakhand,773,10,772,9239,2144,1398,8.37,0,12.5,280141,2394,278709,17.15,11.18,0.73912,0.85,99.49
2020-11-17,Uttarakhand,1249,14,1246,15957,3788,135,7.83,0,12.5,281390,2408,279955,30.3,1.08,1.27656,0.86,99.49
2020-11-18,Uttarakhand,909,9,906,11699,1242,878,7.77,0,12.5,282299,2417,280861,9.94,7.02,0.93592,0.86,99.49
2020-11-19,Uttarakhand,1165,12,1158,14371,724,146,8.11,0,12.5,283464,2429,282019,5.79,1.17,1.14968,0.86,99.49
2020-11-20,Uttarakhand,1187,8,1179,15015,3965,17,7.91,0,12.5,284651,2437,283198,31.72,0.14,1.2012,0.86,99.49
2020-11-21,Uttarakhand,828,4,824,10281,3999,453,8.05,0,12.5,285479,2441,284022,31.99,3.62,0.82248,0.86,99.49
2020-11-22,Uttarakhand,250,3,250,2980,124,104,8.39,0,12.5,285729,2444,284272,0.99,0.83,0.2384,0.86,99.49
2020-11-23,Uttarakhand,100,0,96,976,4682,1947,10.25,4,12.5,285829,2444,284368,37.46,15.58,0.07808,0.86,99.49
2020-11-24,Uttarakhand,176,1,175,2133,4296,2992,8.25,0,12.5,286005,2445,284543,34.37,23.94,0.17064,0.85,99.49
2020-11-25,Uttarakhand,1566,6,1560,19606,1661,225,7.99,0,12.5,287571,2451,286103,13.29,1.8,1.56848,0.85,99.49
2020-11-26,Uttarakhand,1197,14,1190,15214,1982,768,7.87,0,12.5,288768,2465,287293,15.86,6.14,1.21712,0.85,99.49
2020-11-27,Uttarakhand,1384,17,1382,17371,4433,219,7.97,0,12.5,290152,2482,288675,35.46,1.75,1.38968,0.86,99.49
2020-11-28,Uttarakhand,284,3,279,3851,4194,59,7.37,2,12.5,290436,2485,288954,33.55,0.47,0.30808,0.86,99.49
2020-11-29,Uttarakhand,369,2,361,4421,3877,3314,8.35,6,12.5,290805,2487,289315,31.02,26.51,0.35368,0.86,99.49
2020-11-30,Uttarakhand,281,3,281,2900,630,614,9.69,0,12.5,291086,2490,289596,5.04,4.91,0.232,0.86,99.49
2020-12-01,Uttarakhand,536,3,536,6805,4757,1680,7.88,0,12.5,291622,2493,290132,38.06,13.44,0.5444,0.85,99.49
2020-12-02,Uttarakhand,1050,10,1045,12927,988,267,8.12,0,12.5,292672,2503,291177,7.9,2.14,1.03416,0.86,99.49
2020-12-03,Uttarakhand,1428,9,1425,17910,2129,2020,7.97,0,12.5,294100,2512,292602,17.03,16.16,1.4328,0.85,99.49
2020-12-04,Uttarakhand,1212,5,1203,14934,1972,1876,8.12,4,12.5,295312,2517,293805,15.78,15.01,1.19472,0.85,99.49
2020-12-05,Uttarakhand,1062,15,1061,13430,3636,2985,7.91,0,12.5,296374,2532,294866,29.09,23.88,1.0744,0.85,99.49
2020-12-06,Uttarakhand,169,2,163,1634,3280,1770,10.34,4,12.5,296543,2534,295029,26.24,14.16,0.13072,0.85,99.49
2020-12-07,Uttarakhand,1444,6,1443,17680,1440,1046,8.17,0,12.5,297987,2540,296472,11.52,8.37,1.4144,0.85,99.49
2020-12-08,Uttarakhand,316,2,315,3775,2527,2287,8.37,0,12.5,298303,2542,296787,20.22,18.3,0.302,0.85,99.49
2020-12-09,Uttarakhand,111,1,109,1340,4178,199,8.28,1,12.5,298414,2543,296896,33.42,1.59,0.1072,0.85,99.49
2020-12-10,Uttarakhand,618,7,617,7728,4859,1653,8.0,0,12.5,299032,2550,297513,38.87,13.22,0.61824,0.85,99.49
2020-12-11,Uttarakhand,1414,7,1411,17472,1053,217,8.09,0,12.5,300446,2557,298924,8.42,1.74,1.39776,0.85,99.49
2020-12-12,Uttarakhand,1410,9,1409,17956,886,858,7.85,0,12.5,301856,2566,300333,7.09,6.86,1.43648,0.85,99.5
2020-12-13,Uttarakhand,1484,7,1484,18645,907,126,7.96,0,12.5,303340,2573,301817,7.26,1.01,1.4916,0.85,99.5
2020-12-14,Uttarakhand,575,7,572,7034,1564,1388,8.17,0,12.5,303915,2580,302389,12.51,11.1,0.56272,0.85,99.5
2020-12-15,Uttarakhand,1412,5,1404,17704,3830,482,7.98,3,12.5,305327,2585,303793,30.64,3.86,1.41632,0.85,99.5
2020-12-16,Uttarakhand,1365,10,1362,16959,193,120,8.05,0,12.5,306692,2595,305155,1.54,0.96,1.35672,0.85,99.5
2020-12-17,Uttarakhand,1139,12,1132,14159,3779,1496,8.04,0,12.5,307831,2607,306287,30.23,11.97,1.13272,0.85,99.5
2020-12-18,Uttarakhand,1103,8,1101,13735,3911,3695,8.03,0,12.5,308934,2615,307388,31.29,29.56,1.0988,0.85,99.5
2020-12-19,Uttarakhand,339,2,339,3896,2922,361,8.7,0,12.5,309273,2617,307727,23.38,2.89,0.31168,0.85,99.5
2020-12-20,Uttarakhand,1431,6,1424,17476,3328,2572,8.19,1,12.5,310704,2623,309151,26.62,20.58,1.39808,0.84,99.5
2020-12-21,Uttarakhand,1614,20,1605,19887,759,678,8.12,0,12.5,312318,2643,310756,6.07,5.42,1.59096,0.85,99.5
2020-12-22,Uttarakhand,542,2,537,7211,318,52,7.52,3,12.5,312860,2645,311293,2.54,0.42,0.57688,0.85,99.5
2020-12-23,Uttarakhand,893,12,884,11589,3569,3069,7.71,0,12.5,313753,2657,312177,28.55,24.55,0.92712,0.85,99.5
2020-12-24,Uttarakhand,902,12,898,11382,1698,1389,7.92,0,12.5,314655,2669,313075,13.58,11.11,0.91056,0.85,99.5
2020-12-25,Uttarakhand,900,5,900,11267,3343,194,7.99,0,12.5,315555,2674,313975,26.74,1.55,0.90136,0.85,99.5
2020-12-26,Uttarakhand,803,2,796,10047,3823,2952,7.99,5,12.5,316358,2676,314771,30.58,23.62,0.80376,0.85,99.5
2020-12-27,Uttarakhand,249,2,241,2780,2418,1689,8.96,6,12.5,316607,2678,315012,19.34,13.51,0.2224,0.85,99.5
2020-12-28,Uttarakhand,1347,19,1343,16639,1080,190,8.1,0,12.5,317954,2697,316355,8.64,1.52,1.33112,0.85,99.5
2020-12-29,Uttarakhand,298,3,293,3850,4005,3954,7.74,2,12.5,318252,2700,316648,32.04,31.63,0.308,0.85,99.5
2020-12-30,Uttarakhand,823,7,822,10416,661,479,7.9,0,12.5,319075,2707,317470,5.29,3.83,0.83328,0.85,99.5
2020-12-31,Uttarakhand,1075,14,1072,13439,3968,734,8.0,0,12.5,320150,2721,318542,31.74,5.87,1.07512,0.85,99.5
2021-01-01,Uttarakhand,972,11,965,12392,3845,1702,7.84,0,12.5,321122,2732,319507,30.76,13.62,0.99136,0.85,99.5
2021-01-02,Uttarakhand,1199,17,1199,14631,3111,547,8.19,0,12.5,322321,2749,320706,24.89,4.38,1.17048,0.85,99.5
2021-01-03,Uttarakhand,541,6,539,6976,1526,458,7.76,0,12.5,322862,2755,321245,12.21,3.66,0.55808,0.85,99.5
2021-01-04,Uttarakhand,236,1,228,3036,1273,643,7.77,7,12.5,323098,2756,321473,10.18,5.14,0.24288,0.85,99.5
2021-01-05,Uttarakhand,1313,11,1305,16744,2195,621,7.84,0,12.5,324411,2767,322778,17.56,4.97,1.33952,0.85,99.5
2021-01-06,Uttarakhand,1546,15,1540,19248,2920,611,8.03,0,12.5,325957,2782,324318,23.36,4.89,1.53984,0.85,99.5
2021-01-07,Uttarakhand,1467,15,1466,18434,2473,979,7.96,0,12.5,327424,2797,325784,19.78,7.83,1.47472,0.85,99.5
2021-01-08,Uttarakhand,877,6,873,10848,927,96,8.08,0,12.5,328301,2803,326657,7.42,0.77,0.86784,0.85,99.5
2021-01-09,Uttarakhand,450,3,450,5132,1961,410,8.77,0,12.5,328751,2806,327107,15.69,3.28,0.41056,0.85,99.5
2021-01-10,Uttarakhand,1213,13,1210,15376,4820,835,7.89,0,12.5,329964,2819,328317,38.56,6.68,1.23008,0.85,99.5
2021-01-11,Uttarakhand,172,2,163,2212,1173,3,7.78,7,12.5,330136,2821,328480,9.38,0.02,0.17696,0.85,99.5
2021-01-12,Uttarakhand,226,0,222,2833,413,165,7.98,4,12.5,330362,2821,328702,3.3,1.32,0.22664,0.85,99.5
2021-01-13,Uttarakhand,64,0,56,752,1684,950,8.51,8,12.5,330426,2821,328758,13.47,7.6,0.06016,0.85,99.5
2021-01-14,Uttarakhand,1136,14,1130,13864,302,190,8.19,0,12.5,331562,2835,329888,2.42,1.52,1.10912,0.86,99.5
2021-01-15,Uttarakhand,952,3,950,11713,1858,1039,8.13,0,12.5,332514,2838,330838,14.86,8.31,0.93704,0.85,99.5
2021-01-16,Uttarakhand,963,3,962,12258,4923,2699,7.86,0,12.5,333477,2841,331800,39.38,21.59,0.98064,0.85,99.5
2021-01-17,Uttarakhand,850,3,846,10229,582,250,8.31,1,12.5,334327,2844,332646,4.66,2.0,0.81832,0.85,99.5
2021-01-18,Uttarakhand,711,4,711,8880,2679,1718,8.01,0,12.5,335038,2848,333357,21.43,13.74,0.7104,0.85,99.5
2021-01-19,Uttarakhand,305,1,301,3692,1189,624,8.26,3,12.5,335343,2849,333658,9.51,4.99,0.29536,0.85,99.5
2021-01-20,Uttarakhand,223,3,215,2677,1504,526,8.33,5,12.5,335566,2852,333873,12.03,4.21,0.21416,0.85,99.5
2021-01-21,Uttarakhand,172,1,165,2375,2686,2300,7.24,6,12.5,335738,2853,334038,21.49,18.4,0.19,0.85,99.49
2021-01-22,Uttarakhand,822,3,822,10292,3620,736,7.99,0,12.5,336560,2856,334860,28.96,5.89,0.82336,0.85,99.49
2021-01-23,Uttarakhand,530,3,529,6582,2761,258,8.05,0,12.5,337090,2859,335389,22.09,2.06,0.52656,0.85,99.5
2021-01-24,Uttarakhand,1303,16,1295,16123,3866,2860,8.08,0,12.5,338393,2875,336684,30.93,22.88,1.28984,0.85,99.49
2021-01-25,Uttarakhand,578,3,572,7663,2335,342,7.54,3,12.5,338971,2878,337256,18.68,2.74,0.61304,0.85,99.49
2021-01-26,Uttarakhand,273,2,266,3428,23,8,7.96,5,12.5,339244,2880,337522,0.18,0.06,0.27424,0.85,99.49
2021-01-27,Uttarakhand,896,7,892,11410,2631,1755,7.85,0,12.5,340140,2887,338414,21.05,14.04,0.9128,0.85,99.49
2021-01-28,Uttarakhand,784,10,779,10098,2787,2,7.76,0,12.5,340924,2897,339193,22.3,0.02,0.80784,0.85,99.49
2021-01-29,Uttarakhand,614,3,608,7461,2435,1846,8.23,3,12.5,341538,2900,339801,19.48,14.77,0.59688,0.85,99.49
2021-01-30,Uttarakhand,1321,12,1313,16649,4513,3368,7.93,0,12.5,342859,2912,341114,36.1,26.94,1.33192,0.85,99.49
2021-01-31,Uttarakhand,1237,12,1233,15448,3505,2754,8.01,0,12.5,344096,2924,342347,28.04,22.03,1.23584,0.85,99.49
2021-02-01,Uttarakhand,527,1,521,6528,4179,1320,8.07,5,12.5,344623,2925,342868,33.43,10.56,0.52224,0.85,99.49
2021-02-02,Uttarakhand,1480,22,1477,18668,3195,575,7.93,0,12.5,346103,2947,344345,25.56,4.6,1.49344,0.85,99.49
2021-02-03,Uttarakhand,400,4,393,5182,1482,527,7.72,3,12.5,346503,2951,344738,11.86,4.22,0.41456,0.85,99.49
2021-02-04,Uttarakhand,369,4,361,4298,3100,2638,8.59,4,12.5,346872,2955,345099,24.8,21.1,0.34384,0.85,99.49
2021-02-05,Uttarakhand,716,2,707,9033,1235,501,7.93,7,12.5,347588,2957,345806,9.88,4.01,0.72264,0.85,99.49
2021-02-06,Uttarakhand,992,3,989,12511,3905,2877,7.93,0,12.5,348580,2960,346795,31.24,23.02,1.00088,0.85,99.49
2021-02-07,Uttarakhand,261,1,253,3135,4742,1325,8.33,7,12.5,348841,2961,347048,37.94,10.6,0.2508,0.85,99.49
2021-02-08,Uttarakhand,938,4,932,11793,1622,965,7.95,2,12.5,349779,2965,347980,12.98,7.72,0.94344,0.85,99.49
2021-02-09,Uttarakhand,1329,19,1325,16784,4180,3263,7.92,0,12.5,351108,2984,349305,33.44,26.1,1.34272,0.85,99.49
2021-02-10,Uttarakhand,76,0,72,789,2128,420,9.63,4,12.5,351184,2984,349377,17.02,3.36,0.06312,0.85,99.49
2021-02-11,Uttarakhand,52,0,46,1009,1083,981,5.15,6,12.5,351236,2984,349423,8.66,7.85,0.08072,0.85,99.48
2021-02-12,Uttarakhand,1044,6,1039,13207,3007,102,7.9,0,12.5,352280,2990,350462,24.06,0.82,1.05656,0.85,99.48
2021-02-13,Uttarakhand,1448,16,1444,18076,2739,986,8.01,0,12.5,353728,3006,351906,21.91,7.89,1.44608,0.85,99.48
2021-02-14,Uttarakhand,1393,20,1386,17504,1754,1234,7.96,0,12.5,355121,3026,353292,14.03,9.87,1.40032,0.85,99.48
2021-02-15,Uttarakhand,1032,5,1028,13016,4399,1798,7.93,0,12.5,356153,3031,354320,35.19,14.38,1.04128,0.85,99.49
2021-02-16,Uttarakhand,1109,15,1107,13956,3736,3474,7.95,0,12.5,357262,3046,355427,29.89,27.79,1.11648,0.85,99.49
2021-02-17,Uttarakhand,1097,9,1089,13603,619,106,8.06,0,12.5,358359,3055,356516,4.95,0.85,1.08824,0.85,99.49
2021-02-18,Uttarakhand,1264,7,1260,15491,4947,1876,8.16,0,12.5,359623,3062,357776,39.58,15.01,1.23928,0.85,99.49
2021-02-19,Uttarakhand,840,11,835,10809,2754,2622,7.77,0,12.5,360463,3073,358611,22.03,20.98,0.86472,0.85,99.49
2021-02-20,Uttarakhand,1013,9,1008,12632,3214,2003,8.02,0,12.5,361476,3082,359619,25.71,16.02,1.01056,0.85,99.49
2021-02-21,Uttarakhand,1514,21,1510,18991,627,516,7.97,0,12.5,362990,3103,361129,5.02,4.13,1.51928,0.85,99.49
2021-02-22,Uttarakhand,485,4,479,6091,2822,2304,7.96,2,12.5,363475,3107,361608,22.58,18.43,0.48728,0.85,99.49
2021-02-23,Uttarakhand,1037,4,1037,13460,4213,3548,7.7,0,12.5,364512,3111,362645,33.7,28.38,1.0768,0.85,99.49
2021-02-24,Uttarakhand,1098,9,1093,14003,1455,478,7.84,0,12.5,365610,3120,363738,11.64,3.82,1.12024,0.85,99.49
2021-02-25,Uttarakhand,668,7,660,8313,2200,506,8.04,1,12.5,366278,3127,364398,17.6,4.05,0.66504,0.85,99.49
2021-02-26,Uttarakhand,441,5,438,5575,501,492,7.91,0,12.5,366719,3132,364836,4.01,3.94,0.446,0.85,99.49
2021-02-27,Uttarakhand,1316,4,1315,16448,4726,3899,8.0,0,12.5,368035,3136,366151,37.81,31.19,1.31584,0.85,99.49
2021-02-28,Uttarakhand,576,6,569,7064,4228,2039,8.15,1,12.5,368611,3142,366720,33.82,16.31,0.56512,0.85,99.49
2021-03-01,Uttarakhand,191,2,190,2476,2227,784,7.71,0,12.5,368802,3144,366910,17.82,6.27,0.19808,0.85,99.49
2021-03-02,Uttarakhand,336,3,333,4339,429,113,7.74,0,12.5,369138,3147,367243,3.43,0.9,0.34712,0.85,99.49
2021-03-03,Uttarakhand,574,6,570,7444,1079,583,7.71,0,12.5,369712,3153,367813,8.63,4.66,0.59552,0.85,99.49
2021-03-04,Uttarakhand,169,1,168,2284,677,550,7.4,0,12.5,369881,3154,367981,5.42,4.4,0.18272,0.85,99.49
2021-03-05,Uttarakhand,52,0,47,1007,2759,463,5.16,5,12.5,369933,3154,368028,22.07,3.7,0.08056,0.85,99.49
2021-03-06,Uttarakhand,184,2,176,2010,4070,60,9.15,6,12.5,370117,3156,368204,32.56,0.48,0.1608,0.85,99.48
2021-03-07,Uttarakhand,494,3,492,6048,2297,813,8.17,0,12.5,370611,3159,368696,18.38,6.5,0.48384,0.85,99.48
2021-03-08,Uttarakhand,108,0,108,1422,2213,1543,7.59,0,12.5,370719,3159,368804,17.7,12.34,0.11376,0.85,99.48
2021-03-09,Uttarakhand,1546,22,1538,19263,967,465,8.03,0,12.5,372265,3181,370342,7.74,3.72,1.54104,0.85,99.48
2021-03-10,Uttarakhand,350,2,342,4219,3755,615,8.3,6,12.5,372615,3183,370684,30.04,4.92,0.33752,0.85,99.48
2021-03-11,Uttarakhand,734,5,725,9460,2471,2408,7.76,4,12.5,373349,3188,371409,19.77,19.26,0.7568,0.85,99.48
2021-03-12,Uttarakhand,1054,5,1049,13175,3793,2677,8.0,0,12.5,374403,3193,372458,30.34,21.42,1.054,0.85,99.48
2021-03-13,Uttarakhand,1292,7,1288,16203,4770,4640,7.97,0,12.5,375695,3200,373746,38.16,37.12,1.29624,0.85,99.48
2021-03-14,Uttarakhand,769,9,763,9895,1077,297,7.77,0,12.5,376464,3209,374509,8.62,2.38,0.7916,0.85,99.48
2021-03-15,Uttarakhand,1263,4,1257,15617,4771,4672,8.09,2,12.5,377727,3213,375766,38.17,37.38,1.24936,0.85,99.48
2021-03-16,Uttarakhand,569,5,560,7028,488,309,8.1,4,12.5,378296,3218,376326,3.9,2.47,0.56224,0.85,99.48
2021-03-17,Uttarakhand,525,3,521,6543,4117,3838,8.02,1,12.5,378821,3221,376847,32.94,30.7,0.52344,0.85,99.48
2021-03-18,Uttarakhand,1172,10,1163,14713,329,213,7.97,0,12.5,379993,3231,378010,2.63,1.7,1.17704,0.85,99.48
2021-03-19,Uttarakhand,1042,12,1036,13234,4552,1156,7.87,0,12.5,381035,3243,379046,36.42,9.25,1.05872,0.85,99.48
2021-03-20,Uttarakhand,28,0,25,800,110,20,3.5,3,12.5,381063,3243,379071,0.88,0.16,0.064,0.85,99.48
2021-03-21,Uttarakhand,996,6,990,12681,927,141,7.85,0,12.5,382059,3249,380061,7.42,1.13,1.01448,0.85,99.48
2021-03-22,Uttarakhand,1387,9,1383,17061,4397,1742,8.13,0,12.5,383446,3258,381444,35.18,13.94,1.36488,0.85,99.48
2021-03-23,Uttarakhand,100,0,95,1208,4872,94,8.28,5,12.5,383546,3258,381539,38.98,0.75,0.09664,0.85,99.48
2021-03-24,Uttarakhand,1069,10,1063,13490,4931,3286,7.92,0,12.5,384615,3268,382602,39.45,26.29,1.0792,0.85,99.48
2021-03-25,Uttarakhand,913,4,911,11478,2068,226,7.95,0,12.5,385528,3272,383513,16.54,1.81,0.91824,0.85,99.48
2021-03-26,Uttarakhand,1029,5,1028,12579,3106,2378,8.18,0,12.5,386557,3277,384541,24.85,19.02,1.00632,0.85,99.48
2021-03-27,Uttarakhand,557,4,550,7233,2378,248,7.7,3,12.5,387114,3281,385091,19.02,1.98,0.57864,0.85,99.48
2021-03-28,Uttarakhand,1309,14,1306,16478,1568,209,7.94,0,12.5,388423,3295,386397,12.54,1.67,1.31824,0.85,99.48
2021-03-29,Uttarakhand,541,6,534,6810,2720,630,7.94,1,12.5,388964,3301,386931,21.76,5.04,0.5448,0.85,99.48
2021-03-30,Uttarakhand,903,10,903,11024,4271,2069,8.19,0,12.5,389867,3311,387834,34.17,16.55,0.88192,0.85,99.48
2021-03-31,Uttarakhand,547,2,547,7257,2237,1468,7.54,0,12.5,390414,3313,388381,17.9,11.74,0.58056,0.85,99.48
2021-04-01,Uttarakhand,161,0,154,2397,2802,2752,6.72,7,12.5,390575,3313,388535,22.42,22.02,0.19176,0.85,99.48
2021-04-02,Uttarakhand,737,8,734,9000,4164,1420,8.19,0,12.5,391312,3321,389269,33.31,11.36,0.72,0.85,99.48
2021-04-03,Uttarakhand,464,4,464,5654,2259,1839,8.21,0,12.5,391776,3325,389733,18.07,14.71,0.45232,0.85,99.48
2021-04-04,Uttarakhand,1107,11,1106,14064,3277,80,7.87,0,12.5,392883,3336,390839,26.22,0.64,1.12512,0.85,99.48
2021-04-05,Uttarakhand,270,2,265,4021,2812,2139,6.71,3,12.5,393153,3338,391104,22.5,17.11,0.32168,0.85,99.48
2021-04-06,Uttarakhand,1509,20,1507,19277,3084,2760,7.83,0,12.5,394662,3358,392611,24.67,22.08,1.54216,0.85,99.48
2021-04-07,Uttarakhand,269,3,263,3064,3266,585,8.78,3,12.5,394931,3361,392874,26.13,4.68,0.24512,0.85,99.48
2021-04-08,Uttarakhand,1508,18,1502,19025,574,212,7.93,0,12.5,396439,3379,394376,4.59,1.7,1.522,0.85,99.48
2021-04-09,Uttarakhand,1226,15,1226,15400,4208,641,7.96,0,12.5,397665,3394,395602,33.66,5.13,1.232,0.85,99.48
2021-04-10,Uttarakhand,1516,14,1513,18635,387,203,8.14,0,12.5,399181,3408,397115,3.1,1.62,1.4908,0.85,99.48
2021-04-11,Uttarakhand,1292,13,1290,15747,336,59,8.2,0,12.5,400473,3421,398405,2.69,0.47,1.25976,0.85,99.48
2021-04-12,Uttarakhand,833,7,828,9904,1294,264,8.41,0,12.5,401306,3428,399233,10.35,2.11,0.79232,0.85,99.48
2021-04-13,Uttarakhand,1601,15,1597,19780,1181,133,8.09,0,12.5,402907,3443,400830,9.45,1.06,1.5824,0.85,99.48
2021-04-14,Uttarakhand,300,4,298,3787,4648,2292,7.92,0,12.5,403207,3447,401128,37.18,18.34,0.30296,0.85,99.48
2021-04-15,Uttarakhand,403,3,403,5002,2193,997,8.06,0,12.5,403610,3450,401531,17.54,7.98,0.40016,0.85,99.48
2021-04-16,Uttarakhand,296,3,290,3689,709,385,8.02,3,12.5,403906,3453,401821,5.67,3.08,0.29512,0.85,99.48
2021-04-17,Uttarakhand,194,1,190,2482,4490,1480,7.82,3,12.5,404100,3454,402011,35.92,11.84,0.19856,0.85,99.48
2021-04-18,Uttarakhand,1459,19,1450,18308,3055,2587,7.97,0,12.5,405559,3473,403461,24.44,20.7,1.46464,0.86,99.48
2021-04-19,Uttarakhand,1159,15,1150,14644,1644,1124,7.91,0,12.5,406718,3488,404611,13.15,8.99,1.17152,0.86,99.48
2021-04-20,Uttarakhand,986,13,983,11925,1402,1105,8.27,0,12.5,407704,3501,405594,11.22,8.84,0.954,0.86,99.48
2021-04-21,Uttarakhand,1232,11,1224,15235,2517,1436,8.09,0,12.5,408936,3512,406818,20.14,11.49,1.2188,0.86,99.48
2021-04-22,Uttarakhand,943,13,939,11664,3356,401,8.08,0,12.5,409879,3525,407757,26.85,3.21,0.93312,0.86,99.48
2021-04-23,Uttarakhand,143,2,139,1629,1440,577,8.78,2,12.5,410022,3527,407896,11.52,4.62,0.13032,0.86,99.48
2021-04-24,Uttarakhand,473,5,473,5707,1137,648,8.29,0,12.5,410495,3532,408369,9.1,5.18,0.45656,0.86,99.48
2021-04-25,Uttarakhand,1213,5,1213,15493,4317,1581,7.83,0,12.5,411708,3537,409582,34.54,12.65,1.23944,0.86,99.48
2021-04-26,Uttarakhand,609,8,606,7749,1135,918,7.86,0,12.5,412317,3545,410188,9.08,7.34,0.61992,0.86,99.48
2021-04-27,Uttarakhand,134,0,133,1692,1572,112,7.92,1,12.5,412451,3545,410321,12.58,0.9,0.13536,0.86,99.48
2021-04-28,Uttarakhand,1444,20,1435,18132,2448,1346,7.96,0,12.5,413895,3565,411756,19.58,10.77,1.45056,0.86,99.48
2021-04-29,Uttarakhand,227,2,221,2816,2600,2260,8.06,4,12.5,414122,3567,411977,20.8,18.08,0.22528,0.86,99.48
2021-04-30,Uttarakhand,304,1,302,3862,3624,3206,7.87,1,12.5,414426,3568,412279,28.99,25.65,0.30896,0.86,99.48
2021-05-01,Uttarakhand,438,1,429,5597,4929,2276,7.83,8,12.5,414864,3569,412708,39.43,18.21,0.44776,0.86,99.48
2021-05-02,Uttarakhand,169,1,168,2127,4729,3816,7.95,0,12.5,415033,3570,412876,37.83,30.53,0.17016,0.86,99.48
2021-05-03,Uttarakhand,580,5,578,7265,4481,2840,7.98,0,12.5,415613,3575,413454,35.85,22.72,0.5812,0.86,99.48
2021-05-04,Uttarakhand,691,10,686,8967,479,338,7.71,0,12.5,416304,3585,414140,3.83,2.7,0.71736,0.86,99.48
2021-05-05,Uttarakhand,1212,12,1210,14842,2206,1146,8.17,0,12.5,417516,3597,415350,17.65,9.17,1.18736,0.86,99.48
2021-05-06,Uttarakhand,678,8,673,8939,4781,4304,7.58,0,12.5,418194,3605,416023,38.25,34.43,0.71512,0.86,99.48
2021-05-07,Uttarakhand,797,2,791,9834,649,30,8.1,4,12.5,418991,3607,416814,5.19,0.24,0.78672,0.86,99.48
2021-05-08,Uttarakhand,274,3,272,3172,3603,88,8.64,0,12.5,419265,3610,417086,28.82,0.7,0.25376,0.86,99.48
2021-05-09,Uttarakhand,1537,12,1535,19091,3233,920,8.05,0,12.5,420802,3622,418621,25.86,7.36,1.52728,0.86,99.48
2021-05-10,Uttarakhand,986,3,978,12418,985,831,7.94,5,12.5,421788,3625,419599,7.88,6.65,0.99344,0.86,99.48
2021-05-11,Uttarakhand,283,3,276,3747,783,646,7.55,4,12.5,422071,3628,419875,6.26,5.17,0.29976,0.86,99.48
2021-05-12,Uttarakhand,146,1,143,1698,4517,2451,8.6,2,12.5,422217,3629,420018,36.14,19.61,0.13584,0.86,99.48
2021-05-13,Uttarakhand,1027,13,1023,12945,1372,520,7.93,0,12.5,423244,3642,421041,10.98,4.16,1.0356,0.86,99.48
2021-05-14,Uttarakhand,63,0,57,795,4896,3232,7.92,6,12.5,423307,3642,421098,39.17,25.86,0.0636,0.86,99.48
2021-05-15,Uttarakhand,874,9,872,11340,2177,1494,7.71,0,12.5,424181,3651,421970,17.42,11.95,0.9072,0.86,99.48
2021-05-16,Uttarakhand,1036,9,1027,13138,3977,3092,7.89,0,12.5,425217,3660,422997,31.82,24.74,1.05104,0.86,99.48
2021-05-17,Uttarakhand,756,8,751,9519,1135,1072,7.94,0,12.5,425973,3668,423748,9.08,8.58,0.76152,0.86,99.48
2021-05-18,Uttarakhand,1206,4,1197,15249,3860,3697,7.91,5,12.5,427179,3672,424945,30.88,29.58,1.21992,0.86,99.48
2021-05-19,Uttarakhand,1341,18,1339,16486,1103,158,8.13,0,12.5,428520,3690,426284,8.82,1.26,1.31888,0.86,99.48
2021-05-20,Uttarakhand,472,4,469,6139,4704,1063,7.69,0,12.5,428992,3694,426753,37.63,8.5,0.49112,0.86,99.48
2021-05-21,Uttarakhand,1353,12,1350,16885,4229,1874,8.01,0,12.5,430345,3706,428103,33.83,14.99,1.3508,0.86,99.48
2021-05-22,Uttarakhand,52,0,51,710,3561,1239,7.32,1,12.5,430397,3706,428154,28.49,9.91,0.0568,0.86,99.48
2021-05-23,Uttarakhand,155,1,147,2093,369,249,7.41,7,12.5,430552,3707,428301,2.95,1.99,0.16744,0.86,99.48
2021-05-24,Uttarakhand,94,0,85,981,2898,985,9.58,9,12.5,430646,3707,428386,23.18,7.88,0.07848,0.86,99.48
2021-05-25,Uttarakhand,1467,9,1467,18248,1167,1009,8.04,0,12.5,432113,3716,429853,9.34,8.07,1.45984,0.86,99.48
2021-05-26,Uttarakhand,545,6,538,6695,1492,1206,8.14,1,12.5,432658,3722,430391,11.94,9.65,0.5356,0.86,99.48
2021-05-27,Uttarakhand,1438,9,1431,17804,4,4,8.08,0,12.5,434096,3731,431822,0.03,0.03,1.42432,0.86,99.48
2021-05-28,Uttarakhand,998,14,991,12537,1257,1153,7.96,0,12.5,435094,3745,432813,10.06,9.22,1.00296,0.86,99.48
2021-05-29,Uttarakhand,1474,12,1468,18261,134,87,8.07,0,12.5,436568,3757,434281,1.07,0.7,1.46088,0.86,99.48
2021-05-30,Uttarakhand,1341,17,1333,16396,3201,576,8.18,0,12.5,437909,3774,435614,25.61,4.61,1.31168,0.86,99.48
2021-05-31,Uttarakhand,448,3,444,6072,584,393,7.38,1,12.5,438357,3777,436058,4.67,3.14,0.48576,0.86,99.48
2021-06-01,Uttarakhand,244,3,239,3445,1016,203,7.08,2,12.5,438601,3780,436297,8.13,1.62,0.2756,0.86,99.47
2021-06-02,Uttarakhand,843,5,840,10772,2682,1391,7.83,0,12.5,439444,3785,437137,21.46,11.13,0.86176,0.86,99.48
2021-06-03,Uttarakhand,703,10,703,8918,1407,539,7.88,0,12.5,440147,3795,437840,11.26,4.31,0.71344,0.86,99.48
2021-06-04,Uttarakhand,681,4,675,8652,1824,1055,7.87,2,12.5,440828,3799,438515,14.59,8.44,0.69216,0.86,99.48
2021-06-05,Uttarakhand,882,7,881,11097,2428,891,7.95,0,12.5,441710,3806,439396,19.42,7.13,0.88776,0.86,99.48
2021-06-06,Uttarakhand,212,2,208,2599,4132,2022,8.16,2,12.5,441922,3808,439604,33.06,16.18,0.20792,0.86,99.48
2021-06-07,Uttarakhand,606,5,604,7568,279,131,8.01,0,12.5,442528,3813,440208,2.23,1.05,0.60544,0.86,99.48
2021-06-08,Uttarakhand,696,4,688,8929,1406,1233,7.79,4,12.5,443224,3817,440896,11.25,9.86,0.71432,0.86,99.47
2021-06-09,Uttarakhand,880,7,872,11478,4486,2937,7.67,1,12.5,444104,3824,441768,35.89,23.5,0.91824,0.86,99.47
2021-06-10,Uttarakhand,1038,15,1033,12924,499,237,8.03,0,12.5,445142,3839,442801,3.99,1.9,1.03392,0.86,99.47
2021-06-11,Uttarakhand,803,9,796,9905,2094,769,8.11,0,12.5,445945,3848,443597,16.75,6.15,0.7924,0.86,99.47
2021-06-12,Uttarakhand,863,11,855,11052,439,399,7.81,0,12.5,446808,3859,444452,3.51,3.19,0.88416,0.86,99.47
2021-06-13,Uttarakhand,748,4,746,9611,3401,2777,7.78,0,12.5,447556,3863,445198,27.21,22.22,0.76888,0.86,99.47
2021-06-14,Uttarakhand,872,3,867,10839,4744,1505,8.05,2,12.5,448428,3866,446065,37.95,12.04,0.86712,0.86,99.47
2021-06-15,Uttarakhand,429,2,429,5254,3049,978,8.17,0,12.5,448857,3868,446494,24.39,7.82,0.42032,0.86,99.47
2021-06-16,Uttarakhand,330,3,329,4193,4011,2836,7.87,0,12.5,449187,3871,446823,32.09,22.69,0.33544,0.86,99.47
2021-06-17,Uttarakhand,1269,18,1265,16092,2153,566,7.89,0,12.5,450456,3889,448088,17.22,4.53,1.28736,0.86,99.47
2021-06-18,Uttarakhand,270,3,267,3478,1377,1261,7.76,0,12.5,450726,3892,448355,11.02,10.09,0.27824,0.86,99.47
2021-06-19,Uttarakhand,1102,12,1094,14144,3534,3451,7.79,0,12.5,451828,3904,449449,28.27,27.61,1.13152,0.86,99.47
2021-06-20,Uttarakhand,719,3,718,9131,1953,914,7.87,0,12.5,452547,3907,450167,15.62,7.31,0.73048,0.86,99.47
2021-06-21,Uttarakhand,1169,13,1162,14837,2107,1823,7.88,0,12.5,453716,3920,451329,16.86,14.58,1.18696,0.86,99.47
2021-06-22,Uttarakhand,1383,13,1374,17172,4277,4271,8.05,0,12.5,455099,3933,452703,34.22,34.17,1.37376,0.86,99.47
2021-06-23,Uttarakhand,1393,14,1387,16957,4614,1395,8.21,0,12.5,456492,3947,454090,36.91,11.16,1.35656,0.86,99.47
2021-06-24,Uttarakhand,1239,13,1232,15798,812,446,7.84,0,12.5,457731,3960,455322,6.5,3.57,1.26384,0.87,99.47
2021-06-25,Uttarakhand,994,13,985,12171,4205,41,8.17,0,12.5,458725,3973,456307,33.64,0.33,0.97368,0.87,99.47
2021-06-26,Uttarakhand,1242,14,1236,15481,2974,1172,8.02,0,12.5,459967,3987,457543,23.79,9.38,1.23848,0.87,99.47
2021-06-27,Uttarakhand,715,6,710,9409,4533,362,7.6,0,12.5,460682,3993,458253,36.26,2.9,0.75272,0.87,99.47
2021-06-28,Uttarakhand,150,1,147,2445,4604,858,6.13,2,12.5,460832,3994,458400,36.83,6.86,0.1956,0.87,99.47
2021-06-29,Uttarakhand,1239,7,1236,15924,2559,437,7.78,0,12.5,462071,4001,459636,20.47,3.5,1.27392,0.87,99.47
2021-06-30,Uttarakhand,659,6,651,8363,4333,2304,7.88,2,12.5,462730,4007,460287,34.66,18.43,0.66904,0.87,99.47
2021-07-01,Uttarakhand,616,2,613,7576,1984,681,8.13,1,12.5,463346,4009,460900,15.87,5.45,0.60608,0.87,99.47
2021-07-02,Uttarakhand,726,5,726,9266,3726,3566,7.84,0,12.5,464072,4014,461626,29.81,28.53,0.74128,0.86,99.47
2021-07-03,Uttarakhand,323,1,318,4260,1402,698,7.58,4,12.5,464395,4015,461944,11.22,5.58,0.3408,0.86,99.47
2021-07-04,Uttarakhand,1013,3,1009,12358,4052,278,8.2,1,12.5,465408,4018,462953,32.42,2.22,0.98864,0.86,99.47
2021-07-05,Uttarakhand,285,2,280,3555,2546,2307,8.02,3,12.5,465693,4020,463233,20.37,18.46,0.2844,0.86,99.47
2021-07-06,Uttarakhand,1247,5,1238,15615,538,24,7.99,4,12.5,466940,4025,464471,4.3,0.19,1.2492,0.86,99.47
2021-07-07,Uttarakhand,166,2,166,2004,4449,449,8.28,0,12.5,467106,4027,464637,35.59,3.59,0.16032,0.86,99.47
2021-07-08,Uttarakhand,755,7,750,8817,1939,927,8.56,0,12.5,467861,4034,465387,15.51,7.42,0.70536,0.86,99.47
2021-07-09,Uttarakhand,989,5,985,11939,1498,447,8.28,0,12.5,468850,4039,466372,11.98,3.58,0.95512,0.86,99.47
2021-07-10,Uttarakhand,1539,8,1539,19309,2632,232,7.97,0,12.5,470389,4047,467911,21.06,1.86,1.54472,0.86,99.47
2021-07-11,Uttarakhand,257,1,248,2512,1280,557,10.23,8,12.5,470646,4048,468159,10.24,4.46,0.20096,0.86,99.47
2021-07-12,Uttarakhand,1341,12,1339,16585,1514,619,8.09,0,12.5,471987,4060,469498,12.11,4.95,1.3268,0.86,99.47
2021-07-13,Uttarakhand,43,0,39,651,738,283,6.61,4,12.5,472030,4060,469537,5.9,2.26,0.05208,0.86,99.47
2021-07-14,Uttarakhand,724,8,717,8937,2919,403,8.1,0,12.5,472754,4068,470254,23.35,3.22,0.71496,0.86,99.47
2021-07-15,Uttarakhand,1296,7,1288,16339,4165,1277,7.93,1,12.5,474050,4075,471542,33.32,10.22,1.30712,0.86,99.47
2021-07-16,Uttarakhand,486,6,482,5527,573,105,8.79,0,12.5,474536,4081,472024,4.58,0.84,0.44216,0.86,99.47
2021-07-17,Uttarakhand,844,11,840,10448,1396,1166,8.08,0,12.5,475380,4092,472864,11.17,9.33,0.83584,0.86,99.47
2021-07-18,Uttarakhand,149,0,149,2074,2961,2423,7.18,0,12.5,475529,4092,473013,23.69,19.38,0.16592,0.86,99.47
2021-07-19,Uttarakhand,90,0,85,995,3550,3139,9.05,5,12.5,475619,4092,473098,28.4,25.11,0.0796,0.86,99.47
2021-07-20,Uttarakhand,279,3,270,3256,4235,4109,8.57,6,12.5,475898,4095,473368,33.88,32.87,0.26048,0.86,99.47
2021-07-21,Uttarakhand,415,1,412,5267,216,86,7.88,2,12.5,476313,4096,473780,1.73,0.69,0.42136,0.86,99.47
2021-07-22,Uttarakhand,282,3,275,3995,1097,357,7.06,4,12.5,476595,4099,474055,8.78,2.86,0.3196,0.86,99.47
2021-07-23,Uttarakhand,1401,9,1399,17600,547,340,7.96,0,12.5,477996,4108,475454,4.38,2.72,1.408,0.86,99.47
2021-07-24,Uttarakhand,1313,7,1310,16345,2139,1491,8.03,0,12.5,479309,4115,476764,17.11,11.93,1.3076,0.86,99.47
2021-07-25,Uttarakhand,1029,12,1024,13350,545,353,7.71,0,12.5,480338,4127,477788,4.36,2.82,1.068,0.86,99.47
2021-07-26,Uttarakhand,82,0,82,1087,4355,3972,7.54,0,12.5,480420,4127,477870,34.84,31.78,0.08696,0.86,99.47
2021-07-27,Uttarakhand,1026,14,1025,12948,2201,175,7.92,0,12.5,481446,4141,478895,17.61,1.4,1.03584,0.86,99.47
2021-07-28,Uttarakhand,849,10,840,10629,2632,2386,7.99,0,12.5,482295,4151,479735,21.06,19.09,0.85032,0.86,99.47
2021-07-29,Uttarakhand,1240,9,1237,15177,1341,450,8.17,0,12.5,483535,4160,480972,10.73,3.6,1.21416,0.86,99.47
2021-07-30,Uttarakhand,1207,8,1199,14814,2181,164,8.15,0,12.5,484742,4168,482171,17.45,1.31,1.18512,0.86,99.47
2021-07-31,Uttarakhand,1393,7,1386,17500,1823,1590,7.96,0,12.5,486135,4175,483557,14.58,12.72,1.4,0.86,99.47
2021-08-01,Uttarakhand,1110,11,1106,13559,769,172,8.19,0,12.5,487245,4186,484663,6.15,1.38,1.08472,0.86,99.47
2021-08-02,Uttarakhand,1575,7,1567,19851,3155,1482,7.93,1,12.5,488820,4193,486230,25.24,11.86,1.58808,0.86,99.47
2021-08-03,Uttarakhand,210,1,205,2585,3163,738,8.12,4,12.5,489030,4194,486435,25.3,5.9,0.2068,0.86,99.47
2021-08-04,Uttarakhand,1478,18,1476,18581,926,480,7.95,0,12.5,490508,4212,487911,7.41,3.84,1.48648,0.86,99.47
2021-08-05,Uttarakhand,479,5,473,6149,367,97,7.79,1,12.5,490987,4217,488384,2.94,0.78,0.49192,0.86,99.47
2021-08-06,Uttarakhand,1265,16,1261,16317,1706,969,7.75,0,12.5,492252,4233,489645,13.65,7.75,1.30536,0.86,99.47
2021-08-07,Uttarakhand,354,2,351,4276,361,152,8.28,1,12.5,492606,4235,489996,2.89,1.22,0.34208,0.86,99.47
2021-08-08,Uttarakhand,983,3,977,12268,3147,1021,8.01,3,12.5,493589,4238,490973,25.18,8.17,0.98144,0.86,99.47
2021-08-09,Uttarakhand,769,4,766,9428,4551,525,8.16,0,12.5,494358,4242,491739,36.41,4.2,0.75424,0.86,99.47
2021-08-10,Uttarakhand,622,6,614,8231,4707,3411,7.56,2,12.5,494980,4248,492353,37.66,27.29,0.65848,0.86,99.47
2021-08-11,Uttarakhand,1099,5,1097,13361,1700,1265,8.23,0,12.5,496079,4253,493450,13.6,10.12,1.06888,0.86,99.47
2021-08-12,Uttarakhand,803,6,799,10816,2891,2308,7.42,0,12.5,496882,4259,494249,23.13,18.46,0.86528,0.86,99.47
2021-08-13,Uttarakhand,918,9,917,11888,1800,742,7.72,0,12.5,497800,4268,495166,14.4,5.94,0.95104,0.86,99.47
2021-08-14,Uttarakhand,952,4,948,11786,2309,96,8.08,0,12.5,498752,4272,496114,18.47,0.77,0.94288,0.86,99.47
2021-08-15,Uttarakhand,1429,10,1428,18318,3649,2649,7.8,0,12.5,500181,4282,497542,29.19,21.19,1.46544,0.86,99.47
2021-08-16,Uttarakhand,1607,23,1603,19731,2896,1037,8.14,0,12.5,501788,4305,499145,23.17,8.3,1.57848,0.86,99.47
2021-08-17,Uttarakhand,1383,15,1378,17419,894,891,7.94,0,12.5,503171,4320,500523,7.15,7.13,1.39352,0.86,99.47
2021-08-18,Uttarakhand,328,2,320,4311,4449,1512,7.61,6,12.5,503499,4322,500843,35.59,12.1,0.34488,0.86,99.47
2021-08-19,Uttarakhand,623,7,620,7834,2832,790,7.95,0,12.5,504122,4329,501463,22.66,6.32,0.62672,0.86,99.47
2021-08-20,Uttarakhand,385,2,381,4991,1906,1496,7.71,2,12.5,504507,4331,501844,15.25,11.97,0.39928,0.86,99.47
2021-08-21,Uttarakhand,510,6,502,6554,3143,564,7.78,2,12.5,505017,4337,502346,25.14,4.51,0.52432,0.86,99.47
2021-08-22,Uttarakhand,1267,10,1265,15814,2232,470,8.01,0,12.5,506284,4347,503611,17.86,3.76,1.26512,0.86,99.47
2021-08-23,Uttarakhand,1039,4,1037,13044,531,221,7.97,0,12.5,507323,4351,504648,4.25,1.77,1.04352,0.86,99.47
2021-08-24,Uttarakhand,1277,4,1276,16364,3486,2393,7.8,0,12.5,508600,4355,505924,27.89,19.14,1.30912,0.86,99.47
2021-08-25,Uttarakhand,641,7,634,7990,131,28,8.02,0,12.5,509241,4362,506558,1.05,0.22,0.6392,0.86,99.47
2021-08-26,Uttarakhand,491,4,485,5822,2786,2646,8.43,2,12.5,509732,4366,507043,22.29,21.17,0.46576,0.86,99.47
2021-08-27,Uttarakhand,1433,10,1424,18068,3953,3902,7.93,0,12.5,511165,4376,508467,31.62,31.22,1.44544,0.86,99.47
2021-08-28,Uttarakhand,87,0,81,1214,679,177,7.17,6,12.5,511252,4376,508548,5.43,1.42,0.09712,0.86,99.47
2021-08-29,Uttarakhand,1403,12,1400,17384,1521,1420,8.07,0,12.5,512655,4388,509948,12.17,11.36,1.39072,0.86,99.47
2021-08-30,Uttarakhand,825,7,821,10485,2664,403,7.87,0,12.5,513480,4395,510769,21.31,3.22,0.8388,0.86,99.47
2021-08-31,Uttarakhand,989,4,985,12201,4890,4236,8.11,0,12.5,514469,4399,511754,39.12,33.89,0.97608,0.86,99.47
2021-09-01,Uttarakhand,648,8,642,7805,1534,915,8.3,0,12.5,515117,4407,512396,12.27,7.32,0.6244,0.86,99.47
2021-09-02,Uttarakhand,1534,7,1530,19444,4539,2597,7.89,0,12.5,516651,4414,513926,36.31,20.78,1.55552,0.85,99.47
2021-09-03,Uttarakhand,501,6,493,6369,4522,122,7.87,2,12.5,517152,4420,514419,36.18,0.98,0.50952,0.85,99.47
2021-09-04,Uttarakhand,433,6,425,5072,231,164,8.54,2,12.5,517585,4426,514844,1.85,1.31,0.40576,0.86,99.47
2021-09-05,Uttarakhand,633,5,625,7787,2172,1089,8.13,3,12.5,518218,4431,515469,17.38,8.71,0.62296,0.86,99.47
2021-09-06,Uttarakhand,1541,20,1539,19818,4090,1784,7.78,0,12.5,519759,4451,517008,32.72,14.27,1.58544,0.86,99.47
2021-09-07,Uttarakhand,256,3,251,3468,2382,1845,7.38,2,12.5,520015,4454,517259,19.06,14.76,0.27744,0.86,99.47
2021-09-08,Uttarakhand,1355,11,1350,17007,2163,1101,7.97,0,12.5,521370,4465,518609,17.3,8.81,1.36056,0.86,99.47
2021-09-09,Uttarakhand,1200,12,1196,15026,1918,1645,7.99,0,12.5,522570,4477,519805,15.34,13.16,1.20208,0.86,99.47
2021-09-10,Uttarakhand,353,2,347,4436,4385,1303,7.96,4,12.5,522923,4479,520152,35.08,10.42,0.35488,0.86,99.47
2021-09-11,Uttarakhand,1217,14,1213,15006,1830,581,8.11,0,12.5,524140,4493,521365,14.64,4.65,1.20048,0.86,99.47
2021-09-12,Uttarakhand,110,0,101,1210,2833,1665,9.09,9,12.5,524250,4493,521466,22.66,13.32,0.0968,0.86,99.47
2021-09-13,Uttarakhand,906,5,906,11302,1053,101,8.02,0,12.5,525156,4498,522372,8.42,0.81,0.90416,0.86,99.47
2021-09-14,Uttarakhand,1187,15,1186,14753,2800,1416,8.05,0,12.5,526343,4513,523558,22.4,11.33,1.18024,0.86,99.47
2021-09-15,Uttarakhand,1251,18,1248,15551,300,43,8.04,0,12.5,527594,4531,524806,2.4,0.34,1.24408,0.86,99.47
2021-09-16,Uttarakhand,73,0,69,594,4084,2880,12.29,4,12.5,527667,4531,524875,32.67,23.04,0.04752,0.86,99.47
2021-09-17,Uttarakhand,958,12,954,12112,1807,667,7.91,0,12.5,528625,4543,525829,14.46,5.34,0.96896,0.86,99.47
2021-09-18,Uttarakhand,775,10,769,10234,4021,366,7.57,0,12.5,529400,4553,526598,32.17,2.93,0.81872,0.86,99.47
2021-09-19,Uttarakhand,528,7,523,6639,3362,2637,7.95,0,12.5,529928,4560,527121,26.9,21.1,0.53112,0.86,99.47
2021-09-20,Uttarakhand,1536,21,1527,19177,883,405,8.01,0,12.5,531464,4581,528648,7.06,3.24,1.53416,0.86,99.47
2021-09-21,Uttarakhand,138,0,133,1633,3107,53,8.45,5,12.5,531602,4581,528781,24.86,0.42,0.13064,0.86,99.47
2021-09-22,Uttarakhand,435,3,431,5140,3519,582,8.46,1,12.5,532037,4584,529212,28.15,4.66,0.4112,0.86,99.47
2021-09-23,Uttarakhand,1361,9,1354,16853,61,0,8.08,0,12.5,533398,4593,530566,0.49,0.0,1.34824,0.86,99.47
2021-09-24,Uttarakhand,252,3,248,3094,3784,915,8.14,1,12.5,533650,4596,530814,30.27,7.32,0.24752,0.86,99.47
2021-09-25,Uttarakhand,961,4,959,11757,3182,620,8.17,0,12.5,534611,4600,531773,25.46,4.96,0.94056,0.86,99.47
2021-09-26,Uttarakhand,1389,4,1388,17825,4202,370,7.79,0,12.5,536000,4604,533161,33.62,2.96,1.426,0.86,99.47
2021-09-27,Uttarakhand,1305,18,1299,16320,4506,4156,8.0,0,12.5,537305,4622,534460,36.05,33.25,1.3056,0.86,99.47
2021-09-28,Uttarakhand,342,1,336,4118,4628,1105,8.31,5,12.5,537647,4623,534796,37.02,8.84,0.32944,0.86,99.47
2021-09-29,Uttarakhand,1537,6,1536,19387,3470,421,7.93,0,12.5,539184,4629,536332,27.76,3.37,1.55096,0.86,99.47
2021-09-30,Uttarakhand,1599,13,1593,19912,4843,4146,8.03,0,12.5,540783,4642,537925,38.74,33.17,1.59296,0.86,99.47
2021-10-01,Uttarakhand,755,9,746,9111,570,7,8.29,0,12.5,541538,4651,538671,4.56,0.06,0.72888,0.86,99.47
2021-10-02,Uttarakhand,1333,8,1328,17012,3721,395,7.84,0,12.5,542871,4659,539999,29.77,3.16,1.36096,0.86,99.47
2021-10-03,Uttarakhand,1431,4,1426,18093,3509,2324,7.91,1,12.5,544302,4663,541425,28.07,18.59,1.44744,0.86,99.47
2021-10-04,Uttarakhand,589,3,585,7411,4554,726,7.95,1,12.5,544891,4666,542010,36.43,5.81,0.59288,0.86,99.47
2021-10-05,Uttarakhand,1230,7,1221,15662,513,220,7.85,2,12.5,546121,4673,543231,4.1,1.76,1.25296,0.86,99.47
2021-10-06,Uttarakhand,456,5,451,5409,4282,2076,8.43,0,12.5,546577,4678,543682,34.26,16.61,0.43272,0.86,99.47
2021-10-07,Uttarakhand,277,3,277,3647,4393,983,7.6,0,12.5,546854,4681,543959,35.14,7.86,0.29176,0.86,99.47
2021-10-08,Uttarakhand,707,3,701,8421,4398,4377,8.4,3,12.5,547561,4684,544660,35.18,35.02,0.67368,0.86,99.47
2021-10-09,Uttarakhand,58,0,55,720,797,252,8.06,3,12.5,547619,4684,544715,6.38,2.02,0.0576,0.86,99.47
2021-10-10,Uttarakhand,307,2,303,3799,4241,1375,8.08,2,12.5,547926,4686,545018,33.93,11.0,0.30392,0.86,99.47
2021-10-11,Uttarakhand,1401,7,1395,17521,1319,760,8.0,0,12.5,549327,4693,546413,10.55,6.08,1.40168,0.85,99.47
2021-10-12,Uttarakhand,904,9,904,11866,786,398,7.62,0,12.5,550231,4702,547317,6.29,3.18,0.94928,0.85,99.47
2021-10-13,Uttarakhand,572,3,568,7336,4147,1255,7.8,1,12.5,550803,4705,547885,33.18,10.04,0.58688,0.85,99.47
2021-10-14,Uttarakhand,780,8,771,9551,1265,153,8.17,1,12.5,551583,4713,548656,10.12,1.22,0.76408,0.85,99.47
2021-10-15,Uttarakhand,440,2,439,5688,1055,445,7.74,0,12.5,552023,4715,549095,8.44,3.56,0.45504,0.85,99.47
2021-10-16,Uttarakhand,1592,4,1584,19836,2789,1868,8.03,4,12.5,553615,4719,550679,22.31,14.94,1.58688,0.85,99.47
2021-10-17,Uttarakhand,149,1,144,2072,2196,821,7.19,4,12.5,553764,4720,550823,17.57,6.57,0.16576,0.85,99.47
2021-10-18,Uttarakhand,128,1,123,1486,4881,3716,8.61,4,12.5,553892,4721,550946,39.05,29.73,0.11888,0.85,99.47
2021-10-19,Uttarakhand,616,4,616,8290,1251,760,7.43,0,12.5,554508,4725,551562,10.01,6.08,0.6632,0.85,99.47
2021-10-20,Uttarakhand,387,5,386,4483,3440,145,8.63,0,12.5,554895,4730,551948,27.52,1.16,0.35864,0.85,99.47
2021-10-21,Uttarakhand,1485,8,1479,18771,1512,882,7.91,0,12.5,556380,4738,553427,12.1,7.06,1.50168,0.85,99.47
2021-10-22,Uttarakhand,378,2,378,4958,3851,1499,7.62,0,12.5,556758,4740,553805,30.81,11.99,0.39664,0.85,99.47
2021-10-23,Uttarakhand,561,4,555,7181,2651,190,7.81,2,12.5,557319,4744,554360,21.21,1.52,0.57448,0.85,99.47
2021-10-24,Uttarakhand,402,1,402,5105,3730,882,7.87,0,12.5,557721,4745,554762,29.84,7.06,0.4084,0.85,99.47
2021-10-25,Uttarakhand,974,8,973,12171,2924,2782,8.0,0,12.5,558695,4753,555735,23.39,22.26,0.97368,0.85,99.47
2021-10-26,Uttarakhand,1536,11,1530,19066,2197,395,8.06,0,12.5,560231,4764,557265,17.58,3.16,1.52528,0.85,99.47
2021-10-27,Uttarakhand,414,6,409,5475,1253,1212,7.56,0,12.5,560645,4770,557674,10.02,9.7,0.438,0.85,99.47
2021-10-28,Uttarakhand,1457,21,1456,17949,874,3,8.12,0,12.5,562102,4791,559130,6.99,0.02,1.43592,0.85,99.47
2021-10-29,Uttarakhand,979,8,978,12367,19,19,7.92,0,12.5,563081,4799,560108,0.15,0.15,0.98936,0.85,99.47
2021-10-30,Uttarakhand,398,5,389,5148,2118,1952,7.73,4,12.5,563479,4804,560497,16.94,15.62,0.41184,0.85,99.47
2021-10-31,Uttarakhand,1454,12,1451,18341,355,232,7.93,0,12.5,564933,4816,561948,2.84,1.86,1.46728,0.85,99.47
2021-11-01,Uttarakhand,1211,16,1208,14759,2781,1424,8.21,0,12.5,566144,4832,563156,22.25,11.39,1.18072,0.85,99.47
2021-11-02,Uttarakhand,683,2,674,8722,544,278,7.83,7,12.5,566827,4834,563830,4.35,2.22,0.69776,0.85,99.47
2021-11-03,Uttarakhand,534,5,528,6107,1553,520,8.74,1,12.5,567361,4839,564358,12.42,4.16,0.48856,0.85,99.47
2021-11-04,Uttarakhand,242,1,238,2891,2061,1390,8.37,3,12.5,567603,4840,564596,16.49,11.12,0.23128,0.85,99.47
2021-11-05,Uttarakhand,496,1,494,6204,1048,852,7.99,1,12.5,568099,4841,565090,8.38,6.82,0.49632,0.85,99.47
2021-11-06,Uttarakhand,1338,10,1330,16856,1801,953,7.94,0,12.5,569437,4851,566420,14.41,7.62,1.34848,0.85,99.47
2021-11-07,Uttarakhand,664,3,664,7971,702,552,8.33,0,12.5,570101,4854,567084,5.62,4.42,0.63768,0.85,99.47
2021-11-08,Uttarakhand,244,3,240,3220,3376,2240,7.58,1,12.5,570345,4857,567324,27.01,17.92,0.2576,0.85,99.47
2021-11-09,Uttarakhand,908,9,905,11657,1093,799,7.79,0,12.5,571253,4866,568229,8.74,6.39,0.93256,0.85,99.47
2021-11-10,Uttarakhand,835,8,830,10349,2374,1473,8.07,0,12.5,572088,4874,569059,18.99,11.78,0.82792,0.85,99.47
2021-11-11,Uttarakhand,249,1,248,2855,2546,176,8.72,0,12.5,572337,4875,569307,20.37,1.41,0.2284,0.85,99.47
2021-11-12,Uttarakhand,1205,9,1199,15127,4269,2932,7.97,0,12.5,573542,4884,570506,34.15,23.46,1.21016,0.85,99.47
2021-11-13,Uttarakhand,553,6,544,7220,3022,2538,7.66,3,12.5,574095,4890,571050,24.18,20.3,0.5776,0.85,99.47
2021-11-14,Uttarakhand,157,1,153,1845,1078,662,8.51,3,12.5,574252,4891,571203,8.62,5.3,0.1476,0.85,99.47
2021-11-15,Uttarakhand,659,6,658,8316,3566,195,7.92,0,12.5,574911,4897,571861,28.53,1.56,0.66528,0.85,99.47
2021-11-16,Uttarakhand,1296,11,1296,15861,981,705,8.17,0,12.5,576207,4908,573157,7.85,5.64,1.26888,0.85,99.47
2021-11-17,Uttarakhand,830,9,824,10431,3323,1,7.96,0,12.5,577037,4917,573981,26.58,0.01,0.83448,0.85,99.47
2021-11-18,Uttarakhand,561,6,560,7431,3697,286,7.55,0,12.5,577598,4923,574541,29.58,2.29,0.59448,0.85,99.47
2021-11-19,Uttarakhand,487,6,479,6112,2562,957,7.97,2,12.5,578085,4929,575020,20.5,7.66,0.48896,0.85,99.47
2021-11-20,Uttarakhand,1441,9,1432,17831,1239,100,8.08,0,12.5,579526,4938,576452,9.91,0.8,1.42648,0.85,99.47
2021-11-21,Uttarakhand,1080,15,1080,13338,296,94,8.1,0,12.5,580606,4953,577532,2.37,0.75,1.06704,0.85,99.47
2021-11-22,Uttarakhand,672,7,664,7825,1865,1682,8.59,1,12.5,581278,4960,578196,14.92,13.46,0.626,0.85,99.47
2021-11-23,Uttarakhand,1369,10,1360,17070,4294,3894,8.02,0,12.5,582647,4970,579556,34.35,31.15,1.3656,0.85,99.47
2021-11-24,Uttarakhand,1168,8,1163,14795,4756,3948,7.89,0,12.5,583815,4978,580719,38.05,31.58,1.1836,0.85,99.47
2021-11-25,Uttarakhand,533,4,530,6758,2212,828,7.89,0,12.5,584348,4982,581249,17.7,6.62,0.54064,0.85,99.47
2021-11-26,Uttarakhand,189,2,180,2591,1099,651,7.29,7,12.5,584537,4984,581429,8.79,5.21,0.20728,0.85,99.47
2021-11-27,Uttarakhand,1261,15,1254,15731,3720,1968,8.02,0,12.5,585798,4999,582683,29.76,15.74,1.25848,0.85,99.47
2021-11-28,Uttarakhand,923,12,920,11324,1432,972,8.15,0,12.5,586721,5011,583603,11.46,7.78,0.90592,0.85,99.47
2021-11-29,Uttarakhand,1313,12,1304,16371,4732,3348,8.02,0,12.5,588034,5023,584907,37.86,26.78,1.30968,0.85,99.47
2021-11-30,Uttarakhand,1246,9,1241,15370,718,523,8.11,0,12.5,589280,5032,586148,5.74,4.18,1.2296,0.85,99.47
2021-12-01,Uttarakhand,425,4,422,5636,13,1,7.54,0,12.5,589705,5036,586570,0.1,0.01,0.45088,0.85,99.47
2021-12-02,Uttarakhand,235,1,233,2818,9,8,8.34,1,12.5,589940,5037,586803,0.07,0.06,0.22544,0.85,99.47
2021-12-03,Uttarakhand,651,4,647,8504,3052,3005,7.66,0,12.5,590591,5041,587450,24.42,24.04,0.68032,0.85,99.47
2021-12-04,Uttarakhand,946,7,944,11907,4256,1647,7.94,0,12.5,591537,5048,588394,34.05,13.18,0.95256,0.85,99.47
2021-12-05,Uttarakhand,212,1,208,2708,2122,262,7.83,3,12.5,591749,5049,588602,16.98,2.1,0.21664,0.85,99.47
2021-12-06,Uttarakhand,1397,8,1391,17565,473,90,7.95,0,12.5,593146,5057,589993,3.78,0.72,1.4052,0.85,99.47
2021-12-07,Uttarakhand,1101,4,1092,13579,2497,845,8.11,5,12.5,594247,5061,591085,19.98,6.76,1.08632,0.85,99.47
2021-12-08,Uttarakhand,1168,6,1159,14865,3175,1060,7.86,3,12.5,595415,5067,592244,25.4,8.48,1.1892,0.85,99.47
2021-12-09,Uttarakhand,1564,15,1562,19832,3763,366,7.89,0,12.5,596979,5082,593806,30.1,2.93,1.58656,0.85,99.47
2021-12-10,Uttarakhand,1272,16,1272,15844,4804,4746,8.03,0,12.5,598251,5098,595078,38.43,37.97,1.26752,0.85,99.47
2021-12-11,Uttarakhand,832,11,829,10484,1882,1,7.94,0,12.5,599083,5109,595907,15.06,0.01,0.83872,0.85,99.47
2021-12-12,Uttarakhand,350,1,349,4097,3346,2400,8.54,0,12.5,599433,5110,596256,26.77,19.2,0.32776,0.85,99.47
2021-12-13,Uttarakhand,138,1,137,2174,4214,3900,6.35,0,12.5,599571,5111,596393,33.71,31.2,0.17392,0.85,99.47
2021-12-14,Uttarakhand,673,5,670,8091,4282,92,8.32,0,12.5,600244,5116,597063,34.26,0.74,0.64728,0.85,99.47
2021-12-15,Uttarakhand,1384,4,1379,17359,615,218,7.97,1,12.5,601628,5120,598442,4.92,1.74,1.38872,0.85,99.47
2021-12-16,Uttarakhand,994,10,988,12208,461,15,8.14,0,12.5,602622,5130,599430,3.69,0.12,0.97664,0.85,99.47
2021-12-17,Uttarakhand,928,9,924,11668,1177,569,7.95,0,12.5,603550,5139,600354,9.42,4.55,0.93344,0.85,99.47
2021-12-18,Uttarakhand,1329,15,1326,16958,1527,642,7.84,0,12.5,604879,5154,601680,12.22,5.14,1.35664,0.85,99.47
2021-12-19,Uttarakhand,528,3,523,6500,694,322,8.12,2,12.5,605407,5157,602203,5.55,2.58,0.52,0.85,99.47
2021-12-20,Uttarakhand,1447,19,1447,18181,3049,1738,7.96,0,12.5,606854,5176,603650,24.39,13.9,1.45448,0.85,99.47
2021-12-21,Uttarakhand,1223,17,1215,15504,4720,3650,7.89,0,12.5,608077,5193,604865,37.76,29.2,1.24032,0.85,99.47
2021-12-22,Uttarakhand,1143,5,1135,13637,2226,1722,8.38,3,12.5,609220,5198,606000,17.81,13.78,1.09096,0.85,99.47
2021-12-23,Uttarakhand,1562,9,1556,18909,551,176,8.26,0,12.5,610782,5207,607556,4.41,1.41,1.51272,0.85,99.47
2021-12-24,Uttarakhand,140,0,131,1599,2423,241,8.76,9,12.5,610922,5207,607687,19.38,1.93,0.12792,0.85,99.47
2021-12-25,Uttarakhand,641,5,639,8314,594,536,7.71,0,12.5,611563,5212,608326,4.75,4.29,0.66512,0.85,99.47
2021-12-26,Uttarakhand,109,1,100,1215,4671,633,8.97,8,12.5,611672,5213,608426,37.37,5.06,0.0972,0.85,99.47
2021-12-27,Uttarakhand,1155,7,1149,14186,2670,1094,8.14,0,12.5,612827,5220,609575,21.36,8.75,1.13488,0.85,99.47
2021-12-28,Uttarakhand,911,5,909,11112,2975,647,8.2,0,12.5,613738,5225,610484,23.8,5.18,0.88896,0.85,99.47
2021-12-29,Uttarakhand,74,0,71,899,476,326,8.23,3,12.5,613812,5225,610555,3.81,2.61,0.07192,0.85,99.47
2021-12-30,Uttarakhand,1023,10,1018,12977,3688,3177,7.88,0,12.5,614835,5235,611573,29.5,25.42,1.03816,0.85,99.47
2021-12-31,Uttarakhand,534,5,534,6563,23,13,8.14,0,12.5,615369,5240,612107,0.18,0.1,0.52504,0.85,99.47
2022-01-01,Uttarakhand,969,6,969,11932,2060,1480,8.12,0,12.5,616338,5246,613076,16.48,11.84,0.95456,0.85,99.47
2022-01-02,Uttarakhand,662,8,662,7646,695,574,8.66,0,12.5,617000,5254,613738,5.56,4.59,0.61168,0.85,99.47
2022-01-03,Uttarakhand,884,7,879,11365,2800,2169,7.78,0,12.5,617884,5261,614617,22.4,17.35,0.9092,0.85,99.47
2022-01-04,Uttarakhand,800,5,797,9993,3116,195,8.01,0,12.5,618684,5266,615414,24.93,1.56,0.79944,0.85,99.47
2022-01-05,Uttarakhand,347,2,340,4306,961,366,8.06,5,12.5,619031,5268,615754,7.69,2.93,0.34448,0.85,99.47
2022-01-06,Uttarakhand,78,0,72,1459,3687,1279,5.35,6,12.5,619109,5268,615826,29.5,10.23,0.11672,0.85,99.47
2022-01-07,Uttarakhand,133,1,130,1905,1771,1372,6.98,2,12.5,619242,5269,615956,14.17,10.98,0.1524,0.85,99.47
2022-01-08,Uttarakhand,558,3,552,7042,436,284,7.92,3,12.5,619800,5272,616508,3.49,2.27,0.56336,0.85,99.47
2022-01-09,Uttarakhand,266,2,264,3085,294,47,8.62,0,12.5,620066,5274,616772,2.35,0.38,0.2468,0.85,99.47
2022-01-10,Uttarakhand,764,4,763,9851,1802,366,7.76,0,12.5,620830,5278,617535,14.42,2.93,0.78808,0.85,99.47
2022-01-11,Uttarakhand,1516,19,1507,18834,862,149,8.05,0,12.5,622346,5297,619042,6.9,1.19,1.50672,0.85,99.47
2022-01-12,Uttarakhand,1487,11,1480,18708,925,128,7.95,0,12.5,623833,5308,620522,7.4,1.02,1.49664,0.85,99.47
2022-01-13,Uttarakhand,807,4,803,10239,1644,1112,7.88,0,12.5,624640,5312,621325,13.15,8.9,0.81912,0.85,99.47
2022-01-14,Uttarakhand,844,8,840,10499,4160,4034,8.04,0,12.5,625484,5320,622165,33.28,32.27,0.83992,0.85,99.47
2022-01-15,Uttarakhand,945,10,945,12144,4609,1447,7.78,0,12.5,626429,5330,623110,36.87,11.58,0.97152,0.85,99.47
2022-01-16,Uttarakhand,1248,10,1244,15727,1271,209,7.94,0,12.5,627677,5340,624354,10.17,1.67,1.25816,0.85,99.47
2022-01-17,Uttarakhand,1020,10,1017,12742,1221,510,8.01,0,12.5,628697,5350,625371,9.77,4.08,1.01936,0.85,99.47
2022-01-18,Uttarakhand,538,4,538,6790,1721,1671,7.92,0,12.5,629235,5354,625909,13.77,13.37,0.5432,0.85,99.47
2022-01-19,Uttarakhand,530,3,527,6661,1049,218,7.96,0,12.5,629765,5357,626436,8.39,1.74,0.53288,0.85,99.47
2022-01-20,Uttarakhand,203,1,199,2445,1053,821,8.3,3,12.5,629968,5358,626635,8.42,6.57,0.1956,0.85,99.47
2022-01-21,Uttarakhand,584,3,582,7240,1162,977,8.07,0,12.5,630552,5361,627217,9.3,7.82,0.5792,0.85,99.47
2022-01-22,Uttarakhand,1006,10,1004,13014,884,175,7.73,0,12.5,631558,5371,628221,7.07,1.4,1.04112,0.85,99.47
2022-01-23,Uttarakhand,196,2,194,2482,1128,188,7.9,0,12.5,631754,5373,628415,9.02,1.5,0.19856,0.85,99.47
2022-01-24,Uttarakhand,157,2,148,1676,3917,2748,9.37,7,12.5,631911,5375,628563,31.34,21.98,0.13408,0.85,99.47
2022-01-25,Uttarakhand,634,4,634,8015,2646,714,7.91,0,12.5,632545,5379,629197,21.17,5.71,0.6412,0.85,99.47
2022-01-26,Uttarakhand,413,1,407,4856,2521,321,8.5,5,12.5,632958,5380,629604,20.17,2.57,0.38848,0.85,99.47
2022-01-27,Uttarakhand,1301,12,1298,15930,3778,2703,8.17,0,12.5,634259,5392,630902,30.22,21.62,1.2744,0.85,99.47
2022-01-28,Uttarakhand,1475,16,1469,18261,2701,1750,8.08,0,12.5,635734,5408,632371,21.61,14.0,1.46088,0.85,99.47
2022-01-29,Uttarakhand,844,2,843,10319,737,523,8.18,0,12.5,636578,5410,633214,5.9,4.18,0.82552,0.85,99.47
2022-01-30,Uttarakhand,851,10,851,10701,2148,1054,7.95,0,12.5,637429,5420,634065,17.18,8.43,0.85608,0.85,99.47
2022-01-31,Uttarakhand,949,5,948,11485,1599,1175,8.26,0,12.5,638378,5425,635013,12.79,9.4,0.9188,0.85,99.47
2022-02-01,Uttarakhand,465,2,465,5201,2063,437,8.94,0,12.5,638843,5427,635478,16.5,3.5,0.41608,0.85,99.47
2022-02-02,Uttarakhand,1282,15,1281,16196,3755,100,7.92,0,12.5,640125,5442,636759,30.04,0.8,1.29568,0.85,99.47
2022-02-03,Uttarakhand,964,13,960,11967,4434,3386,8.06,0,12.5,641089,5455,637719,35.47,27.09,0.95736,0.85,99.47
2022-02-04,Uttarakhand,1274,14,1270,15850,772,304,8.04,0,12.5,642363,5469,638989,6.18,2.43,1.268,0.85,99.47
2022-02-05,Uttarakhand,860,3,856,10527,4201,2940,8.17,1,12.5,643223,5472,639845,33.61,23.52,0.84216,0.85,99.47
2022-02-06,Uttarakhand,447,6,442,5361,1400,597,8.34,0,12.5,643670,5478,640287,11.2,4.78,0.42888,0.85,99.47
2022-02-07,Uttarakhand,883,3,877,10659,3875,181,8.28,3,12.5,644553,5481,641164,31.0,1.45,0.85272,0.85,99.47
2022-02-08,Uttarakhand,1342,7,1342,16592,361,34,8.09,0,12.5,645895,5488,642506,2.89,0.27,1.32736,0.85,99.48
2022-02-09,Uttarakhand,1425,14,1421,17778,3177,2896,8.02,0,12.5,647320,5502,643927,25.42,23.17,1.42224,0.85,99.48
2022-02-10,Uttarakhand,670,7,662,8475,1435,528,7.91,1,12.5,647990,5509,644589,11.48,4.22,0.678,0.85,99.48
2022-02-11,Uttarakhand,627,6,621,8012,4690,4357,7.83,0,12.5,648617,5515,645210,37.52,34.86,0.64096,0.85,99.47
2022-02-12,Uttarakhand,738,5,732,8712,2338,1267,8.47,1,12.5,649355,5520,645942,18.7,10.14,0.69696,0.85,99.47
2022-02-13,Uttarakhand,925,12,920,11798,3678,1269,7.84,0,12.5,650280,5532,646862,29.42,10.15,0.94384,0.85,99.47
2022-02-14,Uttarakhand,548,5,540,6401,2810,2450,8.56,3,12.5,650828,5537,647402,22.48,19.6,0.51208,0.85,99.47
2022-02-15,Uttarakhand,593,4,586,7028,1802,160,8.44,3,12.5,651421,5541,647988,14.42,1.28,0.56224,0.85,99.47
2022-02-16,Uttarakhand,855,7,851,10750,1445,803,7.95,0,12.5,652276,5548,648839,11.56,6.42,0.86,0.85,99.47
2022-02-17,Uttarakhand,625,9,619,7839,3187,2040,7.97,0,12.5,652901,5557,649458,25.5,16.32,0.62712,0.85,99.47
2022-02-18,Uttarakhand,792,5,783,10077,3940,429,7.86,4,12.5,653693,5562,650241,31.52,3.43,0.80616,0.85,99.47
2022-02-19,Uttarakhand,1053,10,1048,13170,163,38,8.0,0,12.5,654746,5572,651289,1.3,0.3,1.0536,0.85,99.47
2022-02-20,Uttarakhand,827,3,821,10385,3775,3659,7.96,3,12.5,655573,5575,652110,30.2,29.27,0.8308,0.85,99.47
2022-02-21,Uttarakhand,171,2,170,2171,2630,2626,7.88,0,12.5,655744,5577,652280,21.04,21.01,0.17368,0.85,99.47
2022-02-22,Uttarakhand,1204,16,1203,15535,4380,2291,7.75,0,12.5,656948,5593,653483,35.04,18.33,1.2428,0.85,99.47
2022-02-23,Uttarakhand,1519,5,1510,18889,1458,627,8.04,4,12.5,658467,5598,654993,11.66,5.02,1.51112,0.85,99.47
2022-02-24,Uttarakhand,1106,7,1106,13807,100,73,8.01,0,12.5,659573,5605,656099,0.8,0.58,1.10456,0.85,99.47
2022-02-25,Uttarakhand,926,9,921,11711,1191,144,7.91,0,12.5,660499,5614,657020,9.53,1.15,0.93688,0.85,99.47
2022-02-26,Uttarakhand,1442,4,1440,17877,301,301,8.07,0,12.5,661941,5618,658460,2.41,2.41,1.43016,0.85,99.47
2022-02-27,Uttarakhand,607,4,602,7624,3528,2671,7.96,1,12.5,662548,5622,659062,28.22,21.37,0.60992,0.85,99.47
2022-02-28,Uttarakhand,764,4,757,9851,282,159,7.76,3,12.5,663312,5626,659819,2.26,1.27,0.78808,0.85,99.47
2022-03-01,Uttarakhand,1068,15,1066,13186,1626,1028,8.1,0,12.5,664380,5641,660885,13.01,8.22,1.05488,0.85,99.47
2022-03-02,Uttarakhand,682,3,678,8233,88,56,8.28,1,12.5,665062,5644,661563,0.7,0.45,0.65864,0.85,99.47
2022-03-03,Uttarakhand,1248,9,1241,15611,4671,1292,7.99,0,12.5,666310,5653,662804,37.37,10.34,1.24888,0.85,99.47
2022-03-04,Uttarakhand,929,5,928,11594,4612,3458,8.01,0,12.5,667239,5658,663732,36.9,27.66,0.92752,0.85,99.47
2022-03-05,Uttarakhand,463,5,456,6234,4280,2289,7.43,2,12.5,667702,5663,664188,34.24,18.31,0.49872,0.85,99.47
2022-03-06,Uttarakhand,1238,15,1234,15952,1001,492,7.76,0,12.5,668940,5678,665422,8.01,3.94,1.27616,0.85,99.47
2022-03-07,Uttarakhand,121,1,116,1683,87,76,7.19,4,12.5,669061,5679,665538,0.7,0.61,0.13464,0.85,99.47
2022-03-08,Uttarakhand,1322,12,1317,16783,1719,1203,7.88,0,12.5,670383,5691,666855,13.75,9.62,1.34264,0.85,99.47
2022-03-09,Uttarakhand,1180,11,1179,14965,4498,3555,7.89,0,12.5,671563,5702,668034,35.98,28.44,1.1972,0.85,99.47
2022-03-10,Uttarakhand,571,4,562,7081,2,1,8.06,5,12.5,672134,5706,668596,0.02,0.01,0.56648,0.85,99.47
2022-03-11,Uttarakhand,669,8,669,8404,173,7,7.96,0,12.5,672803,5714,669265,1.38,0.06,0.67232,0.85,99.47
2022-03-12,Uttarakhand,1101,10,1101,13878,3255,718,7.93,0,12.5,673904,5724,670366,26.04,5.74,1.11024,0.85,99.47
2022-03-13,Uttarakhand,210,1,208,3076,2607,1428,6.83,1,12.5,674114,5725,670574,20.86,11.42,0.24608,0.85,99.47
2022-03-14,Uttarakhand,1428,18,1426,17441,137,13,8.19,0,12.5,675542,5743,672000,1.1,0.1,1.39528,0.85,99.48
2022-03-15,Uttarakhand,698,9,690,8843,24,24,7.89,0,12.5,676240,5752,672690,0.19,0.19,0.70744,0.85,99.48
2022-03-16,Uttarakhand,148,2,142,1918,2821,739,7.72,4,12.5,676388,5754,672832,22.57,5.91,0.15344,0.85,99.47
2022-03-17,Uttarakhand,1076,6,1067,13802,1972,1840,7.8,3,12.5,677464,5760,673899,15.78,14.72,1.10416,0.85,99.47
2022-03-18,Uttarakhand,833,7,825,10434,2949,1664,7.98,1,12.5,678297,5767,674724,23.59,13.31,0.83472,0.85,99.47
2022-03-19,Uttarakhand,1361,8,1356,16956,2282,1362,8.03,0,12.5,679658,5775,676080,18.26,10.9,1.35648,0.85,99.47
2022-03-20,Uttarakhand,89,1,89,1425,35,7,6.25,0,12.5,679747,5776,676169,0.28,0.06,0.114,0.85,99.47
2022-03-21,Uttarakhand,1437,7,1430,18305,1313,339,7.85,0,12.5,681184,5783,677599,10.5,2.71,1.4644,0.85,99.47
2022-03-22,Uttarakhand,1176,3,1175,15235,2521,172,7.72,0,12.5,682360,5786,678774,20.17,1.38,1.2188,0.85,99.47
2022-03-23,Uttarakhand,1112,15,1109,13549,1013,44,8.21,0,12.5,683472,5801,679883,8.1,0.35,1.08392,0.85,99.47
2022-03-24,Uttarakhand,867,2,866,10715,1873,1318,8.09,0,12.5,684339,5803,680749,14.98,10.54,0.8572,0.85,99.48
2022-03-25,Uttarakhand,1281,12,1278,16102,4419,3768,7.96,0,12.5,685620,5815,682027,35.35,30.14,1.28816,0.85,99.48
2022-03-26,Uttarakhand,365,1,364,4475,1724,521,8.16,0,12.5,685985,5816,682391,13.79,4.17,0.358,0.85,99.48
2022-03-27,Uttarakhand,854,8,851,10856,1164,222,7.87,0,12.5,686839,5824,683242,9.31,1.78,0.86848,0.85,99.48
2022-03-28,Uttarakhand,813,5,813,10192,3179,1774,7.98,0,12.5,687652,5829,684055,25.43,14.19,0.81536,0.85,99.48
2022-03-29,Uttarakhand,283,1,283,3585,2866,1825,7.89,0,12.5,687935,5830,684338,22.93,14.6,0.2868,0.85,99.48
2022-03-30,Uttarakhand,871,6,867,10678,922,219,8.16,0,12.5,688806,5836,685205,7.38,1.75,0.85424,0.85,99.48
2022-03-31,Uttarakhand,1120,10,1111,14043,4594,1340,7.98,0,12.5,689926,5846,686316,36.75,10.72,1.12344,0.85,99.48
2022-04-01,Uttarakhand,1450,11,1445,18497,3331,144,7.84,0,12.5,691376,5857,687761,26.65,1.15,1.47976,0.85,99.48
2022-04-02,Uttarakhand,640,6,639,8385,2480,1673,7.63,0,12.5,692016,5863,688400,19.84,13.38,0.6708,0.85,99.48
2022-04-03,Uttarakhand,541,8,538,7062,1525,631,7.66,0,12.5,692557,5871,688938,12.2,5.05,0.56496,0.85,99.48
2022-04-04,Uttarakhand,1313,13,1305,16691,429,375,7.87,0,12.5,693870,5884,690243,3.43,3.0,1.33528,0.85,99.48
2022-04-05,Uttarakhand,916,8,912,11458,1638,1314,7.99,0,12.5,694786,5892,691155,13.1,10.51,0.91664,0.85,99.48
2022-04-06,Uttarakhand,325,3,325,4002,2738,2127,8.12,0,12.5,695111,5895,691480,21.9,17.02,0.32016,0.85,99.48
2022-04-07,Uttarakhand,1452,10,1447,18282,35,23,7.94,0,12.5,696563,5905,692927,0.28,0.18,1.46256,0.85,99.48
2022-04-08,Uttarakhand,1268,13,1268,15705,449,285,8.07,0,12.5,697831,5918,694195,3.59,2.28,1.2564,0.85,99.48
2022-04-09,Uttarakhand,1576,13,1575,19830,4676,2539,7.95,0,12.5,699407,5931,695770,37.41,20.31,1.5864,0.85,99.48
2022-04-10,Uttarakhand,971,13,964,12272,1901,941,7.91,0,12.5,700378,5944,696734,15.21,7.53,0.98176,0.85,99.48
2022-04-11,Uttarakhand,1227,4,1221,15746,2369,41,7.79,2,12.5,701605,5948,697955,18.95,0.33,1.25968,0.85,99.48
2022-04-12,Uttarakhand,596,6,594,7221,1540,942,8.25,0,12.5,702201,5954,698549,12.32,7.54,0.57768,0.85,99.48
2022-04-13,Uttarakhand,1306,9,1306,15970,1059,894,8.18,0,12.5,703507,5963,699855,8.47,7.15,1.2776,0.85,99.48
2022-04-14,Uttarakhand,84,0,77,1043,1880,1226,8.05,7,12.5,703591,5963,699932,15.04,9.81,0.08344,0.85,99.48
2022-04-15,Uttarakhand,701,6,693,8336,3962,1526,8.41,2,12.5,704292,5969,700625,31.7,12.21,0.66688,0.85,99.48
2022-04-16,Uttarakhand,846,11,840,10363,1399,844,8.16,0,12.5,705138,5980,701465,11.19,6.75,0.82904,0.85,99.48
2022-04-17,Uttarakhand,480,6,473,5980,3717,1614,8.03,1,12.5,705618,5986,701938,29.74,12.91,0.4784,0.85,99.48
2022-04-18,Uttarakhand,1035,8,1034,12532,4301,668,8.26,0,12.5,706653,5994,702972,34.41,5.34,1.00256,0.85,99.48
2022-04-19,Uttarakhand,1347,19,1342,17015,2893,1992,7.92,0,12.5,708000,6013,704314,23.14,15.94,1.3612,0.85,99.48
2022-04-20,Uttarakhand,1130,16,1127,13959,233,224,8.1,0,12.5,709130,6029,705441,1.86,1.79,1.11672,0.85,99.48
2022-04-21,Uttarakhand,457,2,452,5662,1596,408,8.07,3,12.5,709587,6031,705893,12.77,3.26,0.45296,0.85,99.48
2022-04-22,Uttarakhand,1267,6,1261,15842,2776,2623,8.0,0,12.5,710854,6037,707154,22.21,20.98,1.26736,0.85,99.48
2022-04-23,Uttarakhand,319,2,316,3535,3480,2033,9.02,1,12.5,711173,6039,707470,27.84,16.26,0.2828,0.85,99.48
2022-04-24,Uttarakhand,726,4,717,9129,3117,1774,7.95,5,12.5,711899,6043,708187,24.94,14.19,0.73032,0.85,99.48
2022-04-25,Uttarakhand,1194,5,1194,14780,3723,575,8.08,0,12.5,713093,6048,709381,29.78,4.6,1.1824,0.85,99.48
2022-04-26,Uttarakhand,393,2,385,4936,4752,2318,7.96,6,12.5,713486,6050,709766,38.02,18.54,0.39488,0.85,99.48
2022-04-27,Uttarakhand,1345,11,1338,16641,2440,1551,8.08,0,12.5,714831,6061,711104,19.52,12.41,1.33128,0.85,99.48
2022-04-28,Uttarakhand,1235,7,1234,15636,3572,2994,7.9,0,12.5,716066,6068,712338,28.58,23.95,1.25088,0.85,99.48
2022-04-29,Uttarakhand,565,3,559,6757,1338,1242,8.36,3,12.5,716631,6071,712897,10.7,9.94,0.54056,0.85,99.48
2022-04-30,Uttarakhand,325,4,316,4062,1314,1149,8.0,5,12.5,716956,6075,713213,10.51,9.19,0.32496,0.85,99.48
2022-05-01,Uttarakhand,387,4,387,4677,3338,782,8.27,0,12.5,717343,6079,713600,26.7,6.26,0.37416,0.85,99.48
2022-05-02,Uttarakhand,362,2,362,4519,811,671,8.01,0,12.5,717705,6081,713962,6.49,5.37,0.36152,0.85,99.48
2022-05-03,Uttarakhand,1483,16,1476,18107,1703,244,8.19,0,12.5,719188,6097,715438,13.62,1.95,1.44856,0.85,99.48
2022-05-04,Uttarakhand,1025,14,1017,12820,3962,3628,8.0,0,12.5,720213,6111,716455,31.7,29.02,1.0256,0.85,99.48
2022-05-05,Uttarakhand,394,5,385,5143,3771,2680,7.66,4,12.5,720607,6116,716840,30.17,21.44,0.41144,0.85,99.48
2022-05-06,Uttarakhand,554,1,553,6981,4995,709,7.94,0,12.5,721161,6117,717393,39.96,5.67,0.55848,0.85,99.48
2022-05-07,Uttarakhand,1350,4,1343,16901,4788,4609,7.99,3,12.5,722511,6121,718736,38.3,36.87,1.35208,0.85,99.48
2022-05-08,Uttarakhand,1093,5,1092,13718,4173,2396,7.97,0,12.5,723604,6126,719828,33.38,19.17,1.09744,0.85,99.48
2022-05-09,Uttarakhand,512,4,510,6262,2563,1091,8.18,0,12.5,724116,6130,720338,20.5,8.73,0.50096,0.85,99.48
2022-05-10,Uttarakhand,1271,11,1267,15681,502,42,8.11,0,12.5,725387,6141,721605,4.02,0.34,1.25448,0.85,99.48
2022-05-11,Uttarakhand,1295,16,1293,16155,4385,3258,8.02,0,12.5,726682,6157,722898,35.08,26.06,1.2924,0.85,99.48
2022-05-12,Uttarakhand,908,12,905,11162,2437,2369,8.13,0,12.5,727590,6169,723803,19.5,18.95,0.89296,0.85,99.48
2022-05-13,Uttarakhand,158,1,155,2082,2573,510,7.59,2,12.5,727748,6170,723958,20.58,4.08,0.16656,0.85,99.48
2022-05-14,Uttarakhand,272,3,264,2908,2483,2037,9.35,5,12.5,728020,6173,724222,19.86,16.3,0.23264,0.85,99.48
2022-05-15,Uttarakhand,414,4,414,5106,238,213,8.11,0,12.5,728434,6177,724636,1.9,1.7,0.40848,0.85,99.48
2022-05-16,Uttarakhand,142,1,133,2054,3572,3143,6.91,8,12.5,728576,6178,724769,28.58,25.14,0.16432,0.85,99.48
2022-05-17,Uttarakhand,511,6,503,6356,2001,1405,8.04,2,12.5,729087,6184,725272,16.01,11.24,0.50848,0.85,99.48
2022-05-18,Uttarakhand,145,1,137,1727,2292,939,8.4,7,12.5,729232,6185,725409,18.34,7.51,0.13816,0.85,99.48
2022-05-19,Uttarakhand,1091,10,1088,13213,1221,371,8.26,0,12.5,730323,6195,726497,9.77,2.97,1.05704,0.85,99.48
2022-05-20,Uttarakhand,624,4,622,7747,3061,385,8.05,0,12.5,730947,6199,727119,24.49,3.08,0.61976,0.85,99.48
2022-05-21,Uttarakhand,768,2,766,9859,3654,2298,7.79,0,12.5,731715,6201,727885,29.23,18.38,0.78872,0.85,99.48
2022-05-22,Uttarakhand,334,3,333,3986,3958,1568,8.38,0,12.5,732049,6204,728218,31.66,12.54,0.31888,0.85,99.48
2022-05-23,Uttarakhand,339,1,333,4093,1274,399,8.28,5,12.5,732388,6205,728551,10.19,3.19,0.32744,0.85,99.48
2022-05-24,Uttarakhand,232,0,226,3387,2936,1703,6.85,6,12.5,732620,6205,728777,23.49,13.62,0.27096,0.85,99.48
2022-05-25,Uttarakhand,933,4,930,11150,3817,3722,8.37,0,12.5,733553,6209,729707,30.54,29.78,0.892,0.85,99.48
2022-05-26,Uttarakhand,162,1,159,2000,336,196,8.1,2,12.5,733715,6210,729866,2.69,1.57,0.16,0.85,99.48
2022-05-27,Uttarakhand,201,2,195,2333,3197,1585,8.62,4,12.5,733916,6212,730061,25.58,12.68,0.18664,0.85,99.47
2022-05-28,Uttarakhand,696,9,695,8768,1363,103,7.94,0,12.5,734612,6221,730756,10.9,0.82,0.70144,0.85,99.48
2022-05-29,Uttarakhand,1282,5,1280,16207,3375,336,7.91,0,12.5,735894,6226,732036,27.0,2.69,1.29656,0.85,99.48
2022-05-30,Uttarakhand,395,4,394,5021,3206,2286,7.87,0,12.5,736289,6230,732430,25.65,18.29,0.40168,0.85,99.48
2022-05-31,Uttarakhand,571,7,564,6913,1722,1602,8.26,0,12.5,736860,6237,732994,13.78,12.82,0.55304,0.85,99.48
2022-06-01,Uttarakhand,1270,13,1269,15743,4831,4700,8.07,0,12.5,738130,6250,734263,38.65,37.6,1.25944,0.85,99.48
2022-06-02,Uttarakhand,293,4,284,3775,197,16,7.76,5,12.5,738423,6254,734547,1.58,0.13,0.302,0.85,99.48
2022-06-03,Uttarakhand,1332,15,1330,16444,2282,503,8.1,0,12.5,739755,6269,735877,18.26,4.02,1.31552,0.85,99.48
2022-06-04,Uttarakhand,818,6,809,9983,4175,3967,8.19,3,12.5,740573,6275,736686,33.4,31.74,0.79864,0.85,99.48
2022-06-05,Uttarakhand,64,0,64,1201,4049,3427,5.33,0,12.5,740637,6275,736750,32.39,27.42,0.09608,0.85,99.48
2022-06-06,Uttarakhand,1234,12,1229,15101,2065,1259,8.17,0,12.5,741871,6287,737979,16.52,10.07,1.20808,0.85,99.48
2022-06-07,Uttarakhand,1254,10,1253,15733,2292,609,7.97,0,12.5,743125,6297,739232,18.34,4.87,1.25864,0.85,99.48
2022-06-08,Uttarakhand,1168,14,1162,14405,1538,713,8.11,0,12.5,744293,6311,740394,12.3,5.7,1.1524,0.85,99.48
2022-06-09,Uttarakhand,1128,14,1120,14174,4384,1479,7.96,0,12.5,745421,6325,741514,35.07,11.83,1.13392,0.85,99.48
2022-06-10,Uttarakhand,294,2,291,3343,1626,1571,8.79,1,12.5,745715,6327,741805,13.01,12.57,0.26744,0.85,99.48
2022-06-11,Uttarakhand,462,4,456,5631,3522,3480,8.2,2,12.5,746177,6331,742261,28.18,27.84,0.45048,0.85,99.48
2022-06-12,Uttarakhand,1357,13,1354,17067,72,67,7.95,0,12.5,747534,6344,743615,0.58,0.54,1.36536,0.85,99.48
2022-06-13,Uttarakhand,202,0,195,2441,1127,621,8.28,7,12.5,747736,6344,743810,9.02,4.97,0.19528,0.85,99.47
2022-06-14,Uttarakhand,1278,16,1272,15576,854,385,8.2,0,12.5,749014,6360,745082,6.83,3.08,1.24608,0.85,99.48
2022-06-15,Uttarakhand,1513,8,1513,18887,4509,3841,8.01,0,12.5,750527,6368,746595,36.07,30.73,1.51096,0.85,99.48
2022-06-16,Uttarakhand,551,2,544,6702,1414,536,8.22,5,12.5,751078,6370,747139,11.31,4.29,0.53616,0.85,99.48
2022-06-17,Uttarakhand,504,1,502,5957,43,20,8.46,1,12.5,751582,6371,747641,0.34,0.16,0.47656,0.85,99.48
2022-06-18,Uttarakhand,1142,11,1137,14369,2018,734,7.95,0,12.5,752724,6382,748778,16.14,5.87,1.14952,0.85,99.48
2022-06-19,Uttarakhand,90,1,83,922,1268,742,9.76,6,12.5,752814,6383,748861,10.14,5.94,0.07376,0.85,99.47
2022-06-20,Uttarakhand,1354,8,1354,17113,3720,151,7.91,0,12.5,754168,6391,750215,29.76,1.21,1.36904,0.85,99.48
2022-06-21,Uttarakhand,1233,14,1226,15436,2956,2938,7.99,0,12.5,755401,6405,751441,23.65,23.5,1.23488,0.85,99.48
2022-06-22,Uttarakhand,1519,11,1511,18748,3566,922,8.1,0,12.5,756920,6416,752952,28.53,7.38,1.49984,0.85,99.48
2022-06-23,Uttarakhand,103,0,95,1462,424,386,7.05,8,12.5,757023,6416,753047,3.39,3.09,0.11696,0.85,99.47
2022-06-24,Uttarakhand,1279,14,1275,16109,263,262,7.94,0,12.5,758302,6430,754322,2.1,2.1,1.28872,0.85,99.48
2022-06-25,Uttarakhand,730,7,725,9241,1117,464,7.9,0,12.5,759032,6437,755047,8.94,3.71,0.73928,0.85,99.47
2022-06-26,Uttarakhand,1515,19,1507,19132,3603,715,7.92,0,12.5,760547,6456,756554,28.82,5.72,1.53056,0.85,99.47
2022-06-27,Uttarakhand,678,4,677,8386,4799,4165,8.08,0,12.5,761225,6460,757231,38.39,33.32,0.67088,0.85,99.48
2022-06-28,Uttarakhand,443,3,437,5513,697,162,8.04,3,12.5,761668,6463,757668,5.58,1.3,0.44104,0.85,99.47
2022-06-29,Uttarakhand,930,4,927,11817,4858,4612,7.87,0,12.5,762598,6467,758595,38.86,36.9,0.94536,0.85,99.48
2022-06-30,Uttarakhand,1352,18,1345,16576,4822,4193,8.16,0,12.5,763950,6485,759940,38.58,33.54,1.32608,0.85,99.48
2022-07-01,Uttarakhand,555,5,549,6634,594,222,8.37,1,12.5,764505,6490,760489,4.75,1.78,0.53072,0.85,99.47
2022-07-02,Uttarakhand,345,1,342,4421,979,286,7.8,2,12.5,764850,6491,760831,7.83,2.29,0.35368,0.85,99.47
2022-07-03,Uttarakhand,754,8,745,9302,2390,963,8.11,1,12.5,765604,6499,761576,19.12,7.7,0.74416,0.85,99.47
2022-07-04,Uttarakhand,672,5,663,8532,4962,480,7.88,4,12.5,766276,6504,762239,39.7,3.84,0.68256,0.85,99.47
2022-07-05,Uttarakhand,1148,8,1145,14269,4385,1625,8.05,0,12.5,767424,6512,763384,35.08,13.0,1.14152,0.85,99.47
2022-07-06,Uttarakhand,86,1,85,1144,2417,1334,7.52,0,12.5,767510,6513,763469,19.34,10.67,0.09152,0.85,99.47
2022-07-07,Uttarakhand,1583,14,1576,19703,4062,3401,8.03,0,12.5,769093,6527,765045,32.5,27.21,1.57624,0.85,99.47
2022-07-08,Uttarakhand,1596,6,1589,19628,4496,4274,8.13,1,12.5,770689,6533,766634,35.97,34.19,1.57024,0.85,99.47
2022-07-09,Uttarakhand,1585,10,1578,19712,1800,7,8.04,0,12.5,772274,6543,768212,14.4,0.06,1.57696,0.85,99.47
2022-07-10,Uttarakhand,1133,13,1125,14196,4844,2455,7.98,0,12.5,773407,6556,769337,38.75,19.64,1.13568,0.85,99.47
2022-07-11,Uttarakhand,839,5,835,10274,4699,3091,8.17,0,12.5,774246,6561,770172,37.59,24.73,0.82192,0.85,99.47
2022-07-12,Uttarakhand,1363,17,1356,17075,4732,3100,7.98,0,12.5,775609,6578,771528,37.86,24.8,1.366,0.85,99.47
2022-07-13,Uttarakhand,1001,4,997,12653,135,48,7.91,0,12.5,776610,6582,772525,1.08,0.38,1.01224,0.85,99.47
2022-07-14,Uttarakhand,849,4,848,10769,424,344,7.88,0,12.5,777459,6586,773373,3.39,2.75,0.86152,0.85,99.47
2022-07-15,Uttarakhand,861,9,857,10762,3507,3272,8.0,0,12.5,778320,6595,774230,28.06,26.18,0.86096,0.85,99.47
2022-07-16,Uttarakhand,621,4,618,8286,2448,329,7.49,0,12.5,778941,6599,774848,19.58,2.63,0.66288,0.85,99.47
2022-07-17,Uttarakhand,244,2,236,3218,488,199,7.58,6,12.5,779185,6601,775084,3.9,1.59,0.25744,0.85,99.47
2022-07-18,Uttarakhand,1593,9,1589,19887,4242,2075,8.01,0,12.5,780778,6610,776673,33.94,16.6,1.59096,0.85,99.47
2022-07-19,Uttarakhand,1036,5,1028,12941,1899,469,8.01,3,12.5,781814,6615,777701,15.19,3.75,1.03528,0.85,99.47
2022-07-20,Uttarakhand,589,3,587,7481,805,144,7.87,0,12.5,782403,6618,778288,6.44,1.15,0.59848,0.85,99.47
2022-07-21,Uttarakhand,1013,8,1004,12811,1959,986,7.91,1,12.5,783416,6626,779292,15.67,7.89,1.02488,0.85,99.47
2022-07-22,Uttarakhand,1022,12,1013,12243,4568,1077,8.35,0,12.5,784438,6638,780305,36.54,8.62,0.97944,0.85,99.47
2022-07-23,Uttarakhand,765,4,763,10096,2786,2261,7.58,0,12.5,785203,6642,781068,22.29,18.09,0.80768,0.85,99.47
2022-07-24,Uttarakhand,522,1,521,6849,1593,300,7.62,0,12.5,785725,6643,781589,12.74,2.4,0.54792,0.85,99.47
2022-07-25,Uttarakhand,1460,12,1458,18361,339,252,7.95,0,12.5,787185,6655,783047,2.71,2.02,1.46888,0.85,99.47
2022-07-26,Uttarakhand,1477,9,1472,18373,15,2,8.04,0,12.5,788662,6664,784519,0.12,0.02,1.46984,0.84,99.47
2022-07-27,Uttarakhand,268,2,263,3817,4368,3636,7.02,3,12.5,788930,6666,784782,34.94,29.09,0.30536,0.84,99.47
2022-07-28,Uttarakhand,1105,6,1097,13954,1909,502,7.92,2,12.5,790035,6672,785879,15.27,4.02,1.11632,0.84,99.47
2022-07-29,Uttarakhand,980,10,980,12561,4143,2892,7.8,0,12.5,791015,6682,786859,33.14,23.14,1.00488,0.84,99.47
2022-07-30,Uttarakhand,601,2,597,7175,4011,1438,8.38,2,12.5,791616,6684,787456,32.09,11.5,0.574,0.84,99.47
2022-07-31,Uttarakhand,521,3,521,6800,3692,3219,7.66,0,12.5,792137,6687,787977,29.54,25.75,0.544,0.84,99.47
2022-08-01,Uttarakhand,928,6,922,11672,325,232,7.95,0,12.5,793065,6693,788899,2.6,1.86,0.93376,0.84,99.47
2022-08-02,Uttarakhand,1160,16,1159,14761,2894,2740,7.86,0,12.5,794225,6709,790058,23.15,21.92,1.18088,0.84,99.48
2022-08-03,Uttarakhand,311,3,304,4250,1782,1119,7.32,4,12.5,794536,6712,790362,14.26,8.95,0.34,0.84,99.47
2022-08-04,Uttarakhand,361,1,359,4639,1848,1732,7.78,1,12.5,794897,6713,790721,14.78,13.86,0.37112,0.84,99.47
2022-08-05,Uttarakhand,1383,13,1379,17307,666,38,7.99,0,12.5,796280,6726,792100,5.33,0.3,1.38456,0.84,99.48
2022-08-06,Uttarakhand,1570,16,1562,19724,1182,577,7.96,0,12.5,797850,6742,793662,9.46,4.62,1.57792,0.85,99.48
2022-08-07,Uttarakhand,622,6,615,8006,3515,1922,7.77,1,12.5,798472,6748,794277,28.12,15.38,0.64048,0.85,99.47
2022-08-08,Uttarakhand,641,5,635,7965,4927,4151,8.05,1,12.5,799113,6753,794912,39.42,33.21,0.6372,0.85,99.47
2022-08-09,Uttarakhand,1403,4,1395,17287,4287,1045,8.12,4,12.5,800516,6757,796307,34.3,8.36,1.38296,0.84,99.47
2022-08-10,Uttarakhand,606,8,598,7664,4723,901,7.91,0,12.5,801122,6765,796905,37.78,7.21,0.61312,0.84,99.47
2022-08-11,Uttarakhand,1615,8,1615,19754,986,407,8.18,0,12.5,802737,6773,798520,7.89,3.26,1.58032,0.84,99.47
2022-08-12,Uttarakhand,508,4,504,6608,759,63,7.69,0,12.5,803245,6777,799024,6.07,0.5,0.52864,0.84,99.47
2022-08-13,Uttarakhand,229,1,229,3171,1689,1287,7.22,0,12.5,803474,6778,799253,13.51,10.3,0.25368,0.84,99.47
2022-08-14,Uttarakhand,377,2,377,5180,2882,2404,7.28,0,12.5,803851,6780,799630,23.06,19.23,0.4144,0.84,99.47
2022-08-15,Uttarakhand,1355,11,1349,16656,3739,1177,8.14,0,12.5,805206,6791,800979,29.91,9.42,1.33248,0.84,99.48
2022-08-16,Uttarakhand,972,7,964,11729,3482,2939,8.29,1,12.5,806178,6798,801943,27.86,23.51,0.93832,0.84,99.47
2022-08-17,Uttarakhand,1179,14,1176,15283,83,43,7.71,0,12.5,807357,6812,803119,0.66,0.34,1.22264,0.84,99.48
2022-08-18,Uttarakhand,1168,3,1165,14436,2829,1910,8.09,0,12.5,808525,6815,804284,22.63,15.28,1.15488,0.84,99.48
2022-08-19,Uttarakhand,115,0,114,1618,489,428,7.11,1,12.5,808640,6815,804398,3.91,3.42,0.12944,0.84,99.48
2022-08-20,Uttarakhand,238,1,233,3120,2904,518,7.63,4,12.5,808878,6816,804631,23.23,4.14,0.2496,0.84,99.47
2022-08-21,Uttarakhand,1365,14,1360,16909,196,88,8.07,0,12.5,810243,6830,805991,1.57,0.7,1.35272,0.84,99.48
2022-08-22,Uttarakhand,672,7,670,8328,202,123,8.07,0,12.5,810915,6837,806661,1.62,0.98,0.66624,0.84,99.48
2022-08-23,Uttarakhand,1513,9,1504,19156,3973,2408,7.9,0,12.5,812428,6846,808165,31.78,19.26,1.53248,0.84,99.48
2022-08-24,Uttarakhand,599,2,595,7727,490,25,7.75,2,12.5,813027,6848,808760,3.92,0.2,0.61816,0.84,99.48
2022-08-25,Uttarakhand,606,7,605,7455,732,305,8.13,0,12.5,813633,6855,809365,5.86,2.44,0.5964,0.84,99.48
2022-08-26,Uttarakhand,291,2,283,3800,97,92,7.66,6,12.5,813924,6857,809648,0.78,0.74,0.304,0.84,99.47
2022-08-27,Uttarakhand,565,4,564,7535,2337,236,7.5,0,12.5,814489,6861,810212,18.7,1.89,0.6028,0.84,99.47
2022-08-28,Uttarakhand,112,1,104,822,2179,2084,13.63,7,12.5,814601,6862,810316,17.43,16.67,0.06576,0.84,99.47
2022-08-29,Uttarakhand,1163,12,1156,14913,3921,1169,7.8,0,12.5,815764,6874,811472,31.37,9.35,1.19304,0.84,99.47
2022-08-30,Uttarakhand,228,2,221,3081,4150,2718,7.4,5,12.5,815992,6876,811693,33.2,21.74,0.24648,0.84,99.47
2022-08-31,Uttarakhand,517,4,516,6946,4816,4390,7.44,0,12.5,816509,6880,812209,38.53,35.12,0.55568,0.84,99.47
2022-09-01,Uttarakhand,1117,4,1113,13834,3035,1183,8.07,0,12.5,817626,6884,813322,24.28,9.46,1.10672,0.84,99.47
2022-09-02,Uttarakhand,485,7,481,5762,2831,1666,8.42,0,12.5,818111,6891,813803,22.65,13.33,0.46096,0.84,99.47
2022-09-03,Uttarakhand,1412,8,1407,17888,4209,2664,7.89,0,12.5,819523,6899,815210,33.67,21.31,1.43104,0.84,99.47
2022-09-04,Uttarakhand,1466,20,1458,18218,1993,1975,8.05,0,12.5,820989,6919,816668,15.94,15.8,1.45744,0.84,99.47
2022-09-05,Uttarakhand,173,1,166,2127,1814,1704,8.13,6,12.5,821162,6920,816834,14.51,13.63,0.17016,0.84,99.47
2022-09-06,Uttarakhand,276,1,276,3528,3761,930,7.82,0,12.5,821438,6921,817110,30.09,7.44,0.28224,0.84,99.47
2022-09-07,Uttarakhand,375,4,367,4609,861,96,8.14,4,12.5,821813,6925,817477,6.89,0.77,0.36872,0.84,99.47
2022-09-08,Uttarakhand,200,1,197,2458,4285,3134,8.14,2,12.5,822013,6926,817674,34.28,25.07,0.19664,0.84,99.47
2022-09-09,Uttarakhand,187,1,187,2501,1438,1127,7.48,0,12.5,822200,6927,817861,11.5,9.02,0.20008,0.84,99.47
2022-09-10,Uttarakhand,540,2,531,6479,2416,2300,8.33,7,12.5,822740,6929,818392,19.33,18.4,0.51832,0.84,99.47
2022-09-11,Uttarakhand,101,1,97,1231,2119,1807,8.2,3,12.5,822841,6930,818489,16.95,14.46,0.09848,0.84,99.47
2022-09-12,Uttarakhand,189,2,185,2690,2126,1088,7.03,2,12.5,823030,6932,818674,17.01,8.7,0.2152,0.84,99.47
2022-09-13,Uttarakhand,1389,10,1386,17270,3794,1392,8.04,0,12.5,824419,6942,820060,30.35,11.14,1.3816,0.84,99.47
2022-09-14,Uttarakhand,783,10,780,9958,3648,1168,7.86,0,12.5,825202,6952,820840,29.18,9.34,0.79664,0.84,99.47
2022-09-15,Uttarakhand,393,2,388,4898,4815,3147,8.02,3,12.5,825595,6954,821228,38.52,25.18,0.39184,0.84,99.47
2022-09-16,Uttarakhand,380,2,373,4743,3703,3196,8.01,5,12.5,825975,6956,821601,29.62,25.57,0.37944,0.84,99.47
2022-09-17,Uttarakhand,188,1,182,2863,338,254,6.57,5,12.5,826163,6957,821783,2.7,2.03,0.22904,0.84,99.47
2022-09-18,Uttarakhand,809,6,809,9880,1259,708,8.19,0,12.5,826972,6963,822592,10.07,5.66,0.7904,0.84,99.47
2022-09-19,Uttarakhand,871,6,871,11054,3347,3024,7.88,0,12.5,827843,6969,823463,26.78,24.19,0.88432,0.84,99.47
2022-09-20,Uttarakhand,612,6,612,7515,3272,138,8.14,0,12.5,828455,6975,824075,26.18,1.1,0.6012,0.84,99.47
2022-09-21,Uttarakhand,797,6,788,9934,1016,500,8.02,3,12.5,829252,6981,824863,8.13,4.0,0.79472,0.84,99.47
2022-09-22,Uttarakhand,642,5,636,7903,4062,411,8.12,1,12.5,829894,6986,825499,32.5,3.29,0.63224,0.84,99.47
2022-09-23,Uttarakhand,628,3,621,7902,4788,135,7.95,4,12.5,830522,6989,826120,38.3,1.08,0.63216,0.84,99.47
2022-09-24,Uttarakhand,794,6,789,9912,3498,1857,8.01,0,12.5,831316,6995,826909,27.98,14.86,0.79296,0.84,99.47
2022-09-25,Uttarakhand,847,11,846,10492,2173,566,8.07,0,12.5,832163,7006,827755,17.38,4.53,0.83936,0.84,99.47
2022-09-26,Uttarakhand,361,4,352,4415,2638,1264,8.18,5,12.5,832524,7010,828107,21.1,10.11,0.3532,0.84,99.47
2022-09-27,Uttarakhand,743,9,740,9170,4389,3481,8.1,0,12.5,833267,7019,828847,35.11,27.85,0.7336,0.84,99.47
2022-09-28,Uttarakhand,568,4,564,7203,2163,655,7.89,0,12.5,833835,7023,829411,17.3,5.24,0.57624,0.84,99.47
2022-09-29,Uttarakhand,319,1,316,4039,979,768,7.9,2,12.5,834154,7024,829727,7.83,6.14,0.32312,0.84,99.47
2022-09-30,Uttarakhand,194,1,191,2328,819,533,8.33,2,12.5,834348,7025,829918,6.55,4.26,0.18624,0.84,99.47
2022-10-01,Uttarakhand,315,2,306,3953,452,380,7.97,7,12.5,834663,7027,830224,3.62,3.04,0.31624,0.84,99.47
2022-10-02,Uttarakhand,779,7,771,10025,2307,1940,7.77,1,12.5,835442,7034,830995,18.46,15.52,0.802,0.84,99.47
2022-10-03,Uttarakhand,1517,17,1512,19274,586,98,7.87,0,12.5,836959,7051,832507,4.69,0.78,1.54192,0.84,99.47
2022-10-04,Uttarakhand,852,11,850,10504,3730,1490,8.11,0,12.5,837811,7062,833357,29.84,11.92,0.84032,0.84,99.47
2022-10-05,Uttarakhand,830,8,823,10729,4817,4677,7.74,0,12.5,838641,7070,834180,38.54,37.42,0.85832,0.84,99.47
2022-10-06,Uttarakhand,307,3,299,3739,2178,2167,8.21,5,12.5,838948,7073,834479,17.42,17.34,0.29912,0.84,99.47
2022-10-07,Uttarakhand,1065,15,1057,13564,2838,2164,7.85,0,12.5,840013,7088,835536,22.7,17.31,1.08512,0.84,99.47
2022-10-08,Uttarakhand,1114,8,1112,14342,396,125,7.77,0,12.5,841127,7096,836648,3.17,1.0,1.14736,0.84,99.47
2022-10-09,Uttarakhand,758,4,752,9706,394,44,7.81,2,12.5,841885,7100,837400,3.15,0.35,0.77648,0.84,99.47
2022-10-10,Uttarakhand,1366,7,1359,17162,4151,442,7.96,0,12.5,843251,7107,838759,33.21,3.54,1.37296,0.84,99.47
2022-10-11,Uttarakhand,582,7,582,7289,1419,1179,7.98,0,12.5,843833,7114,839341,11.35,9.43,0.58312,0.84,99.47
2022-10-12,Uttarakhand,519,3,515,6493,1648,1505,7.99,1,12.5,844352,7117,839856,13.18,12.04,0.51944,0.84,99.47
2022-10-13,Uttarakhand,660,5,651,8309,1269,775,7.94,4,12.5,845012,7122,840507,10.15,6.2,0.66472,0.84,99.47
2022-10-14,Uttarakhand,775,5,769,9573,4729,3640,8.1,1,12.5,845787,7127,841276,37.83,29.12,0.76584,0.84,99.47
2022-10-15,Uttarakhand,660,6,655,8318,3457,3068,7.93,0,12.5,846447,7133,841931,27.66,24.54,0.66544,0.84,99.47
2022-10-16,Uttarakhand,1033,4,1033,13072,3862,2148,7.9,0,12.5,847480,7137,842964,30.9,17.18,1.04576,0.84,99.47
2022-10-17,Uttarakhand,1005,14,999,12531,2340,2115,8.02,0,12.5,848485,7151,843963,18.72,16.92,1.00248,0.84,99.47
2022-10-18,Uttarakhand,996,4,994,12696,335,259,7.84,0,12.5,849481,7155,844957,2.68,2.07,1.01568,0.84,99.47
2022-10-19,Uttarakhand,1165,15,1158,14432,992,159,8.07,0,12.5,850646,7170,846115,7.94,1.27,1.15456,0.84,99.47
2022-10-20,Uttarakhand,1591,12,1586,19718,3847,1192,8.07,0,12.5,852237,7182,847701,30.78,9.54,1.57744,0.84,99.47
2022-10-21,Uttarakhand,586,3,577,7206,2356,488,8.13,6,12.5,852823,7185,848278,18.85,3.9,0.57648,0.84,99.47
2022-10-22,Uttarakhand,41,0,35,1218,4386,2217,3.37,6,12.5,852864,7185,848313,35.09,17.74,0.09744,0.84,99.47
2022-10-23,Uttarakhand,82,0,78,1507,4153,1402,5.44,4,12.5,852946,7185,848391,33.22,11.22,0.12056,0.84,99.47
2022-10-24,Uttarakhand,1482,6,1475,18660,3092,1859,7.94,1,12.5,854428,7191,849866,24.74,14.87,1.4928,0.84,99.47
2022-10-25,Uttarakhand,746,6,745,8750,458,70,8.53,0,12.5,855174,7197,850611,3.66,0.56,0.7,0.84,99.47
2022-10-26,Uttarakhand,1292,14,1288,16091,3498,1576,8.03,0,12.5,856466,7211,851899,27.98,12.61,1.28728,0.84,99.47
2022-10-27,Uttarakhand,127,1,125,1147,4378,315,11.07,1,12.5,856593,7212,852024,35.02,2.52,0.09176,0.84,99.47
2022-10-28,Uttarakhand,697,8,696,8037,1318,639,8.67,0,12.5,857290,7220,852720,10.54,5.11,0.64296,0.84,99.47
2022-10-29,Uttarakhand,593,6,590,7649,1017,404,7.75,0,12.5,857883,7226,853310,8.14,3.23,0.61192,0.84,99.47
2022-10-30,Uttarakhand,1262,6,1254,15577,2634,775,8.1,2,12.5,859145,7232,854564,21.07,6.2,1.24616,0.84,99.47
2022-10-31,Uttarakhand,1314,6,1312,16674,3541,124,7.88,0,12.5,860459,7238,855876,28.33,0.99,1.33392,0.84,99.47
2022-11-01,Uttarakhand,322,2,320,4068,314,51,7.92,0,12.5,860781,7240,856196,2.51,0.41,0.32544,0.84,99.47
2022-11-02,Uttarakhand,480,6,480,5843,3973,3797,8.21,0,12.5,861261,7246,856676,31.78,30.38,0.46744,0.84,99.47
2022-11-03,Uttarakhand,1230,5,1225,15684,1267,66,7.84,0,12.5,862491,7251,857901,10.14,0.53,1.25472,0.84,99.47
2022-11-04,Uttarakhand,837,7,831,10437,3120,1226,8.02,0,12.5,863328,7258,858732,24.96,9.81,0.83496,0.84,99.47
2022-11-05,Uttarakhand,785,10,777,9443,2678,1566,8.31,0,12.5,864113,7268,859509,21.42,12.53,0.75544,0.84,99.47
2022-11-06,Uttarakhand,1171,4,1168,14285,2183,2131,8.2,0,12.5,865284,7272,860677,17.46,17.05,1.1428,0.84,99.47
2022-11-07,Uttarakhand,622,2,613,7966,1836,1776,7.81,7,12.5,865906,7274,861290,14.69,14.21,0.63728,0.84,99.47
2022-11-08,Uttarakhand,260,3,258,3370,2939,137,7.72,0,12.5,866166,7277,861548,23.51,1.1,0.2696,0.84,99.47
2022-11-09,Uttarakhand,1477,4,1476,18765,4532,698,7.87,0,12.5,867643,7281,863024,36.26,5.58,1.5012,0.84,99.47
2022-11-10,Uttarakhand,1434,7,1427,17614,4372,1937,8.14,0,12.5,869077,7288,864451,34.98,15.5,1.40912,0.84,99.47
2022-11-11,Uttarakhand,173,2,167,2361,3867,387,7.33,4,12.5,869250,7290,864618,30.94,3.1,0.18888,0.84,99.47
2022-11-12,Uttarakhand,906,6,898,11461,1582,1087,7.91,2,12.5,870156,7296,865516,12.66,8.7,0.91688,0.84,99.47
2022-11-13,Uttarakhand,98,0,97,1017,4113,222,9.64,1,12.5,870254,7296,865613,32.9,1.78,0.08136,0.84,99.47
2022-11-14,Uttarakhand,433,5,429,5567,2379,1486,7.78,0,12.5,870687,7301,866042,19.03,11.89,0.44536,0.84,99.47
2022-11-15,Uttarakhand,410,2,407,5174,4867,918,7.92,1,12.5,871097,7303,866449,38.94,7.34,0.41392,0.84,99.47
2022-11-16,Uttarakhand,1191,9,1184,14981,2544,1601,7.95,0,12.5,872288,7312,867633,20.35,12.81,1.19848,0.84,99.47
2022-11-17,Uttarakhand,1009,15,1009,12717,938,514,7.93,0,12.5,873297,7327,868642,7.5,4.11,1.01736,0.84,99.47
2022-11-18,Uttarakhand,919,12,919,11553,3029,2148,7.95,0,12.5,874216,7339,869561,24.23,17.18,0.92424,0.84,99.47
2022-11-19,Uttarakhand,273,1,266,2947,1439,467,9.26,6,12.5,874489,7340,869827,11.51,3.74,0.23576,0.84,99.47
2022-11-20,Uttarakhand,1442,5,1435,17829,3786,890,8.09,2,12.5,875931,7345,871262,30.29,7.12,1.42632,0.84,99.47
2022-11-21,Uttarakhand,48,0,43,729,2870,2481,6.58,5,12.5,875979,7345,871305,22.96,19.85,0.05832,0.84,99.47
2022-11-22,Uttarakhand,103,1,98,1263,1367,1199,8.16,4,12.5,876082,7346,871403,10.94,9.59,0.10104,0.84,99.47
2022-11-23,Uttarakhand,69,0,67,688,695,429,10.03,2,12.5,876151,7346,871470,5.56,3.43,0.05504,0.84,99.47
2022-11-24,Uttarakhand,69,0,67,705,3609,3586,9.79,2,12.5,876220,7346,871537,28.87,28.69,0.0564,0.84,99.47
2022-11-25,Uttarakhand,222,2,215,3476,2399,510,6.39,5,12.5,876442,7348,871752,19.19,4.08,0.27808,0.84,99.46
2022-11-26,Uttarakhand,1402,10,1400,17591,3297,2232,7.97,0,12.5,877844,7358,873152,26.38,17.86,1.40728,0.84,99.47
2022-11-27,Uttarakhand,528,5,527,6259,3017,896,8.44,0,12.5,878372,7363,873679,24.14,7.17,0.50072,0.84,99.47
2022-11-28,Uttarakhand,1124,3,1115,13972,707,531,8.04,6,12.5,879496,7366,874794,5.66,4.25,1.11776,0.84,99.47
2022-11-29,Uttarakhand,448,5,447,5047,614,407,8.88,0,12.5,879944,7371,875241,4.91,3.26,0.40376,0.84,99.47
2022-11-30,Uttarakhand,953,6,947,11689,1640,143,8.15,0,12.5,880897,7377,876188,13.12,1.14,0.93512,0.84,99.47
2022-12-01,Uttarakhand,1050,7,1046,13252,4610,2558,7.92,0,12.5,881947,7384,877234,36.88,20.46,1.06016,0.84,99.47
2022-12-02,Uttarakhand,1441,11,1433,17879,830,487,8.06,0,12.5,883388,7395,878667,6.64,3.9,1.43032,0.84,99.47
2022-12-03,Uttarakhand,1165,13,1160,14396,4312,5,8.09,0,12.5,884553,7408,879827,34.5,0.04,1.15168,0.84,99.47
2022-12-04,Uttarakhand,255,1,253,3320,3278,505,7.68,1,12.5,884808,7409,880080,26.22,4.04,0.2656,0.84,99.47
2022-12-05,Uttarakhand,1018,6,1009,12227,211,61,8.33,3,12.5,885826,7415,881089,1.69,0.49,0.97816,0.84,99.47
2022-12-06,Uttarakhand,990,10,986,12282,2517,1084,8.06,0,12.5,886816,7425,882075,20.14,8.67,0.98256,0.84,99.47
2022-12-07,Uttarakhand,1115,10,1112,13950,4600,1648,7.99,0,12.5,887931,7435,883187,36.8,13.18,1.116,0.84,99.47
2022-12-08,Uttarakhand,580,3,572,7102,4268,3497,8.17,5,12.5,888511,7438,883759,34.14,27.98,0.56816,0.84,99.47
2022-12-09,Uttarakhand,410,5,402,5330,1874,1771,7.69,3,12.5,888921,7443,884161,14.99,14.17,0.4264,0.84,99.46
2022-12-10,Uttarakhand,1469,19,1466,18308,679,458,8.02,0,12.5,890390,7462,885627,5.43,3.66,1.46464,0.84,99.47
2022-12-11,Uttarakhand,975,9,972,12094,495,203,8.06,0,12.5,891365,7471,886599,3.96,1.62,0.96752,0.84,99.47
2022-12-12,Uttarakhand,886,7,877,11093,1892,749,7.99,2,12.5,892251,7478,887476,15.14,5.99,0.88744,0.84,99.46
2022-12-13,Uttarakhand,1575,13,1575,19799,1615,592,7.95,0,12.5,893826,7491,889051,12.92,4.74,1.58392,0.84,99.47
2022-12-14,Uttarakhand,643,5,636,8004,2599,468,8.03,2,12.5,894469,7496,889687,20.79,3.74,0.64032,0.84,99.47
2022-12-15,Uttarakhand,261,1,258,3460,2148,605,7.54,2,12.5,894730,7497,889945,17.18,4.84,0.2768,0.84,99.47
2022-12-16,Uttarakhand,888,2,879,10660,1063,412,8.33,7,12.5,895618,7499,890824,8.5,3.3,0.8528,0.84,99.46
2022-12-17,Uttarakhand,1123,10,1119,13885,919,484,8.09,0,12.5,896741,7509,891943,7.35,3.87,1.1108,0.84,99.46
2022-12-18,Uttarakhand,1530,7,1525,18876,881,500,8.11,0,12.5,898271,7516,893468,7.05,4.0,1.51008,0.84,99.47
2022-12-19,Uttarakhand,561,6,554,7282,4131,3057,7.7,1,12.5,898832,7522,894022,33.05,24.46,0.58256,0.84,99.46
2022-12-20,Uttarakhand,162,1,157,2443,3323,362,6.63,4,12.5,898994,7523,894179,26.58,2.9,0.19544,0.84,99.46
2022-12-21,Uttarakhand,973,6,971,11954,2475,2461,8.14,0,12.5,899967,7529,895150,19.8,19.69,0.95632,0.84,99.46
2022-12-22,Uttarakhand,1326,11,1319,16516,2216,1211,8.03,0,12.5,901293,7540,896469,17.73,9.69,1.32128,0.84,99.46
2022-12-23,Uttarakhand,438,5,437,5367,1107,413,8.16,0,12.5,901731,7545,896906,8.86,3.3,0.42936,0.84,99.46
2022-12-24,Uttarakhand,1025,9,1024,13013,3708,873,7.88,0,12.5,902756,7554,897930,29.66,6.98,1.04104,0.84,99.47
2022-12-25,Uttarakhand,981,5,974,12493,955,535,7.85,2,12.5,903737,7559,898904,7.64,4.28,0.99944,0.84,99.47
2022-12-26,Uttarakhand,654,5,650,8190,2347,2209,7.99,0,12.5,904391,7564,899554,18.78,17.67,0.6552,0.84,99.47
2022-12-27,Uttarakhand,665,2,656,8221,1727,1344,8.09,7,12.5,905056,7566,900210,13.82,10.75,0.65768,0.84,99.46
2022-12-28,Uttarakhand,713,7,712,8648,2673,1756,8.24,0,12.5,905769,7573,900922,21.38,14.05,0.69184,0.84,99.46
2022-12-29,Uttarakhand,1132,3,1132,13972,3436,3182,8.1,0,12.5,906901,7576,902054,27.49,25.46,1.11776,0.84,99.47
2022-12-30,Uttarakhand,1130,12,1126,14641,1879,1194,7.72,0,12.5,908031,7588,903180,15.03,9.55,1.17128,0.84,99.47
2022-12-31,Uttarakhand,616,3,612,7653,4830,2959,8.05,1,12.5,908647,7591,903792,38.64,23.67,0.61224,0.84,99.47
2020-01-01,West Bengal,1302,4,1293,15994,4507,397,8.14,5,99.6,1302,4,1293,4.53,0.4,0.16058232931726907,0.31,99.31
2020-01-02,West Bengal,759,4,755,9554,1057,11,7.94,0,99.6,2061,8,2048,1.06,0.01,0.09592369477911647,0.39,99.37
2020-01-03,West Bengal,868,11,866,10616,1996,161,8.18,0,99.6,2929,19,2914,2.0,0.16,0.1065863453815261,0.65,99.49
2020-01-04,West Bengal,297,3,295,3520,2680,2341,8.44,0,99.6,3226,22,3209,2.69,2.35,0.035341365461847386,0.68,99.47
2020-01-05,West Bengal,324,1,318,3870,359,23,8.37,5,99.6,3550,23,3527,0.36,0.02,0.03885542168674699,0.65,99.35
2020-01-06,West Bengal,257,2,256,3718,292,18,6.91,0,99.6,3807,25,3783,0.29,0.02,0.037329317269076304,0.66,99.37
2020-01-07,West Bengal,1533,13,1525,19298,1074,444,7.94,0,99.6,5340,38,5308,1.08,0.45,0.19375502008032128,0.71,99.4
2020-01-08,West Bengal,640,4,640,7645,2498,1323,8.37,0,99.6,5980,42,5948,2.51,1.33,0.0767570281124498,0.7,99.46
2020-01-09,West Bengal,1178,8,1174,14443,2688,1949,8.16,0,99.6,7158,50,7122,2.7,1.96,0.14501004016064256,0.7,99.5
2020-01-10,West Bengal,1432,6,1432,17791,2891,2100,8.05,0,99.6,8590,56,8554,2.9,2.11,0.17862449799196786,0.65,99.58
2020-01-11,West Bengal,1163,11,1163,14131,2725,249,8.23,0,99.6,9753,67,9717,2.74,0.25,0.14187751004016064,0.69,99.63
2020-01-12,West Bengal,968,6,962,12146,4241,2891,7.97,0,99.6,10721,73,10679,4.26,2.9,0.12194779116465863,0.68,99.61
2020-01-13,West Bengal,1008,10,1008,12462,1869,58,8.09,0,99.6,11729,83,11687,1.88,0.06,0.12512048192771083,0.71,99.64
2020-01-14,West Bengal,1148,6,1144,14115,1598,1440,8.13,0,99.6,12877,89,12831,1.6,1.45,0.14171686746987952,0.69,99.64
2020-01-15,West Bengal,950,12,945,12093,84,11,7.86,0,99.6,13827,101,13776,0.08,0.01,0.12141566265060241,0.73,99.63
2020-01-16,West Bengal,657,4,653,7906,349,158,8.31,0,99.6,14484,105,14429,0.35,0.16,0.07937751004016064,0.72,99.62
2020-01-17,West Bengal,121,1,117,1710,365,252,7.08,3,99.6,14605,106,14546,0.37,0.25,0.01716867469879518,0.73,99.6
2020-01-18,West Bengal,1413,17,1413,17538,1947,1356,8.06,0,99.6,16018,123,15959,1.95,1.36,0.1760843373493976,0.77,99.63
2020-01-19,West Bengal,1582,8,1577,19564,331,175,8.09,0,99.6,17600,131,17536,0.33,0.18,0.19642570281124497,0.74,99.64
2020-01-20,West Bengal,457,1,457,5983,4337,137,7.64,0,99.6,18057,132,17993,4.35,0.14,0.06007028112449799,0.73,99.65
2020-01-21,West Bengal,1581,8,1581,19722,1399,131,8.02,0,99.6,19638,140,19574,1.4,0.13,0.19801204819277107,0.71,99.67
2020-01-22,West Bengal,1437,20,1430,17888,2107,1385,8.03,0,99.6,21075,160,21004,2.12,1.39,0.1795983935742972,0.76,99.66
2020-01-23,West Bengal,369,1,366,4658,4239,1532,7.92,2,99.6,21444,161,21370,4.26,1.54,0.04676706827309237,0.75,99.65
2020-01-24,West Bengal,1349,8,1349,17545,2932,600,7.69,0,99.6,22793,169,22719,2.94,0.6,0.17615461847389557,0.74,99.68
2020-01-25,West Bengal,653,6,646,8426,2565,1856,7.75,1,99.6,23446,175,23365,2.58,1.86,0.08459839357429719,0.75,99.65
2020-01-26,West Bengal,1330,6,1329,16858,4080,1453,7.89,0,99.6,24776,181,24694,4.1,1.46,0.1692570281124498,0.73,99.67
2020-01-27,West Bengal,1404,7,1404,17649,3588,973,7.96,0,99.6,26180,188,26098,3.6,0.98,0.1771987951807229,0.72,99.69
2020-01-28,West Bengal,1264,8,1260,15451,4588,2421,8.18,0,99.6,27444,196,27358,4.61,2.43,0.1551305220883534,0.71,99.69
2020-01-29,West Bengal,820,5,819,10675,969,278,7.68,0,99.6,28264,201,28177,0.97,0.28,0.10717871485943775,0.71,99.69
2020-01-30,West Bengal,1226,13,1222,15352,3663,167,7.99,0,99.6,29490,214,29399,3.68,0.17,0.15413654618473896,0.73,99.69
2020-01-31,West Bengal,1057,13,1050,13338,2141,1475,7.92,0,99.6,30547,227,30449,2.15,1.48,0.1339156626506024,0.74,99.68
2020-02-01,West Bengal,372,2,364,4696,1983,1421,7.92,6,99.6,30919,229,30813,1.99,1.43,0.04714859437751004,0.74,99.66
2020-02-02,West Bengal,1214,4,1209,14844,1042,889,8.18,1,99.6,32133,233,32022,1.05,0.89,0.14903614457831324,0.73,99.65
2020-02-03,West Bengal,703,2,697,8847,1802,747,7.95,4,99.6,32836,235,32719,1.81,0.75,0.08882530120481928,0.72,99.64
2020-02-04,West Bengal,319,2,319,4015,796,57,7.95,0,99.6,33155,237,33038,0.8,0.06,0.040311244979919676,0.71,99.65
2020-02-05,West Bengal,1303,8,1297,16176,2234,55,8.06,0,99.6,34458,245,34335,2.24,0.06,0.16240963855421686,0.71,99.64
2020-02-06,West Bengal,46,0,44,629,2035,418,7.31,2,99.6,34504,245,34379,2.04,0.42,0.0063152610441767065,0.71,99.64
2020-02-07,West Bengal,251,2,245,2682,3024,680,9.36,4,99.6,34755,247,34624,3.04,0.68,0.026927710843373493,0.71,99.62
2020-02-08,West Bengal,641,4,635,8001,1156,9,8.01,2,99.6,35396,251,35259,1.16,0.01,0.08033132530120482,0.71,99.61
2020-02-09,West Bengal,1156,12,1155,14784,55,49,7.82,0,99.6,36552,263,36414,0.06,0.05,0.14843373493975903,0.72,99.62
2020-02-10,West Bengal,630,5,628,8347,2989,1718,7.55,0,99.6,37182,268,37042,3.0,1.72,0.08380522088353413,0.72,99.62
2020-02-11,West Bengal,629,2,625,7772,1880,1546,8.09,2,99.6,37811,270,37667,1.89,1.55,0.07803212851405622,0.71,99.62
2020-02-12,West Bengal,1354,11,1347,16993,4606,1807,7.97,0,99.6,39165,281,39014,4.62,1.81,0.1706124497991968,0.72,99.61
2020-02-13,West Bengal,324,3,319,3805,2089,512,8.52,2,99.6,39489,284,39333,2.1,0.51,0.03820281124497992,0.72,99.6
2020-02-14,West Bengal,983,10,977,12234,4488,1323,8.03,0,99.6,40472,294,40310,4.51,1.33,0.12283132530120482,0.73,99.6
2020-02-15,West Bengal,627,7,627,7938,1313,292,7.9,0,99.6,41099,301,40937,1.32,0.29,0.0796987951807229,0.73,99.61
2020-02-16,West Bengal,157,1,149,1663,869,451,9.44,7,99.6,41256,302,41086,0.87,0.45,0.016696787148594378,0.73,99.59
2020-02-17,West Bengal,931,9,925,11922,757,587,7.81,0,99.6,42187,311,42011,0.76,0.59,0.11969879518072289,0.74,99.58
2020-02-18,West Bengal,1411,9,1408,17445,2242,92,8.09,0,99.6,43598,320,43419,2.25,0.09,0.17515060240963856,0.73,99.59
2020-02-19,West Bengal,1364,11,1362,16471,3490,3095,8.28,0,99.6,44962,331,44781,3.5,3.11,0.1653714859437751,0.74,99.6
2020-02-20,West Bengal,50,0,48,755,145,131,6.62,2,99.6,45012,331,44829,0.15,0.13,0.007580321285140562,0.74,99.59
2020-02-21,West Bengal,1165,8,1158,14779,587,574,7.88,0,99.6,46177,339,45987,0.59,0.58,0.14838353413654617,0.73,99.59
2020-02-22,West Bengal,604,7,597,7648,1388,646,7.9,0,99.6,46781,346,46584,1.39,0.65,0.0767871485943775,0.74,99.58
2020-02-23,West Bengal,106,0,101,1156,3256,818,9.17,5,99.6,46887,346,46685,3.27,0.82,0.011606425702811245,0.74,99.57
2020-02-24,West Bengal,271,3,263,3504,969,147,7.73,5,99.6,47158,349,46948,0.97,0.15,0.03518072289156626,0.74,99.55
2020-02-25,West Bengal,260,1,259,2854,2751,826,9.11,0,99.6,47418,350,47207,2.76,0.83,0.028654618473895582,0.74,99.56
2020-02-26,West Bengal,721,3,717,9314,2602,610,7.74,1,99.6,48139,353,47924,2.61,0.61,0.0935140562248996,0.73,99.55
2020-02-27,West Bengal,1190,11,1183,14848,4122,2671,8.01,0,99.6,49329,364,49107,4.14,2.68,0.14907630522088353,0.74,99.55
2020-02-28,West Bengal,1507,10,1500,18708,455,146,8.06,0,99.6,50836,374,50607,0.46,0.15,0.18783132530120483,0.74,99.55
2020-02-29,West Bengal,1237,18,1230,15169,4181,3656,8.15,0,99.6,52073,392,51837,4.2,3.67,0.1522991967871486,0.75,99.55
2020-03-01,West Bengal,973,12,970,11867,4710,2586,8.2,0,99.6,53046,404,52807,4.73,2.6,0.11914658634538153,0.76,99.55
2020-03-02,West Bengal,381,5,377,4397,3595,600,8.66,0,99.6,53427,409,53184,3.61,0.6,0.044146586345381524,0.77,99.55
2020-03-03,West Bengal,617,8,609,7541,2987,2694,8.18,0,99.6,54044,417,53793,3.0,2.7,0.07571285140562249,0.77,99.54
2020-03-04,West Bengal,401,3,400,5095,2282,609,7.87,0,99.6,54445,420,54193,2.29,0.61,0.05115461847389558,0.77,99.54
2020-03-05,West Bengal,155,0,151,1731,1120,429,8.95,4,99.6,54600,420,54344,1.12,0.43,0.017379518072289157,0.77,99.53
2020-03-06,West Bengal,743,4,741,9145,366,90,8.12,0,99.6,55343,424,55085,0.37,0.09,0.09181726907630522,0.77,99.53
2020-03-07,West Bengal,1346,17,1345,17172,296,290,7.84,0,99.6,56689,441,56430,0.3,0.29,0.17240963855421687,0.78,99.54
2020-03-08,West Bengal,696,2,688,8740,19,5,7.96,6,99.6,57385,443,57118,0.02,0.01,0.08775100401606425,0.77,99.53
2020-03-09,West Bengal,377,2,377,4787,4460,1399,7.88,0,99.6,57762,445,57495,4.48,1.4,0.048062248995983936,0.77,99.54
2020-03-10,West Bengal,1201,9,1196,15237,4227,2336,7.88,0,99.6,58963,454,58691,4.24,2.35,0.15298192771084337,0.77,99.54
2020-03-11,West Bengal,1331,9,1324,16460,3710,3377,8.09,0,99.6,60294,463,60015,3.72,3.39,0.16526104417670684,0.77,99.54
2020-03-12,West Bengal,1534,4,1527,18891,964,629,8.12,3,99.6,61828,467,61542,0.97,0.63,0.18966867469879517,0.76,99.54
2020-03-13,West Bengal,1423,18,1416,17789,2202,1306,8.0,0,99.6,63251,485,62958,2.21,1.31,0.17860441767068272,0.77,99.54
2020-03-14,West Bengal,1066,12,1064,12861,4158,583,8.29,0,99.6,64317,497,64022,4.17,0.59,0.1291265060240964,0.77,99.54
2020-03-15,West Bengal,385,3,380,5091,3256,2326,7.56,2,99.6,64702,500,64402,3.27,2.34,0.0511144578313253,0.77,99.54
2020-03-16,West Bengal,1042,9,1033,13180,945,366,7.91,0,99.6,65744,509,65435,0.95,0.37,0.13232931726907632,0.77,99.53
2020-03-17,West Bengal,1335,4,1327,17032,1385,284,7.84,4,99.6,67079,513,66762,1.39,0.29,0.17100401606425703,0.76,99.53
2020-03-18,West Bengal,90,0,85,1169,3053,927,7.7,5,99.6,67169,513,66847,3.07,0.93,0.01173694779116466,0.76,99.52
2020-03-19,West Bengal,92,0,92,1290,3198,2351,7.13,0,99.6,67261,513,66939,3.21,2.36,0.012951807228915663,0.76,99.52
2020-03-20,West Bengal,1261,13,1258,15597,1028,184,8.08,0,99.6,68522,526,68197,1.03,0.18,0.15659638554216868,0.77,99.53
2020-03-21,West Bengal,552,5,551,6647,3051,1803,8.3,0,99.6,69074,531,68748,3.06,1.81,0.06673694779116465,0.77,99.53
2020-03-22,West Bengal,145,0,143,1903,4721,4077,7.62,2,99.6,69219,531,68891,4.74,4.09,0.019106425702811246,0.77,99.53
2020-03-23,West Bengal,877,3,872,10573,3366,776,8.29,2,99.6,70096,534,69763,3.38,0.78,0.10615461847389558,0.76,99.52
2020-03-24,West Bengal,1147,10,1140,14015,1901,1108,8.18,0,99.6,71243,544,70903,1.91,1.11,0.14071285140562248,0.76,99.52
2020-03-25,West Bengal,1435,20,1426,18077,495,28,7.94,0,99.6,72678,564,72329,0.5,0.03,0.18149598393574298,0.78,99.52
2020-03-26,West Bengal,648,9,639,7925,2177,378,8.18,0,99.6,73326,573,72968,2.19,0.38,0.07956827309236948,0.78,99.51
2020-03-27,West Bengal,622,5,622,7731,4966,907,8.05,0,99.6,73948,578,73590,4.99,0.91,0.07762048192771084,0.78,99.52
2020-03-28,West Bengal,1427,20,1427,17920,1656,1355,7.96,0,99.6,75375,598,75017,1.66,1.36,0.17991967871485945,0.79,99.53
2020-03-29,West Bengal,927,2,925,11654,351,317,7.95,0,99.6,76302,600,75942,0.35,0.32,0.11700803212851406,0.79,99.53
2020-03-30,West Bengal,448,4,442,5678,3549,1437,7.89,2,99.6,76750,604,76384,3.56,1.44,0.057008032128514054,0.79,99.52
2020-03-31,West Bengal,358,2,352,4487,2103,1573,7.98,4,99.6,77108,606,76736,2.11,1.58,0.04505020080321285,0.79,99.52
2020-04-01,West Bengal,1115,10,1115,14135,1684,736,7.89,0,99.6,78223,616,77851,1.69,0.74,0.14191767068273092,0.79,99.52
2020-04-02,West Bengal,1366,18,1359,16691,374,281,8.18,0,99.6,79589,634,79210,0.38,0.28,0.16758032128514055,0.8,99.52
2020-04-03,West Bengal,332,3,330,3926,160,9,8.46,0,99.6,79921,637,79540,0.16,0.01,0.03941767068273092,0.8,99.52
2020-04-04,West Bengal,1581,5,1581,19654,1797,153,8.04,0,99.6,81502,642,81121,1.8,0.15,0.1973293172690763,0.79,99.53
2020-04-05,West Bengal,1004,7,995,12388,2923,1154,8.1,2,99.6,82506,649,82116,2.93,1.16,0.12437751004016065,0.79,99.53
2020-04-06,West Bengal,401,4,396,4865,1595,1501,8.24,1,99.6,82907,653,82512,1.6,1.51,0.04884538152610442,0.79,99.52
2020-04-07,West Bengal,251,1,245,3026,888,660,8.29,5,99.6,83158,654,82757,0.89,0.66,0.03038152610441767,0.79,99.52
2020-04-08,West Bengal,1368,11,1364,17282,3366,3357,7.92,0,99.6,84526,665,84121,3.38,3.37,0.1735140562248996,0.79,99.52
2020-04-09,West Bengal,263,1,263,3380,664,526,7.78,0,99.6,84789,666,84384,0.67,0.53,0.03393574297188755,0.79,99.52
2020-04-10,West Bengal,967,3,958,12114,2866,2823,7.98,6,99.6,85756,669,85342,2.88,2.83,0.12162650602409639,0.78,99.52
2020-04-11,West Bengal,1048,6,1047,12983,3755,3715,8.07,0,99.6,86804,675,86389,3.77,3.73,0.13035140562248995,0.78,99.52
2020-04-12,West Bengal,163,1,161,2101,739,428,7.76,1,99.6,86967,676,86550,0.74,0.43,0.02109437751004016,0.78,99.52
2020-04-13,West Bengal,362,3,353,4383,3955,1698,8.26,6,99.6,87329,679,86903,3.97,1.7,0.04400602409638554,0.78,99.51
2020-04-14,West Bengal,1311,10,1311,16980,1663,156,7.72,0,99.6,88640,689,88214,1.67,0.16,0.17048192771084336,0.78,99.52
2020-04-15,West Bengal,103,1,103,830,4537,931,12.41,0,99.6,88743,690,88317,4.56,0.93,0.008333333333333333,0.78,99.52
2020-04-16,West Bengal,952,13,944,12374,2841,1861,7.69,0,99.6,89695,703,89261,2.85,1.87,0.12423694779116466,0.78,99.52
2020-04-17,West Bengal,1517,6,1511,18620,2731,927,8.15,0,99.6,91212,709,90772,2.74,0.93,0.18694779116465862,0.78,99.52
2020-04-18,West Bengal,1535,22,1534,18777,4888,52,8.17,0,99.6,92747,731,92306,4.91,0.05,0.18852409638554216,0.79,99.52
2020-04-19,West Bengal,1098,4,1090,13773,1654,213,7.97,4,99.6,93845,735,93396,1.66,0.21,0.13828313253012048,0.78,99.52
2020-04-20,West Bengal,1439,6,1439,17896,718,50,8.04,0,99.6,95284,741,94835,0.72,0.05,0.17967871485943776,0.78,99.53
2020-04-21,West Bengal,1465,9,1460,18761,3392,276,7.81,0,99.6,96749,750,96295,3.41,0.28,0.18836345381526104,0.78,99.53
2020-04-22,West Bengal,875,9,867,10836,3086,2131,8.07,0,99.6,97624,759,97162,3.1,2.14,0.10879518072289157,0.78,99.53
2020-04-23,West Bengal,233,1,228,2380,2683,2465,9.79,4,99.6,97857,760,97390,2.69,2.47,0.02389558232931727,0.78,99.52
2020-04-24,West Bengal,1468,18,1468,18448,2728,1338,7.96,0,99.6,99325,778,98858,2.74,1.34,0.18522088353413654,0.78,99.53
2020-04-25,West Bengal,1300,6,1294,16156,3138,1528,8.05,0,99.6,100625,784,100152,3.15,1.53,0.16220883534136546,0.78,99.53
2020-04-26,West Bengal,856,11,853,10856,298,108,7.89,0,99.6,101481,795,101005,0.3,0.11,0.10899598393574297,0.78,99.53
2020-04-27,West Bengal,787,5,780,9817,138,107,8.02,2,99.6,102268,800,101785,0.14,0.11,0.09856425702811245,0.78,99.53
2020-04-28,West Bengal,1004,9,995,12822,4058,493,7.83,0,99.6,103272,809,102780,4.07,0.49,0.12873493975903613,0.78,99.52
2020-04-29,West Bengal,387,2,383,4808,4169,3169,8.05,2,99.6,103659,811,103163,4.19,3.18,0.04827309236947791,0.78,99.52
2020-04-30,West Bengal,468,4,460,5693,4261,1855,8.22,4,99.6,104127,815,103623,4.28,1.86,0.05715863453815261,0.78,99.52
2020-05-01,West Bengal,81,1,74,941,2871,2562,8.61,6,99.6,104208,816,103697,2.88,2.57,0.009447791164658634,0.78,99.51
2020-05-02,West Bengal,212,2,206,2915,4910,1989,7.27,4,99.6,104420,818,103903,4.93,2.0,0.02926706827309237,0.78,99.5
2020-05-03,West Bengal,406,5,401,5232,3154,701,7.76,0,99.6,104826,823,104304,3.17,0.7,0.05253012048192771,0.79,99.5
2020-05-04,West Bengal,49,0,44,840,4576,3109,5.83,5,99.6,104875,823,104348,4.59,3.12,0.008433734939759036,0.78,99.5
2020-05-05,West Bengal,960,3,959,11635,1141,192,8.25,0,99.6,105835,826,105307,1.15,0.19,0.11681726907630523,0.78,99.5
2020-05-06,West Bengal,493,4,489,6117,827,364,8.06,0,99.6,106328,830,105796,0.83,0.37,0.06141566265060241,0.78,99.5
2020-05-07,West Bengal,1369,19,1364,17068,4343,3230,8.02,0,99.6,107697,849,107160,4.36,3.24,0.17136546184738957,0.79,99.5
2020-05-08,West Bengal,803,10,797,9844,193,115,8.16,0,99.6,108500,859,107957,0.19,0.12,0.09883534136546185,0.79,99.5
2020-05-09,West Bengal,567,7,566,7181,385,205,7.9,0,99.6,109067,866,108523,0.39,0.21,0.07209839357429719,0.79,99.5
2020-05-10,West Bengal,95,0,93,1386,2018,1745,6.85,2,99.6,109162,866,108616,2.03,1.75,0.01391566265060241,0.79,99.5
2020-05-11,West Bengal,391,2,385,5252,1742,964,7.44,4,99.6,109553,868,109001,1.75,0.97,0.052730923694779115,0.79,99.5
2020-05-12,West Bengal,765,5,764,9383,1690,980,8.15,0,99.6,110318,873,109765,1.7,0.98,0.09420682730923695,0.79,99.5
2020-05-13,West Bengal,407,1,401,5358,4487,2340,7.6,5,99.6,110725,874,110166,4.51,2.35,0.053795180722891564,0.79,99.5
2020-05-14,West Bengal,794,11,788,9914,766,534,8.01,0,99.6,111519,885,110954,0.77,0.54,0.09953815261044177,0.79,99.49
2020-05-15,West Bengal,508,6,507,6592,3944,929,7.71,0,99.6,112027,891,111461,3.96,0.93,0.06618473895582329,0.8,99.49
2020-05-16,West Bengal,544,7,538,7016,3606,904,7.75,0,99.6,112571,898,111999,3.62,0.91,0.0704417670682731,0.8,99.49
2020-05-17,West Bengal,389,3,384,4574,2453,246,8.5,2,99.6,112960,901,112383,2.46,0.25,0.04592369477911647,0.8,99.49
2020-05-18,West Bengal,1524,13,1519,19020,414,43,8.01,0,99.6,114484,914,113902,0.42,0.04,0.19096385542168676,0.8,99.49
2020-05-19,West Bengal,1444,18,1441,18236,2682,1406,7.92,0,99.6,115928,932,115343,2.69,1.41,0.18309236947791166,0.8,99.5
2020-05-20,West Bengal,825,8,823,10281,4886,3068,8.02,0,99.6,116753,940,116166,4.91,3.08,0.10322289156626506,0.81,99.5
2020-05-21,West Bengal,89,1,84,1057,1413,747,8.42,4,99.6,116842,941,116250,1.42,0.75,0.010612449799196786,0.81,99.49
2020-05-22,West Bengal,393,1,388,5697,2560,1106,6.9,4,99.6,117235,942,116638,2.57,1.11,0.05719879518072289,0.8,99.49
2020-05-23,West Bengal,262,2,254,3334,3906,3537,7.86,6,99.6,117497,944,116892,3.92,3.55,0.03347389558232932,0.8,99.49
2020-05-24,West Bengal,1103,12,1102,13692,571,192,8.06,0,99.6,118600,956,117994,0.57,0.19,0.1374698795180723,0.81,99.49
2020-05-25,West Bengal,696,8,690,8573,895,399,8.12,0,99.6,119296,964,118684,0.9,0.4,0.08607429718875502,0.81,99.49
2020-05-26,West Bengal,587,4,585,7033,1586,494,8.35,0,99.6,119883,968,119269,1.59,0.5,0.07061244979919679,0.81,99.49
2020-05-27,West Bengal,42,0,34,630,136,108,6.67,8,99.6,119925,968,119303,0.14,0.11,0.006325301204819277,0.81,99.48
2020-05-28,West Bengal,339,2,332,3742,2398,215,9.06,5,99.6,120264,970,119635,2.41,0.22,0.03757028112449799,0.81,99.48
2020-05-29,West Bengal,621,5,620,7672,1546,1221,8.09,0,99.6,120885,975,120255,1.55,1.23,0.0770281124497992,0.81,99.48
2020-05-30,West Bengal,277,3,274,3149,4772,2634,8.8,0,99.6,121162,978,120529,4.79,2.64,0.03161646586345382,0.81,99.48
2020-05-31,West Bengal,1199,3,1195,15292,178,177,7.84,1,99.6,122361,981,121724,0.18,0.18,0.15353413654618475,0.8,99.48
2020-06-01,West Bengal,966,3,959,12240,2530,63,7.89,4,99.6,123327,984,122683,2.54,0.06,0.12289156626506025,0.8,99.48
2020-06-02,West Bengal,1501,11,1497,18616,3504,2689,8.06,0,99.6,124828,995,124180,3.52,2.7,0.18690763052208836,0.8,99.48
2020-06-03,West Bengal,458,4,449,5679,1280,12,8.06,5,99.6,125286,999,124629,1.29,0.01,0.057018072289156625,0.8,99.48
2020-06-04,West Bengal,1147,13,1138,14206,937,600,8.07,0,99.6,126433,1012,125767,0.94,0.6,0.14263052208835342,0.8,99.47
2020-06-05,West Bengal,987,7,978,12212,2040,323,8.08,2,99.6,127420,1019,126745,2.05,0.32,0.12261044176706827,0.8,99.47
2020-06-06,West Bengal,1332,15,1330,16747,670,464,7.95,0,99.6,128752,1034,128075,0.67,0.47,0.1681425702811245,0.8,99.47
2020-06-07,West Bengal,1476,14,1468,18523,4986,4349,7.97,0,99.6,130228,1048,129543,5.01,4.37,0.18597389558232932,0.8,99.47
2020-06-08,West Bengal,648,8,645,8182,4332,2424,7.92,0,99.6,130876,1056,130188,4.35,2.43,0.08214859437751004,0.81,99.47
2020-06-09,West Bengal,463,6,463,5756,1839,1668,8.04,0,99.6,131339,1062,130651,1.85,1.67,0.057791164658634535,0.81,99.48
2020-06-10,West Bengal,1251,12,1249,15916,1768,1,7.86,0,99.6,132590,1074,131900,1.78,0.0,0.1597991967871486,0.81,99.48
2020-06-11,West Bengal,1328,4,1323,16470,3539,674,8.06,1,99.6,133918,1078,133223,3.55,0.68,0.16536144578313253,0.8,99.48
2020-06-12,West Bengal,1120,9,1114,13527,819,514,8.28,0,99.6,135038,1087,134337,0.82,0.52,0.1358132530120482,0.8,99.48
2020-06-13,West Bengal,907,3,898,11333,4616,3494,8.0,6,99.6,135945,1090,135235,4.63,3.51,0.11378514056224899,0.8,99.48
2020-06-14,West Bengal,928,2,925,11376,2563,1151,8.16,1,99.6,136873,1092,136160,2.57,1.16,0.11421686746987952,0.8,99.48
2020-06-15,West Bengal,1161,15,1159,14791,255,94,7.85,0,99.6,138034,1107,137319,0.26,0.09,0.14850401606425703,0.8,99.48
2020-06-16,West Bengal,311,4,310,3647,1144,357,8.53,0,99.6,138345,1111,137629,1.15,0.36,0.036616465863453816,0.8,99.48
2020-06-17,West Bengal,526,5,519,6870,4172,2259,7.66,2,99.6,138871,1116,138148,4.19,2.27,0.06897590361445784,0.8,99.48
2020-06-18,West Bengal,834,9,833,10499,3411,379,7.94,0,99.6,139705,1125,138981,3.42,0.38,0.10541164658634539,0.81,99.48
2020-06-19,West Bengal,1127,9,1119,14081,4224,3492,8.0,0,99.6,140832,1134,140100,4.24,3.51,0.14137550200803212,0.81,99.48
2020-06-20,West Bengal,280,4,271,3931,2354,150,7.12,5,99.6,141112,1138,140371,2.36,0.15,0.03946787148594377,0.81,99.47
2020-06-21,West Bengal,1439,8,1433,18275,3280,741,7.87,0,99.6,142551,1146,141804,3.29,0.74,0.1834839357429719,0.8,99.48
2020-06-22,West Bengal,77,0,72,1034,3258,1192,7.45,5,99.6,142628,1146,141876,3.27,1.2,0.010381526104417671,0.8,99.47
2020-06-23,West Bengal,197,2,191,2620,2433,703,7.52,4,99.6,142825,1148,142067,2.44,0.71,0.026305220883534135,0.8,99.47
2020-06-24,West Bengal,603,6,595,7739,2781,2243,7.79,2,99.6,143428,1154,142662,2.79,2.25,0.0777008032128514,0.8,99.47
2020-06-25,West Bengal,1115,15,1112,13889,1815,96,8.03,0,99.6,144543,1169,143774,1.82,0.1,0.13944779116465864,0.81,99.47
2020-06-26,West Bengal,1400,17,1392,17444,466,376,8.03,0,99.6,145943,1186,145166,0.47,0.38,0.175140562248996,0.81,99.47
2020-06-27,West Bengal,813,8,808,10201,4320,1945,7.97,0,99.6,146756,1194,145974,4.34,1.95,0.10241967871485944,0.81,99.47
2020-06-28,West Bengal,1200,15,1191,15128,2666,2663,7.93,0,99.6,147956,1209,147165,2.68,2.67,0.15188755020080322,0.82,99.47
2020-06-29,West Bengal,1424,7,1416,17877,3803,1886,7.97,1,99.6,149380,1216,148581,3.82,1.89,0.17948795180722893,0.81,99.47
2020-06-30,West Bengal,59,0,53,629,2300,1659,9.38,6,99.6,149439,1216,148634,2.31,1.67,0.0063152610441767065,0.81,99.46
2020-07-01,West Bengal,1287,15,1282,15920,2577,1959,8.08,0,99.6,150726,1231,149916,2.59,1.97,0.1598393574297189,0.82,99.46
2020-07-02,West Bengal,974,7,973,12286,2540,1548,7.93,0,99.6,151700,1238,150889,2.55,1.55,0.12335341365461848,0.82,99.47
2020-07-03,West Bengal,898,12,898,11513,471,430,7.8,0,99.6,152598,1250,151787,0.47,0.43,0.11559236947791164,0.82,99.47
2020-07-04,West Bengal,211,0,203,2557,2185,190,8.25,8,99.6,152809,1250,151990,2.19,0.19,0.02567269076305221,0.82,99.46
2020-07-05,West Bengal,1174,15,1171,14512,4347,606,8.09,0,99.6,153983,1265,153161,4.36,0.61,0.1457028112449799,0.82,99.47
2020-07-06,West Bengal,166,0,157,1904,788,324,8.72,9,99.6,154149,1265,153318,0.79,0.33,0.019116465863453815,0.82,99.46
2020-07-07,West Bengal,1257,15,1256,15927,4034,2942,7.89,0,99.6,155406,1280,154574,4.05,2.95,0.15990963855421686,0.82,99.46
2020-07-08,West Bengal,1559,12,1556,19271,4694,2661,8.09,0,99.6,156965,1292,156130,4.71,2.67,0.19348393574297187,0.82,99.47
2020-07-09,West Bengal,1342,11,1338,16500,2450,2424,8.13,0,99.6,158307,1303,157468,2.46,2.43,0.16566265060240964,0.82,99.47
2020-07-10,West Bengal,395,3,395,4907,3218,1902,8.05,0,99.6,158702,1306,157863,3.23,1.91,0.04926706827309237,0.82,99.47
2020-07-11,West Bengal,254,1,245,3220,3186,1901,7.89,8,99.6,158956,1307,158108,3.2,1.91,0.032329317269076306,0.82,99.47
2020-07-12,West Bengal,221,2,215,2767,2422,1068,7.99,4,99.6,159177,1309,158323,2.43,1.07,0.027781124497991968,0.82,99.46
2020-07-13,West Bengal,214,2,214,2587,4731,1061,8.27,0,99.6,159391,1311,158537,4.75,1.07,0.025973895582329317,0.82,99.46
2020-07-14,West Bengal,686,2,684,8318,3492,580,8.25,0,99.6,160077,1313,159221,3.51,0.58,0.0835140562248996,0.82,99.47
2020-07-15,West Bengal,145,0,142,2067,1876,830,7.01,3,99.6,160222,1313,159363,1.88,0.83,0.02075301204819277,0.82,99.46
2020-07-16,West Bengal,1162,10,1156,14982,215,88,7.76,0,99.6,161384,1323,160519,0.22,0.09,0.15042168674698794,0.82,99.46
2020-07-17,West Bengal,348,4,347,4520,515,270,7.7,0,99.6,161732,1327,160866,0.52,0.27,0.04538152610441767,0.82,99.46
2020-07-18,West Bengal,1036,11,1033,12991,121,52,7.97,0,99.6,162768,1338,161899,0.12,0.05,0.13043172690763052,0.82,99.47
2020-07-19,West Bengal,164,1,162,2197,4929,853,7.46,1,99.6,162932,1339,162061,4.95,0.86,0.022058232931726908,0.82,99.47
2020-07-20,West Bengal,728,6,728,8828,4909,153,8.25,0,99.6,163660,1345,162789,4.93,0.15,0.08863453815261044,0.82,99.47
2020-07-21,West Bengal,284,3,275,3584,808,66,7.92,6,99.6,163944,1348,163064,0.81,0.07,0.03598393574297189,0.82,99.46
2020-07-22,West Bengal,101,0,96,1413,2813,2718,7.15,5,99.6,164045,1348,163160,2.82,2.73,0.014186746987951807,0.82,99.46
2020-07-23,West Bengal,1524,16,1520,18858,2912,1205,8.08,0,99.6,165569,1364,164680,2.92,1.21,0.18933734939759037,0.82,99.46
2020-07-24,West Bengal,576,5,569,7246,1352,1193,7.95,2,99.6,166145,1369,165249,1.36,1.2,0.07275100401606426,0.82,99.46
2020-07-25,West Bengal,663,5,659,8202,363,170,8.08,0,99.6,166808,1374,165908,0.36,0.17,0.08234939759036145,0.82,99.46
2020-07-26,West Bengal,635,2,626,8229,4828,3455,7.72,7,99.6,167443,1376,166534,4.85,3.47,0.08262048192771085,0.82,99.46
2020-07-27,West Bengal,441,5,435,5073,1123,824,8.69,1,99.6,167884,1381,166969,1.13,0.83,0.050933734939759036,0.82,99.45
2020-07-28,West Bengal,230,0,227,3183,4940,2020,7.23,3,99.6,168114,1381,167196,4.96,2.03,0.0319578313253012,0.82,99.45
2020-07-29,West Bengal,618,9,613,7880,323,297,7.84,0,99.6,168732,1390,167809,0.32,0.3,0.07911646586345382,0.82,99.45
2020-07-30,West Bengal,113,1,108,1195,4383,3994,9.46,4,99.6,168845,1391,167917,4.4,4.01,0.011997991967871486,0.82,99.45
2020-07-31,West Bengal,1338,12,1337,16581,4419,3745,8.07,0,99.6,170183,1403,169254,4.44,3.76,0.16647590361445783,0.82,99.45
2020-08-01,West Bengal,703,3,695,8658,4288,1932,8.12,5,99.6,170886,1406,169949,4.31,1.94,0.08692771084337349,0.82,99.45
2020-08-02,West Bengal,385,1,378,4777,1935,1289,8.06,6,99.6,171271,1407,170327,1.94,1.29,0.047961847389558235,0.82,99.45
2020-08-03,West Bengal,667,4,660,8776,2476,960,7.6,3,99.6,171938,1411,170987,2.49,0.96,0.08811244979919679,0.82,99.45
2020-08-04,West Bengal,319,1,318,4172,895,484,7.65,0,99.6,172257,1412,171305,0.9,0.49,0.04188755020080321,0.82,99.45
2020-08-05,West Bengal,784,7,776,10182,1191,812,7.7,1,99.6,173041,1419,172081,1.2,0.82,0.1022289156626506,0.82,99.45
2020-08-06,West Bengal,1082,6,1082,13641,4553,4531,7.93,0,99.6,174123,1425,173163,4.57,4.55,0.1369578313253012,0.82,99.45
2020-08-07,West Bengal,481,2,481,6046,448,362,7.96,0,99.6,174604,1427,173644,0.45,0.36,0.06070281124497992,0.82,99.45
2020-08-08,West Bengal,1200,15,1196,15045,2097,733,7.98,0,99.6,175804,1442,174840,2.11,0.74,0.1510542168674699,0.82,99.45
2020-08-09,West Bengal,181,2,172,2663,2319,155,6.8,7,99.6,175985,1444,175012,2.33,0.16,0.02673694779116466,0.82,99.45
2020-08-10,West Bengal,314,3,306,3911,993,940,8.03,5,99.6,176299,1447,175318,1.0,0.94,0.03926706827309237,0.82,99.44
2020-08-11,West Bengal,71,0,70,688,2209,1879,10.32,1,99.6,176370,1447,175388,2.22,1.89,0.006907630522088353,0.82,99.44
2020-08-12,West Bengal,455,4,449,5939,2077,424,7.66,2,99.6,176825,1451,175837,2.09,0.43,0.0596285140562249,0.82,99.44
2020-08-13,West Bengal,872,7,865,10977,694,252,7.94,0,99.6,177697,1458,176702,0.7,0.25,0.11021084337349397,0.82,99.44
2020-08-14,West Bengal,462,4,457,5618,3534,1467,8.22,1,99.6,178159,1462,177159,3.55,1.47,0.05640562248995984,0.82,99.44
2020-08-15,West Bengal,670,9,666,8466,3346,2351,7.91,0,99.6,178829,1471,177825,3.36,2.36,0.085,0.82,99.44
2020-08-16,West Bengal,290,3,286,3722,2120,1531,7.79,1,99.6,179119,1474,178111,2.13,1.54,0.03736947791164659,0.82,99.44
2020-08-17,West Bengal,1519,16,1518,19062,2414,646,7.97,0,99.6,180638,1490,179629,2.42,0.65,0.1913855421686747,0.82,99.44
2020-08-18,West Bengal,1100,11,1093,14070,4178,1118,7.82,0,99.6,181738,1501,180722,4.19,1.12,0.14126506024096386,0.83,99.44
2020-08-19,West Bengal,47,0,46,683,1577,665,6.88,1,99.6,181785,1501,180768,1.58,0.67,0.006857429718875502,0.83,99.44
2020-08-20,West Bengal,1426,16,1418,18109,2574,2484,7.87,0,99.6,183211,1517,182186,2.58,2.49,0.18181726907630522,0.83,99.44
2020-08-21,West Bengal,934,4,934,11539,4937,1957,8.09,0,99.6,184145,1521,183120,4.96,1.96,0.11585341365461847,0.83,99.44
2020-08-22,West Bengal,279,2,270,3355,4343,3986,8.32,7,99.6,184424,1523,183390,4.36,4.0,0.033684738955823294,0.83,99.44
2020-08-23,West Bengal,262,2,254,3750,2141,1903,6.99,6,99.6,184686,1525,183644,2.15,1.91,0.03765060240963856,0.83,99.44
2020-08-24,West Bengal,1095,16,1095,14019,2978,189,7.81,0,99.6,185781,1541,184739,2.99,0.19,0.14075301204819277,0.83,99.44
2020-08-25,West Bengal,1421,11,1416,17430,483,174,8.15,0,99.6,187202,1552,186155,0.48,0.17,0.175,0.83,99.44
2020-08-26,West Bengal,847,5,847,10165,2474,975,8.33,0,99.6,188049,1557,187002,2.48,0.98,0.1020582329317269,0.83,99.44
2020-08-27,West Bengal,244,1,243,2860,4561,4101,8.53,0,99.6,188293,1558,187245,4.58,4.12,0.028714859437751004,0.83,99.44
2020-08-28,West Bengal,400,2,392,4875,4972,4552,8.21,6,99.6,188693,1560,187637,4.99,4.57,0.04894578313253012,0.83,99.44
2020-08-29,West Bengal,822,6,821,10204,667,191,8.06,0,99.6,189515,1566,188458,0.67,0.19,0.10244979919678715,0.83,99.44
2020-08-30,West Bengal,563,3,557,7060,2013,700,7.97,3,99.6,190078,1569,189015,2.02,0.7,0.07088353413654619,0.83,99.44
2020-08-31,West Bengal,300,1,294,3711,1775,1652,8.08,5,99.6,190378,1570,189309,1.78,1.66,0.03725903614457831,0.82,99.44
2020-09-01,West Bengal,70,0,70,807,3256,2226,8.67,0,99.6,190448,1570,189379,3.27,2.23,0.008102409638554216,0.82,99.44
2020-09-02,West Bengal,1028,11,1019,12833,4069,311,8.01,0,99.6,191476,1581,190398,4.09,0.31,0.12884538152610442,0.83,99.44
2020-09-03,West Bengal,538,4,538,6739,672,193,7.98,0,99.6,192014,1585,190936,0.67,0.19,0.06766064257028112,0.83,99.44
2020-09-04,West Bengal,679,9,679,8207,2215,1430,8.27,0,99.6,192693,1594,191615,2.22,1.44,0.0823995983935743,0.83,99.44
2020-09-05,West Bengal,1167,15,1167,15071,2632,1380,7.74,0,99.6,193860,1609,192782,2.64,1.39,0.1513152610441767,0.83,99.44
2020-09-06,West Bengal,1171,17,1166,14635,1400,1124,8.0,0,99.6,195031,1626,193948,1.41,1.13,0.14693775100401607,0.83,99.44
2020-09-07,West Bengal,1063,13,1063,13253,335,130,8.02,0,99.6,196094,1639,195011,0.34,0.13,0.13306224899598393,0.84,99.45
2020-09-08,West Bengal,625,4,618,7858,3786,2885,7.95,3,99.6,196719,1643,195629,3.8,2.9,0.07889558232931727,0.84,99.45
2020-09-09,West Bengal,185,1,178,2892,851,811,6.4,6,99.6,196904,1644,195807,0.85,0.81,0.02903614457831325,0.83,99.44
2020-09-10,West Bengal,767,10,763,9302,3123,1113,8.25,0,99.6,197671,1654,196570,3.14,1.12,0.09339357429718875,0.84,99.44
2020-09-11,West Bengal,151,1,145,1795,1907,344,8.41,5,99.6,197822,1655,196715,1.91,0.35,0.018022088353413655,0.84,99.44
2020-09-12,West Bengal,1576,10,1576,19491,4762,3383,8.09,0,99.6,199398,1665,198291,4.78,3.4,0.19569277108433736,0.84,99.44
2020-09-13,West Bengal,1316,5,1312,16259,2483,2268,8.09,0,99.6,200714,1670,199603,2.49,2.28,0.16324297188755021,0.83,99.45
2020-09-14,West Bengal,392,2,391,5094,4067,768,7.7,0,99.6,201106,1672,199994,4.08,0.77,0.05114457831325301,0.83,99.45
2020-09-15,West Bengal,101,0,98,951,337,77,10.62,3,99.6,201207,1672,200092,0.34,0.08,0.009548192771084337,0.83,99.45
2020-09-16,West Bengal,1395,17,1390,17383,1820,797,8.03,0,99.6,202602,1689,201482,1.83,0.8,0.17452811244979918,0.83,99.45
2020-09-17,West Bengal,667,4,663,8260,435,271,8.08,0,99.6,203269,1693,202145,0.44,0.27,0.08293172690763052,0.83,99.45
2020-09-18,West Bengal,685,2,684,8453,4753,3287,8.1,0,99.6,203954,1695,202829,4.77,3.3,0.08486947791164659,0.83,99.45
2020-09-19,West Bengal,575,6,574,7175,2815,983,8.01,0,99.6,204529,1701,203403,2.83,0.99,0.07203815261044176,0.83,99.45
2020-09-20,West Bengal,1242,4,1240,15326,3273,2141,8.1,0,99.6,205771,1705,204643,3.29,2.15,0.15387550200803213,0.83,99.45
2020-09-21,West Bengal,1038,11,1037,13040,4594,1920,7.96,0,99.6,206809,1716,205680,4.61,1.93,0.13092369477911647,0.83,99.45
2020-09-22,West Bengal,565,4,564,7114,714,650,7.94,0,99.6,207374,1720,206244,0.72,0.65,0.07142570281124498,0.83,99.46
2020-09-23,West Bengal,636,2,636,8484,3148,1412,7.5,0,99.6,208010,1722,206880,3.16,1.42,0.08518072289156627,0.83,99.46
2020-09-24,West Bengal,1019,6,1013,12602,1971,310,8.09,0,99.6,209029,1728,207893,1.98,0.31,0.12652610441767068,0.83,99.46
2020-09-25,West Bengal,636,2,633,8013,4727,2264,7.94,1,99.6,209665,1730,208526,4.75,2.27,0.08045180722891566,0.83,99.46
2020-09-26,West Bengal,243,2,243,2689,1996,909,9.04,0,99.6,209908,1732,208769,2.0,0.91,0.026997991967871487,0.83,99.46
2020-09-27,West Bengal,1213,8,1211,15310,4427,3968,7.92,0,99.6,211121,1740,209980,4.44,3.98,0.153714859437751,0.82,99.46
2020-09-28,West Bengal,61,0,60,689,901,128,8.85,1,99.6,211182,1740,210040,0.9,0.13,0.006917670682730924,0.82,99.46
2020-09-29,West Bengal,824,8,820,10848,1193,1020,7.6,0,99.6,212006,1748,210860,1.2,1.02,0.10891566265060242,0.82,99.46
2020-09-30,West Bengal,910,11,907,11337,4287,276,8.03,0,99.6,212916,1759,211767,4.3,0.28,0.11382530120481928,0.83,99.46
2020-10-01,West Bengal,237,0,237,2766,2389,520,8.57,0,99.6,213153,1759,212004,2.4,0.52,0.027771084337349396,0.83,99.46
2020-10-02,West Bengal,1100,5,1099,13818,2237,1944,7.96,0,99.6,214253,1764,213103,2.25,1.95,0.13873493975903614,0.82,99.46
2020-10-03,West Bengal,1482,5,1479,18625,985,179,7.96,0,99.6,215735,1769,214582,0.99,0.18,0.18699799196787148,0.82,99.47
2020-10-04,West Bengal,1140,10,1140,13885,2380,2364,8.21,0,99.6,216875,1779,215722,2.39,2.37,0.13940763052208835,0.82,99.47
2020-10-05,West Bengal,1215,13,1214,15278,52,3,7.95,0,99.6,218090,1792,216936,0.05,0.0,0.15339357429718875,0.82,99.47
2020-10-06,West Bengal,103,1,96,731,2015,198,14.09,6,99.6,218193,1793,217032,2.02,0.2,0.007339357429718875,0.82,99.47
2020-10-07,West Bengal,110,0,110,1414,1611,1357,7.78,0,99.6,218303,1793,217142,1.62,1.36,0.014196787148594377,0.82,99.47
2020-10-08,West Bengal,46,0,43,618,2916,161,7.44,3,99.6,218349,1793,217185,2.93,0.16,0.006204819277108434,0.82,99.47
2020-10-09,West Bengal,326,1,321,4723,1017,714,6.9,4,99.6,218675,1794,217506,1.02,0.72,0.047419678714859435,0.82,99.47
2020-10-10,West Bengal,363,2,358,4627,503,267,7.85,3,99.6,219038,1796,217864,0.51,0.27,0.04645582329317269,0.82,99.46
2020-10-11,West Bengal,873,12,872,11491,1546,1105,7.6,0,99.6,219911,1808,218736,1.55,1.11,0.1153714859437751,0.82,99.47
2020-10-12,West Bengal,148,0,139,2221,1923,897,6.66,9,99.6,220059,1808,218875,1.93,0.9,0.022299196787148593,0.82,99.46
2020-10-13,West Bengal,135,1,133,1648,4873,2761,8.19,1,99.6,220194,1809,219008,4.89,2.77,0.016546184738955822,0.82,99.46
2020-10-14,West Bengal,707,5,700,8535,820,166,8.28,2,99.6,220901,1814,219708,0.82,0.17,0.08569277108433734,0.82,99.46
2020-10-15,West Bengal,1247,14,1241,15742,4139,2519,7.92,0,99.6,222148,1828,220949,4.16,2.53,0.15805220883534138,0.82,99.46
2020-10-16,West Bengal,1355,16,1355,16890,4071,1601,8.02,0,99.6,223503,1844,222304,4.09,1.61,0.16957831325301204,0.83,99.46
2020-10-17,West Bengal,1609,16,1606,19895,553,363,8.09,0,99.6,225112,1860,223910,0.56,0.36,0.19974899598393575,0.83,99.47
2020-10-18,West Bengal,1168,9,1160,14276,2968,2152,8.18,0,99.6,226280,1869,225070,2.98,2.16,0.14333333333333334,0.83,99.47
2020-10-19,West Bengal,583,7,576,7870,1403,918,7.41,0,99.6,226863,1876,225646,1.41,0.92,0.07901606425702812,0.83,99.46
2020-10-20,West Bengal,894,12,889,11383,4795,2881,7.85,0,99.6,227757,1888,226535,4.81,2.89,0.11428714859437751,0.83,99.46
2020-10-21,West Bengal,254,3,245,3695,2664,981,6.87,6,99.6,228011,1891,226780,2.67,0.98,0.03709839357429719,0.83,99.46
2020-10-22,West Bengal,727,8,719,9262,542,164,7.85,0,99.6,228738,1899,227499,0.54,0.16,0.09299196787148595,0.83,99.46
2020-10-23,West Bengal,1164,4,1164,14504,2897,1524,8.03,0,99.6,229902,1903,228663,2.91,1.53,0.14562248995983937,0.83,99.46
2020-10-24,West Bengal,701,9,699,8796,220,105,7.97,0,99.6,230603,1912,229362,0.22,0.11,0.08831325301204819,0.83,99.46
2020-10-25,West Bengal,492,2,488,6736,2430,1051,7.3,2,99.6,231095,1914,229850,2.44,1.06,0.06763052208835342,0.83,99.46
2020-10-26,West Bengal,456,3,451,5529,4993,1332,8.25,2,99.6,231551,1917,230301,5.01,1.34,0.055512048192771085,0.83,99.46
2020-10-27,West Bengal,1500,7,1494,18912,189,112,7.93,0,99.6,233051,1924,231795,0.19,0.11,0.18987951807228914,0.83,99.46
2020-10-28,West Bengal,614,8,608,7913,3173,2456,7.76,0,99.6,233665,1932,232403,3.19,2.47,0.07944779116465864,0.83,99.46
2020-10-29,West Bengal,144,2,143,1847,222,86,7.8,0,99.6,233809,1934,232546,0.22,0.09,0.018544176706827308,0.83,99.46
2020-10-30,West Bengal,859,3,858,10500,2889,5,8.18,0,99.6,234668,1937,233404,2.9,0.01,0.10542168674698796,0.83,99.46
2020-10-31,West Bengal,1488,7,1483,18340,2303,856,8.11,0,99.6,236156,1944,234887,2.31,0.86,0.18413654618473896,0.82,99.46
2020-11-01,West Bengal,385,5,379,4351,1908,84,8.85,1,99.6,236541,1949,235266,1.92,0.08,0.043684738955823296,0.82,99.46
2020-11-02,West Bengal,666,8,665,8799,2365,825,7.57,0,99.6,237207,1957,235931,2.37,0.83,0.0883433734939759,0.83,99.46
2020-11-03,West Bengal,17,0,13,921,1001,853,1.85,4,99.6,237224,1957,235944,1.01,0.86,0.009246987951807228,0.82,99.46
2020-11-04,West Bengal,1573,21,1571,19545,4184,2565,8.05,0,99.6,238797,1978,237515,4.2,2.58,0.19623493975903614,0.83,99.46
2020-11-05,West Bengal,305,3,301,4089,972,899,7.46,1,99.6,239102,1981,237816,0.98,0.9,0.04105421686746988,0.83,99.46
2020-11-06,West Bengal,111,1,111,1394,1924,1401,7.96,0,99.6,239213,1982,237927,1.93,1.41,0.013995983935742973,0.83,99.46
2020-11-07,West Bengal,676,9,676,7813,23,8,8.65,0,99.6,239889,1991,238603,0.02,0.01,0.07844377510040161,0.83,99.46
2020-11-08,West Bengal,160,1,156,1766,3676,927,9.06,3,99.6,240049,1992,238759,3.69,0.93,0.017730923694779115,0.83,99.46
2020-11-09,West Bengal,971,6,970,11630,372,35,8.35,0,99.6,241020,1998,239729,0.37,0.04,0.11676706827309237,0.83,99.46
2020-11-10,West Bengal,330,1,325,4176,586,514,7.9,4,99.6,241350,1999,240054,0.59,0.52,0.041927710843373496,0.83,99.46
2020-11-11,West Bengal,1561,15,1554,19949,843,37,7.82,0,99.6,242911,2014,241608,0.85,0.04,0.20029116465863453,0.83,99.46
2020-11-12,West Bengal,1091,5,1090,13880,4783,2529,7.86,0,99.6,244002,2019,242698,4.8,2.54,0.1393574297188755,0.83,99.47
2020-11-13,West Bengal,317,1,309,3531,3741,2588,8.98,7,99.6,244319,2020,243007,3.76,2.6,0.035451807228915666,0.83,99.46
2020-11-14,West Bengal,966,9,958,12096,2821,2228,7.99,0,99.6,245285,2029,243965,2.83,2.24,0.12144578313253013,0.83,99.46
2020-11-15,West Bengal,365,2,360,4643,4637,1952,7.86,3,99.6,245650,2031,244325,4.66,1.96,0.04661646586345382,0.83,99.46
2020-11-16,West Bengal,757,5,748,9568,2975,1548,7.91,4,99.6,246407,2036,245073,2.99,1.55,0.09606425702811244,0.83,99.46
2020-11-17,West Bengal,1545,22,1536,19364,4080,1711,7.98,0,99.6,247952,2058,246609,4.1,1.72,0.19441767068273091,0.83,99.46
2020-11-18,West Bengal,651,3,651,8211,2435,189,7.93,0,99.6,248603,2061,247260,2.44,0.19,0.08243975903614457,0.83,99.46
2020-11-19,West Bengal,1237,10,1235,14891,3004,1260,8.31,0,99.6,249840,2071,248495,3.02,1.27,0.14950803212851405,0.83,99.46
2020-11-20,West Bengal,228,3,219,2606,380,349,8.75,6,99.6,250068,2074,248714,0.38,0.35,0.02616465863453815,0.83,99.46
2020-11-21,West Bengal,1033,9,1027,13255,1997,408,7.79,0,99.6,251101,2083,249741,2.01,0.41,0.13308232931726907,0.83,99.46
2020-11-22,West Bengal,913,11,908,11621,3587,3217,7.86,0,99.6,252014,2094,250649,3.6,3.23,0.11667670682730924,0.83,99.46
2020-11-23,West Bengal,210,2,204,2731,388,188,7.69,4,99.6,252224,2096,250853,0.39,0.19,0.02741967871485944,0.83,99.46
2020-11-24,West Bengal,598,8,596,7548,3346,2785,7.92,0,99.6,252822,2104,251449,3.36,2.8,0.07578313253012048,0.83,99.46
2020-11-25,West Bengal,173,2,171,2117,777,342,8.17,0,99.6,252995,2106,251620,0.78,0.34,0.021255020080321284,0.83,99.46
2020-11-26,West Bengal,148,2,148,1789,2547,810,8.27,0,99.6,253143,2108,251768,2.56,0.81,0.017961847389558232,0.83,99.46
2020-11-27,West Bengal,127,1,122,1243,2876,1732,10.22,4,99.6,253270,2109,251890,2.89,1.74,0.01247991967871486,0.83,99.46
2020-11-28,West Bengal,1407,19,1405,17379,425,299,8.1,0,99.6,254677,2128,253295,0.43,0.3,0.17448795180722892,0.84,99.46
2020-11-29,West Bengal,1028,14,1019,12489,803,660,8.23,0,99.6,255705,2142,254314,0.81,0.66,0.12539156626506023,0.84,99.46
2020-11-30,West Bengal,1104,16,1103,13879,4218,201,7.95,0,99.6,256809,2158,255417,4.23,0.2,0.13934738955823292,0.84,99.46
2020-12-01,West Bengal,770,4,770,9438,1886,628,8.16,0,99.6,257579,2162,256187,1.89,0.63,0.09475903614457831,0.84,99.46
2020-12-02,West Bengal,141,1,135,1680,4343,2153,8.39,5,99.6,257720,2163,256322,4.36,2.16,0.016867469879518072,0.84,99.46
2020-12-03,West Bengal,189,2,181,2427,634,563,7.79,6,99.6,257909,2165,256503,0.64,0.57,0.024367469879518072,0.84,99.45
2020-12-04,West Bengal,281,1,274,3410,2511,120,8.24,6,99.6,258190,2166,256777,2.52,0.12,0.03423694779116466,0.84,99.45
2020-12-05,West Bengal,1068,4,1064,13191,2324,21,8.1,0,99.6,259258,2170,257841,2.33,0.02,0.13243975903614458,0.84,99.45
2020-12-06,West Bengal,1548,15,1542,19374,1221,421,7.99,0,99.6,260806,2185,259383,1.23,0.42,0.19451807228915663,0.84,99.45
2020-12-07,West Bengal,1197,9,1190,14556,554,14,8.22,0,99.6,262003,2194,260573,0.56,0.01,0.146144578313253,0.84,99.45
2020-12-08,West Bengal,633,9,624,7949,2434,469,7.96,0,99.6,262636,2203,261197,2.44,0.47,0.07980923694779117,0.84,99.45
2020-12-09,West Bengal,851,11,851,10550,4243,561,8.07,0,99.6,263487,2214,262048,4.26,0.56,0.10592369477911646,0.84,99.45
2020-12-10,West Bengal,270,1,267,2929,1723,783,9.22,2,99.6,263757,2215,262315,1.73,0.79,0.029407630522088352,0.84,99.45
2020-12-11,West Bengal,819,8,811,10317,1939,865,7.94,0,99.6,264576,2223,263126,1.95,0.87,0.10358433734939759,0.84,99.45
2020-12-12,West Bengal,722,6,714,8368,3003,2770,8.63,2,99.6,265298,2229,263840,3.02,2.78,0.08401606425702811,0.84,99.45
2020-12-13,West Bengal,807,8,798,9810,919,786,8.23,1,99.6,266105,2237,264638,0.92,0.79,0.09849397590361446,0.84,99.45
2020-12-14,West Bengal,459,5,451,5886,3389,1919,7.8,3,99.6,266564,2242,265089,3.4,1.93,0.05909638554216867,0.84,99.45
2020-12-15,West Bengal,99,0,93,1120,2065,789,8.84,6,99.6,266663,2242,265182,2.07,0.79,0.011244979919678716,0.84,99.44
2020-12-16,West Bengal,996,3,987,12422,1809,1144,8.02,6,99.6,267659,2245,266169,1.82,1.15,0.12471887550200803,0.84,99.44
2020-12-17,West Bengal,860,5,852,10846,1636,1007,7.93,3,99.6,268519,2250,267021,1.64,1.01,0.10889558232931727,0.84,99.44
2020-12-18,West Bengal,1557,14,1555,19318,568,532,8.06,0,99.6,270076,2264,268576,0.57,0.53,0.19395582329317268,0.84,99.44
2020-12-19,West Bengal,1464,16,1464,18349,4477,2700,7.98,0,99.6,271540,2280,270040,4.49,2.71,0.1842269076305221,0.84,99.45
2020-12-20,West Bengal,338,1,331,4221,2665,1343,8.01,6,99.6,271878,2281,270371,2.68,1.35,0.04237951807228916,0.84,99.45
2020-12-21,West Bengal,611,7,603,7837,960,532,7.8,1,99.6,272489,2288,270974,0.96,0.53,0.0786847389558233,0.84,99.44
2020-12-22,West Bengal,1569,10,1566,19286,2617,1351,8.14,0,99.6,274058,2298,272540,2.63,1.36,0.19363453815261045,0.84,99.45
2020-12-23,West Bengal,1351,4,1344,17322,2061,516,7.8,3,99.6,275409,2302,273884,2.07,0.52,0.1739156626506024,0.84,99.45
2020-12-24,West Bengal,592,7,585,7682,206,4,7.71,0,99.6,276001,2309,274469,0.21,0.0,0.0771285140562249,0.84,99.44
2020-12-25,West Bengal,883,5,878,10604,4718,1131,8.33,0,99.6,276884,2314,275347,4.74,1.14,0.10646586345381526,0.84,99.44
2020-12-26,West Bengal,851,4,846,10246,1836,1555,8.31,1,99.6,277735,2318,276193,1.84,1.56,0.1028714859437751,0.83,99.44
2020-12-27,West Bengal,523,4,521,6599,2722,1250,7.93,0,99.6,278258,2322,276714,2.73,1.26,0.06625502008032129,0.83,99.45
2020-12-28,West Bengal,1034,12,1034,12899,2560,114,8.02,0,99.6,279292,2334,277748,2.57,0.11,0.12950803212851406,0.84,99.45
2020-12-29,West Bengal,71,0,68,1442,1243,777,4.92,3,99.6,279363,2334,277816,1.25,0.78,0.014477911646586345,0.84,99.45
2020-12-30,West Bengal,1130,5,1127,13994,3416,819,8.07,0,99.6,280493,2339,278943,3.43,0.82,0.1405020080321285,0.83,99.45
2020-12-31,West Bengal,1394,16,1388,17572,4627,1788,7.93,0,99.6,281887,2355,280331,4.65,1.8,0.17642570281124498,0.84,99.45
2021-01-01,West Bengal,62,0,53,874,2159,1875,7.09,9,99.6,281949,2355,280384,2.17,1.88,0.008775100401606426,0.84,99.44
2021-01-02,West Bengal,728,9,719,9429,2021,467,7.72,0,99.6,282677,2364,281103,2.03,0.47,0.09466867469879518,0.84,99.44
2021-01-03,West Bengal,990,10,990,12213,959,834,8.11,0,99.6,283667,2374,282093,0.96,0.84,0.12262048192771084,0.84,99.45
2021-01-04,West Bengal,321,2,314,3656,487,418,8.78,5,99.6,283988,2376,282407,0.49,0.42,0.036706827309236946,0.84,99.44
2021-01-05,West Bengal,279,1,272,3424,1337,319,8.15,6,99.6,284267,2377,282679,1.34,0.32,0.034377510040160646,0.84,99.44
2021-01-06,West Bengal,1040,9,1037,12994,4215,362,8.0,0,99.6,285307,2386,283716,4.23,0.36,0.13046184738955824,0.84,99.44
2021-01-07,West Bengal,1258,12,1250,15024,2900,1614,8.37,0,99.6,286565,2398,284966,2.91,1.62,0.1508433734939759,0.84,99.44
2021-01-08,West Bengal,550,2,541,6654,702,638,8.27,7,99.6,287115,2400,285507,0.7,0.64,0.06680722891566265,0.84,99.44
2021-01-09,West Bengal,418,4,417,5279,1536,650,7.92,0,99.6,287533,2404,285924,1.54,0.65,0.05300200803212851,0.84,99.44
2021-01-10,West Bengal,387,3,378,4445,2348,1480,8.71,6,99.6,287920,2407,286302,2.36,1.49,0.0446285140562249,0.84,99.44
2021-01-11,West Bengal,980,5,976,12280,181,33,7.98,0,99.6,288900,2412,287278,0.18,0.03,0.12329317269076305,0.83,99.44
2021-01-12,West Bengal,367,3,366,4661,695,146,7.87,0,99.6,289267,2415,287644,0.7,0.15,0.04679718875502008,0.83,99.44
2021-01-13,West Bengal,1102,10,1096,13939,2909,1701,7.91,0,99.6,290369,2425,288740,2.92,1.71,0.13994979919678716,0.84,99.44
2021-01-14,West Bengal,1046,14,1042,12880,2663,1872,8.12,0,99.6,291415,2439,289782,2.67,1.88,0.12931726907630522,0.84,99.44
2021-01-15,West Bengal,714,4,710,8437,100,57,8.46,0,99.6,292129,2443,290492,0.1,0.06,0.08470883534136546,0.84,99.44
2021-01-16,West Bengal,265,1,258,3093,4884,3198,8.57,6,99.6,292394,2444,290750,4.9,3.21,0.03105421686746988,0.84,99.44
2021-01-17,West Bengal,319,1,317,4168,4664,205,7.65,1,99.6,292713,2445,291067,4.68,0.21,0.04184738955823293,0.84,99.44
2021-01-18,West Bengal,368,3,362,4625,4713,4186,7.96,3,99.6,293081,2448,291429,4.73,4.2,0.04643574297188755,0.84,99.44
2021-01-19,West Bengal,1546,13,1545,19604,2080,973,7.89,0,99.6,294627,2461,292974,2.09,0.98,0.1968273092369478,0.84,99.44
2021-01-20,West Bengal,1350,15,1346,16826,4906,609,8.02,0,99.6,295977,2476,294320,4.93,0.61,0.16893574297188754,0.84,99.44
2021-01-21,West Bengal,1052,5,1043,13347,4932,2491,7.88,4,99.6,297029,2481,295363,4.95,2.5,0.13400602409638554,0.84,99.44
2021-01-22,West Bengal,1117,14,1110,13827,3723,3427,8.08,0,99.6,298146,2495,296473,3.74,3.44,0.13882530120481928,0.84,99.44
2021-01-23,West Bengal,855,9,853,10605,148,126,8.06,0,99.6,299001,2504,297326,0.15,0.13,0.10647590361445783,0.84,99.44
2021-01-24,West Bengal,1486,21,1481,18546,1932,278,8.01,0,99.6,300487,2525,298807,1.94,0.28,0.18620481927710844,0.84,99.44
2021-01-25,West Bengal,1314,19,1307,16349,3731,1026,8.04,0,99.6,301801,2544,300114,3.75,1.03,0.16414658634538154,0.84,99.44
2021-01-26,West Bengal,686,7,682,8611,1421,531,7.97,0,99.6,302487,2551,300796,1.43,0.53,0.0864558232931727,0.84,99.44
2021-01-27,West Bengal,1553,21,1550,19558,2213,1520,7.94,0,99.6,304040,2572,302346,2.22,1.53,0.19636546184738957,0.85,99.44
2021-01-28,West Bengal,461,6,452,5553,2228,978,8.3,3,99.6,304501,2578,302798,2.24,0.98,0.055753012048192774,0.85,99.44
2021-01-29,West Bengal,1270,13,1265,15896,1594,1157,7.99,0,99.6,305771,2591,304063,1.6,1.16,0.1595983935742972,0.85,99.44
2021-01-30,West Bengal,1120,9,1114,14250,1587,665,7.86,0,99.6,306891,2600,305177,1.59,0.67,0.1430722891566265,0.85,99.44
2021-01-31,West Bengal,1295,15,1287,16260,4896,533,7.96,0,99.6,308186,2615,306464,4.92,0.54,0.16325301204819276,0.85,99.44
2021-02-01,West Bengal,480,2,479,6138,1419,821,7.82,0,99.6,308666,2617,306943,1.42,0.82,0.06162650602409638,0.85,99.44
2021-02-02,West Bengal,962,12,958,11704,180,159,8.22,0,99.6,309628,2629,307901,0.18,0.16,0.11751004016064256,0.85,99.44
2021-02-03,West Bengal,1182,11,1177,14806,2534,2387,7.98,0,99.6,310810,2640,309078,2.54,2.4,0.14865461847389558,0.85,99.44
2021-02-04,West Bengal,693,2,689,8752,4581,4453,7.92,2,99.6,311503,2642,309767,4.6,4.47,0.0878714859437751,0.85,99.44
2021-02-05,West Bengal,917,11,908,11677,3857,2621,7.85,0,99.6,312420,2653,310675,3.87,2.63,0.11723895582329318,0.85,99.44
2021-02-06,West Bengal,244,3,235,3269,3368,1022,7.46,6,99.6,312664,2656,310910,3.38,1.03,0.03282128514056225,0.85,99.44
2021-02-07,West Bengal,1097,7,1092,13661,1913,389,8.03,0,99.6,313761,2663,312002,1.92,0.39,0.1371586345381526,0.85,99.44
2021-02-08,West Bengal,1180,17,1174,14575,104,52,8.1,0,99.6,314941,2680,313176,0.1,0.05,0.14633534136546184,0.85,99.44
2021-02-09,West Bengal,429,4,429,5239,4871,2,8.19,0,99.6,315370,2684,313605,4.89,0.0,0.052600401606425706,0.85,99.44
2021-02-10,West Bengal,937,11,929,11458,3035,852,8.18,0,99.6,316307,2695,314534,3.05,0.86,0.11504016064257028,0.85,99.44
2021-02-11,West Bengal,1038,8,1036,13037,2054,1929,7.96,0,99.6,317345,2703,315570,2.06,1.94,0.13089357429718876,0.85,99.44
2021-02-12,West Bengal,715,7,709,9324,3637,553,7.67,0,99.6,318060,2710,316279,3.65,0.56,0.0936144578313253,0.85,99.44
2021-02-13,West Bengal,1283,3,1278,15872,3085,731,8.08,2,99.6,319343,2713,317557,3.1,0.73,0.1593574297188755,0.85,99.44
2021-02-14,West Bengal,691,10,690,8507,1469,9,8.12,0,99.6,320034,2723,318247,1.47,0.01,0.08541164658634538,0.85,99.44
2021-02-15,West Bengal,854,5,848,10795,424,131,7.91,1,99.6,320888,2728,319095,0.43,0.13,0.10838353413654618,0.85,99.44
2021-02-16,West Bengal,294,0,287,3542,3582,3526,8.3,7,99.6,321182,2728,319382,3.6,3.54,0.03556224899598394,0.85,99.44
2021-02-17,West Bengal,605,1,597,7553,3510,946,8.01,7,99.6,321787,2729,319979,3.52,0.95,0.07583333333333334,0.85,99.44
2021-02-18,West Bengal,968,12,968,12566,4131,170,7.7,0,99.6,322755,2741,320947,4.15,0.17,0.12616465863453816,0.85,99.44
2021-02-19,West Bengal,1289,5,1283,16359,552,551,7.88,1,99.6,324044,2746,322230,0.55,0.55,0.16424698795180723,0.85,99.44
2021-02-20,West Bengal,786,9,783,9920,3450,1933,7.92,0,99.6,324830,2755,323013,3.46,1.94,0.09959839357429719,0.85,99.44
2021-02-21,West Bengal,448,2,442,5567,3158,3127,8.05,4,99.6,325278,2757,323455,3.17,3.14,0.055893574297188754,0.85,99.44
2021-02-22,West Bengal,1172,12,1165,14588,2545,881,8.03,0,99.6,326450,2769,324620,2.56,0.88,0.14646586345381526,0.85,99.44
2021-02-23,West Bengal,1494,13,1491,18629,815,302,8.02,0,99.6,327944,2782,326111,0.82,0.3,0.18703815261044177,0.85,99.44
2021-02-24,West Bengal,1094,14,1092,13753,1624,129,7.95,0,99.6,329038,2796,327203,1.63,0.13,0.13808232931726908,0.85,99.44
2021-02-25,West Bengal,526,2,520,6879,2397,1499,7.65,4,99.6,329564,2798,327723,2.41,1.51,0.06906626506024097,0.85,99.44
2021-02-26,West Bengal,945,12,943,11785,510,346,8.02,0,99.6,330509,2810,328666,0.51,0.35,0.11832329317269076,0.85,99.44
2021-02-27,West Bengal,759,2,753,9500,2916,746,7.99,4,99.6,331268,2812,329419,2.93,0.75,0.09538152610441768,0.85,99.44
2021-02-28,West Bengal,145,0,140,1737,1777,679,8.35,5,99.6,331413,2812,329559,1.78,0.68,0.01743975903614458,0.85,99.44
2021-03-01,West Bengal,632,2,628,8128,1109,680,7.78,2,99.6,332045,2814,330187,1.11,0.68,0.08160642570281125,0.85,99.44
2021-03-02,West Bengal,386,3,384,4669,1056,76,8.27,0,99.6,332431,2817,330571,1.06,0.08,0.04687751004016064,0.85,99.44
2021-03-03,West Bengal,812,5,803,10239,3353,672,7.93,4,99.6,333243,2822,331374,3.37,0.67,0.10280120481927711,0.85,99.44
2021-03-04,West Bengal,1337,11,1328,16672,1071,447,8.02,0,99.6,334580,2833,332702,1.08,0.45,0.16738955823293172,0.85,99.44
2021-03-05,West Bengal,748,2,746,9527,3920,2616,7.85,0,99.6,335328,2835,333448,3.94,2.63,0.09565261044176707,0.85,99.44
2021-03-06,West Bengal,941,4,938,12047,2196,1498,7.81,0,99.6,336269,2839,334386,2.2,1.5,0.12095381526104418,0.84,99.44
2021-03-07,West Bengal,1047,7,1044,12401,4668,237,8.44,0,99.6,337316,2846,335430,4.69,0.24,0.12450803212851405,0.84,99.44
2021-03-08,West Bengal,1352,7,1344,17023,3198,2984,7.94,1,99.6,338668,2853,336774,3.21,3.0,0.1709136546184739,0.84,99.44
2021-03-09,West Bengal,272,2,263,3273,3830,3161,8.31,7,99.6,338940,2855,337037,3.85,3.17,0.03286144578313253,0.84,99.44
2021-03-10,West Bengal,116,1,113,1425,310,13,8.14,2,99.6,339056,2856,337150,0.31,0.01,0.01430722891566265,0.84,99.44
2021-03-11,West Bengal,947,7,947,11613,4327,1643,8.15,0,99.6,340003,2863,338097,4.34,1.65,0.11659638554216867,0.84,99.44
2021-03-12,West Bengal,265,2,261,3579,4394,1861,7.4,2,99.6,340268,2865,338358,4.41,1.87,0.035933734939759036,0.84,99.44
2021-03-13,West Bengal,794,6,787,9962,3013,2167,7.97,1,99.6,341062,2871,339145,3.03,2.18,0.10002008032128513,0.84,99.44
2021-03-14,West Bengal,159,1,158,2064,1689,1520,7.7,0,99.6,341221,2872,339303,1.7,1.53,0.02072289156626506,0.84,99.44
2021-03-15,West Bengal,1567,8,1563,19378,1491,1415,8.09,0,99.6,342788,2880,340866,1.5,1.42,0.19455823293172692,0.84,99.44
2021-03-16,West Bengal,1029,7,1023,12968,14,13,7.93,0,99.6,343817,2887,341889,0.01,0.01,0.1302008032128514,0.84,99.44
2021-03-17,West Bengal,1274,14,1271,16009,4323,2125,7.96,0,99.6,345091,2901,343160,4.34,2.13,0.16073293172690764,0.84,99.44
2021-03-18,West Bengal,400,4,395,4970,63,29,8.05,1,99.6,345491,2905,343555,0.06,0.03,0.049899598393574295,0.84,99.44
2021-03-19,West Bengal,494,6,490,6502,3515,1855,7.6,0,99.6,345985,2911,344045,3.53,1.86,0.06528112449799196,0.84,99.44
2021-03-20,West Bengal,312,4,308,3990,1841,203,7.82,0,99.6,346297,2915,344353,1.85,0.2,0.04006024096385542,0.84,99.44
2021-03-21,West Bengal,411,5,409,4968,778,174,8.27,0,99.6,346708,2920,344762,0.78,0.17,0.04987951807228916,0.84,99.44
2021-03-22,West Bengal,264,1,256,2804,4428,956,9.42,7,99.6,346972,2921,345018,4.45,0.96,0.02815261044176707,0.84,99.44
2021-03-23,West Bengal,67,0,58,1236,3143,1579,5.42,9,99.6,347039,2921,345076,3.16,1.59,0.012409638554216867,0.84,99.43
2021-03-24,West Bengal,1421,5,1417,17744,131,124,8.01,0,99.6,348460,2926,346493,0.13,0.12,0.17815261044176706,0.84,99.44
2021-03-25,West Bengal,415,6,413,5312,4544,4415,7.81,0,99.6,348875,2932,346906,4.56,4.43,0.05333333333333334,0.84,99.44
2021-03-26,West Bengal,675,9,675,8372,4590,914,8.06,0,99.6,349550,2941,347581,4.61,0.92,0.0840562248995984,0.84,99.44
2021-03-27,West Bengal,1180,17,1172,14507,2639,545,8.13,0,99.6,350730,2958,348753,2.65,0.55,0.14565261044176706,0.84,99.44
2021-03-28,West Bengal,1124,14,1122,14112,998,512,7.96,0,99.6,351854,2972,349875,1.0,0.51,0.1416867469879518,0.84,99.44
2021-03-29,West Bengal,93,0,93,1335,1621,1189,6.97,0,99.6,351947,2972,349968,1.63,1.19,0.013403614457831326,0.84,99.44
2021-03-30,West Bengal,1412,19,1408,17650,4587,1101,8.0,0,99.6,353359,2991,351376,4.61,1.11,0.17720883534136547,0.85,99.44
2021-03-31,West Bengal,353,3,349,4509,779,574,7.83,1,99.6,353712,2994,351725,0.78,0.58,0.045271084337349395,0.85,99.44
2021-04-01,West Bengal,620,5,615,7633,357,105,8.12,0,99.6,354332,2999,352340,0.36,0.11,0.07663654618473896,0.85,99.44
2021-04-02,West Bengal,1035,10,1028,12763,2523,1662,8.11,0,99.6,355367,3009,353368,2.53,1.67,0.1281425702811245,0.85,99.44
2021-04-03,West Bengal,589,7,588,7088,1153,625,8.31,0,99.6,355956,3016,353956,1.16,0.63,0.07116465863453815,0.85,99.44
2021-04-04,West Bengal,545,5,544,6624,4185,735,8.23,0,99.6,356501,3021,354500,4.2,0.74,0.06650602409638554,0.85,99.44
2021-04-05,West Bengal,807,7,798,9897,2046,60,8.15,2,99.6,357308,3028,355298,2.05,0.06,0.09936746987951807,0.85,99.44
2021-04-06,West Bengal,1207,17,1202,15247,1423,222,7.92,0,99.6,358515,3045,356500,1.43,0.22,0.1530823293172691,0.85,99.44
2021-04-07,West Bengal,238,1,232,2777,4866,1796,8.57,5,99.6,358753,3046,356732,4.89,1.8,0.02788152610441767,0.85,99.44
2021-04-08,West Bengal,245,2,236,2974,4308,838,8.24,7,99.6,358998,3048,356968,4.33,0.84,0.029859437751004015,0.85,99.43
2021-04-09,West Bengal,262,1,258,3369,4112,365,7.78,3,99.6,359260,3049,357226,4.13,0.37,0.033825301204819275,0.85,99.43
2021-04-10,West Bengal,669,6,669,8248,4880,2240,8.11,0,99.6,359929,3055,357895,4.9,2.25,0.08281124497991968,0.85,99.43
2021-04-11,West Bengal,1489,15,1485,18547,320,101,8.03,0,99.6,361418,3070,359380,0.32,0.1,0.186214859437751,0.85,99.44
2021-04-12,West Bengal,504,6,501,6301,1041,696,8.0,0,99.6,361922,3076,359881,1.05,0.7,0.06326305220883534,0.85,99.44
2021-04-13,West Bengal,1441,11,1432,18296,488,337,7.88,0,99.6,363363,3087,361313,0.49,0.34,0.18369477911646587,0.85,99.44
2021-04-14,West Bengal,168,0,161,2144,1148,1103,7.84,7,99.6,363531,3087,361474,1.15,1.11,0.021526104417670684,0.85,99.43
2021-04-15,West Bengal,1203,7,1200,15018,3482,1977,8.01,0,99.6,364734,3094,362674,3.5,1.98,0.1507831325301205,0.85,99.44
2021-04-16,West Bengal,999,11,990,12363,4457,185,8.08,0,99.6,365733,3105,363664,4.47,0.19,0.12412650602409639,0.85,99.43
2021-04-17,West Bengal,1144,5,1137,14367,159,102,7.96,2,99.6,366877,3110,364801,0.16,0.1,0.14424698795180724,0.85,99.43
2021-04-18,West Bengal,952,8,947,11964,1939,1544,7.96,0,99.6,367829,3118,365748,1.95,1.55,0.12012048192771084,0.85,99.43
2021-04-19,West Bengal,1221,5,1213,15348,99,75,7.96,3,99.6,369050,3123,366961,0.1,0.08,0.15409638554216867,0.85,99.43
2021-04-20,West Bengal,924,6,921,11269,4061,1148,8.2,0,99.6,369974,3129,367882,4.08,1.15,0.1131425702811245,0.85,99.43
2021-04-21,West Bengal,151,0,144,2017,112,80,7.49,7,99.6,370125,3129,368026,0.11,0.08,0.020251004016064257,0.85,99.43
2021-04-22,West Bengal,485,1,485,6311,135,24,7.68,0,99.6,370610,3130,368511,0.14,0.02,0.06336345381526104,0.84,99.43
2021-04-23,West Bengal,1157,8,1153,14493,1068,886,7.98,0,99.6,371767,3138,369664,1.07,0.89,0.14551204819277108,0.84,99.43
2021-04-24,West Bengal,13,0,5,529,4567,525,2.46,8,99.6,371780,3138,369669,4.59,0.53,0.005311244979919679,0.84,99.43
2021-04-25,West Bengal,653,7,646,8192,4876,3199,7.97,0,99.6,372433,3145,370315,4.9,3.21,0.08224899598393574,0.84,99.43
2021-04-26,West Bengal,272,2,271,3711,76,11,7.33,0,99.6,372705,3147,370586,0.08,0.01,0.03725903614457831,0.84,99.43
2021-04-27,West Bengal,956,14,954,11882,3895,553,8.05,0,99.6,373661,3161,371540,3.91,0.56,0.11929718875502009,0.85,99.43
2021-04-28,West Bengal,34,0,30,626,2729,1274,5.43,4,99.6,373695,3161,371570,2.74,1.28,0.006285140562248996,0.85,99.43
2021-04-29,West Bengal,1154,6,1149,14501,1866,644,7.96,0,99.6,374849,3167,372719,1.87,0.65,0.14559236947791165,0.84,99.43
2021-04-30,West Bengal,803,2,794,9800,4192,1455,8.19,7,99.6,375652,3169,373513,4.21,1.46,0.09839357429718876,0.84,99.43
2021-05-01,West Bengal,525,4,519,6348,792,85,8.27,2,99.6,376177,3173,374032,0.8,0.09,0.06373493975903614,0.84,99.43
2021-05-02,West Bengal,1463,15,1459,18227,1765,1334,8.03,0,99.6,377640,3188,375491,1.77,1.34,0.18300200803212852,0.84,99.43
2021-05-03,West Bengal,354,4,345,3953,3459,1195,8.96,5,99.6,377994,3192,375836,3.47,1.2,0.03968875502008032,0.84,99.43
2021-05-04,West Bengal,1487,6,1485,18368,4131,3909,8.1,0,99.6,379481,3198,377321,4.15,3.92,0.18441767068273093,0.84,99.43
2021-05-05,West Bengal,1100,9,1096,14047,4015,563,7.83,0,99.6,380581,3207,378417,4.03,0.57,0.14103413654618474,0.84,99.43
2021-05-06,West Bengal,1427,15,1420,18013,3001,2261,7.92,0,99.6,382008,3222,379837,3.01,2.27,0.18085341365461846,0.84,99.43
2021-05-07,West Bengal,1325,4,1325,16330,2739,897,8.11,0,99.6,383333,3226,381162,2.75,0.9,0.16395582329317268,0.84,99.43
2021-05-08,West Bengal,774,10,767,9378,672,193,8.25,0,99.6,384107,3236,381929,0.67,0.19,0.09415662650602409,0.84,99.43
2021-05-09,West Bengal,1182,11,1182,14785,4490,2187,7.99,0,99.6,385289,3247,383111,4.51,2.2,0.1484437751004016,0.84,99.43
2021-05-10,West Bengal,1038,8,1035,13138,1835,591,7.9,0,99.6,386327,3255,384146,1.84,0.59,0.13190763052208834,0.84,99.44
2021-05-11,West Bengal,1513,17,1506,19101,1118,692,7.92,0,99.6,387840,3272,385652,1.12,0.69,0.19177710843373494,0.84,99.44
2021-05-12,West Bengal,21,0,20,521,2829,156,4.03,1,99.6,387861,3272,385672,2.84,0.16,0.005230923694779116,0.84,99.44
2021-05-13,West Bengal,580,4,571,7019,2949,1250,8.26,5,99.6,388441,3276,386243,2.96,1.26,0.0704718875502008,0.84,99.43
2021-05-14,West Bengal,717,8,712,9168,2749,4,7.82,0,99.6,389158,3284,386955,2.76,0.0,0.09204819277108434,0.84,99.43
2021-05-15,West Bengal,738,9,735,9344,888,371,7.9,0,99.6,389896,3293,387690,0.89,0.37,0.0938152610441767,0.84,99.43
2021-05-16,West Bengal,545,3,541,6736,1908,32,8.09,1,99.6,390441,3296,388231,1.92,0.03,0.06763052208835342,0.84,99.43
2021-05-17,West Bengal,384,4,376,4990,1519,235,7.7,4,99.6,390825,3300,388607,1.53,0.24,0.050100401606425704,0.84,99.43
2021-05-18,West Bengal,1211,17,1207,15357,1071,677,7.89,0,99.6,392036,3317,389814,1.08,0.68,0.15418674698795182,0.85,99.43
2021-05-19,West Bengal,1570,9,1562,19590,3985,3614,8.01,0,99.6,393606,3326,391376,4.0,3.63,0.1966867469879518,0.85,99.43
2021-05-20,West Bengal,122,1,113,1168,3705,1664,10.45,8,99.6,393728,3327,391489,3.72,1.67,0.011726907630522088,0.84,99.43
2021-05-21,West Bengal,469,1,460,5974,1565,334,7.85,8,99.6,394197,3328,391949,1.57,0.34,0.05997991967871486,0.84,99.43
2021-05-22,West Bengal,188,1,183,2260,3311,420,8.32,4,99.6,394385,3329,392132,3.32,0.42,0.022690763052208834,0.84,99.43
2021-05-23,West Bengal,1439,5,1432,18288,4885,2740,7.87,2,99.6,395824,3334,393564,4.9,2.75,0.1836144578313253,0.84,99.43
2021-05-24,West Bengal,810,11,810,10223,1170,1041,7.92,0,99.6,396634,3345,394374,1.17,1.05,0.10264056224899598,0.84,99.43
2021-05-25,West Bengal,690,3,690,8195,595,513,8.42,0,99.6,397324,3348,395064,0.6,0.52,0.08227911646586346,0.84,99.43
2021-05-26,West Bengal,107,1,107,1308,1147,630,8.18,0,99.6,397431,3349,395171,1.15,0.63,0.013132530120481928,0.84,99.43
2021-05-27,West Bengal,1059,11,1051,12786,1,1,8.28,0,99.6,398490,3360,396222,0.0,0.0,0.1283734939759036,0.84,99.43
2021-05-28,West Bengal,213,2,213,2918,1406,372,7.3,0,99.6,398703,3362,396435,1.41,0.37,0.02929718875502008,0.84,99.43
2021-05-29,West Bengal,797,11,793,10141,3131,2867,7.86,0,99.6,399500,3373,397228,3.14,2.88,0.10181726907630521,0.84,99.43
2021-05-30,West Bengal,985,8,978,12019,4544,2229,8.2,0,99.6,400485,3381,398206,4.56,2.24,0.1206726907630522,0.84,99.43
2021-05-31,West Bengal,305,2,300,3727,224,101,8.18,3,99.6,400790,3383,398506,0.22,0.1,0.03741967871485944,0.84,99.43
2021-06-01,West Bengal,1169,6,1168,14427,3404,2279,8.1,0,99.6,401959,3389,399674,3.42,2.29,0.14484939759036145,0.84,99.43
2021-06-02,West Bengal,1170,10,1169,14718,4750,3192,7.95,0,99.6,403129,3399,400843,4.77,3.2,0.1477710843373494,0.84,99.43
2021-06-03,West Bengal,1002,3,995,12611,1602,1051,7.95,4,99.6,404131,3402,401838,1.61,1.06,0.12661646586345382,0.84,99.43
2021-06-04,West Bengal,1126,9,1120,13698,1525,604,8.22,0,99.6,405257,3411,402958,1.53,0.61,0.1375301204819277,0.84,99.43
2021-06-05,West Bengal,314,2,311,4028,2593,1166,7.8,1,99.6,405571,3413,403269,2.6,1.17,0.04044176706827309,0.84,99.43
2021-06-06,West Bengal,1246,11,1241,15905,995,587,7.83,0,99.6,406817,3424,404510,1.0,0.59,0.15968875502008031,0.84,99.43
2021-06-07,West Bengal,229,3,229,2794,2715,253,8.2,0,99.6,407046,3427,404739,2.73,0.25,0.028052208835341364,0.84,99.43
2021-06-08,West Bengal,152,0,146,2059,3890,3887,7.38,6,99.6,407198,3427,404885,3.91,3.9,0.02067269076305221,0.84,99.43
2021-06-09,West Bengal,1354,15,1354,16954,743,211,7.99,0,99.6,408552,3442,406239,0.75,0.21,0.17022088353413656,0.84,99.43
2021-06-10,West Bengal,1116,15,1116,14223,2546,602,7.85,0,99.6,409668,3457,407355,2.56,0.6,0.1428012048192771,0.84,99.44
2021-06-11,West Bengal,518,3,512,6753,2823,275,7.67,3,99.6,410186,3460,407867,2.83,0.28,0.06780120481927711,0.84,99.43
2021-06-12,West Bengal,1457,7,1456,17872,4943,1742,8.15,0,99.6,411643,3467,409323,4.96,1.75,0.17943775100401607,0.84,99.44
2021-06-13,West Bengal,1402,14,1394,17225,3250,1645,8.14,0,99.6,413045,3481,410717,3.26,1.65,0.1729417670682731,0.84,99.44
2021-06-14,West Bengal,920,12,915,11677,1791,1446,7.88,0,99.6,413965,3493,411632,1.8,1.45,0.11723895582329318,0.84,99.44
2021-06-15,West Bengal,625,7,619,7485,4866,3863,8.35,0,99.6,414590,3500,412251,4.89,3.88,0.07515060240963856,0.84,99.44
2021-06-16,West Bengal,777,5,768,9424,2224,770,8.24,4,99.6,415367,3505,413019,2.23,0.77,0.09461847389558233,0.84,99.43
2021-06-17,West Bengal,1295,13,1294,15901,3980,2346,8.14,0,99.6,416662,3518,414313,4.0,2.36,0.15964859437751003,0.84,99.44
2021-06-18,West Bengal,1015,10,1009,12478,1976,888,8.13,0,99.6,417677,3528,415322,1.98,0.89,0.12528112449799197,0.84,99.44
2021-06-19,West Bengal,470,5,464,5684,1196,510,8.27,1,99.6,418147,3533,415786,1.2,0.51,0.057068273092369476,0.84,99.44
2021-06-20,West Bengal,1370,14,1368,17467,4334,2735,7.84,0,99.6,419517,3547,417154,4.35,2.75,0.1753714859437751,0.85,99.44
2021-06-21,West Bengal,1105,4,1101,13734,1521,294,8.05,0,99.6,420622,3551,418255,1.53,0.3,0.13789156626506024,0.84,99.44
2021-06-22,West Bengal,480,1,478,5972,3241,589,8.04,1,99.6,421102,3552,418733,3.25,0.59,0.05995983935742972,0.84,99.44
2021-06-23,West Bengal,412,2,407,4814,4045,1845,8.56,3,99.6,421514,3554,419140,4.06,1.85,0.04833333333333333,0.84,99.44
2021-06-24,West Bengal,90,0,90,833,67,63,10.8,0,99.6,421604,3554,419230,0.07,0.06,0.008363453815261044,0.84,99.44
2021-06-25,West Bengal,1125,9,1119,14487,2754,2126,7.77,0,99.6,422729,3563,420349,2.77,2.13,0.14545180722891565,0.84,99.44
2021-06-26,West Bengal,1002,4,996,12667,562,515,7.91,2,99.6,423731,3567,421345,0.56,0.52,0.12717871485943774,0.84,99.44
2021-06-27,West Bengal,1151,9,1146,14275,3227,2678,8.06,0,99.6,424882,3576,422491,3.24,2.69,0.14332329317269077,0.84,99.44
2021-06-28,West Bengal,316,4,313,3721,2373,1564,8.49,0,99.6,425198,3580,422804,2.38,1.57,0.03735943775100402,0.84,99.44
2021-06-29,West Bengal,941,11,937,11922,3458,224,7.89,0,99.6,426139,3591,423741,3.47,0.22,0.11969879518072289,0.84,99.44
2021-06-30,West Bengal,1537,9,1534,18997,4235,2424,8.09,0,99.6,427676,3600,425275,4.25,2.43,0.19073293172690764,0.84,99.44
2021-07-01,West Bengal,523,2,516,6135,662,153,8.52,5,99.6,428199,3602,425791,0.66,0.15,0.061596385542168675,0.84,99.44
2021-07-02,West Bengal,923,4,923,11427,2401,115,8.08,0,99.6,429122,3606,426714,2.41,0.12,0.1147289156626506,0.84,99.44
2021-07-03,West Bengal,1204,14,1203,15266,4816,1027,7.89,0,99.6,430326,3620,427917,4.84,1.03,0.15327309236947792,0.84,99.44
2021-07-04,West Bengal,167,1,164,2308,4671,1161,7.24,2,99.6,430493,3621,428081,4.69,1.17,0.023172690763052207,0.84,99.44
2021-07-05,West Bengal,898,9,897,10836,409,113,8.29,0,99.6,431391,3630,428978,0.41,0.11,0.10879518072289157,0.84,99.44
2021-07-06,West Bengal,924,10,915,11721,2552,1823,7.88,0,99.6,432315,3640,429893,2.56,1.83,0.11768072289156627,0.84,99.44
2021-07-07,West Bengal,1244,8,1237,16047,2416,1185,7.75,0,99.6,433559,3648,431130,2.43,1.19,0.1611144578313253,0.84,99.44
2021-07-08,West Bengal,315,2,315,3319,3432,3235,9.49,0,99.6,433874,3650,431445,3.45,3.25,0.03332329317269076,0.84,99.44
2021-07-09,West Bengal,665,8,660,8143,2995,1215,8.17,0,99.6,434539,3658,432105,3.01,1.22,0.0817570281124498,0.84,99.44
2021-07-10,West Bengal,725,9,725,8357,1917,1213,8.68,0,99.6,435264,3667,432830,1.92,1.22,0.08390562248995984,0.84,99.44
2021-07-11,West Bengal,543,4,542,6918,2714,1003,7.85,0,99.6,435807,3671,433372,2.72,1.01,0.0694578313253012,0.84,99.44
2021-07-12,West Bengal,328,2,322,4444,2535,1911,7.38,4,99.6,436135,3673,433694,2.55,1.92,0.04461847389558233,0.84,99.44
2021-07-13,West Bengal,533,6,525,6342,1787,275,8.4,2,99.6,436668,3679,434219,1.79,0.28,0.06367469879518073,0.84,99.44
2021-07-14,West Bengal,35,0,35,848,64,7,4.13,0,99.6,436703,3679,434254,0.06,0.01,0.008514056224899598,0.84,99.44
2021-07-15,West Bengal,646,7,637,7925,2186,1745,8.15,2,99.6,437349,3686,434891,2.19,1.75,0.07956827309236948,0.84,99.44
2021-07-16,West Bengal,254,2,250,3726,3150,319,6.82,2,99.6,437603,3688,435141,3.16,0.32,0.03740963855421687,0.84,99.44
2021-07-17,West Bengal,481,2,480,5687,1502,888,8.46,0,99.6,438084,3690,435621,1.51,0.89,0.05709839357429719,0.84,99.44
2021-07-18,West Bengal,1032,14,1023,12782,2165,1764,8.07,0,99.6,439116,3704,436644,2.17,1.77,0.12833333333333333,0.84,99.44
2021-07-19,West Bengal,904,12,898,11393,76,70,7.93,0,99.6,440020,3716,437542,0.08,0.07,0.11438755020080321,0.84,99.44
2021-07-20,West Bengal,856,10,856,10514,3515,2168,8.14,0,99.6,440876,3726,438398,3.53,2.18,0.10556224899598393,0.85,99.44
2021-07-21,West Bengal,888,2,886,10971,2183,1303,8.09,0,99.6,441764,3728,439284,2.19,1.31,0.11015060240963856,0.84,99.44
2021-07-22,West Bengal,473,6,464,5603,4910,4301,8.44,3,99.6,442237,3734,439748,4.93,4.32,0.05625502008032129,0.84,99.44
2021-07-23,West Bengal,1362,19,1362,17201,3436,2136,7.92,0,99.6,443599,3753,441110,3.45,2.14,0.17270080321285142,0.85,99.44
2021-07-24,West Bengal,737,6,736,9194,3807,1558,8.02,0,99.6,444336,3759,441846,3.82,1.56,0.09230923694779117,0.85,99.44
2021-07-25,West Bengal,1080,11,1076,13356,4194,2931,8.09,0,99.6,445416,3770,442922,4.21,2.94,0.13409638554216868,0.85,99.44
2021-07-26,West Bengal,813,11,807,10452,501,193,7.78,0,99.6,446229,3781,443729,0.5,0.19,0.10493975903614458,0.85,99.44
2021-07-27,West Bengal,1211,11,1203,15156,1228,809,7.99,0,99.6,447440,3792,444932,1.23,0.81,0.1521686746987952,0.85,99.44
2021-07-28,West Bengal,79,0,74,1049,338,166,7.53,5,99.6,447519,3792,445006,0.34,0.17,0.010532128514056225,0.85,99.44
2021-07-29,West Bengal,781,4,780,9845,1286,905,7.93,0,99.6,448300,3796,445786,1.29,0.91,0.09884538152610442,0.85,99.44
2021-07-30,West Bengal,728,4,722,8896,2715,1422,8.18,2,99.6,449028,3800,446508,2.73,1.43,0.08931726907630522,0.85,99.44
2021-07-31,West Bengal,647,9,639,8316,720,357,7.78,0,99.6,449675,3809,447147,0.72,0.36,0.08349397590361446,0.85,99.44
2021-08-01,West Bengal,1089,6,1089,13561,2802,1468,8.03,0,99.6,450764,3815,448236,2.81,1.47,0.1361546184738956,0.85,99.44
2021-08-02,West Bengal,1061,13,1057,13493,1668,398,7.86,0,99.6,451825,3828,449293,1.67,0.4,0.13547188755020081,0.85,99.44
2021-08-03,West Bengal,962,3,956,12255,43,39,7.85,3,99.6,452787,3831,450249,0.04,0.04,0.12304216867469879,0.85,99.44
2021-08-04,West Bengal,1550,22,1549,19195,2806,1509,8.08,0,99.6,454337,3853,451798,2.82,1.52,0.19272088353413655,0.85,99.44
2021-08-05,West Bengal,583,6,581,7139,1003,445,8.17,0,99.6,454920,3859,452379,1.01,0.45,0.07167670682730924,0.85,99.44
2021-08-06,West Bengal,408,1,406,5104,1163,1128,7.99,1,99.6,455328,3860,452785,1.17,1.13,0.05124497991967872,0.85,99.44
2021-08-07,West Bengal,805,11,798,10220,3654,2233,7.88,0,99.6,456133,3871,453583,3.67,2.24,0.10261044176706827,0.85,99.44
2021-08-08,West Bengal,327,2,319,4007,648,292,8.16,6,99.6,456460,3873,453902,0.65,0.29,0.04023092369477912,0.85,99.44
2021-08-09,West Bengal,1060,4,1058,13212,610,149,8.02,0,99.6,457520,3877,454960,0.61,0.15,0.13265060240963855,0.85,99.44
2021-08-10,West Bengal,661,7,660,8749,679,51,7.56,0,99.6,458181,3884,455620,0.68,0.05,0.08784136546184738,0.85,99.44
2021-08-11,West Bengal,526,2,523,6468,1018,477,8.13,1,99.6,458707,3886,456143,1.02,0.48,0.06493975903614457,0.85,99.44
2021-08-12,West Bengal,489,2,480,6602,138,57,7.41,7,99.6,459196,3888,456623,0.14,0.06,0.06628514056224899,0.85,99.44
2021-08-13,West Bengal,819,4,810,10332,3729,332,7.93,5,99.6,460015,3892,457433,3.74,0.33,0.10373493975903614,0.85,99.44
2021-08-14,West Bengal,770,5,761,9536,4036,774,8.07,4,99.6,460785,3897,458194,4.05,0.78,0.0957429718875502,0.85,99.44
2021-08-15,West Bengal,1464,12,1456,18659,4679,1846,7.85,0,99.6,462249,3909,459650,4.7,1.85,0.18733935742971888,0.85,99.44
2021-08-16,West Bengal,898,13,898,11296,631,388,7.95,0,99.6,463147,3922,460548,0.63,0.39,0.1134136546184739,0.85,99.44
2021-08-17,West Bengal,1005,6,1001,12370,449,4,8.12,0,99.6,464152,3928,461549,0.45,0.0,0.12419678714859438,0.85,99.44
2021-08-18,West Bengal,240,3,235,3648,909,107,6.58,2,99.6,464392,3931,461784,0.91,0.11,0.03662650602409639,0.85,99.44
2021-08-19,West Bengal,320,1,316,4080,3013,2945,7.84,3,99.6,464712,3932,462100,3.03,2.96,0.04096385542168675,0.85,99.44
2021-08-20,West Bengal,829,3,820,10439,279,81,7.94,6,99.6,465541,3935,462920,0.28,0.08,0.10480923694779117,0.85,99.44
2021-08-21,West Bengal,412,1,405,5570,3074,737,7.4,6,99.6,465953,3936,463325,3.09,0.74,0.05592369477911647,0.84,99.44
2021-08-22,West Bengal,246,2,244,3262,3473,3019,7.54,0,99.6,466199,3938,463569,3.49,3.03,0.032751004016064254,0.84,99.44
2021-08-23,West Bengal,760,10,756,9436,4521,4036,8.05,0,99.6,466959,3948,464325,4.54,4.05,0.09473895582329317,0.85,99.44
2021-08-24,West Bengal,672,7,672,8755,717,686,7.68,0,99.6,467631,3955,464997,0.72,0.69,0.08790160642570281,0.85,99.44
2021-08-25,West Bengal,389,3,384,5057,2560,1122,7.69,2,99.6,468020,3958,465381,2.57,1.13,0.05077309236947791,0.85,99.44
2021-08-26,West Bengal,1543,20,1541,19575,3036,2801,7.88,0,99.6,469563,3978,466922,3.05,2.81,0.19653614457831325,0.85,99.44
2021-08-27,West Bengal,191,2,191,1999,106,59,9.55,0,99.6,469754,3980,467113,0.11,0.06,0.02007028112449799,0.85,99.44
2021-08-28,West Bengal,229,1,223,2912,1054,845,7.86,5,99.6,469983,3981,467336,1.06,0.85,0.029236947791164657,0.85,99.44
2021-08-29,West Bengal,1463,13,1456,18551,2944,1732,7.89,0,99.6,471446,3994,468792,2.96,1.74,0.1862550200803213,0.85,99.44
2021-08-30,West Bengal,1178,9,1176,15358,1800,1064,7.67,0,99.6,472624,4003,469968,1.81,1.07,0.1541967871485944,0.85,99.44
2021-08-31,West Bengal,1400,14,1400,17622,419,176,7.94,0,99.6,474024,4017,471368,0.42,0.18,0.1769277108433735,0.85,99.44
2021-09-01,West Bengal,1555,11,1550,19569,3222,2976,7.95,0,99.6,475579,4028,472918,3.23,2.99,0.19647590361445783,0.85,99.44
2021-09-02,West Bengal,1161,14,1157,14714,990,187,7.89,0,99.6,476740,4042,474075,0.99,0.19,0.1477309236947791,0.85,99.44
2021-09-03,West Bengal,781,8,779,9374,345,16,8.33,0,99.6,477521,4050,474854,0.35,0.02,0.09411646586345382,0.85,99.44
2021-09-04,West Bengal,344,3,342,3980,1517,688,8.64,0,99.6,477865,4053,475196,1.52,0.69,0.03995983935742972,0.85,99.44
2021-09-05,West Bengal,114,1,110,1260,1744,513,9.05,3,99.6,477979,4054,475306,1.75,0.52,0.012650602409638554,0.85,99.44
2021-09-06,West Bengal,923,5,917,11263,3557,2068,8.19,1,99.6,478902,4059,476223,3.57,2.08,0.11308232931726908,0.85,99.44
2021-09-07,West Bengal,367,2,363,4864,2407,932,7.55,2,99.6,479269,4061,476586,2.42,0.94,0.048835341365461846,0.85,99.44
2021-09-08,West Bengal,583,4,578,6883,4431,2001,8.47,1,99.6,479852,4065,477164,4.45,2.01,0.06910642570281124,0.85,99.44
2021-09-09,West Bengal,683,10,681,8087,2814,1909,8.45,0,99.6,480535,4075,477845,2.83,1.92,0.08119477911646586,0.85,99.44
2021-09-10,West Bengal,414,3,412,5367,1778,993,7.71,0,99.6,480949,4078,478257,1.79,1.0,0.0538855421686747,0.85,99.44
2021-09-11,West Bengal,1252,16,1245,15706,695,302,7.97,0,99.6,482201,4094,479502,0.7,0.3,0.15769076305220883,0.85,99.44
2021-09-12,West Bengal,1184,8,1184,14922,4127,390,7.93,0,99.6,483385,4102,480686,4.14,0.39,0.14981927710843373,0.85,99.44
2021-09-13,West Bengal,1054,13,1051,13148,4047,2573,8.02,0,99.6,484439,4115,481737,4.06,2.58,0.13200803212851406,0.85,99.44
2021-09-14,West Bengal,1238,16,1231,16084,717,703,7.7,0,99.6,485677,4131,482968,0.72,0.71,0.1614859437751004,0.85,99.44
2021-09-15,West Bengal,135,1,127,2040,1929,1527,6.62,7,99.6,485812,4132,483095,1.94,1.53,0.020481927710843374,0.85,99.44
2021-09-16,West Bengal,1376,11,1374,17148,1501,1307,8.02,0,99.6,487188,4143,484469,1.51,1.31,0.17216867469879518,0.85,99.44
2021-09-17,West Bengal,580,2,580,6885,2933,2276,8.42,0,99.6,487768,4145,485049,2.94,2.29,0.06912650602409638,0.85,99.44
2021-09-18,West Bengal,1572,6,1565,19796,505,397,7.94,1,99.6,489340,4151,486614,0.51,0.4,0.19875502008032128,0.85,99.44
2021-09-19,West Bengal,956,5,949,12045,1444,125,7.94,2,99.6,490296,4156,487563,1.45,0.13,0.12093373493975904,0.85,99.44
2021-09-20,West Bengal,1351,5,1345,16993,1430,543,7.95,1,99.6,491647,4161,488908,1.44,0.55,0.1706124497991968,0.85,99.44
2021-09-21,West Bengal,1354,16,1349,17015,1815,564,7.96,0,99.6,493001,4177,490257,1.82,0.57,0.17083333333333334,0.85,99.44
2021-09-22,West Bengal,1100,6,1092,13949,874,125,7.89,2,99.6,494101,4183,491349,0.88,0.13,0.14005020080321284,0.85,99.44
2021-09-23,West Bengal,1249,3,1245,15917,3082,1439,7.85,1,99.6,495350,4186,492594,3.09,1.44,0.15980923694779117,0.85,99.44
2021-09-24,West Bengal,1551,18,1542,19335,11,8,8.02,0,99.6,496901,4204,494136,0.01,0.01,0.1941265060240964,0.85,99.44
2021-09-25,West Bengal,511,6,510,6113,1721,1151,8.36,0,99.6,497412,4210,494646,1.73,1.16,0.06137550200803213,0.85,99.44
2021-09-26,West Bengal,690,9,688,8058,3233,918,8.56,0,99.6,498102,4219,495334,3.25,0.92,0.08090361445783133,0.85,99.44
2021-09-27,West Bengal,945,9,938,11349,4728,4723,8.33,0,99.6,499047,4228,496272,4.75,4.74,0.11394578313253012,0.85,99.44
2021-09-28,West Bengal,1548,10,1544,19000,4081,421,8.15,0,99.6,500595,4238,497816,4.1,0.42,0.19076305220883535,0.85,99.44
2021-09-29,West Bengal,234,2,227,3069,74,57,7.62,5,99.6,500829,4240,498043,0.07,0.06,0.03081325301204819,0.85,99.44
2021-09-30,West Bengal,1309,4,1306,15994,244,72,8.18,0,99.6,502138,4244,499349,0.24,0.07,0.16058232931726907,0.85,99.44
2021-10-01,West Bengal,452,1,449,5194,1197,881,8.7,2,99.6,502590,4245,499798,1.2,0.88,0.052148594377510044,0.84,99.44
2021-10-02,West Bengal,1034,7,1025,12940,3365,1462,7.99,2,99.6,503624,4252,500823,3.38,1.47,0.12991967871485943,0.84,99.44
2021-10-03,West Bengal,904,12,904,11360,264,14,7.96,0,99.6,504528,4264,501727,0.27,0.01,0.1140562248995984,0.85,99.44
2021-10-04,West Bengal,1581,6,1580,19526,4552,1645,8.1,0,99.6,506109,4270,503307,4.57,1.65,0.1960441767068273,0.84,99.45
2021-10-05,West Bengal,535,1,532,6971,4225,3801,7.67,2,99.6,506644,4271,503839,4.24,3.82,0.06998995983935744,0.84,99.45
2021-10-06,West Bengal,339,1,331,4232,3000,2588,8.01,7,99.6,506983,4272,504170,3.01,2.6,0.04248995983935743,0.84,99.45
2021-10-07,West Bengal,1342,12,1339,16950,1552,1478,7.92,0,99.6,508325,4284,505509,1.56,1.48,0.17018072289156627,0.84,99.45
2021-10-08,West Bengal,1292,17,1287,16297,4978,4012,7.93,0,99.6,509617,4301,506796,5.0,4.03,0.16362449799196788,0.84,99.45
2021-10-09,West Bengal,1545,17,1536,18967,4854,4506,8.15,0,99.6,511162,4318,508332,4.87,4.52,0.19043172690763052,0.84,99.45
2021-10-10,West Bengal,1347,5,1340,16794,4829,2675,8.02,2,99.6,512509,4323,509672,4.85,2.69,0.1686144578313253,0.84,99.45
2021-10-11,West Bengal,1071,11,1063,13296,4249,3846,8.06,0,99.6,513580,4334,510735,4.27,3.86,0.13349397590361445,0.84,99.45
2021-10-12,West Bengal,1568,20,1561,19678,3150,2727,7.97,0,99.6,515148,4354,512296,3.16,2.74,0.19757028112449798,0.85,99.45
2021-10-13,West Bengal,1112,5,1108,13658,1137,687,8.14,0,99.6,516260,4359,513404,1.14,0.69,0.1371285140562249,0.84,99.45
2021-10-14,West Bengal,915,9,909,10870,4573,597,8.42,0,99.6,517175,4368,514313,4.59,0.6,0.10913654618473896,0.84,99.45
2021-10-15,West Bengal,1540,4,1534,19480,4461,906,7.91,2,99.6,518715,4372,515847,4.48,0.91,0.19558232931726907,0.84,99.45
2021-10-16,West Bengal,103,0,96,1370,4428,3874,7.52,7,99.6,518818,4372,515943,4.45,3.89,0.013755020080321286,0.84,99.45
2021-10-17,West Bengal,719,3,714,9040,1309,707,7.95,2,99.6,519537,4375,516657,1.31,0.71,0.09076305220883533,0.84,99.45
2021-10-18,West Bengal,481,4,472,5880,1576,421,8.18,5,99.6,520018,4379,517129,1.58,0.42,0.05903614457831325,0.84,99.44
2021-10-19,West Bengal,554,3,553,6889,2242,2187,8.04,0,99.6,520572,4382,517682,2.25,2.2,0.06916666666666667,0.84,99.44
2021-10-20,West Bengal,535,3,532,6698,1818,1077,7.99,0,99.6,521107,4385,518214,1.83,1.08,0.06724899598393574,0.84,99.44
2021-10-21,West Bengal,1038,8,1034,12530,1987,1931,8.28,0,99.6,522145,4393,519248,1.99,1.94,0.1258032128514056,0.84,99.45
2021-10-22,West Bengal,1511,12,1510,18945,3408,1632,7.98,0,99.6,523656,4405,520758,3.42,1.64,0.19021084337349398,0.84,99.45
2021-10-23,West Bengal,808,3,799,10249,739,272,7.88,6,99.6,524464,4408,521557,0.74,0.27,0.10290160642570281,0.84,99.45
2021-10-24,West Bengal,759,9,752,9502,637,580,7.99,0,99.6,525223,4417,522309,0.64,0.58,0.0954016064257028,0.84,99.45
2021-10-25,West Bengal,686,5,682,9246,964,464,7.42,0,99.6,525909,4422,522991,0.97,0.47,0.09283132530120482,0.84,99.45
2021-10-26,West Bengal,164,1,158,2091,4535,612,7.84,5,99.6,526073,4423,523149,4.55,0.61,0.02099397590361446,0.84,99.44
2021-10-27,West Bengal,1241,10,1232,15738,507,232,7.89,0,99.6,527314,4433,524381,0.51,0.23,0.1580120481927711,0.84,99.44
2021-10-28,West Bengal,501,6,498,6256,3236,1610,8.01,0,99.6,527815,4439,524879,3.25,1.62,0.06281124497991968,0.84,99.44
2021-10-29,West Bengal,866,11,865,10964,535,9,7.9,0,99.6,528681,4450,525744,0.54,0.01,0.11008032128514056,0.84,99.44
2021-10-30,West Bengal,1594,11,1593,19713,445,67,8.09,0,99.6,530275,4461,527337,0.45,0.07,0.19792168674698796,0.84,99.45
2021-10-31,West Bengal,559,7,552,7221,2555,1231,7.74,0,99.6,530834,4468,527889,2.57,1.24,0.0725,0.84,99.45
2021-11-01,West Bengal,737,6,735,9031,2439,1886,8.16,0,99.6,531571,4474,528624,2.45,1.89,0.0906726907630522,0.84,99.45
2021-11-02,West Bengal,1455,14,1451,18087,1834,1260,8.04,0,99.6,533026,4488,530075,1.84,1.27,0.18159638554216867,0.84,99.45
2021-11-03,West Bengal,577,2,577,6965,3070,1671,8.28,0,99.6,533603,4490,530652,3.08,1.68,0.069929718875502,0.84,99.45
2021-11-04,West Bengal,1440,14,1434,17973,367,186,8.01,0,99.6,535043,4504,532086,0.37,0.19,0.18045180722891566,0.84,99.45
2021-11-05,West Bengal,121,0,113,1445,3946,2059,8.37,8,99.6,535164,4504,532199,3.96,2.07,0.014508032128514056,0.84,99.45
2021-11-06,West Bengal,178,2,177,2540,4269,2648,7.01,0,99.6,535342,4506,532376,4.29,2.66,0.025502008032128515,0.84,99.45
2021-11-07,West Bengal,1539,18,1532,19362,1778,945,7.95,0,99.6,536881,4524,533908,1.79,0.95,0.19439759036144577,0.84,99.45
2021-11-08,West Bengal,1488,14,1479,18550,4689,3056,8.02,0,99.6,538369,4538,535387,4.71,3.07,0.18624497991967873,0.84,99.45
2021-11-09,West Bengal,1231,16,1224,15514,393,306,7.93,0,99.6,539600,4554,536611,0.39,0.31,0.15576305220883535,0.84,99.45
2021-11-10,West Bengal,1274,9,1270,15986,482,170,7.97,0,99.6,540874,4563,537881,0.48,0.17,0.16050200803212852,0.84,99.45
2021-11-11,West Bengal,719,4,712,9223,4998,3737,7.8,3,99.6,541593,4567,538593,5.02,3.75,0.0926004016064257,0.84,99.45
2021-11-12,West Bengal,677,3,672,8776,2470,1191,7.71,2,99.6,542270,4570,539265,2.48,1.2,0.08811244979919679,0.84,99.45
2021-11-13,West Bengal,402,3,396,5123,2689,1920,7.85,3,99.6,542672,4573,539661,2.7,1.93,0.05143574297188755,0.84,99.45
2021-11-14,West Bengal,72,0,64,1123,4029,19,6.41,8,99.6,542744,4573,539725,4.05,0.02,0.011275100401606425,0.84,99.44
2021-11-15,West Bengal,1578,9,1569,19663,1780,1425,8.03,0,99.6,544322,4582,541294,1.79,1.43,0.19741967871485944,0.84,99.44
2021-11-16,West Bengal,649,7,641,8168,280,206,7.95,1,99.6,544971,4589,541935,0.28,0.21,0.08200803212851406,0.84,99.44
2021-11-17,West Bengal,401,1,393,5226,2927,471,7.67,7,99.6,545372,4590,542328,2.94,0.47,0.05246987951807229,0.84,99.44
2021-11-18,West Bengal,30,0,28,509,1514,1382,5.89,2,99.6,545402,4590,542356,1.52,1.39,0.005110441767068273,0.84,99.44
2021-11-19,West Bengal,961,8,959,12229,3253,3006,7.86,0,99.6,546363,4598,543315,3.27,3.02,0.12278112449799197,0.84,99.44
2021-11-20,West Bengal,929,12,920,11460,4350,854,8.11,0,99.6,547292,4610,544235,4.37,0.86,0.11506024096385542,0.84,99.44
2021-11-21,West Bengal,457,5,450,5533,3694,1882,8.26,2,99.6,547749,4615,544685,3.71,1.89,0.055552208835341364,0.84,99.44
2021-11-22,West Bengal,959,6,953,11969,1170,842,8.01,0,99.6,548708,4621,545638,1.17,0.85,0.1201706827309237,0.84,99.44
2021-11-23,West Bengal,720,7,714,8912,2773,1919,8.08,0,99.6,549428,4628,546352,2.78,1.93,0.08947791164658635,0.84,99.44
2021-11-24,West Bengal,732,8,732,9050,2235,1474,8.09,0,99.6,550160,4636,547084,2.24,1.48,0.09086345381526105,0.84,99.44
2021-11-25,West Bengal,788,6,781,9832,4187,2400,8.01,1,99.6,550948,4642,547865,4.2,2.41,0.098714859437751,0.84,99.44
2021-11-26,West Bengal,204,1,203,2912,3230,1964,7.01,0,99.6,551152,4643,548068,3.24,1.97,0.029236947791164657,0.84,99.44
2021-11-27,West Bengal,795,8,793,9839,940,873,8.08,0,99.6,551947,4651,548861,0.94,0.88,0.09878514056224899,0.84,99.44
2021-11-28,West Bengal,1326,19,1325,16667,3394,3327,7.96,0,99.6,553273,4670,550186,3.41,3.34,0.16733935742971887,0.84,99.44
2021-11-29,West Bengal,832,3,830,10499,2893,504,7.92,0,99.6,554105,4673,551016,2.9,0.51,0.10541164658634539,0.84,99.44
2021-11-30,West Bengal,1373,18,1369,17161,257,6,8.0,0,99.6,555478,4691,552385,0.26,0.01,0.17229919678714858,0.84,99.44
2021-12-01,West Bengal,1311,13,1307,16199,91,58,8.09,0,99.6,556789,4704,553692,0.09,0.06,0.16264056224899598,0.84,99.44
2021-12-02,West Bengal,369,5,364,4368,270,68,8.45,0,99.6,557158,4709,554056,0.27,0.07,0.04385542168674699,0.85,99.44
2021-12-03,West Bengal,845,11,839,10587,2441,1187,7.98,0,99.6,558003,4720,554895,2.45,1.19,0.10629518072289157,0.85,99.44
2021-12-04,West Bengal,1085,12,1081,13566,2599,249,8.0,0,99.6,559088,4732,555976,2.61,0.25,0.13620481927710842,0.85,99.44
2021-12-05,West Bengal,919,3,918,11515,4230,1592,7.98,0,99.6,560007,4735,556894,4.25,1.6,0.11561244979919678,0.85,99.44
2021-12-06,West Bengal,94,0,88,1185,3052,1037,7.93,6,99.6,560101,4735,556982,3.06,1.04,0.011897590361445783,0.85,99.44
2021-12-07,West Bengal,534,2,531,6690,2131,1538,7.98,1,99.6,560635,4737,557513,2.14,1.54,0.06716867469879519,0.84,99.44
2021-12-08,West Bengal,935,8,927,11897,1653,171,7.86,0,99.6,561570,4745,558440,1.66,0.17,0.11944779116465863,0.84,99.44
2021-12-09,West Bengal,855,3,851,10824,3482,788,7.9,1,99.6,562425,4748,559291,3.5,0.79,0.10867469879518073,0.84,99.44
2021-12-10,West Bengal,666,2,661,8180,2768,973,8.14,3,99.6,563091,4750,559952,2.78,0.98,0.0821285140562249,0.84,99.44
2021-12-11,West Bengal,1017,4,1013,12736,1979,896,7.99,0,99.6,564108,4754,560965,1.99,0.9,0.1278714859437751,0.84,99.44
2021-12-12,West Bengal,963,10,961,11709,2295,799,8.22,0,99.6,565071,4764,561926,2.3,0.8,0.11756024096385542,0.84,99.44
2021-12-13,West Bengal,314,3,307,3964,3219,990,7.92,4,99.6,565385,4767,562233,3.23,0.99,0.03979919678714859,0.84,99.44
2021-12-14,West Bengal,143,0,135,1525,2462,431,9.38,8,99.6,565528,4767,562368,2.47,0.43,0.015311244979919678,0.84,99.44
2021-12-15,West Bengal,747,9,747,8914,2557,670,8.38,0,99.6,566275,4776,563115,2.57,0.67,0.08949799196787149,0.84,99.44
2021-12-16,West Bengal,1123,12,1123,14081,2585,1595,7.98,0,99.6,567398,4788,564238,2.6,1.6,0.14137550200803212,0.84,99.44
2021-12-17,West Bengal,430,3,421,5243,3456,2377,8.2,6,99.6,567828,4791,564659,3.47,2.39,0.052640562248995985,0.84,99.44
2021-12-18,West Bengal,1426,16,1425,17490,3921,3351,8.15,0,99.6,569254,4807,566084,3.94,3.36,0.17560240963855422,0.84,99.44
2021-12-19,West Bengal,870,8,863,10912,3749,1131,7.97,0,99.6,570124,4815,566947,3.76,1.14,0.10955823293172691,0.84,99.44
2021-12-20,West Bengal,442,6,438,5825,101,26,7.59,0,99.6,570566,4821,567385,0.1,0.03,0.058483935742971886,0.84,99.44
2021-12-21,West Bengal,912,13,905,10756,1024,461,8.48,0,99.6,571478,4834,568290,1.03,0.46,0.10799196787148595,0.85,99.44
2021-12-22,West Bengal,592,3,588,7633,1341,189,7.76,1,99.6,572070,4837,568878,1.35,0.19,0.07663654618473896,0.85,99.44
2021-12-23,West Bengal,64,0,55,842,4582,3715,7.6,9,99.6,572134,4837,568933,4.6,3.73,0.008453815261044178,0.85,99.44
2021-12-24,West Bengal,1040,13,1034,13112,1177,279,7.93,0,99.6,573174,4850,569967,1.18,0.28,0.13164658634538154,0.85,99.44
2021-12-25,West Bengal,762,11,754,9593,2106,1240,7.94,0,99.6,573936,4861,570721,2.11,1.24,0.0963152610441767,0.85,99.44
2021-12-26,West Bengal,553,7,552,7266,1435,1260,7.61,0,99.6,574489,4868,571273,1.44,1.27,0.07295180722891566,0.85,99.44
2021-12-27,West Bengal,277,3,277,3348,255,103,8.27,0,99.6,574766,4871,571550,0.26,0.1,0.0336144578313253,0.85,99.44
2021-12-28,West Bengal,275,3,275,3255,3229,3038,8.45,0,99.6,575041,4874,571825,3.24,3.05,0.03268072289156627,0.85,99.44
2021-12-29,West Bengal,397,1,389,5355,3001,206,7.41,7,99.6,575438,4875,572214,3.01,0.21,0.053765060240963856,0.85,99.44
2021-12-30,West Bengal,650,5,641,8139,644,552,7.99,4,99.6,576088,4880,572855,0.65,0.55,0.08171686746987952,0.85,99.44
2021-12-31,West Bengal,1409,13,1406,17654,1469,779,7.98,0,99.6,577497,4893,574261,1.47,0.78,0.17724899598393573,0.85,99.44
2022-01-01,West Bengal,269,3,260,3438,4652,3743,7.82,6,99.6,577766,4896,574521,4.67,3.76,0.034518072289156626,0.85,99.44
2022-01-02,West Bengal,713,5,710,9019,405,125,7.91,0,99.6,578479,4901,575231,0.41,0.13,0.09055220883534136,0.85,99.44
2022-01-03,West Bengal,1045,3,1039,13015,1087,232,8.03,3,99.6,579524,4904,576270,1.09,0.23,0.1306726907630522,0.85,99.44
2022-01-04,West Bengal,367,2,363,5048,1325,1163,7.27,2,99.6,579891,4906,576633,1.33,1.17,0.050682730923694776,0.85,99.44
2022-01-05,West Bengal,324,2,317,4137,3734,1497,7.83,5,99.6,580215,4908,576950,3.75,1.5,0.041536144578313255,0.85,99.44
2022-01-06,West Bengal,1204,5,1200,15033,3837,1440,8.01,0,99.6,581419,4913,578150,3.85,1.45,0.15093373493975903,0.85,99.44
2022-01-07,West Bengal,26,0,26,633,1556,1346,4.11,0,99.6,581445,4913,578176,1.56,1.35,0.006355421686746988,0.84,99.44
2022-01-08,West Bengal,138,0,138,1811,4554,3974,7.62,0,99.6,581583,4913,578314,4.57,3.99,0.018182730923694778,0.84,99.44
2022-01-09,West Bengal,854,4,847,10330,4263,2699,8.27,3,99.6,582437,4917,579161,4.28,2.71,0.10371485943775101,0.84,99.44
2022-01-10,West Bengal,512,3,504,6043,703,345,8.47,5,99.6,582949,4920,579665,0.71,0.35,0.060672690763052206,0.84,99.44
2022-01-11,West Bengal,352,3,343,4251,4204,2301,8.28,6,99.6,583301,4923,580008,4.22,2.31,0.04268072289156626,0.84,99.44
2022-01-12,West Bengal,990,4,981,12470,1587,308,7.94,5,99.6,584291,4927,580989,1.59,0.31,0.1252008032128514,0.84,99.43
2022-01-13,West Bengal,1308,12,1306,16328,840,116,8.01,0,99.6,585599,4939,582295,0.84,0.12,0.16393574297188754,0.84,99.44
2022-01-14,West Bengal,1552,5,1551,19297,689,48,8.04,0,99.6,587151,4944,583846,0.69,0.05,0.1937449799196787,0.84,99.44
2022-01-15,West Bengal,293,2,288,3792,2328,451,7.73,3,99.6,587444,4946,584134,2.34,0.45,0.038072289156626506,0.84,99.44
2022-01-16,West Bengal,714,4,710,8995,4241,2790,7.94,0,99.6,588158,4950,584844,4.26,2.8,0.09031124497991967,0.84,99.44
2022-01-17,West Bengal,716,4,716,9302,2130,485,7.7,0,99.6,588874,4954,585560,2.14,0.49,0.09339357429718875,0.84,99.44
2022-01-18,West Bengal,311,1,308,3987,4302,1054,7.8,2,99.6,589185,4955,585868,4.32,1.06,0.04003012048192771,0.84,99.44
2022-01-19,West Bengal,1251,17,1246,15682,4076,1361,7.98,0,99.6,590436,4972,587114,4.09,1.37,0.15744979919678714,0.84,99.44
2022-01-20,West Bengal,322,2,321,3918,3729,3391,8.22,0,99.6,590758,4974,587435,3.74,3.4,0.039337349397590364,0.84,99.44
2022-01-21,West Bengal,760,6,755,9563,45,41,7.95,0,99.6,591518,4980,588190,0.05,0.04,0.0960140562248996,0.84,99.44
2022-01-22,West Bengal,1327,8,1323,16314,2716,2308,8.13,0,99.6,592845,4988,589513,2.73,2.32,0.16379518072289156,0.84,99.44
2022-01-23,West Bengal,1506,10,1505,18836,110,7,8.0,0,99.6,594351,4998,591018,0.11,0.01,0.18911646586345382,0.84,99.44
2022-01-24,West Bengal,981,7,975,12215,2047,1877,8.03,0,99.6,595332,5005,591993,2.06,1.88,0.12264056224899599,0.84,99.44
2022-01-25,West Bengal,571,5,565,7363,3820,1957,7.75,1,99.6,595903,5010,592558,3.84,1.96,0.07392570281124498,0.84,99.44
2022-01-26,West Bengal,1181,6,1177,14813,4654,2978,7.97,0,99.6,597084,5016,593735,4.67,2.99,0.14872489959839358,0.84,99.44
2022-01-27,West Bengal,244,0,241,2992,2006,395,8.16,3,99.6,597328,5016,593976,2.01,0.4,0.03004016064257028,0.84,99.44
2022-01-28,West Bengal,1078,12,1072,13233,4647,2670,8.15,0,99.6,598406,5028,595048,4.67,2.68,0.13286144578313253,0.84,99.44
2022-01-29,West Bengal,928,13,921,11825,3500,2719,7.85,0,99.6,599334,5041,595969,3.51,2.73,0.11872489959839358,0.84,99.44
2022-01-30,West Bengal,878,9,876,10977,1806,1644,8.0,0,99.6,600212,5050,596845,1.81,1.65,0.11021084337349397,0.84,99.44
2022-01-31,West Bengal,382,2,379,4772,426,104,8.01,1,99.6,600594,5052,597224,0.43,0.1,0.047911646586345384,0.84,99.44
2022-02-01,West Bengal,891,8,890,11158,4442,4317,7.99,0,99.6,601485,5060,598114,4.46,4.33,0.1120281124497992,0.84,99.44
2022-02-02,West Bengal,1327,16,1320,16570,1833,441,8.01,0,99.6,602812,5076,599434,1.84,0.44,0.16636546184738957,0.84,99.44
2022-02-03,West Bengal,1105,10,1098,13841,4709,3615,7.98,0,99.6,603917,5086,600532,4.73,3.63,0.13896586345381526,0.84,99.44
2022-02-04,West Bengal,1003,8,995,12903,1924,596,7.77,0,99.6,604920,5094,601527,1.93,0.6,0.12954819277108434,0.84,99.44
2022-02-05,West Bengal,1133,14,1130,14459,3502,2602,7.84,0,99.6,606053,5108,602657,3.52,2.61,0.1451706827309237,0.84,99.44
2022-02-06,West Bengal,1203,6,1198,15240,999,377,7.89,0,99.6,607256,5114,603855,1.0,0.38,0.1530120481927711,0.84,99.44
2022-02-07,West Bengal,1064,10,1058,12691,2816,246,8.38,0,99.6,608320,5124,604913,2.83,0.25,0.12741967871485943,0.84,99.44
2022-02-08,West Bengal,1530,15,1529,18916,872,608,8.09,0,99.6,609850,5139,606442,0.88,0.61,0.18991967871485943,0.84,99.44
2022-02-09,West Bengal,174,0,167,1786,4007,1238,9.74,7,99.6,610024,5139,606609,4.02,1.24,0.01793172690763052,0.84,99.44
2022-02-10,West Bengal,312,3,310,3751,1017,688,8.32,0,99.6,610336,5142,606919,1.02,0.69,0.03766064257028112,0.84,99.44
2022-02-11,West Bengal,588,8,581,7652,67,49,7.68,0,99.6,610924,5150,607500,0.07,0.05,0.07682730923694779,0.84,99.44
2022-02-12,West Bengal,637,7,633,7429,4490,137,8.57,0,99.6,611561,5157,608133,4.51,0.14,0.07458835341365462,0.84,99.44
2022-02-13,West Bengal,966,9,957,12282,1744,115,7.87,0,99.6,612527,5166,609090,1.75,0.12,0.1233132530120482,0.84,99.44
2022-02-14,West Bengal,946,11,937,11999,2022,1387,7.88,0,99.6,613473,5177,610027,2.03,1.39,0.1204718875502008,0.84,99.44
2022-02-15,West Bengal,247,0,238,3247,1918,1659,7.61,9,99.6,613720,5177,610265,1.93,1.67,0.0326004016064257,0.84,99.44
2022-02-16,West Bengal,786,7,778,9973,3797,367,7.88,1,99.6,614506,5184,611043,3.81,0.37,0.10013052208835341,0.84,99.44
2022-02-17,West Bengal,1230,8,1229,15784,2046,1694,7.79,0,99.6,615736,5192,612272,2.05,1.7,0.15847389558232933,0.84,99.44
2022-02-18,West Bengal,800,6,799,10055,3042,1145,7.96,0,99.6,616536,5198,613071,3.05,1.15,0.10095381526104417,0.84,99.44
2022-02-19,West Bengal,863,4,862,10985,1899,1388,7.86,0,99.6,617399,5202,613933,1.91,1.39,0.11029116465863453,0.84,99.44
2022-02-20,West Bengal,810,6,808,9609,3683,2574,8.43,0,99.6,618209,5208,614741,3.7,2.58,0.09647590361445783,0.84,99.44
2022-02-21,West Bengal,123,1,120,1819,2625,1860,6.76,2,99.6,618332,5209,614861,2.64,1.87,0.01826305220883534,0.84,99.44
2022-02-22,West Bengal,853,12,852,10843,3698,940,7.87,0,99.6,619185,5221,615713,3.71,0.94,0.10886546184738956,0.84,99.44
2022-02-23,West Bengal,678,3,672,8562,3304,717,7.92,3,99.6,619863,5224,616385,3.32,0.72,0.08596385542168675,0.84,99.44
2022-02-24,West Bengal,669,8,667,7986,345,129,8.38,0,99.6,620532,5232,617052,0.35,0.13,0.08018072289156626,0.84,99.44
2022-02-25,West Bengal,438,2,435,5049,3377,1121,8.67,1,99.6,620970,5234,617487,3.39,1.13,0.05069277108433735,0.84,99.44
2022-02-26,West Bengal,471,3,462,5837,532,280,8.07,6,99.6,621441,5237,617949,0.53,0.28,0.05860441767068273,0.84,99.44
2022-02-27,West Bengal,555,5,551,6630,2725,846,8.37,0,99.6,621996,5242,618500,2.74,0.85,0.06656626506024096,0.84,99.44
2022-02-28,West Bengal,1027,10,1021,13051,324,149,7.87,0,99.6,623023,5252,619521,0.33,0.15,0.13103413654618473,0.84,99.44
2022-03-01,West Bengal,635,8,635,8153,3255,3154,7.79,0,99.6,623658,5260,620156,3.27,3.17,0.0818574297188755,0.84,99.44
2022-03-02,West Bengal,1000,11,991,12240,4694,2492,8.17,0,99.6,624658,5271,621147,4.71,2.5,0.12289156626506025,0.84,99.44
2022-03-03,West Bengal,1370,17,1367,17131,2907,2144,8.0,0,99.6,626028,5288,622514,2.92,2.15,0.1719979919678715,0.84,99.44
2022-03-04,West Bengal,1402,5,1397,17310,4649,2948,8.1,0,99.6,627430,5293,623911,4.67,2.96,0.17379518072289157,0.84,99.44
2022-03-05,West Bengal,338,3,336,4196,4854,2264,8.06,0,99.6,627768,5296,624247,4.87,2.27,0.0421285140562249,0.84,99.44
2022-03-06,West Bengal,1470,10,1468,18572,1050,1047,7.92,0,99.6,629238,5306,625715,1.05,1.05,0.18646586345381527,0.84,99.44
2022-03-07,West Bengal,634,2,625,8210,2197,147,7.72,7,99.6,629872,5308,626340,2.21,0.15,0.082429718875502,0.84,99.44
2022-03-08,West Bengal,1124,14,1118,14082,3016,2934,7.98,0,99.6,630996,5322,627458,3.03,2.95,0.1413855421686747,0.84,99.44
2022-03-09,West Bengal,1224,9,1223,15752,1268,426,7.77,0,99.6,632220,5331,628681,1.27,0.43,0.15815261044176707,0.84,99.44
2022-03-10,West Bengal,1025,9,1023,12356,1288,911,8.3,0,99.6,633245,5340,629704,1.29,0.91,0.12405622489959839,0.84,99.44
2022-03-11,West Bengal,994,3,986,12903,2333,2106,7.7,5,99.6,634239,5343,630690,2.34,2.11,0.12954819277108434,0.84,99.44
2022-03-12,West Bengal,872,8,872,10254,4601,4128,8.5,0,99.6,635111,5351,631562,4.62,4.14,0.10295180722891566,0.84,99.44
2022-03-13,West Bengal,838,11,835,10727,3249,1859,7.81,0,99.6,635949,5362,632397,3.26,1.87,0.1077008032128514,0.84,99.44
2022-03-14,West Bengal,329,3,323,4397,2012,1199,7.48,3,99.6,636278,5365,632720,2.02,1.2,0.044146586345381524,0.84,99.44
2022-03-15,West Bengal,16,0,8,729,3328,1193,2.19,8,99.6,636294,5365,632728,3.34,1.2,0.007319277108433735,0.84,99.44
2022-03-16,West Bengal,304,3,302,3603,1243,257,8.44,0,99.6,636598,5368,633030,1.25,0.26,0.036174698795180725,0.84,99.44
2022-03-17,West Bengal,749,6,748,9357,2735,830,8.0,0,99.6,637347,5374,633778,2.75,0.83,0.09394578313253012,0.84,99.44
2022-03-18,West Bengal,144,1,144,1779,3024,1165,8.09,0,99.6,637491,5375,633922,3.04,1.17,0.01786144578313253,0.84,99.44
2022-03-19,West Bengal,552,7,550,6991,1464,1298,7.9,0,99.6,638043,5382,634472,1.47,1.3,0.07019076305220884,0.84,99.44
2022-03-20,West Bengal,1518,17,1516,18904,787,353,8.03,0,99.6,639561,5399,635988,0.79,0.35,0.1897991967871486,0.84,99.44
2022-03-21,West Bengal,790,10,790,9669,1020,691,8.17,0,99.6,640351,5409,636778,1.02,0.69,0.09707831325301204,0.84,99.44
2022-03-22,West Bengal,776,3,775,9511,3035,981,8.16,0,99.6,641127,5412,637553,3.05,0.98,0.09549196787148595,0.84,99.44
2022-03-23,West Bengal,1495,12,1489,18772,953,532,7.96,0,99.6,642622,5424,639042,0.96,0.53,0.18847389558232933,0.84,99.44
2022-03-24,West Bengal,713,8,712,9092,2982,2895,7.84,0,99.6,643335,5432,639754,2.99,2.91,0.091285140562249,0.84,99.44
2022-03-25,West Bengal,497,4,497,6220,3113,1350,7.99,0,99.6,643832,5436,640251,3.13,1.36,0.06244979919678715,0.84,99.44
2022-03-26,West Bengal,1207,14,1205,14879,2823,2240,8.11,0,99.6,645039,5450,641456,2.83,2.25,0.14938755020080322,0.84,99.44
2022-03-27,West Bengal,583,5,578,6962,1099,541,8.37,0,99.6,645622,5455,642034,1.1,0.54,0.06989959839357429,0.84,99.44
2022-03-28,West Bengal,1559,12,1552,19570,4880,4690,7.97,0,99.6,647181,5467,643586,4.9,4.71,0.1964859437751004,0.84,99.44
2022-03-29,West Bengal,1063,5,1061,13539,1064,246,7.85,0,99.6,648244,5472,644647,1.07,0.25,0.13593373493975905,0.84,99.45
2022-03-30,West Bengal,173,1,167,2335,1518,190,7.41,5,99.6,648417,5473,644814,1.52,0.19,0.023443775100401607,0.84,99.44
2022-03-31,West Bengal,1576,12,1574,19504,2381,2261,8.08,0,99.6,649993,5485,646388,2.39,2.27,0.19582329317269076,0.84,99.45
2022-04-01,West Bengal,43,0,41,779,469,25,5.52,2,99.6,650036,5485,646429,0.47,0.03,0.007821285140562248,0.84,99.45
2022-04-02,West Bengal,1403,12,1394,17785,1802,691,7.89,0,99.6,651439,5497,647823,1.81,0.69,0.17856425702811246,0.84,99.44
2022-04-03,West Bengal,571,5,571,7363,2680,1198,7.75,0,99.6,652010,5502,648394,2.69,1.2,0.07392570281124498,0.84,99.45
2022-04-04,West Bengal,806,3,797,10383,2205,1099,7.76,6,99.6,652816,5505,649191,2.21,1.1,0.10424698795180723,0.84,99.44
2022-04-05,West Bengal,506,2,506,6387,908,361,7.92,0,99.6,653322,5507,649697,0.91,0.36,0.06412650602409639,0.84,99.45
2022-04-06,West Bengal,789,8,785,10117,1561,710,7.8,0,99.6,654111,5515,650482,1.57,0.71,0.10157630522088354,0.84,99.45
2022-04-07,West Bengal,500,4,494,6386,348,305,7.83,2,99.6,654611,5519,650976,0.35,0.31,0.06411646586345382,0.84,99.44
2022-04-08,West Bengal,989,8,982,12065,4118,1964,8.2,0,99.6,655600,5527,651958,4.13,1.97,0.12113453815261044,0.84,99.44
2022-04-09,West Bengal,953,7,945,11731,2143,2080,8.12,1,99.6,656553,5534,652903,2.15,2.09,0.11778112449799197,0.84,99.44
2022-04-10,West Bengal,1426,7,1426,17848,2269,2160,7.99,0,99.6,657979,5541,654329,2.28,2.17,0.17919678714859438,0.84,99.45
2022-04-11,West Bengal,1116,7,1115,13707,2900,2808,8.14,0,99.6,659095,5548,655444,2.91,2.82,0.13762048192771084,0.84,99.45
2022-04-12,West Bengal,1517,19,1514,18901,3342,701,8.03,0,99.6,660612,5567,656958,3.36,0.7,0.18976907630522089,0.84,99.45
2022-04-13,West Bengal,1385,6,1378,17263,2052,771,8.02,1,99.6,661997,5573,658336,2.06,0.77,0.17332329317269077,0.84,99.45
2022-04-14,West Bengal,1001,8,993,12724,2235,1877,7.87,0,99.6,662998,5581,659329,2.24,1.88,0.12775100401606426,0.84,99.45
2022-04-15,West Bengal,1448,17,1447,17967,2379,1896,8.06,0,99.6,664446,5598,660776,2.39,1.9,0.18039156626506025,0.84,99.45
2022-04-16,West Bengal,867,11,866,11361,1654,498,7.63,0,99.6,665313,5609,661642,1.66,0.5,0.11406626506024097,0.84,99.45
2022-04-17,West Bengal,405,5,397,5222,1396,1201,7.76,3,99.6,665718,5614,662039,1.4,1.21,0.05242971887550201,0.84,99.45
2022-04-18,West Bengal,1273,13,1266,15890,3275,2213,8.01,0,99.6,666991,5627,663305,3.29,2.22,0.15953815261044177,0.84,99.45
2022-04-19,West Bengal,903,6,896,11748,2031,965,7.69,1,99.6,667894,5633,664201,2.04,0.97,0.11795180722891566,0.84,99.45
2022-04-20,West Bengal,1522,22,1517,19063,3319,1238,7.98,0,99.6,669416,5655,665718,3.33,1.24,0.19139558232931728,0.84,99.45
2022-04-21,West Bengal,1088,9,1083,13504,1277,1256,8.06,0,99.6,670504,5664,666801,1.28,1.26,0.13558232931726907,0.84,99.45
2022-04-22,West Bengal,1609,10,1604,19901,2461,152,8.09,0,99.6,672113,5674,668405,2.47,0.15,0.19980923694779115,0.84,99.45
2022-04-23,West Bengal,46,0,37,788,3181,2542,5.84,9,99.6,672159,5674,668442,3.19,2.55,0.007911646586345382,0.84,99.45
2022-04-24,West Bengal,730,6,725,9085,3195,18,8.04,0,99.6,672889,5680,669167,3.21,0.02,0.091214859437751,0.84,99.45
2022-04-25,West Bengal,326,2,326,3923,635,483,8.31,0,99.6,673215,5682,669493,0.64,0.48,0.039387550200803215,0.84,99.45
2022-04-26,West Bengal,1063,12,1054,13464,4526,1506,7.9,0,99.6,674278,5694,670547,4.54,1.51,0.13518072289156627,0.84,99.45
2022-04-27,West Bengal,1451,7,1451,17953,532,485,8.08,0,99.6,675729,5701,671998,0.53,0.49,0.18025100401606425,0.84,99.45
2022-04-28,West Bengal,648,3,644,7829,3206,469,8.28,1,99.6,676377,5704,672642,3.22,0.47,0.07860441767068273,0.84,99.45
2022-04-29,West Bengal,1145,17,1139,14337,3331,3146,7.99,0,99.6,677522,5721,673781,3.34,3.16,0.14394578313253012,0.84,99.45
2022-04-30,West Bengal,1517,13,1508,18954,3494,342,8.0,0,99.6,679039,5734,675289,3.51,0.34,0.19030120481927712,0.84,99.45
2022-05-01,West Bengal,685,9,681,9123,1263,1114,7.51,0,99.6,679724,5743,675970,1.27,1.12,0.09159638554216867,0.84,99.45
2022-05-02,West Bengal,961,3,956,11904,3592,3313,8.07,2,99.6,680685,5746,676926,3.61,3.33,0.11951807228915663,0.84,99.45
2022-05-03,West Bengal,993,3,993,11821,2677,238,8.4,0,99.6,681678,5749,677919,2.69,0.24,0.1186847389558233,0.84,99.45
2022-05-04,West Bengal,704,3,696,8989,1746,507,7.83,5,99.6,682382,5752,678615,1.75,0.51,0.09025100401606426,0.84,99.45
2022-05-05,West Bengal,80,0,78,1080,1135,902,7.41,2,99.6,682462,5752,678693,1.14,0.91,0.010843373493975903,0.84,99.45
2022-05-06,West Bengal,504,2,502,6529,992,398,7.72,0,99.6,682966,5754,679195,1.0,0.4,0.06555220883534137,0.84,99.45
2022-05-07,West Bengal,1375,12,1366,17102,1012,130,8.04,0,99.6,684341,5766,680561,1.02,0.13,0.17170682730923695,0.84,99.45
2022-05-08,West Bengal,319,3,317,3314,1316,1029,9.63,0,99.6,684660,5769,680878,1.32,1.03,0.03327309236947791,0.84,99.45
2022-05-09,West Bengal,287,1,284,3728,2296,1437,7.7,2,99.6,684947,5770,681162,2.31,1.44,0.037429718875502005,0.84,99.45
2022-05-10,West Bengal,710,2,704,8835,172,45,8.04,4,99.6,685657,5772,681866,0.17,0.05,0.08870481927710844,0.84,99.45
2022-05-11,West Bengal,1415,17,1408,17564,431,65,8.06,0,99.6,687072,5789,683274,0.43,0.07,0.1763453815261044,0.84,99.45
2022-05-12,West Bengal,946,13,944,12260,3872,1213,7.72,0,99.6,688018,5802,684218,3.89,1.22,0.12309236947791165,0.84,99.45
2022-05-13,West Bengal,400,3,397,5271,4849,4021,7.59,0,99.6,688418,5805,684615,4.87,4.04,0.05292168674698795,0.84,99.45
2022-05-14,West Bengal,187,0,180,2834,562,367,6.6,7,99.6,688605,5805,684795,0.56,0.37,0.028453815261044176,0.84,99.45
2022-05-15,West Bengal,490,5,483,6159,2540,1497,7.96,2,99.6,689095,5810,685278,2.55,1.5,0.06183734939759036,0.84,99.45
2022-05-16,West Bengal,426,5,426,5172,795,223,8.24,0,99.6,689521,5815,685704,0.8,0.22,0.05192771084337349,0.84,99.45
2022-05-17,West Bengal,72,0,66,1083,3184,826,6.65,6,99.6,689593,5815,685770,3.2,0.83,0.010873493975903615,0.84,99.45
2022-05-18,West Bengal,1355,18,1346,17170,215,186,7.89,0,99.6,690948,5833,687116,0.22,0.19,0.17238955823293173,0.84,99.45
2022-05-19,West Bengal,1342,13,1340,17130,3904,3558,7.83,0,99.6,692290,5846,688456,3.92,3.57,0.17198795180722892,0.84,99.45
2022-05-20,West Bengal,469,2,462,6303,2052,192,7.44,5,99.6,692759,5848,688918,2.06,0.19,0.06328313253012048,0.84,99.45
2022-05-21,West Bengal,1000,10,993,12970,84,70,7.71,0,99.6,693759,5858,689911,0.08,0.07,0.13022088353413655,0.84,99.45
2022-05-22,West Bengal,948,9,945,12295,4268,317,7.71,0,99.6,694707,5867,690856,4.29,0.32,0.12344377510040161,0.84,99.45
2022-05-23,West Bengal,1581,14,1577,19891,20,6,7.95,0,99.6,696288,5881,692433,0.02,0.01,0.19970883534136546,0.84,99.45
2022-05-24,West Bengal,1500,11,1493,18576,1826,1123,8.07,0,99.6,697788,5892,693926,1.83,1.13,0.18650602409638553,0.84,99.45
2022-05-25,West Bengal,190,0,188,2494,867,177,7.62,2,99.6,697978,5892,694114,0.87,0.18,0.02504016064257028,0.84,99.45
2022-05-26,West Bengal,1486,10,1480,18408,2499,2460,8.07,0,99.6,699464,5902,695594,2.51,2.47,0.18481927710843374,0.84,99.45
2022-05-27,West Bengal,1575,5,1575,19954,31,27,7.89,0,99.6,701039,5907,697169,0.03,0.03,0.2003413654618474,0.84,99.45
2022-05-28,West Bengal,77,0,69,1080,1418,898,7.13,8,99.6,701116,5907,697238,1.42,0.9,0.010843373493975903,0.84,99.45
2022-05-29,West Bengal,821,4,818,9953,3222,1328,8.25,0,99.6,701937,5911,698056,3.23,1.33,0.099929718875502,0.84,99.45
2022-05-30,West Bengal,1563,20,1560,19360,3555,2057,8.07,0,99.6,703500,5931,699616,3.57,2.07,0.19437751004016066,0.84,99.45
2022-05-31,West Bengal,768,10,760,9945,1462,141,7.72,0,99.6,704268,5941,700376,1.47,0.14,0.09984939759036145,0.84,99.45
2022-06-01,West Bengal,256,2,254,3202,3973,2563,8.0,0,99.6,704524,5943,700630,3.99,2.57,0.03214859437751004,0.84,99.45
2022-06-02,West Bengal,571,5,567,7092,587,362,8.05,0,99.6,705095,5948,701197,0.59,0.36,0.07120481927710844,0.84,99.45
2022-06-03,West Bengal,525,5,521,6811,4246,3996,7.71,0,99.6,705620,5953,701718,4.26,4.01,0.06838353413654619,0.84,99.45
2022-06-04,West Bengal,1422,7,1413,17612,1692,1682,8.07,2,99.6,707042,5960,703131,1.7,1.69,0.17682730923694778,0.84,99.45
2022-06-05,West Bengal,96,0,94,1946,2431,2291,4.93,2,99.6,707138,5960,703225,2.44,2.3,0.019538152610441766,0.84,99.45
2022-06-06,West Bengal,931,12,924,11756,2814,437,7.92,0,99.6,708069,5972,704149,2.83,0.44,0.11803212851405623,0.84,99.45
2022-06-07,West Bengal,169,0,163,1807,4047,1267,9.35,6,99.6,708238,5972,704312,4.06,1.27,0.0181425702811245,0.84,99.45
2022-06-08,West Bengal,848,10,846,10628,1617,1543,7.98,0,99.6,709086,5982,705158,1.62,1.55,0.10670682730923695,0.84,99.45
2022-06-09,West Bengal,1056,12,1050,13669,4799,3486,7.73,0,99.6,710142,5994,706208,4.82,3.5,0.13723895582329318,0.84,99.45
2022-06-10,West Bengal,878,4,873,10693,2199,555,8.21,1,99.6,711020,5998,707081,2.21,0.56,0.10735943775100401,0.84,99.45
2022-06-11,West Bengal,330,4,330,3907,3277,866,8.45,0,99.6,711350,6002,707411,3.29,0.87,0.03922690763052209,0.84,99.45
2022-06-12,West Bengal,77,0,77,1033,2353,932,7.45,0,99.6,711427,6002,707488,2.36,0.94,0.010371485943775101,0.84,99.45
2022-06-13,West Bengal,1340,6,1335,16661,1328,1309,8.04,0,99.6,712767,6008,708823,1.33,1.31,0.16727911646586346,0.84,99.45
2022-06-14,West Bengal,186,1,184,2421,2205,1934,7.68,1,99.6,712953,6009,709007,2.21,1.94,0.02430722891566265,0.84,99.45
2022-06-15,West Bengal,980,10,977,11930,2559,1635,8.21,0,99.6,713933,6019,709984,2.57,1.64,0.11977911646586345,0.84,99.45
2022-06-16,West Bengal,639,4,639,8162,3421,1682,7.83,0,99.6,714572,6023,710623,3.43,1.69,0.08194779116465864,0.84,99.45
2022-06-17,West Bengal,633,2,626,8102,3914,2879,7.81,5,99.6,715205,6025,711249,3.93,2.89,0.08134538152610442,0.84,99.45
2022-06-18,West Bengal,42,0,34,611,2046,966,6.87,8,99.6,715247,6025,711283,2.05,0.97,0.006134538152610442,0.84,99.45
2022-06-19,West Bengal,1042,15,1037,12855,1372,98,8.11,0,99.6,716289,6040,712320,1.38,0.1,0.12906626506024096,0.84,99.45
2022-06-20,West Bengal,1082,10,1079,13176,3244,1217,8.21,0,99.6,717371,6050,713399,3.26,1.22,0.13228915662650603,0.84,99.45
2022-06-21,West Bengal,663,5,659,8148,1560,425,8.14,0,99.6,718034,6055,714058,1.57,0.43,0.08180722891566265,0.84,99.45
2022-06-22,West Bengal,1176,13,1174,14843,4436,2132,7.92,0,99.6,719210,6068,715232,4.45,2.14,0.1490261044176707,0.84,99.45
2022-06-23,West Bengal,1159,16,1159,14482,4186,3872,8.0,0,99.6,720369,6084,716391,4.2,3.89,0.14540160642570282,0.84,99.45
2022-06-24,West Bengal,643,9,643,8123,91,84,7.92,0,99.6,721012,6093,717034,0.09,0.08,0.08155622489959839,0.85,99.45
2022-06-25,West Bengal,947,9,947,11935,4092,3601,7.93,0,99.6,721959,6102,717981,4.11,3.62,0.11982931726907631,0.85,99.45
2022-06-26,West Bengal,37,0,31,527,2935,1632,7.02,6,99.6,721996,6102,718012,2.95,1.64,0.0052911646586345385,0.85,99.45
2022-06-27,West Bengal,504,6,498,6607,3652,2948,7.63,0,99.6,722500,6108,718510,3.67,2.96,0.06633534136546185,0.85,99.45
2022-06-28,West Bengal,1630,22,1624,19792,2569,630,8.24,0,99.6,724130,6130,720134,2.58,0.63,0.198714859437751,0.85,99.45
2022-06-29,West Bengal,93,1,90,1816,3954,3790,5.12,2,99.6,724223,6131,720224,3.97,3.81,0.018232931726907632,0.85,99.45
2022-06-30,West Bengal,256,2,253,3663,2901,2059,6.99,1,99.6,724479,6133,720477,2.91,2.07,0.03677710843373494,0.85,99.45
2022-07-01,West Bengal,789,2,784,9861,3627,1746,8.0,3,99.6,725268,6135,721261,3.64,1.75,0.09900602409638554,0.85,99.45
2022-07-02,West Bengal,1281,15,1277,16172,2554,433,7.92,0,99.6,726549,6150,722538,2.56,0.43,0.16236947791164658,0.85,99.45
2022-07-03,West Bengal,339,3,339,4218,3193,2646,8.04,0,99.6,726888,6153,722877,3.21,2.66,0.042349397590361444,0.85,99.45
2022-07-04,West Bengal,1219,16,1217,15380,2619,357,7.93,0,99.6,728107,6169,724094,2.63,0.36,0.15441767068273093,0.85,99.45
2022-07-05,West Bengal,624,9,615,7762,473,341,8.04,0,99.6,728731,6178,724709,0.47,0.34,0.07793172690763052,0.85,99.45
2022-07-06,West Bengal,708,4,705,8763,733,5,8.08,0,99.6,729439,6182,725414,0.74,0.01,0.08798192771084337,0.85,99.45
2022-07-07,West Bengal,685,3,678,8592,3079,3031,7.97,4,99.6,730124,6185,726092,3.09,3.04,0.08626506024096385,0.85,99.45
2022-07-08,West Bengal,1299,7,1292,16049,390,152,8.09,0,99.6,731423,6192,727384,0.39,0.15,0.16113453815261045,0.85,99.45
2022-07-09,West Bengal,821,3,815,10196,849,595,8.05,3,99.6,732244,6195,728199,0.85,0.6,0.10236947791164659,0.85,99.45
2022-07-10,West Bengal,207,2,200,2518,4971,1489,8.22,5,99.6,732451,6197,728399,4.99,1.49,0.02528112449799197,0.85,99.45
2022-07-11,West Bengal,480,3,479,5919,1288,584,8.11,0,99.6,732931,6200,728878,1.29,0.59,0.05942771084337349,0.85,99.45
2022-07-12,West Bengal,121,1,121,997,2111,2025,12.14,0,99.6,733052,6201,728999,2.12,2.03,0.01001004016064257,0.85,99.45
2022-07-13,West Bengal,741,8,734,9032,1238,173,8.2,0,99.6,733793,6209,729733,1.24,0.17,0.09068273092369478,0.85,99.45
2022-07-14,West Bengal,458,5,455,5300,3712,2055,8.64,0,99.6,734251,6214,730188,3.73,2.06,0.05321285140562249,0.85,99.45
2022-07-15,West Bengal,95,0,87,1398,4342,2955,6.8,8,99.6,734346,6214,730275,4.36,2.97,0.014036144578313254,0.85,99.45
2022-07-16,West Bengal,383,5,375,5002,1668,575,7.66,3,99.6,734729,6219,730650,1.67,0.58,0.05022088353413655,0.85,99.44
2022-07-17,West Bengal,582,6,573,7177,4992,2259,8.11,3,99.6,735311,6225,731223,5.01,2.27,0.0720582329317269,0.85,99.44
2022-07-18,West Bengal,1538,5,1529,18985,2655,2611,8.1,4,99.6,736849,6230,732752,2.67,2.62,0.19061244979919678,0.85,99.44
2022-07-19,West Bengal,124,1,117,1698,3545,1653,7.3,6,99.6,736973,6231,732869,3.56,1.66,0.01704819277108434,0.85,99.44
2022-07-20,West Bengal,638,7,638,7969,734,442,8.01,0,99.6,737611,6238,733507,0.74,0.44,0.08001004016064257,0.85,99.44
2022-07-21,West Bengal,260,3,254,2974,1715,1052,8.74,3,99.6,737871,6241,733761,1.72,1.06,0.029859437751004015,0.85,99.44
2022-07-22,West Bengal,1444,19,1441,18036,1592,136,8.01,0,99.6,739315,6260,735202,1.6,0.14,0.18108433734939758,0.85,99.44
2022-07-23,West Bengal,436,3,435,5467,923,498,7.98,0,99.6,739751,6263,735637,0.93,0.5,0.05488955823293173,0.85,99.44
2022-07-24,West Bengal,238,3,234,2827,3370,880,8.42,1,99.6,739989,6266,735871,3.38,0.88,0.028383534136546186,0.85,99.44
2022-07-25,West Bengal,934,4,931,11771,4518,3476,7.93,0,99.6,740923,6270,736802,4.54,3.49,0.11818273092369477,0.85,99.44
2022-07-26,West Bengal,400,4,392,5212,2406,2376,7.67,4,99.6,741323,6274,737194,2.42,2.39,0.0523293172690763,0.85,99.44
2022-07-27,West Bengal,117,0,109,1372,1018,366,8.53,8,99.6,741440,6274,737303,1.02,0.37,0.013775100401606425,0.85,99.44
2022-07-28,West Bengal,75,0,74,928,1805,822,8.08,1,99.6,741515,6274,737377,1.81,0.83,0.00931726907630522,0.85,99.44
2022-07-29,West Bengal,576,4,572,6949,2616,1103,8.29,0,99.6,742091,6278,737949,2.63,1.11,0.06976907630522089,0.85,99.44
2022-07-30,West Bengal,964,4,963,12246,4829,3627,7.87,0,99.6,743055,6282,738912,4.85,3.64,0.12295180722891566,0.85,99.44
2022-07-31,West Bengal,556,6,547,6969,2374,1219,7.98,3,99.6,743611,6288,739459,2.38,1.22,0.06996987951807229,0.85,99.44
2022-08-01,West Bengal,270,1,266,3563,100,82,7.58,3,99.6,743881,6289,739725,0.1,0.08,0.03577309236947791,0.85,99.44
2022-08-02,West Bengal,1124,15,1118,13961,2740,461,8.05,0,99.6,745005,6304,740843,2.75,0.46,0.1401706827309237,0.85,99.44
2022-08-03,West Bengal,581,6,580,7399,2265,1416,7.85,0,99.6,745586,6310,741423,2.27,1.42,0.07428714859437752,0.85,99.44
2022-08-04,West Bengal,1370,9,1367,17306,4544,2820,7.92,0,99.6,746956,6319,742790,4.56,2.83,0.1737550200803213,0.85,99.44
2022-08-05,West Bengal,1552,21,1546,19816,120,99,7.83,0,99.6,748508,6340,744336,0.12,0.1,0.19895582329317268,0.85,99.44
2022-08-06,West Bengal,1151,4,1148,14264,4526,2983,8.07,0,99.6,749659,6344,745484,4.54,2.99,0.14321285140562248,0.85,99.44
2022-08-07,West Bengal,428,1,420,4939,2317,1539,8.67,7,99.6,750087,6345,745904,2.33,1.55,0.04958835341365462,0.85,99.44
2022-08-08,West Bengal,585,3,581,7455,3740,3505,7.85,1,99.6,750672,6348,746485,3.76,3.52,0.07484939759036145,0.85,99.44
2022-08-09,West Bengal,190,1,188,2063,4609,3202,9.21,1,99.6,750862,6349,746673,4.63,3.21,0.02071285140562249,0.85,99.44
2022-08-10,West Bengal,423,5,416,5570,1832,991,7.59,2,99.6,751285,6354,747089,1.84,0.99,0.05592369477911647,0.85,99.44
2022-08-11,West Bengal,397,3,388,5014,1150,684,7.92,6,99.6,751682,6357,747477,1.15,0.69,0.05034136546184739,0.85,99.44
2022-08-12,West Bengal,165,1,163,1920,4195,2383,8.59,1,99.6,751847,6358,747640,4.21,2.39,0.01927710843373494,0.85,99.44
2022-08-13,West Bengal,1406,6,1400,17654,3381,1929,7.96,0,99.6,753253,6364,749040,3.39,1.94,0.17724899598393573,0.84,99.44
2022-08-14,West Bengal,1097,11,1097,13729,4653,1493,7.99,0,99.6,754350,6375,750137,4.67,1.5,0.1378413654618474,0.85,99.44
2022-08-15,West Bengal,1499,14,1495,18661,866,559,8.03,0,99.6,755849,6389,751632,0.87,0.56,0.18735943775100403,0.85,99.44
2022-08-16,West Bengal,1329,7,1328,16472,1761,45,8.07,0,99.6,757178,6396,752960,1.77,0.05,0.16538152610441767,0.84,99.44
2022-08-17,West Bengal,841,10,839,10158,3689,3568,8.28,0,99.6,758019,6406,753799,3.7,3.58,0.10198795180722892,0.85,99.44
2022-08-18,West Bengal,1389,20,1389,17223,1446,71,8.06,0,99.6,759408,6426,755188,1.45,0.07,0.17292168674698796,0.85,99.44
2022-08-19,West Bengal,295,2,292,3756,590,14,7.85,1,99.6,759703,6428,755480,0.59,0.01,0.03771084337349397,0.85,99.44
2022-08-20,West Bengal,1255,9,1248,15880,3313,2632,7.9,0,99.6,760958,6437,756728,3.33,2.64,0.15943775100401605,0.85,99.44
2022-08-21,West Bengal,1363,4,1361,16920,2031,22,8.06,0,99.6,762321,6441,758089,2.04,0.02,0.16987951807228915,0.84,99.44
2022-08-22,West Bengal,298,1,297,3643,453,81,8.18,0,99.6,762619,6442,758386,0.45,0.08,0.03657630522088354,0.84,99.44
2022-08-23,West Bengal,366,5,366,5064,3740,1005,7.23,0,99.6,762985,6447,758752,3.76,1.01,0.050843373493975906,0.84,99.45
2022-08-24,West Bengal,816,7,807,10353,388,12,7.88,2,99.6,763801,6454,759559,0.39,0.01,0.10394578313253013,0.84,99.44
2022-08-25,West Bengal,507,2,503,6351,1366,1004,7.98,2,99.6,764308,6456,760062,1.37,1.01,0.06376506024096386,0.84,99.44
2022-08-26,West Bengal,218,2,213,2718,757,659,8.02,3,99.6,764526,6458,760275,0.76,0.66,0.027289156626506023,0.84,99.44
2022-08-27,West Bengal,787,9,782,9911,3829,155,7.94,0,99.6,765313,6467,761057,3.84,0.16,0.09950803212851406,0.85,99.44
2022-08-28,West Bengal,1066,13,1061,13271,3345,1931,8.03,0,99.6,766379,6480,762118,3.36,1.94,0.1332429718875502,0.85,99.44
2022-08-29,West Bengal,1511,6,1507,18913,4490,2230,7.99,0,99.6,767890,6486,763625,4.51,2.24,0.18988955823293172,0.84,99.44
2022-08-30,West Bengal,1417,18,1413,17567,3044,2433,8.07,0,99.6,769307,6504,765038,3.06,2.44,0.17637550200803212,0.85,99.45
2022-08-31,West Bengal,1351,18,1351,16697,2611,1849,8.09,0,99.6,770658,6522,766389,2.62,1.86,0.16764056224899598,0.85,99.45
2022-09-01,West Bengal,318,1,310,4352,278,91,7.31,7,99.6,770976,6523,766699,0.28,0.09,0.04369477911646586,0.85,99.45
2022-09-02,West Bengal,394,2,386,4939,2869,769,7.98,6,99.6,771370,6525,767085,2.88,0.77,0.04958835341365462,0.85,99.44
2022-09-03,West Bengal,262,3,253,3443,782,12,7.61,6,99.6,771632,6528,767338,0.79,0.01,0.03456827309236948,0.85,99.44
2022-09-04,West Bengal,575,5,567,7237,4104,3064,7.95,3,99.6,772207,6533,767905,4.12,3.08,0.07266064257028113,0.85,99.44
2022-09-05,West Bengal,1152,16,1152,14701,510,326,7.84,0,99.6,773359,6549,769057,0.51,0.33,0.1476004016064257,0.85,99.44
2022-09-06,West Bengal,1392,17,1389,17397,3730,1057,8.0,0,99.6,774751,6566,770446,3.74,1.06,0.17466867469879518,0.85,99.44
2022-09-07,West Bengal,270,2,264,3507,3343,1906,7.7,4,99.6,775021,6568,770710,3.36,1.91,0.03521084337349398,0.85,99.44
2022-09-08,West Bengal,782,5,778,9710,3751,1018,8.05,0,99.6,775803,6573,771488,3.77,1.02,0.09748995983935743,0.85,99.44
2022-09-09,West Bengal,188,0,181,2722,4869,3667,6.91,7,99.6,775991,6573,771669,4.89,3.68,0.027329317269076305,0.85,99.44
2022-09-10,West Bengal,1560,12,1555,19331,1673,1193,8.07,0,99.6,777551,6585,773224,1.68,1.2,0.1940863453815261,0.85,99.44
2022-09-11,West Bengal,1421,15,1412,17754,527,131,8.0,0,99.6,778972,6600,774636,0.53,0.13,0.17825301204819277,0.85,99.44
2022-09-12,West Bengal,933,5,924,12021,979,28,7.76,4,99.6,779905,6605,775560,0.98,0.03,0.12069277108433735,0.85,99.44
2022-09-13,West Bengal,700,3,693,8897,24,15,7.87,4,99.6,780605,6608,776253,0.02,0.02,0.08932730923694779,0.85,99.44
2022-09-14,West Bengal,270,3,266,3276,2170,90,8.24,1,99.6,780875,6611,776519,2.18,0.09,0.03289156626506024,0.85,99.44
2022-09-15,West Bengal,559,3,554,6398,4245,4202,8.74,2,99.6,781434,6614,777073,4.26,4.22,0.06423694779116466,0.85,99.44
2022-09-16,West Bengal,1076,15,1067,13147,1165,562,8.18,0,99.6,782510,6629,778140,1.17,0.56,0.1319979919678715,0.85,99.44
2022-09-17,West Bengal,1194,10,1191,14689,4547,978,8.13,0,99.6,783704,6639,779331,4.57,0.98,0.14747991967871485,0.85,99.44
2022-09-18,West Bengal,191,2,191,2088,2182,271,9.15,0,99.6,783895,6641,779522,2.19,0.27,0.020963855421686748,0.85,99.44
2022-09-19,West Bengal,1410,11,1408,17859,291,1,7.9,0,99.6,785305,6652,780930,0.29,0.0,0.17930722891566264,0.85,99.44
2022-09-20,West Bengal,313,3,305,3843,4679,2256,8.14,5,99.6,785618,6655,781235,4.7,2.27,0.03858433734939759,0.85,99.44
2022-09-21,West Bengal,1462,6,1456,18093,3121,1557,8.08,0,99.6,787080,6661,782691,3.13,1.56,0.1816566265060241,0.85,99.44
2022-09-22,West Bengal,471,6,463,5985,669,602,7.87,2,99.6,787551,6667,783154,0.67,0.6,0.060090361445783134,0.85,99.44
2022-09-23,West Bengal,1557,5,1556,19467,4382,2726,8.0,0,99.6,789108,6672,784710,4.4,2.74,0.19545180722891567,0.85,99.44
2022-09-24,West Bengal,994,4,988,12373,4373,1683,8.03,2,99.6,790102,6676,785698,4.39,1.69,0.12422690763052209,0.84,99.44
2022-09-25,West Bengal,628,7,624,8050,2765,601,7.8,0,99.6,790730,6683,786322,2.78,0.6,0.08082329317269077,0.85,99.44
2022-09-26,West Bengal,1522,15,1514,18983,2944,1058,8.02,0,99.6,792252,6698,787836,2.96,1.06,0.19059236947791164,0.85,99.44
2022-09-27,West Bengal,619,3,618,7748,2731,230,7.99,0,99.6,792871,6701,788454,2.74,0.23,0.07779116465863453,0.85,99.44
2022-09-28,West Bengal,101,1,100,1382,1756,1034,7.31,0,99.6,792972,6702,788554,1.76,1.04,0.013875502008032128,0.85,99.44
2022-09-29,West Bengal,1344,12,1335,16985,1000,551,7.91,0,99.6,794316,6714,789889,1.0,0.55,0.17053212851405622,0.85,99.44
2022-09-30,West Bengal,1028,6,1021,12554,1219,1181,8.19,1,99.6,795344,6720,790910,1.22,1.19,0.1260441767068273,0.84,99.44
2022-10-01,West Bengal,331,1,331,4331,2665,2002,7.64,0,99.6,795675,6721,791241,2.68,2.01,0.04348393574297189,0.84,99.44
2022-10-02,West Bengal,922,9,922,11227,3411,863,8.21,0,99.6,796597,6730,792163,3.42,0.87,0.11272088353413655,0.84,99.44
2022-10-03,West Bengal,1099,10,1098,13770,2537,626,7.98,0,99.6,797696,6740,793261,2.55,0.63,0.13825301204819276,0.84,99.44
2022-10-04,West Bengal,232,2,230,2439,3459,656,9.51,0,99.6,797928,6742,793491,3.47,0.66,0.024487951807228917,0.84,99.44
2022-10-05,West Bengal,941,11,935,11351,3598,1368,8.29,0,99.6,798869,6753,794426,3.61,1.37,0.11396586345381526,0.85,99.44
2022-10-06,West Bengal,179,1,171,2164,136,23,8.27,7,99.6,799048,6754,794597,0.14,0.02,0.02172690763052209,0.85,99.44
2022-10-07,West Bengal,499,6,499,5934,1877,514,8.41,0,99.6,799547,6760,795096,1.88,0.52,0.05957831325301205,0.85,99.44
2022-10-08,West Bengal,745,11,742,9505,1451,273,7.84,0,99.6,800292,6771,795838,1.46,0.27,0.09543172690763052,0.85,99.44
2022-10-09,West Bengal,1273,15,1267,16089,678,449,7.91,0,99.6,801565,6786,797105,0.68,0.45,0.16153614457831325,0.85,99.44
2022-10-10,West Bengal,1150,14,1141,14561,2381,5,7.9,0,99.6,802715,6800,798246,2.39,0.01,0.14619477911646586,0.85,99.44
2022-10-11,West Bengal,1270,17,1269,15109,3625,857,8.41,0,99.6,803985,6817,799515,3.64,0.86,0.1516967871485944,0.85,99.44
2022-10-12,West Bengal,691,4,691,8628,2937,1670,8.01,0,99.6,804676,6821,800206,2.95,1.68,0.08662650602409638,0.85,99.44
2022-10-13,West Bengal,1160,7,1158,14744,3561,2404,7.87,0,99.6,805836,6828,801364,3.58,2.41,0.14803212851405623,0.85,99.45
2022-10-14,West Bengal,419,2,411,4911,866,546,8.53,6,99.6,806255,6830,801775,0.87,0.55,0.04930722891566265,0.85,99.44
2022-10-15,West Bengal,1371,18,1367,16871,885,549,8.13,0,99.6,807626,6848,803142,0.89,0.55,0.1693875502008032,0.85,99.44
2022-10-16,West Bengal,432,4,423,5561,4004,1664,7.77,5,99.6,808058,6852,803565,4.02,1.67,0.05583333333333333,0.85,99.44
2022-10-17,West Bengal,629,6,628,8077,2980,1798,7.79,0,99.6,808687,6858,804193,2.99,1.81,0.08109437751004016,0.85,99.44
2022-10-18,West Bengal,1006,8,997,12800,1976,277,7.86,1,99.6,809693,6866,805190,1.98,0.28,0.1285140562248996,0.85,99.44
2022-10-19,West Bengal,702,5,698,8970,1936,437,7.83,0,99.6,810395,6871,805888,1.94,0.44,0.09006024096385543,0.85,99.44
2022-10-20,West Bengal,950,4,941,11656,1274,302,8.15,5,99.6,811345,6875,806829,1.28,0.3,0.1170281124497992,0.85,99.44
2022-10-21,West Bengal,860,9,856,10719,1961,1151,8.02,0,99.6,812205,6884,807685,1.97,1.16,0.10762048192771084,0.85,99.44
2022-10-22,West Bengal,1290,11,1284,15800,4203,2916,8.16,0,99.6,813495,6895,808969,4.22,2.93,0.15863453815261044,0.85,99.44
2022-10-23,West Bengal,809,4,802,9669,1838,1447,8.37,3,99.6,814304,6899,809771,1.85,1.45,0.09707831325301204,0.85,99.44
2022-10-24,West Bengal,1573,12,1570,19862,814,588,7.92,0,99.6,815877,6911,811341,0.82,0.59,0.19941767068273092,0.85,99.44
2022-10-25,West Bengal,357,4,351,4717,177,54,7.57,2,99.6,816234,6915,811692,0.18,0.05,0.04735943775100401,0.85,99.44
2022-10-26,West Bengal,1338,12,1331,16786,134,93,7.97,0,99.6,817572,6927,813023,0.13,0.09,0.16853413654618474,0.85,99.44
2022-10-27,West Bengal,1158,6,1150,14494,4919,2341,7.99,2,99.6,818730,6933,814173,4.94,2.35,0.14552208835341365,0.85,99.44
2022-10-28,West Bengal,1515,21,1508,18832,2877,2385,8.04,0,99.6,820245,6954,815681,2.89,2.39,0.18907630522088353,0.85,99.44
2022-10-29,West Bengal,1172,16,1168,14312,353,345,8.19,0,99.6,821417,6970,816849,0.35,0.35,0.14369477911646586,0.85,99.44
2022-10-30,West Bengal,468,6,465,5949,4640,4252,7.87,0,99.6,821885,6976,817314,4.66,4.27,0.0597289156626506,0.85,99.44
2022-10-31,West Bengal,972,14,968,11998,1898,674,8.1,0,99.6,822857,6990,818282,1.91,0.68,0.12046184738955823,0.85,99.44
2022-11-01,West Bengal,1055,12,1054,12911,3607,577,8.17,0,99.6,823912,7002,819336,3.62,0.58,0.12962851405622489,0.85,99.44
2022-11-02,West Bengal,378,2,376,4618,4349,1099,8.19,0,99.6,824290,7004,819712,4.37,1.1,0.04636546184738956,0.85,99.44
2022-11-03,West Bengal,1088,7,1088,13176,3502,541,8.26,0,99.6,825378,7011,820800,3.52,0.54,0.13228915662650603,0.85,99.45
2022-11-04,West Bengal,324,3,319,4244,1711,1470,7.63,2,99.6,825702,7014,821119,1.72,1.48,0.042610441767068276,0.85,99.44
2022-11-05,West Bengal,1372,8,1369,17859,487,219,7.68,0,99.6,827074,7022,822488,0.49,0.22,0.17930722891566264,0.85,99.45
2022-11-06,West Bengal,1122,4,1119,13756,682,46,8.16,0,99.6,828196,7026,823607,0.68,0.05,0.1381124497991968,0.85,99.45
2022-11-07,West Bengal,674,9,667,8260,1255,827,8.16,0,99.6,828870,7035,824274,1.26,0.83,0.08293172690763052,0.85,99.45
2022-11-08,West Bengal,1156,11,1155,14745,1162,3,7.84,0,99.6,830026,7046,825429,1.17,0.0,0.1480421686746988,0.85,99.45
2022-11-09,West Bengal,1267,17,1259,15498,1844,635,8.18,0,99.6,831293,7063,826688,1.85,0.64,0.1556024096385542,0.85,99.45
2022-11-10,West Bengal,456,5,451,5481,1535,548,8.32,0,99.6,831749,7068,827139,1.54,0.55,0.05503012048192771,0.85,99.45
2022-11-11,West Bengal,672,4,670,8388,2482,1686,8.01,0,99.6,832421,7072,827809,2.49,1.69,0.08421686746987952,0.85,99.45
2022-11-12,West Bengal,781,5,776,9488,156,29,8.23,0,99.6,833202,7077,828585,0.16,0.03,0.09526104417670683,0.85,99.45
2022-11-13,West Bengal,181,1,172,2436,95,82,7.43,8,99.6,833383,7078,828757,0.1,0.08,0.024457831325301205,0.85,99.44
2022-11-14,West Bengal,623,5,617,7677,2681,1180,8.12,1,99.6,834006,7083,829374,2.69,1.18,0.07707831325301205,0.85,99.44
2022-11-15,West Bengal,1245,9,1241,15733,3158,1857,7.91,0,99.6,835251,7092,830615,3.17,1.86,0.15796184738955824,0.85,99.44
2022-11-16,West Bengal,305,0,303,3692,3358,246,8.26,2,99.6,835556,7092,830918,3.37,0.25,0.03706827309236948,0.85,99.44
2022-11-17,West Bengal,373,3,367,4096,1415,1201,9.11,3,99.6,835929,7095,831285,1.42,1.21,0.04112449799196787,0.85,99.44
2022-11-18,West Bengal,51,0,47,1086,1693,907,4.7,4,99.6,835980,7095,831332,1.7,0.91,0.010903614457831326,0.85,99.44
2022-11-19,West Bengal,777,4,776,10036,2287,2055,7.74,0,99.6,836757,7099,832108,2.3,2.06,0.10076305220883534,0.85,99.44
2022-11-20,West Bengal,427,4,425,5378,200,108,7.94,0,99.6,837184,7103,832533,0.2,0.11,0.053995983935742974,0.85,99.44
2022-11-21,West Bengal,287,1,279,3733,3049,1496,7.69,7,99.6,837471,7104,832812,3.06,1.5,0.03747991967871486,0.85,99.44
2022-11-22,West Bengal,188,1,186,2174,4220,346,8.65,1,99.6,837659,7105,832998,4.24,0.35,0.02182730923694779,0.85,99.44
2022-11-23,West Bengal,1073,5,1072,13809,3079,2026,7.77,0,99.6,838732,7110,834070,3.09,2.03,0.13864457831325303,0.85,99.44
2022-11-24,West Bengal,684,3,676,8325,1447,174,8.22,5,99.6,839416,7113,834746,1.45,0.17,0.08358433734939759,0.85,99.44
2022-11-25,West Bengal,133,0,125,1961,586,73,6.78,8,99.6,839549,7113,834871,0.59,0.07,0.01968875502008032,0.85,99.44
2022-11-26,West Bengal,273,2,268,3266,439,285,8.36,3,99.6,839822,7115,835139,0.44,0.29,0.03279116465863454,0.85,99.44
2022-11-27,West Bengal,415,3,414,5555,3833,3183,7.47,0,99.6,840237,7118,835553,3.85,3.2,0.05577309236947791,0.85,99.44
2022-11-28,West Bengal,1005,5,999,12693,1554,259,7.92,1,99.6,841242,7123,836552,1.56,0.26,0.12743975903614457,0.85,99.44
2022-11-29,West Bengal,928,11,927,11673,3554,1479,7.95,0,99.6,842170,7134,837479,3.57,1.48,0.11719879518072289,0.85,99.44
2022-11-30,West Bengal,96,0,87,1456,1322,636,6.59,9,99.6,842266,7134,837566,1.33,0.64,0.014618473895582329,0.85,99.44
2022-12-01,West Bengal,288,2,283,3653,4922,3172,7.88,3,99.6,842554,7136,837849,4.94,3.18,0.03667670682730924,0.85,99.44
2022-12-02,West Bengal,487,3,486,5706,3907,1754,8.53,0,99.6,843041,7139,838335,3.92,1.76,0.05728915662650602,0.85,99.44
2022-12-03,West Bengal,1562,15,1562,19538,405,43,7.99,0,99.6,844603,7154,839897,0.41,0.04,0.19616465863453816,0.85,99.44
2022-12-04,West Bengal,234,2,229,3083,673,261,7.59,3,99.6,844837,7156,840126,0.68,0.26,0.03095381526104418,0.85,99.44
2022-12-05,West Bengal,1083,5,1074,13712,2369,1363,7.9,4,99.6,845920,7161,841200,2.38,1.37,0.1376706827309237,0.85,99.44
2022-12-06,West Bengal,670,4,664,8514,4282,2863,7.87,2,99.6,846590,7165,841864,4.3,2.87,0.08548192771084337,0.85,99.44
2022-12-07,West Bengal,969,10,968,11818,1607,1364,8.2,0,99.6,847559,7175,842832,1.61,1.37,0.11865461847389558,0.85,99.44
2022-12-08,West Bengal,1000,9,1000,12123,3020,1279,8.25,0,99.6,848559,7184,843832,3.03,1.28,0.12171686746987952,0.85,99.44
2022-12-09,West Bengal,1368,7,1360,17005,1489,1047,8.04,1,99.6,849927,7191,845192,1.49,1.05,0.17073293172690762,0.85,99.44
2022-12-10,West Bengal,1430,15,1428,17800,3423,825,8.03,0,99.6,851357,7206,846620,3.44,0.83,0.178714859437751,0.85,99.44
2022-12-11,West Bengal,1433,13,1432,17777,389,50,8.06,0,99.6,852790,7219,848052,0.39,0.05,0.1784839357429719,0.85,99.44
2022-12-12,West Bengal,669,9,663,8152,2694,401,8.21,0,99.6,853459,7228,848715,2.7,0.4,0.08184738955823294,0.85,99.44
2022-12-13,West Bengal,1171,15,1163,14330,3373,1105,8.17,0,99.6,854630,7243,849878,3.39,1.11,0.14387550200803212,0.85,99.44
2022-12-14,West Bengal,1517,4,1516,19247,3873,2814,7.88,0,99.6,856147,7247,851394,3.89,2.83,0.1932429718875502,0.85,99.44
2022-12-15,West Bengal,1000,12,999,12797,1422,1069,7.81,0,99.6,857147,7259,852393,1.43,1.07,0.1284839357429719,0.85,99.45
2022-12-16,West Bengal,631,8,625,7471,151,8,8.45,0,99.6,857778,7267,853018,0.15,0.01,0.07501004016064257,0.85,99.45
2022-12-17,West Bengal,355,3,351,4249,1156,334,8.35,1,99.6,858133,7270,853369,1.16,0.34,0.042660642570281126,0.85,99.44
2022-12-18,West Bengal,236,2,230,2888,781,677,8.17,4,99.6,858369,7272,853599,0.78,0.68,0.028995983935742972,0.85,99.44
2022-12-19,West Bengal,361,3,355,4723,3193,1268,7.64,3,99.6,858730,7275,853954,3.21,1.27,0.047419678714859435,0.85,99.44
2022-12-20,West Bengal,1047,15,1044,12688,4447,3761,8.25,0,99.6,859777,7290,854998,4.46,3.78,0.12738955823293172,0.85,99.44
2022-12-21,West Bengal,649,8,641,8076,1383,1307,8.04,0,99.6,860426,7298,855639,1.39,1.31,0.08108433734939759,0.85,99.44
2022-12-22,West Bengal,394,5,386,4623,3264,174,8.52,3,99.6,860820,7303,856025,3.28,0.17,0.04641566265060241,0.85,99.44
2022-12-23,West Bengal,865,4,862,11346,81,11,7.62,0,99.6,861685,7307,856887,0.08,0.01,0.1139156626506024,0.85,99.44
2022-12-24,West Bengal,1418,12,1413,17399,1447,750,8.15,0,99.6,863103,7319,858300,1.45,0.75,0.17468875502008033,0.85,99.44
2022-12-25,West Bengal,1160,11,1151,14418,1438,1046,8.05,0,99.6,864263,7330,859451,1.44,1.05,0.1447590361445783,0.85,99.44
2022-12-26,West Bengal,300,1,297,3801,1446,458,7.89,2,99.6,864563,7331,859748,1.45,0.46,0.038162650602409635,0.85,99.44
2022-12-27,West Bengal,1095,13,1093,13601,1391,760,8.05,0,99.6,865658,7344,860841,1.4,0.76,0.1365562248995984,0.85,99.44
2022-12-28,West Bengal,1006,7,1006,12884,3609,2728,7.81,0,99.6,866664,7351,861847,3.62,2.74,0.1293574297188755,0.85,99.44
2022-12-29,West Bengal,540,8,537,6512,923,863,8.29,0,99.6,867204,7359,862384,0.93,0.87,0.06538152610441766,0.85,99.44
2022-12-30,West Bengal,193,1,193,2736,4501,3657,7.05,0,99.6,867397,7360,862577,4.52,3.67,0.02746987951807229,0.85,99.44
2022-12-31,West Bengal,1504,19,1496,18673,1382,117,8.05,0,99.6,868901,7379,864073,1.39,0.12,0.18747991967871486,0.85,99.44
